abbaba	sískyldfólk
abbabarn	sískyldfólk
abbabeiggi	sískyldfólk
abbabróðir	sískyldfólk
abbadadda	sískyldfólk
abbadidd	sískyldfólk
abbadidda	sískyldfólk
abbadóttir	sískyldfólk
abbaliga	síavlagdur
abbaligur	síavlagdur
abbar	sískyldfólk
abbasonur	sískyldfólk
abbasystir	sískyldfólk
abbi	sígamalmenni,skyldfólk
adjunktur	sílærarafólk
adressa	síboðan,bústaður,mótmæli
adressubók	síyvirlit
aðal	síaðalsfólk,hábærsligur,kjør
aðalborin	síhábærsligur
aðalendamál	síendamál
aðalevni	sítilfar,umrøðuevni
aðaleyðkenni	síeyðkenni
aðalfundur	sífundur
aðalhugsan	síhugsan
aðalhugtak	síhugsan
aðalhyrnissteinur	síbjarging,grót,undirlag
aðalinnihald	sítilfar,umrøðuevni
aðalkorn	síkjør
aðalligur	síhábærsligur
aðallyndi	símikilleiki
aðallýti	síbrek
aðalmaður	síaðalsfólk
aðalmunur	símunur
aðalnevnari	sínevnari
aðalorsøk	síorsøk
aðalregla	sígrundregla
aðalroynd	sípróvroynd
aðalsfólk	Samheiti:aðal,aðalmaður,aðalsfrúgv,aðalsmaður,aðalsætt,aðils-aðalsbarn, -kona o.fl.(stórmaður)edilingur,eðilingur,harramaður,harri,høvdingi,høvdingur,stoltsriddari,tignarfólk,tignarkona,tignarmaður,tívi,valdharri,valdsharri,valdsmaður,veldisharri,veldismaður,ættarhøvdingi(hástætt)harrastætt,yvirstætt(kongsevni)kongakyn,kongsætt↔hábærsligur,oddamaður,samfelagsstætt
aðalsfrúgv	síaðalsfólk
aðalsmaður	síaðalsfólk
aðalspurningur	síumrøðuevni
aðalstavur	sívald
aðalstjórn	sívald
aðalsætt	síaðalsfólk
aðalting	sífundur
aðalumboð	sívaramaður
aðalverk	síkjør
aðalverkfall	síverkfall
aðils-	síaðalsfólk
aðramáta	Samheiti:annanmáta,annars,hinvegin,umfram,umframtá annan hátt;á hin bógvin;har afturat, umframt;hin vegin;í aðrar mátar;mótsett kann sigast at...;og tó;tá ið eg hugsi meg um...↔andstaddur,harafturímótiAndheiti:á sama hátt
aðrastaðna	síburturstaddur
aðrastaðni	síburturstaddur
aðrastaðnis	síburturstaddur
aftan	sídimmiSamheiti:atfangadagur,atfangakvøld,brúdleypsaftan,budingsaftan,dýrabiðidagsaftan,hvítusunnuaftan,høgtíðisaftan,jóansøkuaftan,jólaaftan,kongaaftan,kyndilsmessuaftan,mikkjalsmessuaftan,nýggjársaftan,ólavsøkuaftan,páskaaftan,skírhósaftan,summarmálaaftan,tollaksmessuaftan,trettandaaftan↔hátíð,veitsluhald
aftaná	síaftureftir,ikki enn,síðani
aftanbøn	síbønarhald
aftanfyri	síhinumegin
aftanífrá	síframeftir,óbeinleiðis
aftanlestur	síbókalestur,bønarhald
aftansangur	síkirkjugangur
aftansfiskur	sífiskur
aftanskin	síljósglæma
aftansmatur	símatur
aftansneitt	síseyðamark
aftansongur	síkirkjugangur
aftanstund	sídimmi
aftantíð	sídimmi
aftanvarsil	síboða,boðan
aftastatá	sítá
aftastifingur	sífingur
aftastur	sítapa,tapari
aftna	sídimma,líða
aftra	síaftra seg
aftran	sídrál,ivasemi
aftraseg	Samheiti:aftrast,lánka,meinskast,skulka,sneiðaaftra, atra seg, sær;aftra sær á;bera, draga, hava seg undan;berast, dragast, havast, sigast undan;draga undan;einki vilja til at...;halda seg aftur;hava letisting, skúlastingir (t.e.) ikki (vilja) fara í skúla;hveppa, hvøppa seg við at...;hveppast við at...;ikki halda seg til;ikki hava hug at...;ikki vilja;skáka, skálka, sleppa, snúgva sær undan;skulka seg undan;vera lítið hugaður;vera malsjønskur, meinskur, óbeinasamur o.fl.;vera varin↔bíða,bíðan,ivast,latur,letast,leti,ófúsur,ógjarna,ræðast,smæðastAndheiti:vága sær
aftrast	síaftra seg,ivast
aftrat	síafturat
aftur	síaftureftir,afturlatin,umaftur
afturaftur	síumaftur
afturat	Samheiti:aftrat,afturvið,eisini,enn,enntá,eyka,eyks,eyksum,framíhjá,harafturat,hartil,harumframt,og...,omaná,pluss,umfram,umframt,uppíaftur at;aftur at tí;eins væl (og);fyri ikki at tala um...;har til kemur;har uppií, uppí;hvat tá alt hitt, hitt alt;í, sum viðbót;meira at siga;og eisini;saman við;so kanst tú ætla;sum alt annað;sum ískoyti;tá afturat;umframt tað(hava eyksum)hava til eyks;leggja afturat(vera umframt)ikki hoyra uppí;sita, vera til eyks;vera eyka;vera til at taka↔eykalutur,hjálp,hoyra til,ískoyti,leggja afturat,leypa av,skoyta,skoyti,tilsaman(s),til varavissu,vøksturAndheiti:frároknaður
afturatbygging	síbygging
afturatkoma	síeftirfylgja
afturatlagdur	síhoyra til
afturatløga	síískoyti
afturatyrking	sísangur
afturav	síaftureftir
afturá	síaftureftir
afturáaftur	síumaftur
afturábendur	sífattur
afturáboygdur	sífattur
afturbein	sígongulimur
afturbleytur	sískitin
afturblíðkaður	sígóðsintur
afturborin	Samheiti:afturfingin,afturgivin,afturgoldin,afturgreiddur,afturlatin,afturrindaðurbera, fáa e-m;geva, gjalda, lata, rinda aftur↔afturgjald,geva,gjalda
afturbót	síendurgjald
afturbragd	sírørsla
afturbregðiligur	síarviligur
afturbyrgdur	síafturlatin
afturbøtandi	sífyrigeviligur
afturbøting	Samheiti:albati,ábót,ábøting,bót,bøss,endurbót,endurbøting,fyribilsumvæling,høvuðsumvæling,pábót,ráðabót,triv,umbót,umbøting,umvæling,umvøling,uppábót,viðbøting(garðahald)garðagerð(stopping)stiking(endurgerð)afturreising,endurføðing,endurnýgging,endurnýggjan,endurreising,endurreisn,endurskipan,nýreising,upplívgan,uppnýggjan,uppreising↔bati,batnaður,endurskapa,gagn,gagna,grøða,hjálp,hjálpa,seyming,styrkja,umvæla,uppreisn,viðgerðAndheiti:niðurríving,skaði
aftureftir	Samheiti:aftur,afturav,afturá,afturøvutur,bakleiðis,bakleingis,framman,frammanífrá,opin,øvigur,øvugur,øvutur(afturúr)aftaná,afturfrá(afturøvut)aftur av, frá, í, til, o.fl.;aftur á bak, hond;aftur eftir hæli;av framman;eftir bakinum, hæli, reyv, reyvini, rygginum o.fl.;framman av;frammanífrá og aftur;úr frammi, rongini, skarpinum, skutinum, stavninum, stevninum o.fl.;úr fremra enda;□tað gekk eitt fram og tvey aftur;tað gekk tann skeiva vegin, øvutan veg↔avveltur,niðureftirAndheiti:frameftir
afturendi	síafturpartur,oddur
afturfall	síeftirfylgja
afturfarin	sísvunnin
afturferð	síminking,túrur
afturfingin	síafturborin,framkomin
afturfit	sífótur
afturfitja	sífótur
afturfitjing	sífótur
afturfløddur	síflóð
afturfótur	sífótur
afturfrá	síaftureftir
afturfrásøgn	sífrásøgn
afturfunnin	síframkomin
afturfyri	síafturlatin,ístaðinSamheiti:ístaðiní staðin;í staðin fyri...;í, sum samsýning;í tann stað;sum plástur (upp) á sárið↔afturgjald,avgjald,endurgjald,gjalda,løntur,uppreisn
afturfyrisegkomin	síbatnaður
afturgiftur	sígiftast
afturgivin	síafturborin
afturgjald	Samheiti:afturgjalding,afturrindan↔afturborin,afturfyri,avgjald,endurgjald,gjald,gjalda,gjaldkomin,løntur
afturgjalding	síafturgjald,gjald
afturgoldin	síafturborin
afturgonga	síminking,spøking,ævintýrhugtak
afturgongd	síminking,spøking,ævintýrhugtak
afturgrasaður	síbatnaður
afturgreiddur	síafturborin
afturgrógvin	síbatnaður
afturgrøddur	síbatnaður
afturhald	Samheiti:afturhaldsandi,afturhaldsstevna,afturstrev,bakdráttur,fyrilit,hógv,hósk,hóvsemi,íhald,íhaldssemi,javnlyndi,javnsinni,máti,mýkindi(r),spakføri,spaklyndi,spekt,stillføri,varlæti,varsemi(afturhaldsflokkur)afturhaldsblað,afturhaldskroppur,afturhaldsmaður,húðarskógvamaður,íhaldsflokkur,íhaldsmaður↔drýggja,eftirsíggin,fólkaligur,hóvsamur,natinskapur,sinnalag,tolAndheiti:bersøgni,ørskapur
afturhaldandi	síhóvsamur
afturhaldin	síhóvsamur
afturhaldsandi	síafturhald
afturhaldsblað	síafturhald
afturhaldsflokkur	síafturhald
afturhaldshugaður	síhóvsamur
afturhaldskroppur	síafturhald
afturhaldsmaður	síafturhald
afturhaldssamur	síhóvsamur
afturhaldssinnaður	síhóvsamur
afturhaldsstevna	síafturhald
afturheilsan	síheilsan
afturhildin	síhóvsamur,smæðin
afturhitting	Samheiti:møti,samfundur↔fundur,heilsa,heilsan
afturhittur	síhevna
afturhokin	sídravlorkutur
afturhond	sínáttlagdur
afturhorvandi	Samheiti:afturlítandi,afturskoðandi↔minnast,minning,minnismerki
afturhógvur	sífótur
afturi	síafturlatin
afturíaftur	sífinna veg
afturíafturkomin	síframkomin
afturíafturtvinning	sítøting
afturíkast	símatur
afturímóti	sílutfalsliga
afturjakslur	sítonn
afturkast	síavlop
afturkastaður	sívanda
afturkembing	síeftirfylgja,pína
afturkenning	síafturkensla
afturkensla	Samheiti:afturkenning,kensil,kensl,kensla,kensul↔kenna mun á,minnast,minning
afturkeyp	síhandilsskapur
afturkleyv	sífótur
afturklógv	sínegl
afturkoma	síkoming
afturkomandi	síreglubundin
afturkomin	síframkomin
afturkoming	síkoming
afturlabbi	sífótur
afturlagdur	síafturlatin
afturlagstur	síleggja seg
afturlatin	síafturborinSamheiti:aftur,afturfyri,afturi,afturlæstur,afturstongdur,hálvafturlatin,lokaður,luktur,læstur,óupplatin,stongdurikki upplatin;í lási;○sum liggur afturat, at, ímót, ímóti, saman(undirlagdur)afturbyrgdur,afturlagdur,byrgdur,tyrvdur,undirgrivin,undirskruddurgrivin, lagdur undir heilt;ikki seyðrendur↔avbyrgdur,botnur,lás,lok,proppur,steingja,tætturAndheiti:upplatin
afturlating	síendi
afturlatingartíð	síendi,ótíð
afturleið	síferðaleið
afturleistur	sísóli
afturlítandi	síafturhorvandi
afturljóð	Samheiti:bergmál,bjargamál,dvørgamál,eftirljóð,ekkó,endurljóð,endurljómur↔innanopin,ljóð,ljóða,spegla
afturljós	sílampa
afturlykt	sílampa
afturlæstur	síafturlatin
afturløning	sígjald
afturløntur	síhevna
afturmastur	símastur
afturmenning	síbati
afturminning	síminning
afturmøttur	síframkomin
afturnørdur	síbatnaður
aftur ogaftur	síupp í slag
aftur og fram	síhigar og hagar
afturopin	síavveltur
afturpartslega	sílega
afturpartur	Samheiti:dintil,dirðil,døv,galvur,keil,keili,knappur,konurassur,rassur,reyv,rumpa,rumpustell,rumpusteyri,rumpustykki,seta,setur,steyri,steyrur,stintur,stumpur,stættur(gumpur)druður,drunnur,døv,lambsdrunnur,rumpa(hali)dintil,dirðil,halakveistur,halasnetur,halasnippur,stintur(mintur)døv,gumpur,knappur(saks)dirðil,raggari,stintur(sporl)dreingjasporl,geirrøvil,klingra,revil,røvil,sporðklingra,stertur,sir,øskufjøður(sveiv)hamarstjølur,siggstertur,stertur,sveivur(hekka)afturendi,bakendi(vel)stintur,velafjøður,velfjøður
afturreising	síafturbøting
afturrenning	sígrøðing
afturrikin	sífrákoyrdur,vanda
afturrindaður	síafturborin
afturrindan	síafturgjald
afturrong	sísessur
afturróður	sífótatraðk,koming,lívd,róður
afturrunnið	síbatnaður
aftursegl	sísegl
aftursending	sísending
aftursettur	sílaðin
aftursigin	síniðurdottin
aftursíður	sídravlorkutur
aftursjuggaður	sífrákoyrdur
aftursjúgvaður	sífrákoyrdur
afturskin	síljósglæmaSamheiti:endurskin,endurspegling,glámlýsi,spegilmynd,spegilsmynd,spegling↔glitra,ljósglæma,skínandi
afturskoðandi	síafturhorvandi
afturslag	síduk
aftursnúður	sísnúður
aftursovnaður	síleggja seg
aftursókn	síkrav
afturstev	sídansingarháttur
afturstig	sídansingarháttur,eftirfylgja,minking
afturstigshiti	síhiti
afturstingur	sístingur
afturstongdur	síafturlatin
afturstrev	síafturhald
aftursvar	sísvar
aftursvarðaður	síbatnaður
aftursøgn	sífrásøgn
afturtog	síband
afturtrá	sítrá
afturtungur	sílaðin
afturumfarin	sídragna afturúr,liðin
afturumlestur	síbókalestur
afturumsigldur	sídragna afturúr
afturundir	síhinumegin
afturundirgerð	sístreymur
afturúr	síaftureftir
afturúrsigldur	sídragna afturúr,uppikastaður
afturvaldur	sívaldur
afturvallaður	síbatnaður
afturveggur	síveggur
afturvegur	síferðaleið
afturvend	síbroyting,koming
afturvendandi	síreglubundin
afturvending	síbroyting,koming
afturvendur	síframkomin,málbundin
afturvitjan	sívitjan
afturvitjing	sívitjan
afturæs	síhol
afturæsa	síhol
afturøvut	síaftureftir
afturøvutur	síaftureftir,avveltur
aga	síspekja,tykta,vegleiða
agafastur	sífólkaligur
agaleysur	sínasadjarvur
agat	sígrót
agg	síargapetti,hindur,mótvilji,pína
agga	síarga,verkja
aggandi	síaldrandi
agi	síuppaling
agn	símuturSamheiti:agnabiti,agnaneit,agnaseil,agnbiti,agngágga,agnsild,biti,brosmuagn,fiskaagn,fjarðaragn,flundruagn,foragn,fuglaagn,gággagn,gágguagn,gilla,hálsagn,hvítagn,kalvaagn,línuagn,murt(a)agn,nakkaagn,seiðabergsagn,sildaagn,skøtuagn,snørisagn,øðuagn(beita)beit,beituagn,brosmubeita,búkbeita,gummibeita,kalvabeita,magabeita,ongiljubeita,ongilsbeita,ryggbeita,seiðabeita,steinbítabeita,svartabeita,toskabeita(lokkingarmatur)alimatur,æti(útgjar)flidnagjar,gággugrús,gjar,svartgjarknústar skeljar(valagn)føgur lyfti;føgur orð↔agnloysi,avegndur,egna,fella,lokkuboppa
agnabiti	síagn
agnaneit	síagn,avegndur
agnaplága	sípína
agnarorð	síspottorð
agnaseil	síagn,avegndur
agnaspjaldur	sífiskur
agnaspragga	sífiskur
agngágga	síagn
agnhald	sískarð
agnleysur	síavegndur
agnloysi	sítørvurSamheiti:agnneyð,agnsetur,agntrot↔agn,avegndur,egna
agnneyð	síagnloysi,tørvur
agnsettur	síavegndur
agnsetur	síagnloysi,avegndur
agnsild	síagn,fiskur
agntrot	síagnloysi,tørvur
agnvandin	síkræsin
agnvandur	síkræsin
ak	síeftirbátur
aka	síførka,skreiða
akademi	sífelag,skúli
akademikari	sífróðarmaður
akademiskur	sílærdur
akandi	sílandvegin
akast	síførka,letast
akbreyt	síkoyrivegur
akferð	sítúrur
akker	Samheiti:akkeri,ankar,dregg,dreggj,ílasteinur,íli,krókur,línusteinur,línuvarp,neyðakker,teymur,varp,varpakker(drivakker)drivsegl↔ankra
akkeri	síakker
akkersbotnur	síbotnur
akkersboya	síbløðra
akkersbundin	síankra
akkersgrunnur	síbotnur,fjørður
akkersketa	síketa
akkersleið	síbotnur
akkersljós	sílampa
akkerstog	síband
akkunettur	sínærlagdur
akkurát	síjúst
akkurátur	sínærlagdur
akna	sídimma
akneyt	síneyt
aksabytta	síspann
aksaleypur	síkassi
aksaskjótast	sígrógva
aksaskotin	sígróðrarbúgvin
aksast	sígrógva
aksastampur	síkassi
aksatungur	sígróðrarbúgvin
aksla	síklæða,troka
akslaband	síband
akslabreiður	síførligur
akslahædd	síhædd
akslargrein	síarmur
akslarliður	síliður
akslarseymur	sístingur
akslaskjótast	sískelkja,troka
akslasneiddur	Samheiti:herðasneiddur,slútakslaður,slútherðaður↔hallur,kílaskapaður
akslatøk	sítak
akslaypp	síviðbragd
akstólur	sísessur
akstur	síflutningur
aksturvinna	sívinnulív
akt	síansni,endamál,seyðarakstur
akta	síeftirlíka,jagstra,passa,reka seyð
aktarær	sígjald,seyður
akting	síseyðarakstur
aktingargildi	síveitsluhald
aktingarhundur	síhundur
aktingarlamb	sígjald,seyður
aktingarløn	sígjald
aktingarmaður	sívaktari
aktingarær	sígjald,seyður
aktær	sígjald,seyður
akur	síjarðarstykki
akurendi	síjarðarstykki
akurhøna	sífuglur
akurhøsn	sífuglur
akurknívur	síknívur
akurlendi	síjarðarstykki
akurskrift	sífuglur
akurskritt	sífuglur
akurskurður	síinnheysting
akurveður	síveðurlag
akvegur	síkoyrivegur
ala	sídyrka,føða,mata,nørast
alabasturkrukka	sífløska
alari	sífiskurSamheiti:fiskaalari,laksaalari,sílaalari,sjógvalari,smoltalari↔djórahald,mata,nøra,nørast,nøring,skipan,viðseting
alátin	símatfegin
albann	síforboð
albati	síafturbøting
albatrossur	sífuglur
albeittur	síloðin
albilsin	síbilsin
albirgur	síarbeiðsførur
alblóðigur	síblóðigur
albogaliður	síliður
albogaslag	síduk
albogastoytur	síduk
albrynjaður	síherbúgvin
albúgvin	sítilbúgvin
albygdur	síavtakin
alda	sídanda,førka,gera aldu,ljóða,rukka,sjóvarilska
Aldafaðir	síGud
aldagamal	síaldrandi
aldalangur	síaldrandi,varandi
aldan	sígrøði
aldanshúð	síhúð
aldansvín	sígrísur
aldargamal	síaldrandi
aldaskifti	síbroyting
aldavinur	sívinur
aldeilis	síógvuliga
aldin	sígrøði
aldingarður	síurtagarður
aldraður	síaldrandi
aldrandi	Samheiti:aldagamal,aldalangur,aldargamal,aldraður,algamal,avdeyða,avdeyður,aveldur,avgamal,avoldaður,áragamal,ársgamal,burturfyrndur,burturfyrntur,daggamal,deyðgamal,einnáttaður,eldgamal,eldur,elligamal,ellihvítur,ellikomin,elliljótur,ellisgrógvin,erfornur,ergamal,fornaldarligur,fornligur,fornur,forsøguligur,framkomin,fyrisøguligur,fyrndargamal,gamal,gamaldur,gamalur,gránaður,hálvgamal,húðfornur,jarðfunnin,jarðsøguligur,langlívaður,náttstaðin,siðsøguligur,søguligur,tilárskomin,trævetur,træveturgamal,trøllgamal,tvævetrugur,tvævetur,tvæveturgamal,úrfornur,úrgamal,úteldur,útfornur,útfyrntur,veturgamal,ævigamalaggandi gamal;bitin, merktur, slitin av tíðarinnar tonn;eingin ársungi, unglingi, unglingur o.fl.;gamal í garði, gøtuni;ikki ungur í herðunum;ikki ungur longur, meira;komin (nakað) upp í árini;komin til aldurs;merktur av tíðartonn, elli;heilt, nakað, rættiliga gamal;(nakað) til árs (komin);nakað við aldur;so gamal at mosi veksur á tonnunum;so gamal sum ein fornklássa;vorðin gamal;væl til árs, væl við aldur;○sum hevur nógv ár á baki;sum hevur nætur á baki;sum hevur sæð sínar bestu dagar;□aldur er dottin á hann;aldur sæst á honum;hatta er bæði gamalt og fornt;hon er farin av, úr barnburði;yvirferðin er av t.e. manndómsárini eru liðug↔avlagdur,barn,barnaár,eldast,ellisár,fornminni,gamalmenni,javnaldur,lívstíð,tilkominAndheiti:ungligur,ungur
aldri	síongantíð
aldrin	síongantíð
aldubarmur	sísjóvarilska
aldubár	sísjóvarilska
aldubára	sísjóvarilska
aldubrot	sísjóvarilska
aldudalur	sísjóvarilska
aldudrabb	sísjóvarilska
aldudráttur	sísjóvarilska
aldugerð	sísjóvarilska
aldukambur	sísjóvarilska
aldukendur	síaldutur
aldumikil	síaldutur
aldur	síellisár,lívstíð,uppalin
aldurdómsár	síellisár
aldurdómsbrek	síbrek
aldurdómur	síellisár
aldurið	sísjóvarilska
alduringur	sísjóvarilska
aldursbólkur	síluteind
aldursbrek	síbrek
aldursbýti	síbýti
aldursmark	símark
aldursmunur	símunur
aldursskifti	síbýti
aldursstig	símenningarstig
aldursstyrkur	sígjald
alduryggur	sísjóvarilska
aldurøð	sísjóvarilska
aldusig	sísjóvarilska
alduskol	sísjóvarilska
alduskot	sísjóvarilska
alduskvatl	síljóð,sjóvarilska
aldusuð	síljóð
aldutoppur	sísjóvarilska
aldutur	síójavnurSamheiti:aldukendur,aldumikil,avveltur,baldrutur,baskaligur,bárutur,bóltut,brimhvítur,brimligt,brimmikil,drabbsjógvað,drabbutur,fløktur,frísutur,fullur,gjálvutur,hálvrísin,hálvruskutur,hirðisligur,hvítsjógvaður,illfjøskutur,illfýsin,illruskutur,illstakin,illveðursligur,illvíggjutur,ilsligur,í andarisi,íðukendur,jaggutur,kjakutur,kjøklutur,kjøkrutur,kjøkutur,kraklutur,krappsjógvað,krappur,molgrutur,ófantaligur,ófiskiligur,ófridligur,ófýsiligur,ófýsin,ófýsisligur,óførur,ógóðsligur,ókyrrur,ónossligur,óróligur,óslættur,ósvivaligur,ótýdligur,óveðursligur,raggutur,ringur,rísin,ruðvelt,rullutur,runutur,ruplaligur,ruplutur,ruskutur,sjaskutur,sjógvilt,skrubbisligur,skrubbutur,skubbutur,skvaggutur,skvalputur,skvatlutur,skvølputur,slafsutur,slapsutur,slufsutur,slupsutur,stórsjógvaður,streymaljótt,streymharður,streymljótur,svaggutur,sválgutur,svølgutur,sældutur,topputur,tungur,tvagsjógvað,tvarrutur,tvassutur,tvætlutur,tvættutur,tvørsjógvað,tvørsjóvað,tættsjógvað,uppøstur,vágarmikil,vágarstórur,vágmikil,válkuturavilt, avvelt, ódn, óført í brimi;avvelt(ur) í brimi;baldrut, drabbut, illfýsið, krappsjógvað, ruskut, stórsjógvað o.fl.;molgrut, óført, ógjørt, óslætt, rullut o.fl.;ófanta líkindi(r), sjógvur, veður;□boðin, íðan er uppi;brimið stendur (upp) í grasið;bylgjurnar eru sum fjallaryggir;fjørðurin er ikki bátaførur t.e. tað er ikki fjarðført, fjørðfart;hann er, gerst frísutur;hann rísur upp undir ættina;hann setir í sjógv t.e. øsir sjógvin upp, øtlar sjógvin, veðrið;hann, tað kjøkrar, ókyrrar, rísnar, runar;har er íðukent, streymhart, sum í einari íðu;har er so fult;har er so ófiskiligt, so ófiskiligt veður;havið er fast;havið, sjógvurin stendur í andarisi;her er ikki smáfiskasjógvur;lógvin hvessir t.e. tað brestur í óløgunum;sjógvurin er fløktur, kjøkrutur;sjógvurin rísur;sjógvurin øsist upp;skurðir ganga;tað er alda, drabb, kjøkr, sig, tvætl, tvætt, vág, øsing o.fl. í sjónum;tað er at í sjónum;tað er avvilt í brimi;tað er av mesta brimi;tað er breið og síð alda;tað er brim, leysur sjógvur o.fl.;tað er fast í sjónum;tað er fastur sjógvur;tað er flot, ódn, uppgangur, uppgongd, upptøka, ørvald, ørvali í brimi;tað er fløktur, kjøkrutur, óslættur, ringur, tungur sjógvur;tað er ikki farandi, klúgvandi, rógvandi, siglandi (um fjørðin);tað er ókyrt, óslætt, sjógvilt, tvørsjógvað;tað er riv, rull, trongd, troti í sjónum;tað er tung alda;tað eru reitingar í sjónum;tað hvítir, rýkur á aldunum;tað rísur á boðanum, bylgjuni, sjónum↔bakbrot,fiskileið,froysan,gera aldu,hav,illveður,ódnardagur,sjóvarilska,streymur,veðurringurAndheiti:blikastillur
aleina	síeinans
aleinaður	síeinsamallur
alfaðir	síGud
alfagur	sívakur
alfaravegur	síkoyrivegur
alfarin	síkoyrivegur
alfegin	síglaður
alfevndur	síalmenniligur
alfólkaligur	síalmenniligur
alfriða	sífriða
alfrøðibók	sískriv
alfundur	sífundur
alfúsur	sívilligur
alføroyskur	síføroyskur
algamal	síaldrandi
algilda	síseta í gildi
algildi	sígildi
algildur	síalmenniligur
algloypandi	símatfegin
algongdur	síalmenniligur,vanligur
algoystur	síhugspentur,skjótførur,útmøddur
algóður	sídygdargóður,góðsintur,tryggur
alheimsligur	síalmenniligur
alheimur	síverøld
ali	símegi,sinnalag
alidjór	sídjór
alidýr	sídjór
alifiskafóður	símatur
alifiskur	sífiskur
alifóður	símatur
alifuglur	sífuglur
alikar	síkassi
aliker	sígoymsla
alimatur	síagn
alin	síuppalin
aling	sídjórahald,viðseting
alinlangur	sílangur
alintráður	símátingarband
alipisa	síbarn,fuglur,ungi
alisfrøði	sískriv
alkavaður	sífrystur
alkendur	síalmenniligur
alkeyptur	sídýrur
alklakaður	sífrystur
alkohol	sírúsdrekka
alkrem	síkrem
alkunnugur	síalmenniligur,fullkønur
alkunnur	sífullkønur
alkønur	sífullkønur
allahandamaður	síavtakafólk
allareiða	sínæstan
allarflestur	símeginpartur
allarfyrst	sífyrst
allarhelst	síádú ádú,kanska
allar vegir	Samheiti:á allan hátt,bæði so og so,í allar mátará ein og hvønn hátt;á hvønn hátt;bæði andaliga og handaliga;bæði á brøttum og sløttum, á sjógv(i) og landi, í rong og rók, til fjals og fjøru;bæði á ein og annan hátt, í ein og annan máta;bæði beinleiðis og óbeinleiðis, beinleiðis og umvegis;bæði í mótburði og viðburði, mótgangi og viðgangi, óveðri og góðveðri;bæði í orði, orðum og verki;bæði tá ið tað gongur við og ímóti;bæði til hond og fót, høvur og hond;bæði til vás og stás;í allar lutir;í líkindum og ólíkindum, veðri og óveðri;í ringum sum í góðum;í øllum førum, lutum, veðri, viðurskiftum;sama hvat ein tekst við;undir øllum umstøðum;upp á allar mátar↔allastaðni,altíð,báðumegin,higar og hagar,ofta,ymsastaðni
allastaðna	síallastaðni
allastaðni	Samheiti:allastaðna,runt,umkring,umkringurallar staðir;á hvørjum tanga;á, í øllum støðum;bygd úr bygd, oyggj úr oyggj, stað úr stað;bæði á brøttum og sløttum, sjógv(i) og landi;bæði burtur og heima, frá og hjá, inni og úti;bæði burtur og hjá, her og har, úti og inni;bæði høgt og lágt, ovarlaga og niðarlaga, uppi og niðri;bæði innan og uttan, uttan og innan;bæði til fjals og fjøru;í hvørjari vitru;í hvørjum heraðshorni, króki;í kring;í rong og rók;um alla leið, allar vegir;um hól og heyg;undir hvørjum steini;úr eini bygd, oyggj í aðra;(úti) um alt(nógvastaðni)fleiristaðni,flestastaðni,flestustaðni,mangastaðni,víða,víðan,víðaniá, í fleiri, flestum, flestøllum, nógvum støðum;mestsum, nærum, næstan allastaðni;runt, víða, víðan, víðani um;víða hvar;víða um lond↔allar vegir,altíð,báðumegin,higar og hagar,ymsastaðniAndheiti:ongastaðni
alleingi	síleingi
allíkur	sílíkur
allítil	sísmáur
alljósur	sílitaður
alloðin	síloðin
allogandi	Samheiti:álogandi,brennandi,brimandi,geislandi,gløðandi,logandi,uppkyndurí ljósum loga;□alt, tað stendur í (bjørtum, ljósum) loga;eldur er í;eldur, logi leikar um e-n;login stendur himmalhøgt;tað er eldur í↔eldur,ífesting,loga,tendraAndheiti:brunnin
alloysing	síspjaðing
allur	síendaður,hvør einasti,óskerdur
allýsa	sínágreina
allýsing	símerkingSamheiti:eyðlýsing,frágreiðing,frágreiðsla,heildarlýsing,lýsing,mannlýsing,marking,náttúrulýsing,persónlýsing,skilmarking,starvslýsing,útgreiðing,útgreining,útlegging,ævilýsing(heildarmynd)heildmynd,heilmynd,mynd,náttúrumynd↔eyðkenni,flokkan,merking,nágreina,týðing
almakt	símegi
almangur	sínógvur
almannafæ	síogn
almannagagn	sígagn
almannagagnligur	síhóskiligur
almannagøta	síkoyrivegur
almannahjálp	síhjálp
almannahugsan	síáskoðan
almannakendur	síalmenniligur
almannakunnugur	síalmenniligur
almannakunnur	síalmenniligur
almannaleið	síkoyrivegur
almannamál	sífelagsmál
almannaogn	síogn
almannapláss	síferðapláss
almannaráðgevi	síleiðbeinari
almannatal	síáskoðan
almannatos	síáskoðan
almannavegur	síkoyrivegur
almannaveiting	síhjálp
almáttugur	síGud,sterkur
almáttur	síGud,megi
almenniligur	Samheiti:alfevndur,alfólkaligur,algildur,algongdur,alheimsligur,alkendur,alkunnugur,almannakendur,almannakunnugur,almannakunnur,almenskur,altjóðaður,altjóðaligur,altøkur,felagsligur,felagsmenniskjaligur,fólkabærur,fólksligur,heimsvíður,sammenniskjansligur,sosialur,tíður,títtalmanna-, heims-, millumlanda-, millumtjóða-, veraldar-;hvørs mans;□e-t er altjóðaspurningur;tað javna er at...
almenningur	síjarðarstykki,persónur
almennur	síopinberur
almenskur	síalmenniligur
alment	síopinberur
almerkiligur	síóvanligur
almikið	síógvuliga
almikil	símikil,nógvur
almorreyður	sílitaður
almúga	sípersónur
almúgi	sípersónur
almúgumaður	sípersónur
almyrking	símyrkur
almyrkur	sílitaður,myrkur
alnalangur	sílangur
alnamál	símátingarband
alnamát	símátingarband
alnarlangur	sílangur
alnartráður	símátingarband
alneyðugur	síneyðugur
alnógvur	sínógvur
alnýggjur	sínýggjur
aloftast	síofta
aloyða	síavlíva,søra
alraflestur	símeginpartur
alrafyrst	sífyrst
alrahelst	síkanska
alrasin	sívreiður
alráðandi	sítýðandi
alreyður	sílitaður
alríki	sístatur
alríkur	síríkur
als	síógvuliga,samstundis,tilsaman(s)
alsamt	síaltíð,framvegis,líðandiSamheiti:dyggiliga,framhaldandi,javnan,javnliga,ofta,støðugt,vanligaaðruhvørja løtu;allan dagin (í dag), veturin;alla tíðina, vikuna;alt árið, heystið, summarið;al tíð og stund;av, á sífeldum, síføldum;frá hond;hvønn dag;hvønn einasta dag frá Guði;hvønn (einasta) gudsskaptan dag;hvønn Guds skapta dag;hvørja einastu løtu;(í) alla nátt;(í) allan dag;í heilum;í hvørjum andarhaldi, andaræli;javnan og samnan, savnan;um dagarnar;uttan hvíld, íhald, steðg↔altíð,framvegis,fyrr,higartil,leingi,nú,síðani,skjótt,varandi,æviga
alsamur	síáhaldandi
alsettur	síloðin
alsjálvvirkin	sísjálvvirkandi
alska	síásttikin
alskari	síleyslyntur persónur,unnustar
alskhugaður	síásttikin
alskhugi	síkærleiki
alskhugsmikil	síásttikin
alskhugur	síkærleiki
alskiliga	síyndisliga
alskiligur	sígóðsintur
alskin	síásttikin,góðsintur,spakur
alskkona	síleyslyntur persónur
alsklingur	síyndisbarn
alskur	síkærleiki
alskyns	sífjølbroyttur,ymiskt
alslættur	síflatur
alspentur	síhovin,hugspentur,vóngóður
alspurin	síforvitin
alstórur	síhøgur,mikil
alsveittur	sívátur
alsýndur	sísjónligur
alt	síframvegis,líkur,nú,tó
altar	síkirkja
altarblæa	síteppi
altarborð	síkirkjugangur
altarbók	sískriv
altardúkur	síteppi
altargangur	síkirkjugangur
altargonga	síkirkjugangur
altargongd	síkirkjugangur
altarklæði	síteppi
altarljós	sílampa
altarsálmur	sísangur
altarsbrúk	sítil stásbrúk
altarsfólk	Samheiti:altarsgestur,altarslag,altarsskari,borðgangur,lag,messufólk,messugestur,messuskari↔kirkjugangur,kirkja,bírætting
altarsgestur	síaltarsfólk,gestur
altarsklæddur	sípyntaður
altarsklæði(r)	síklæði(r)
altarslag	síaltarsfólk
altarsskari	síaltarsfólk
altarvín	sírúsdrekka
alting	sívald
altíð	sílættligaSamheiti:alsamt,áhaldandi,ofta,støðugt,vanligaaldur og alla ævi;allar dagar;alla tíð(ina), ævina;alla ævi sína;alt lívið;av, á sífeldum, síføldum;(bæði) gerandis- og halgidag(ar);bæði tá ið gongur við og (tá ið tað gongur) ímót;fyri alla tíð;fyri lívið;gerandi og heilagt;heilagt sum yrkt;í øllum førum;tann líðilanga dag;til seinasta, síðsta andadrátt;til tað síðsta;úr vøggu í grøv;yrkt og heilagt;ævi og allan aldur;□tað er ikki dagur frá Guði at ikki...(æviga)ævinligaallar dagar, tíðir, ævir;allar ævir til enda;alla tíð;eina ferð fyri allar;frá upphavi og um allar ævir;fyri alla tíð;í alla(ri) framtíð;í allar ævir;(líka) til sankta nimmursdag;med alla;so leingi klettarnir standa;so leingi sum fløðir og fjarar;til ævigar tíðir;um (aldur og) allar ævir;um ævir (allar);við øllum↔allar vegir,allastaðni,alsamt,áhaldandi,brádliga,fyribils,fyrr,fyrst,higartil,ikki enn,leingi,liðin,líða,líðandi,lívstíð,løta,nú,ofta,síðani,skjótt,tíðarskeið,tíðliga,upprunaliga,útliðið,varandi,æviga
alt í lagi	sísama ger
altjóðabókmentir	síbókaheimur
altjóðadómstólur	sívald
altjóðaður	síalmenniligur
altjóðafelagsskapur	sífelag
altjóðafundur	sífundur
altjóðahandil	síhandilsskapur
altjóðaligur	síalmenniligur
altjóðarættur	sívald
altjóðaskráseting	síyvirlit
altó	sító
altráin	síáhaldandi,hugspentur
altráur	síáhaldandi,hugspentur
altso	síádú ádú,líkur,meðni
altumráðandi	sítýðandi
altur	sírødd
altvaldandi	síGud
altýðandi	sítýðandi
altøgn	sítøgn
altøkur	síalmenniligur
altørvandi	sídýrur
aluminiumstak	sítekja
aluminiumstekja	sítekja
alún	sígarva
alúna	sígarva
alv	símegi
alva	síeldur,føða
alvakin	Samheiti:fullvakin,klárur,klárvakin,klárvaknaður,nývaknaður,vakandi,vakin,viðraknaður(hálvvakin)hálvvaknaður,uppvaknaðurum at vakna;□hann liggur fram á stokk(svøvnleysur)í andvekri;uttan svøvn(fullsvøvntur)útsvøvnturvæl svøvntur(framkomin)frammi,fótaður,uppi,uppkominá fótum;farin av bóli;komin upp;komin úr seingini, bólinum, fjaðrunum;stigin fram (á gólv);□hann er frá seingini↔andvekur,árrisin,lívga,vaka,vakna,vaktarhald,vaktari,vekjaAndheiti:svøvntungur
alvaksin	síloðin
alvakur	sívakur
alvald	síGud
alvaldandi	síGud
alvaldur	síGud
alvallaður	síavtakin
alvandaliga	sívandaliga
alvarligur	síálvarsamur
alvápnaður	síherbúgvin
alvegis	síógvuliga
alverjaður	síherbúgvin
alverkfall	síverkfall
alvi	síbarn,dirvi,eldur,megi,skyldfólk
alvinur	sívinur
alvitandi	síklókur
alvitska	síklókskapur
alvitur	síklókur
alvísur	síklókur,opinberur
alvur	síeldur
alvæl	síhvaðna,sanniliga,vandaliga
ama	síoyðsla burtur
amari	síoyðslari
amast	síhamast
amboð	Samheiti:apparat,áhaldsi,greiður,gøgn,hentleiki,hjálparamboð,hjálpargøgn,hjálparráð,hjálpartól,reiði,reiðskapur,tól,útbúnaður,útbúningur,yrkisevni(arbeiðstól)búnaðaramboð,etingaramboð,framleiðsluamboð,framleiðslutól,frálæruamboð,frálærutilfar,grindareiðskapur,handamboð,húsarhaldstól,húshaldstól,kensluamboð,kókigreiður,kókingaramboð,maskinamboð,matamboð,mataramboð,mátingartól,ravmagnstól,siglingartól,sløkkiamboð,smíðatól,smíðtól,snákingaramboð,trivtól,tungamboð,undirvísingaramboð,urtagarðsamboð,útgerð,veiðiamboð,veiðiføri,veltingaramboð,virkisamboðnútíðar hentleikar↔húsbúni,lutur
amboðskassi	síkassi
amboltur	Samheiti:smiðjustiði,steðji,stiði↔smíða
ambæta	símatgera,passa
ambæti	sístarv
ambæting	sírøkt
amma	síkassi
ampa	síhindra,órógva
ampaður	sídarvaður
ampaleysur	síóttaleysur,tryggur
ampaloysi	sífrídómur
ampast	síhindra,órógva
ampi	síbaksan,hindur,levind,ræðsla,sorg
ampilára	síhindra
ampur	síbaksan,hindur
amtmansflís	sídáli
amutur	sínærgongdur,oyðslutur
an	síeftirbátur,lampa
ana	síliva,loga
analfabetur	sísibbi
anari	sílampa
anda	sístormaSamheiti:blása,físa,froysa,frýsa,fræsa,hæsa,hvæsa,pístra,prutla,puffa,pústra,sjúa,snýsa,suffa,sukka,tivaanda gjøgnum munnin, nøsina;anda inn, út;anda lætt, lættliga, tungan, tungt;blása á, í e-t;blása í keym, keyma, kjóm t.e. geyknina, lógvarnar;draga anda, andan, ond, ondina;draga andan djúpan, djúpt;fáa luft;fylla lunguni;gera hálsbluss;halda andanum;halda, sleppa ondini;orka væl at anda, vera lættur fyri andanum;skjóta andan (frá sær);suffa djúpan, tungliga;tiva sum eltur vargur, sum hundur á fjalli;vera andlættur;vera í klumsi↔andatrongd,anding,snork,snorka
andablástur	síanding
andadráttur	síanding
andadýrkan	síátrúni
andaður	sídeyður
andakt	síbønarhald
andalátilsi	sídeyði
andaleyp	sídeyði
andaleypsbrot	sídeyði
andaliga	síandligur
andaligur	síandligur
andalop	sídeyði
andarblak	sívindur
andarhald	síanding,íhald,løta
andarið	síandatrongd
andaris	síaldutur,frísutur,gera aldu,vreiður
andartippi	síandatrongd
andarúm	síhimmalhválv,pláss
andaskifti	sídeyði
andast	sídoyggja
andatak	síløta
andatoka	sítoka
andatrongd	Samheiti:andarið,andartippi,hjartklemmilsi,trongd(astma)bróstmøði,brósttrongd(fáa, hava andatrongd)hæsafáa, hava klemmilsi, trongd;gerast ússaligur;hava ilt, ringt við at anda, draga ondina;hava trongd fyri andanum, bróstinum;hava tungan, tungligan andadrátt;illa fáa anda;kikka eftir ondini;missa ondina;orka illa at anda;sita undir hjartklemmilsi;vera í klumsi;vera trongur, tungur fyri andanum;vera tungur fyri ondini;□ein fær illa andað;tað setti at hjartanum;tað typpir fyri ondini(seta í hálsin)fáa (e-t) í rangastrúpan↔anda,anding,sjúka,sjúkur
andbráður	sífattur,nasadjarvur,stoltur
andeitur	síeitur
andgletti	síhindur,illveðurshol
andglettur	síhindur,illveðurshol
andi	síanding,íblástur,lív,sinnalag,vindur,ævintýrhugtak
anding	Samheiti:andablástur,andadráttur,andi,blástur,blóstur,bróstgangur,fís,físan,fros,froys,froysan,grindablástur,grindablóstur,hark,hjartasuff,hvæs,hvæsan,innanding,lívsandi,ond,prutl,puff,smáhark,snýs,snýsing,suff,sukk,tiv,tivan,útanding(nos)njósi,nosrið(hist)histan,histi(higst)higstandi andadráttur(rop)luft upp úr maga↔anda,andatrongd
andkast	síblaking
andkollvelting	síbylting
andkoma	sííblástur
andlát	sídeyði
andleysur	sídeyður,latur,útmøddur
andliga	síandligur
andligur	Samheiti:andaligur,átrúnaðarligur,átrúnaligur(gudiligur)frómur,gudlýðin,gudóttandi,gudræddur,gudrøkin,gudsóttandi,gudsøkin,guðiligur,kristiligur,kristin,rætttrúgvandi,rætttrúgvin,sannkristin,trúgvandi,trúmikil,trúrøkinfastur, sterkur í trúnni;við sterkari trúgv(heilagur)dýrur,halgur,háheilagur,heiligur(kirkjuligur)hákirkjuligur○sum er eitt gudsbarn, Guds barn(gudiliga)andaliga,andliga,guðiliga,halgiliga,kristiliga↔átrúni,bíbilskur,doypa,Gud,gudur,halgimenni,heilagleiki,himnaríki,Jesus,kirkja,kirkjugangur,kristning,prædika,trúarfelag,umvenda,umvendur,yvirjarðligurAndheiti:heiðin
andlit	Samheiti:ásjón,ásjónd,einglaandlit,konufólkaandlit,mannfólkaandlit,mansandlit(skon)grími,gron,snáldur(skortur)grýluskortur,hampatrýni,skortbílæti,skortgron,skriðuskortur↔høvur,nøs,útsjónd
andlitsbragd	síútsjónd
andlitsbrá	síútsjónd
andlitsdrag	síútsjónd
andlitsdæmi	sílittóni
andlitsfríður	sívakur
andlitsgrein	síútlinja,útsjónd
andlitsgríma	sídularbúni
andlitshúð	síhúð
andlitskrem	síkrem
andlitslitur	síkrem
andlitsmynd	símynd
andlitsrukka	sírukka
andlitsrøkt	síreinføri
andlitsskap	síútsjónd
andlitssmyrsl	síkrem,litevni
andlitstváttur	sívasking
andlitsverja	sívernd
andlitsyvirbragd	síútsjónd
andlív	sígerandislív
andlættur	síanda
andmót	síhindur
andnegl	síhúð
andnes	sínes
andnæmi	síkneysur
andriða	sífiskur
andrísin	síófúsur
androk	síhindur
andróður	síhindur,róður
andróðursfiskur	sífiskur
andróðursflokkur	símótstøðumaður
andróðursmaður	símótstøðumaður
andrógva	sírógva
andskræmiliga	síógvuliga
andskræmiligur	símisháttur
andsperr	sípína
andsperra	sípína
andsperri	sípína
andstaddur	Samheiti:gagnstøður,mótsettur,mótstaddur,tvørvendur,øvigur,øvugur,øvutur○sum er í andstøðu við...;sum eru, standa andstøðis (hvørjum øðrum);sum liggja, standa rygg móti ryggi(gagnstøtt)skeivumegin,øvutumeginhin vegin;mótsettan veg;rongu megin;tann øvuta vegin↔aðramáta,áraka,harafturímóti,hinumegin,javnsíðis,mótstøðumaður,munur,øvutur
andstevna	síelva
andstreymur	sístreymur
andstroymi	sístreymur
andstygd	síbrotsverk,mótvilji
andstyggiliga	síógvuliga
andstyggiligur	símisháttur
andstyggur	símisháttur
andstøða	síhindur,mótstøðumaður,svara
andstøðingur	símótstøðumaður
andstøðis	síandstaddur
andstøðublað	símótstøðumaður
andstøðuflokkur	símótstøðumaður
andsvar	síábyrgd,svar
andsølis	sísólarrangt
andtíð	síótíð
andvali	síillgruni
andvarpa	síbrótast,førka,ivast
andvarpast	síbrótast,búgva út,førka
andveður	sívindur
andveikur	sísvakur
andvekur	Samheiti:hálvvekur,jólaandvekur,jólaríggjur,ovvekur,svøvnloysi,vandring,vekur,vøka(náttarvøka)náttarvekur,uppiseta(vøkunátt)andvekursnátt,vøkutíð↔alvakin,vaka,vakna,vekjaAndheiti:svøvnur
andvekursnátt	síandvekur
andverk	sígrøði,starv
andviðaður	sískeivvaksin
andvirði	sídygd
andvirki	sígrøði,starv
andvirkin	síraskur
andvíki	síósemja
andøva	sírógva,vera eftiransin
andøving	síróður
andøvsfiskur	sífiskur,gjald
andøvsgul	sívindur
andøvsmaður	síróðrarmaður,sjómaður
andøvssessur	sísessur
anga	Samheiti:krása,smíla,smílkastgeva frá sær, hava góðan lukt, royk, tev o.fl.;lukta, rúka væl (av, í e-m);vera balsamligur, nasasøtur, tevgóður o.fl.;□luktur, roykur, tevur gongur at hasum↔angagóður,illramur,luktilsi,luktur,smakka at,tevja,tevsansurAndheiti:stinka
angagóður	Samheiti:angandi,angasøtur,balsamligur,nasasøtur,smílandi,tevgóðurvæl luktandi;○sum luktar væl↔anga,luktilsi,luktleysur,luktur,smakkgóður,stinka,tevja,tevsansurAndheiti:illramur
angahoyggj	síhoyggj
angaleysur	síluktleysur
angaluktur	síluktur
angan	síluktur
angandi	síangagóður
angaroykur	síluktur
angasøtur	síangagóður
angavatn	síluktilsi
anghoyggj	síhoyggj
angi	síluktur,oddur
angist	síræðsla
angistróp	síákall
angorageit	sígeit
angorakøttur	síketta
angra	Samheiti:iðra,iðrast,harma,harmast,pinteradrekka e-t upp aftur;eta orðini (orð síni) aftur í seg;fella iðranartár;gremja seg um;iðra seg, iðrast (eftir), (um);slætta afturumaftur;taka aftur orð síni;taka orðini aftur (í seg);traðka á tveingin;vera harmur um(biðja fyrigeva sær)avsaka seg,orsaka segbiðja avsaka, orsaka, umbera seg;biðja forláta, fyriláta sær;biðja halda sær til góðar;biðja um forlátilsi, fyrigeving, orsakan, tilgeving, umbering, umberslu o.fl.;siga "um forlátilsi"↔angur,fyrigeva,fyrigeviligur,fyrigeving,iðranarfullur,sorg
angrandi	síiðranarfullur
angur	sísorgSamheiti:gremjan,iðran,iðranargrátur,iðranartár,iðri,iðring,iðrun,rúilsi,samvitskubit,samvitskuófriðurring samvitska↔angra,iðranarfullur,sorg
angurbitin	síiðranarfullur,sorgarbundin
angurfullur	síiðranarfullur,sorgarbundin
anguri	sífiskur
angurleysur	síiðranarleysur
angurloysi	síiðranarloysi
angurmerktur	síiðranarfullur,sorgarbundin
angurstár	sídropi
aning	síeldur
aningarstrá	sígras
aningur	sílampa
ank	sígremjan,stynjan
anka	sígremja seg
ankar	síakker,kassi
ankarketa	síketa
ankarsbiði	síspann
ankiliga	sísára
ankra	kasta akker, ankar;lata akker(ið), ankarið falla;leggja í vetrarlegu;leggja(st) fyri akker, ankar, íla, teym;liggja fyri íla, akkeri, ankari, teymi, varpi;varpa upp(liggja vetrarlegu)ikki loysa frá landi;liggja í havn, við bryggju;vera inni(vágbinda)svínabindaleggja fyri teym(akkersbundin)uppankraður,uppvarpaður↔akker
annaðhvørt	síofta
annaðpláss	síferðapláss
annaðslíkt	eins nógv, mikið, stórt o.fl. (afturat);sama nøgd, tað sama (afturat)(meira)meir,meiriannað og meira;meira enn hatta;meira enn so;meira skal til
annanmáta	síaðramáta
annar	síáðurnevndur
annarleiðis	Samheiti:frálíkur (øðrum),øðrvísi,øðrvísiniá annan hátt;□hann bregður frá, bregður úr ætt;hann er ikki sær sjálvum líkur;hasin er frálíkur øðrum, kennist, líkist frá øðrum;hatta er annar (betri) báturin, maðurin o.fl.;hatta líkist burturfrá, burturúr, sker seg burturúr;hatta líkist, víkir frá;tað er hvørt sítt, ikki tað sama;tað er ikki makabrá til;tað líknar ikki til(ólíkur)ómakaður,ójavnur,óparalig (flt.),ymis,ymiskur,ymissur□har brýtur (nógv) av;hasin er ólíkur (øllum) øðrum;hatta líkist ikki, samsvarar ikki;tað berst ikki saman (við e-t);tað ber, teir bera ikki á brá at líkjast;tað er nógv ímillum;tað er, teir eru sum dagur og nátt, nátt og dagur, summar og vetur;tað er, teir eru sum veðragjólingur og stoppinál;teir eru ikki at líkna saman, kunnu ikki saman líknast;teir eru misjavnir, ójavnir, ólíkir, ómakaðir, ymiskir o.fl.;teir hóska ikki saman, líkjast ikki(mismennið)óhóskandi,óklæðiligur,ósambæriligur,ósambærligur○sum ikki hóskar (saman), ikki klæðir til, ikki sameinist↔broyting,fjølbroyttur,óvanligur,sjáldsamur,umskiftiligurAndheiti:líkur
annars	síaðramáta
annarstaðni	síburturstaddur
annám	sítak
annáma	sígrípa
anriða	sífiskur
ansa	síeftiransin,passa
ansaleysur	síbusutur
ansaligur	síhóvsamur,stoltur
ansaloysi	sílíkasæla
ansalótir	síhykl
ansalæti	síhykl
ansin	síeftiransin
ansingarverdur	síáhugaverdur
ansjós	sífiskur
ansmikil	síáhugaverdur
ansni	Samheiti:akt,ansur,eftiransni,far,framskygni,fyrihyggja,fyrilit,fyrivarni,gætur,hugvarni,hyggi,hyggja,hygni,lagaligheit,nákvæmi,nærkvæmi,nærlagni,ómak,ómaki,ómakur,umhugi,umhugsan,umhugsni,umhygni,umráð,umráðing,umvæli,vandni,varni,varsemi,væla↔eftiransin,eftirlit,fyribyrging,nærlagdur,passa,røkiskapur,røkt,vandaliga,vanda sær,vaktari,vaktarhald,verja,verja annan,verja segAndheiti:vansketni
ansur	síansni,áhugi,eftirlit,klókskapur,viðgerð
antakrist	síSátan
antarfuglur	sífuglur
antarlittur	sílitaður
antarlitur	sílittóni
antarpar	sífuglur,par
antarsteggi	sífuglur,kallvera
antarungi	sífuglur
antast	síhamast,tráa
antikrist	síSátan
antrast	síivast
apa	síendurgeva,sjómaður
apaldgarður	síurtagarður
apaldgráur	sílitaður
apast	síhamast
apingarfuglur	sífuglur
apokrýfiskar bøkur	sískriv
apotek	sísølubúð
apparat	síamboð
appilsingulur	sílitaður
apukattalótir	sílótir
apukattur	síbýttlingur
apuspjað	síbýttlingur
apuspjót	síbýttlingur,fínarimpa
apuspæl	síbýttlingur,hykl
aputur	síuppgjørdur
aputýggi	síbýttlingur,óflýggjakroppur
arbeið	sístarv
arbeiða	síristaSamheiti:avgreiða,avrika,ávirka,diskast,dríva,evna,fremja,gera,greiða,handfara,inna,íðka,maka,mynda,reka,rumma,skapa,smíða,starva,starvast,tæna,útinna,útrætta,verka,viðgera,vinna,virkaarbeiða av og á, hálvan dag, hálva tíð, so hissini;arbeiða á, fyri, í, sum, upp á, við...;búgva, evna, gera, reiða e-t til;diskast, fáast, havast, takast við;dríva upp á;evna til;fáa avrikað, av, á skafti(ð);fáa e-t gjørt;fáa, leggja frá hondini;ganga til handa;gera e-t til nyttu;gera fyri gott, takast við, tríva í e-t;gera gagn (fyri pengarnar);gera við;greiða úr hondum;halda hungurin frá durunum;halda hús, hava húspláss;halda pottin;hava (fast) arbeiði;hava fyri;havast at;ikki liggja á tí løtu liðini, síðuni, í leti, og letast;lívbjarga sær;lívbjarga sær við e-m;tæna e-m, hjá e-m;vera at at..., vera at em;vera í arbeiði, tænastu, vinnu, til arbeiðis;vera í ferð, holt, holtur, takferð, takholt við e-t;vera uppi í e-m;verka, virka fyri e-m;vinna dagligt breyð;vinna til lívsins uppihald(framleiða)endurvinnaútvinna t.e. fáa til vegar (úr náttúruni)(vevjast í øllum í senn)vavdast,veftast,vevdastganga og vevdast;hava fleiri, nógv jørn í eldinum (í senn)(stríða)asa,baksa,baksast,balast,bardía,bardíggja,bogra,eykast,fokkast,grubba,heksast,kløtrast,kneyka,kneykla,kneykra,knikka,knosa,knosast,knossa,knossast,knógva,knógvast,knugga,knukka,knúlva,knúlvast,krubbast,kýtast,rokast,rutast,seilast,sjabba,sjaga,sjagga,sjaggast,skeipa,skítast,skjaldrast,slabba,slabbast,sleipa,slíta,slítast,slyðrast,starvast,stremba,streva,strevast,strita,stríðast,svarvast,tava,tavast,toga,tota,totast,træla,tuska,tuskast,túra,túrast,ursast,vásastaltíð vera á klótendanum t.e. altíð gera tyngra partin;arbeiða av allari megi, øllum alvi, av grimd, krafti, fyri lívinum;arbeiða av forverkum;arbeiða, bera, sjabba tungliga;arbeiða hart, uttan íhald;arbeiða sum eitt ið ótt, ørt er, sum eitt ótt, ørt;asa seg út;baksast, dragast, hundast, skítast, skjaldrast, slabbast, sorast við e-t;bera tunga byrði;berja, stríða seg fram, ígjøgnum;bíta á kampi;bíta fast saman;bíta saman tenn;bíta tenninar saman;bjarga sær føðina;benda, díkja, dríva, koyra, seta, spenna, stemma, streingja, taka á;ganga og rokast, skeipa;gera knossarbeiði;gera knút á seg;gera, royna sítt ítasta;gera sær ómak;hava mangan ringan;hava nóg mikið at starvast í, sýsast við, takast við, tríva í;hava nógv at gera, nógv niðurfyri, nógv um at vera, nógv um oyruni;hava nógv at tríva í, nógv við at starvast;hava upp um bæði oyru(ni);hava úr at gera;herða seg;høgga á báðar hendur;ikki fáa, geva sær uppnos, ikki rætta ryggin, ikki unna sær hvíld;ikki fáa, unna sær frið, hvíld, matnáðir, ress, rest, ró, rógv;ikki fáa, unna sær hvíld ella frið, ress ella ró, rest ella ró, rógv ella ró;ikki hava sessuró á sær;ikki hyggja uppúr;ikki kunna bukka beinini, ikki kunna rætta ryggin;knýta, kýta, stytta seg saman;kýta, sperra seg;leggja alla orku í;leggja allar árar í sjógv, út;leggja doyðin, lívið á;leggja nógv at sær, fyri (seg);leggja seg eftir;leggja sær eina við;leggja sær e-t nær;leika í;lívbjarga sær;noyðast at bróta svøvn, vakt;oysa í bæði borð;royna at fáa liðugt;seta føtur í bekk, spenn, spenni;seta ketturygg á seg;sita í gølli, springskíti, toti (við e-m);sita og kroystast, totast við e-m;sita undir høvd(ið) í e-m;spenna á, í, ímóti;spenna fót í bekk;spenna, spíla seg út;sperra seg;standa í sveittabroti, við sveittabrot, við sveittan í barm;standa tiptur í arbeiði;standa undir eyguni í (t.d. fiski);standa, vera hondum fastur;starvast fyri e-m;stríðast og strevast;taka bekktøk, ódnartøk, skiparatøk, tøk o.fl.;taka dik á seg;taka mangt tungt takið;taka tung tøk;vera javnur á tí t.e. liggja á takinum;vera kroystur av, við arbeiði;vera nógv eftirspurdur, umbiðin;vera ovklyvjaður, undirbyrjaður, undirgrýttur, undirkleksaður, undirklektur;vera ovbyrjaður, undirborin, undirdíktur, undirgrivin, yvirbyrjaður av arbeiði;vinna sær lívsbreyð;vinna tungliga á (e-m)↔arbeiða óvandaliga,arbeiði,arbeiðsleysur,arbeiðsloysi,avtakin,baksan,bera,forvinna,ítriv,ótøkur,putla,starv,starvsgrein,verkevni,verkfall,vinnulív,yrkiAndheiti:hvíla,letast,putla
arbeiðaóvandaliga	Samheiti:bograst,bollast,bonglast,bonsklast,bulka,bunja,bøla,fansa,físpa,fritlast,funsa,girðlast,hurla,klampa,klodda,klombra,klombrast,knortlast,lámast,ruspa,skridlast,skrumbla,skrumla,skrumma,skølma,skølmast,svansast,ursastarbeiða í skundi, óstortliga, skjótt og illa o.fl.;bollast, girlast, skølmast við...;fansa e-t til;fara, gera e-t fram eftir fummum, sum best ber til, uttan fyrilit;fara harðliga avstað, fram, um;fara illa um, við;fara ófantaliga, óstortsliga fram;gera e-t av forverkum, handahógv, í bráðskundi, óðum verkum;gera e-t illa, ófantaliga, óvandaliga;gera e-t út í bláan, blindan heim, út í luftina;gera e-t við bróður fingrum, sum Harra Gud veit;greiða illa úr hondum;hurla, klampa, klombra, ruspa o.fl. e-t saman;ikki duga við e-t;ikki fáa vant seg til, við e-t;ongar høgtíðir gera sær av e-m;ripa e-t upp;ruspa e-t frá hondini;vanda sær illa um;vera harðhentur(arbeiða til onga nyttu)arbeiða eftir reyv;byrja frá (tí) øvuta endanum;gera e-t upp aftur í saman;gera nyttuleyst arbeiði;noyðast at fara aftur um aftur↔arbeiða,barbrot,busutur,kloddaarbeiði,onkursvegnaAndheiti:vanda sær
arbeiðaraløn	sígjald
arbeiðarastætt	sísamfelagsstætt
arbeiði	síbygging,starvSamheiti:avriksarbeiði,ánæmingur,ársarbeiði,ársgerð,ársverk,ársvinna,búnaðararbeiði,bygdararbeiði,byggiarbeiði,byggingararbeiði,frágerð,frálandavinna,frálandsvinna,dagsarbeiði,dagsgerð,dagsverk,dagverk,dáð,dáðmansverk,einmansføri,einsmansføri,einsmansverk,eykaarbeiði,felagsarbeiði,framíhjáarbeiði,gagnsverk,garðsarbeiði,gerandissjagg,gitisverk,grótarbeiði,handarbeiði,handaverk,handverk,húsarbeiði,húsasmíð,hvønndagsstríð,innanhýsisarbeiði,inniarbeiði,inning,inniverk,kellingarverk,kolarbeiði,konufólkaarbeiði,kropsarbeiði,kvinnuarbeiði,køksarbeiði,lívsstríð,lívsverk,lønararbeiði,løtuverk,mannfólkaarbeiði,mansarbeiði,mansskurður,matstrev,námsvinna,næmingsverk,ovarbeiði,óvitaarbeiði,pappírsarbeiði,peningsverk,skylduarbeiði,sprongdararbeiði,stórarbeiði,stórverk,summararbeiði,timburarbeiði,timbursmíð,timburverk,torvarbeiði,triðingsgerð,tvígerð,tænasta,umloysur,ungdómsarbeiði,ungmannaarbeiði,urtagarðsarbeiði,urtagarðsrøkt,uttanhýsisarbeiði,útiarbeiði,vandaarbeiði,vás,vásarbeiði,vegagerð,vegarbeiði,verk,vetrararbeiði,vetrargerð,viðgerð,virkan,virki,virking,virksemi,yvirarbeiðidagligt stríð;dagsins vás og slit;kropsligt, likamligt, lønt arbeiði↔arbeiða,baksan,forvinna,ítriv,starv,starvsgrein,verkevni,verkfall,vinnulív,yrki
arbeiðsandi	sídugnaskapur
arbeiðsbólkur	sínøgd
arbeiðsbrúk	sínýtsla
arbeiðsbýti	síbýti
arbeiðsdagur	síyrkadagur
arbeiðseftirlit	síeftirlit
arbeiðsevni	sídugnaskapur,megi
arbeiðsfelagi	sífelagslimur
arbeiðsfólk	síhjálpari
arbeiðsfriður	sífriður
arbeiðsførur	Samheiti:albirgur,arbeiðskonufør,árligur,birgur,embætisførur,evnaligur,fepurfríur,ferðigur,ferðugur,flogtreystur,frískur,fullbirgur,fullfíggjaður,fullfrískur,fullførur,fullmentur,fullsterkur,fullstyrknaður,fulltakin,fulltikin,fulltøkin,heilbregðin,heilbrigður,heilsugóður,heilsuheilur,heilsusterkur,heilur,hirtisligur,kimpurligur,kippuligur,lívførur,natúrsterkur,ósærdur,pínuleysur,raskur,sinnisfrískur,spilfrískur,sunnur,vinnuførur(útskrivaður)heimsloppinfrískur og ferðigur, ferðugur;frægari stjølaður;heilt birgur;ikki avbrekin, ikki sjúkur, ikki ússaligur;rættiliga frægur;sera væl fyri;so toygur;styrktur, styrknaður (aftur);sum ein rættur maður;sum fiskurin, sum hvalurin í havinum;sum fyrsta dagin;uttan pínu;við góða heilsu, við sítt fríska lív;væl fyri, heitin, til passar, upplagdur, útborin;væl til passar, við heilsu;□hann er frammi hvønn dag;hann er frá seingini;hann er ikki nøkur bleika;tað sæst ikki høgg á fóti, føti(vera arbeiðsførur)aldri hava kent sær mein í bein;bera seg, sín stjøl, skjøldur væl;einki baga, bagga, bila, saka o.fl.;finna, føla, kenna seg væl;gera fult mansverk;hava gott gróðrarhold, hava lívhold;hava góða heilsu, vera við góða heilsu;hava lív og heilsu;ikki føla, hava, hava kent, kenna sær hundavaml;ikki føla, kenna sær mannabit;ikki vera avbrekin, ikki vera sjúkur, ikki vera ússaligur;liva so dánt, so toluliga, væl;síggja (heldur) frægari, (heldur) væl út;vera albirgur, fullførur, heilsugóður, raskur;vera frægari stjølaður, so toygur;vera heilt birgur, rættiliga frægur, sum fyrsta dagin;vera (sera) væl fyri;vera styrknaður, styrktur (aftur);vera sum ein rættur maður↔bati,batnaður,frálíkur,grøða,harðbalin,heilsugevandi,heilsustandur,hvussu hevur tú tað,raskur,tilkomin,sterkurAndheiti:brekaður,kraftleysur,sjúkur
arbeiðsgongd	síarbeiðslag
arbeiðsgrev	síslitmaður
arbeiðsháttur	síarbeiðslag
arbeiðshestur	síross
arbeiðshugaður	síraskur
arbeiðshugur	sídirvi,dugnaskapur
arbeiðsjarn	síslitmaður
arbeiðsklæddur	síílatin
arbeiðsklæði(r)	síklæði(r)
arbeiðskonufør	síarbeiðsførur,tilkomin
arbeiðskor	sílíkindi(r)
arbeiðskraft	síhjálpari,megi
arbeiðskroppur	síslitmaður
arbeiðskvinnufelag	sífelag
arbeiðslag	Samheiti:arbeiðsgongd,arbeiðsháttur,atburðarlag,bindingarlag,dansingarlag,dráttarlag,dráttrarlag,fiskiháttur,framferðarháttur,goymsluháttur,greiningarháttur,handakeipur,handalag,handarbragð,handarbrá,innblástrarháttur,róðrarlag,samstarvslag,siglingarlag,skipanarlag,spinningarlag,starvslag,stíllag,stílur,stjórnarlag,stýrislag,veiðiháttur,verklag,veruháttur,verulag,virkisháttur,yrkislag(gongulag)fótabragd,fótaferð,renningarlag,skóferð,stev(tosingarlag)frálæruháttur,frásøguháttur,kenslulag,lestrarháttur,rokningarháttur,skrivingarlag,stavingarháttur,stavingarlag,tosingarmáti,yrkingarháttur,yrkingarlag(máti)atburður,atferð,framferð,háttalag,háttur,hóttur,lag,mannagongd,medferð,vegur↔fermleiki,málnýtsla,medferð,sinnalag
arbeiðsleysur	Samheiti:arbeiðstøkur,breyðleysur,dáðleysur,gerðarleysur,hýruleysur,óvirkin,vinnuleysur,virkisleysur,yrkisleysuruttan arbeiði, vinnu, yrki;við ongum arbeiði;○sum fer upp á leyst, óvist (hagar sum arbeiði er);sum gongur fyri einki, hendur í lumma o.fl.↔arbeiða,arbeiðsloysi,reka úr starviAndheiti:ótøkur
arbeiðsligur	síhóskiligur,ómakaleysur
arbeiðslíkindi	sílíkindi(r)
arbeiðsljóst	síljósglæma
arbeiðsloysi	Samheiti:atgerðaloysi,dáðloysi,gerðarloysi,verkloysi,vinnuloysi,virkisloysi,yrkisloysieinki arbeiði;einki at forvinna;einki at gera, takast við;einki fyri hendurnar;trot á arbeiði;vantandi fyritakssemi↔arbeiða,arbeiðsleysur,reka úr starvi
arbeiðsloyvi	sírættindi
arbeiðslýsi	síljósglæma
arbeiðsløn	sígjald
arbeiðsløta	sígóðveður
arbeiðsmannafelag	sífelag
arbeiðsmegi	síhjálpari,megi
arbeiðsnáðir	sífriður
arbeiðsnevnd	sívald
arbeiðsneyt	síneyt
arbeiðsond	síslitmaður
arbeiðsorka	síhjálpari,megi
arbeiðsósemja	síósemja
arbeiðspláss	sípláss,stað
arbeiðsross	síross
arbeiðsrót	síslitmaður
arbeiðsrúm	síhøli
arbeiðsrúmd	sípláss
arbeiðssamur	síraskur
arbeiðssemi	sídirvi,dugnaskapur
arbeiðssetningur	síverkevni
arbeiðsskaði	sískaði
arbeiðssteðgur	síendi,verkfall
arbeiðstarn	síhindur
arbeiðstarni	síhindur
arbeiðstól	síamboð
arbeiðstrælur	síslitmaður
arbeiðstøkur	síarbeiðsleysur
arbeiðsumstøður	sílíkindi(r)
arbeiðsveður	sígóðveður
arbeiðsvilji	sídirvi,megi
arbeiðsvit	síklókskapur
arbeiðsøki	sístað,starvsgrein
arga	Samheiti:agga,erta,forarga,gessa,glósa,happa,ilska,kreinkja,kugga,negla,neita,nilta,píska,pretta,prika,prilla,pritla,purra,reiða,reita,skjóta,smáarga,stikla,stinga,særa,tenna,terga,øða,øsa,villadraga e-m dráttir;fara illa við e-m;fáa, loypa ilt, øði í e-n;fáa sinnið í e-n;ganga e-m undir eyguni;gera e-m skálkheit, skálk;gera e-n argan, firtnan, illan, óðan, villan o.fl.;gera skálkabrøgd;geva glósur;ikki geva e-m frið, náðir;ikki (kunna) lata e-n fáa, hava frið;ikki (kunna) lata e-n vera í frið(i);ilska, reita, tenna, øsa e-n upp;koma við spotsglósum;píska e-n við e-m;rógva undir hvítli;skjóta undir vatni;spæla e-m e-t puss;spæla upp á e-n;stinga skør;traðka á halan á e-m;vera eftir e-m;vera e-m til skapeggjanar;vera e-m upp á bakið;villa e-n;vinna e-m neisur↔argapetti,arging,argingarsamur,elva,eyðmýking,eyðmýkja,forhánisliga,hugsæra,spotta,spottaður,spottari,spottorð,vanæruligur
argandi	síargingarsamur
argapetti	síklandursvættiSamheiti:agg,argapisa,ertari,forargilsi,mannreitingur,plága,plágari,syndarhugska,uppøsariein íð argar, er argin(argasjón)eygnariv,forargilsie-t ið argar, øsir(landaplága)syndaplága,syndakleppur↔arga,arging,argingarsamur,óflýggjakroppur
argapisa	síargapetti,kastibløka,klandursvætti
argasjón	síargapetti,ræðumynd
argast	síilskast
arggivin	símannvándur
argiligur	síargingarsamur
argilsi	sívreiði
arging	Samheiti:erting,happ,skapeggjan,uppøsing,øsing↔arga,argapetti,argingarsamur,eyðmýking,eyðmýkja,forhánisliga,hugsæra,spotta,spottaður,spottari,spottorð,vanæruligur
argingarsamur	Samheiti:ertin,ertingarsamur,ertisamur,glósutur,reitingarsamur,skálkaligur,stingandi,trælskurargur at erta, píska, stinga skør o.fl.(mannargiligur)argandi,argiligur,forargiligur,ótolandi,ótoliligur,tennandi,troyttandi,øsandi○sum bert sær tað ringa í, við e-m;□hann er altíð við tí ringa orðinum↔arga,argapetti,arging,eyðmýking,eyðmýkja,forhánisliga,hugsæra,spotta,spottaður,spottari,spottorð,vanæruligur
argjakostur	síbaksan
argjalimur	síkloddakot,sjúklingur
argjamáltíð	símatur
argjamunnur	símatur
argjaseyður	sígáva,seyður
argleiki	sívreiði
argur	símannvándur,vreiður
ark	sípappír,sjófar,skriv
armadovin	síútmøddur
armadómur	sífátækt
armadømi	sífátækt
armast	sífátækur,troyttast
armasterkur	síklófastur
armatak	sítak
armaveikur	síkraftleysur
armbandsur	síklokka
armbending	sírørsla
armbind	síeyðkenni
armbrot	síbrák,skaði
armdylla	síspann
armingi	sívánamaður
armingshús	síbygningur
armóð	sífátækt,máttloysi
armóðarlamb	sípinkulingur,seyður
armóðsligur	sídygdarleysur,fátækur
armóðsmaður	sífátækafólk
armslit	síbaksan
armslitin	síútmøddur
armsterkur	síklófastur,sterkur
armstólur	sísessur
armstyrki	símegi
armsveiggj	síveipan
armur	sídygdarleysur,fátækur,høliSamheiti:akslargrein,hond,limur,upplimur,útlimur
armveikur	síkraftleysur
arnarbøga	sífuglur,kvennvera
arnarklógv	sínegl
arnarnøs	sínøs
arnarreiður	síreiður
arnarungi	sífuglur
arr	sísár,skríggj
arrutur	síójavnur
art	sígagn,luteind,sinnalag
arta	sígrógva,skikka sær
artaður	sískikkaður
artargóður	sígóðsintur
artaseg	síbúnast
arva	sífáa
arvaborin	Samheiti:arvborin,bóndaborin,óðalborin,óðalsborin,tilborin,ættborinborin, føddur til arv;borin til festi, festu;tilborin, við rættindum, ættborin til arv, festi o.fl.;○sum er frumborin, frumgitin;sum hevur arvarætt, stendur til festi↔arviligur,arvingi,fáa,frumborin,frumburður,rættindiAndheiti:arvaleysur
arvabræv	síváttan
arvaður	síarviligur
arvafesti	sígáva
arvafæ	sígáva
arvagingin	síillgresjaður
arvagjald	síavgjald
arvagóðs	sígáva
arvagrein	sígáva
arvagrógvin	síillgresjaður
arvagull	sígáva
arvajørð	sígáva
arvaklandur	síósemja
arvaleivd	sígáva
arvaleysur	Samheiti:arvleysurgjørdur arvaleysur;uttan arvarætt;○sum hevur mist arvarættin↔fátækurAndheiti:arvaborin
arvalutur	sígáva
arvamál	sígáva
arvandi	síarviligur
arvapartur	sígáva
arvaríki	sígáva,statur
arvarættur	sírættindi,vald
arvaskifti	síbýti
arvaskjal	sígáva,váttan
arvaskotin	síillgresjaður
arvastríð	síósemja
arvastykki	sígáva,jarðarstykki
arvasynd	sísynd
arvasøgn	sífrásøgn
arvavaksin	síillgresjaður
arvaveður	síveðurlag
arvaviðurskifti	sígáva
arvborin	síarvaborin
arvbærur	síarviligur
arvi	síbarn,illgras,skyldfólk
arviligur	Samheiti:afturbregðiligur,arvaður,arvandi,arvbærur,íborin,íbregðiligur,ískaptur,natúrligur,náttúruborin,náttúruligur,niðurarvaður,viðføddur,ættarborin,ættbundin○sum bregður til, gongur í arv, kann arvast, er fingin, gingin í arv;sum e-n hevur í sær, sum er e-m í holdið, kjøtið borið↔arvaborin,ættaður
arvingi	síbarn,skyldfólkSamheiti:arvingur,arvtakari,arvtaki,bóndi,festari,festnari,garðagenta,kongsfestari,krúnprinsur,lívsarvingi,ríkisarvingi,samarvingi,útarvingielsti sonur;ein sum er frumborin, frumgitin↔arvaborin,fáa,frumborin,frumburður,rættindi
arvingur	síarvingi,barn,skyldfólk
arvland	sígáva,statur
arvleysur	síarvaleysur
arvmentir	sífrásøgn,gáva,vani
arvorð	síorð
arvríki	sístatur
arvsynd	sísynd
arvtakari	síarvingi
arvtaki	síarvingi,skyldfólk
arvur	sígáva
as	síbaksan
asa	síarbeiða
asaður	síútmøddur
ask	síviður
askarmastur	símastur
askarstavur	sístavur
askur	síviður
askviður	síviður
asnafoli	síross
asnaross	síross
asni	síross
assistentur	síhjálpari
assuransi	sítrygging
astma	síandatrongd
at	síímóti,til tess at
atburðarlag	síarbeiðslag,medferð
atburðarsiður	símedferð
atburður	síarbeiðslag,medferð
atdjúpur	sídjúpur
atdráttarkraft	síatdráttarmegi
atdráttarmáttur	síatdráttarmegi
atdráttarmegi	Samheiti:atdráttarkraft,atdráttarmáttur,atdráttur,dráttur(tyngdarkraft)tyngdarmáttur(sigulmagn)magnetisma,ravsigulmagn(sigulmagna)seta sigulmagn í(sigulmagnaður)magnetiskur,ravmagnaður(sigul)magnet,magnetur,ravsigul
atdráttarmikil	Samheiti:biðlasæl,dárandi,dragandi,freistandi,froystandi,lokkandi,tølandi,villandi↔freistari,freisting,lokka
atdráttur	síatdráttarmegi,streymur
atdýpi	síbládýpi
atfangadagur	síaftan
atfangakvøld	síaftan
atfeingi	sítilfar
atferð	síarbeiðslag,medferð
atfinnari	síklandursvætti
atfinning	Samheiti:atfinsla,listdómur,ritdómur↔atfinningarverdur,ámæli,ummæli
atfinningarsamur	sísmásárur
atfinningarsemi	símótvilji
atfinningarverdur	Samheiti:átaluverdurikki í lagi;ikki sambært avtalu, lóg, reglugerð, viðtøku;○sum ikki samsvarar við...↔atfinning
atfinsla	síatfinning
atflutningur	síflyting,handilsskapur
atgangur	síálop,streymur
atgeingi	síatgongd
atgerð	síálop,streymur
atgerðaloysi	síarbeiðsloysi
atgonga	síatgongd,álop
atgongd	síálopSamheiti:atgeingi,atgonga,atgongdarrættur,atkoma,atkomstur,inngangurhøvi, møguleiki, vegur at koma inn
atgongdarrættur	síatgongd
atgongdur	síatkomandi,tøkur
atgongugjald	sígjald
atgongumerki	síváttan
atgongupeningur	sígjald
atgonguprógv	síváttan
atgrunnur	Samheiti:flúrutur,grunnur,harðskøltur,óreinur,skerjutur,útgrunnuratgrunt, grunt, harðskølt, óreint, útgrunt inni við land;grunn jørð, grunt vatn;grunnur botnur, á grunnum botni, vatni;ikki djúpur;□har er óreint (at sigla) framvið;har er stutt niður á botn, ikki djúpt;tað rísur upp av hellu;tað sæst botnur↔skerAndheiti:djúpur
athav	símedferð
atholvdur	síhallur
atholvin	síhallur
athugaverdur	síáhugaverdur
athugdur	síkannaður
athugi	síáhugi
athygging	síkanning,viðraking
athyggingarmaður	sívaktari,veiðimaður
athyggjandi	síáhugaverdur
athyggjari	síáskoðari
atkoma	síatgongd,koming,líkindi(r)
atkomandi	sítøkurSamheiti:atgongdur,atkomuligur,atleggjandi,ákomandi,eyðgongdur,farandi,fjarðført,fjarðrøtt,fjørðfart,fólkagongdur,framkomandi,frágongdur,gangandi,gongdur,gongubærur,gonguligur,góðgongdur,høgligur,kloyvt,klúgvandi,komandi,laggongdur,lendandi,lættgongdur,niðanrent,omanrendur,rógvandi,siglandi,treðið,uppgongdur,uppkomandi,útrógvandi,vælgongdurfarandi á flot, til útróðrar, um fjørðin o.fl.;lættur at ganga;lættur at koma at, av, á, í, til, úr o.fl.;lættur, góður at fara, ganga á, eftir, í;stutt at ganga, sigla;væl gongdur;□har er gott at ganga, ganga um;har er góðgongt, uppgongt o.fl.;har er smeðið men treðið(komandi uppfyri, útfyri, útyvir)gerandi,gjørligur,møguligur○sum ber til, er møguligt, liggur fyri;sum e-r kann, klárar, megnar, orkar o.fl.;sum gerst, kann gerast, letur seg gera↔eyðfingin,lættliga,ómakaleysur,steðugurAndheiti:ófarandi
atkomin	síframkomin,kraddutur,lenda
atkomstur	síatgongd
atkomufuglur	sífuglur
atkomuligur	síatkomandi,tøkur
atkomupláss	síbryggja
atkomustaður	síbryggja
atkomuvegur	síkoyrivegur
atkvøða	síval,velja
atkvøðing	síval
atkvøðugreiðsla	síval
atkvøðurættur	sírættindi
atkvøðuslúkur	síúrval
atkvøðutal	síyvirlit
atkyrktur	sífastur
atlaðaður	síhallur
atlaðin	síhallur
atlagstur	síframkomin,lenda
atland	sístatur
atlantsorð	sítungumál
atlas	Samheiti:europakort,føroyakort,globus,heimskort,kort,kortabók,landkort,matrikulkort,sjókort,stjørnukort,streymkort,uppdráttur,veðurkort,vegakort,veraldarkort
atlát	síávaring
atleggjandi	síatkomandi
atlop	síálop
atløga	síálop,gjald,koming,reis
atløgubrúgv	síbryggja
atløgubryggja	síbryggja
atløgupláss	síbryggja
atløgutangi	síbryggja,nes
atmeldur	sístreymur
atombumba	síbumba
atomorka	símegi
atrák	sístreymur
atreið	síálop
atrend	síátak
atrenning	síkenning
atrikið	síreka av leið
atroynd	síroysnisgerð
atsetur	síbústaður
atskoyti	síískoyti
atslag	síálop
atsmakkur	sísmakkur
atsókn	síálop,elting,vitjan
atsóknari	síákæri
atsóknarmaður	Samheiti:atsøkjari,ágangsmaður,álopsmaður,uppreistrarmaður,yvirgangsmaður(álopsleikari)áleypari,álop,framherji,miðframherji,miðherji(álopsland)álopsherur↔álop,berjast,fíggindi,herja,herlið,kríggj,kríggjast,mótstøðumaður,standa fyri skotum,verja segAndheiti:hampafólk
atstoytur	sístreymur
atstøða	síhjálp,hjálpari,viðgerð
atstøðari	síhjálpari
atstøðingur	síhjálpari
atstøður	sílíkindi(r)
atstøðuskip	sísjófar
atsúgur	sístreymur
atsøkin	síkravmikil
atsøkjari	síatsóknarmaður
attala	símótmæli
atvinna	sístarv
atvold	síorsøk
auktión	síhandilsskapur
av	síbrotin,burtur,burturav,endaður
avabbi	sískyldfólk
avafturrunnið	síódrukkin
avá	síá
avát	síát
avbangaður	síavbardur
avbankaður	síavbardur
avbardur	síveðurbardurSamheiti:avbangaður,avbankaður,avbukaður,avdukaður,avflongdur,avlamdur,avsmurdur,avstrokin,avtuskaður,blóðbardur,bøðilsbankaður,bøðilsflongdur,flongdur,gronsoraður,hundbardur,húðflongdur,koyrilsflongdur,moyrbangaður,moyrbardur,sligin,turrbankaðurbangaður, bankaður, bardur, bukaður, lamdur, tuskaður av;givin upp í bøðilshendur;vorðin handborin, harðliga viðfarin;○sum hevur fingið ein bakkalóara, kjaftfisk, leðrara, vangabrest o.fl.;sum hevur fingið eina avsmyrjing, fleingju, oyrafiku, tuskan o.fl.;sum hevur fingið eitt hálshøgg, nakkaslag, nevaduk, tuskilsi o.fl.↔berja,berjast,brekaður,duk,skaða,verða bardur
avbeklaður	síavlagaður
avbendingur	síbugur,seyður
avbendur	síhallur
avbera	síógvuliga
avbitin	síavgnagaður
avbjóðari	símótstøðumaður
avbjóðing	síálop
avblásin	síhovin
avblástur	sípyntaður,ruddiligur
avblomstra	sífølna
avblóma	sífølna
avboð	Samheiti:avlýsing,mótboð,ógilding(messufall)avlýst gudstænasta↔avlýsa,frest,fresta,hindraður (í at...)
avbragdsstyrki	símegi
avbrandaður	síbrunnin
avbreiddur	síavtakin
avbrek	síbrek
avbrekin	síbrekaður
avbrendur	síbrunnin
avbreyt	síinngongd
avbrigdi	sífrábrigdi
avbrodda	sífiska
avbrongla	síboyggja
avbronglaður	síóskapiligur
avbronglan	síavlaging
avbronglast	síavlagast
avbrot	síluteind,sindur
avbrotin	síbrotin
avbroyting	sífrábrigdi
avbrótari	síknøttur
avbrýndur	sírundur,uppslitin
avbukaður	síavbardur
avbundin	sítokutur
avburðarmaður	síavtakafólk,kraftamaður
avburðarseyður	síseyður
avbygd	síbýur,fjarleið
avbygdarfólk	sífremmandamaður
avbygdarligur	síheimføðisligur
avbygdarmaður	sífremmandamaður
avbygdarskapur	síheimføðisskapur
avbygdur	síavtakin
avbyrgdur	Samheiti:avgirdur,avstikaður,básaður,básbundin,burturgoymdur,byrgdur,girdur,inngirdur,innibyrgdur,innigerdur,innigirdur,innigjørdur,innilæstur,innistikaður,innistongdur,innistroymdur,innklombraður,innstikaður,múrgirdur,stikaður,umgirdurbyrgdur, læstur, stikaður, stongdur inni;í klombrum;settur á bás(fongslaður)varðhaldsfongslaður(undirkavaður)innikavaður,inniskelvtur(randaður)avmarkaður,gyrdur,havgyrdur,innrammaður,kransaður,kringdur,umgyrdurrammaður inn(kringsettur)avmannaður,kringrendur,umringaður,umringdurmannaður av;ringaður, ringdur inni↔afturlatin,búr,fjarskotin,garður,kring,krógvaður,mark,randa,rimaverk,ringur,steingja,útlinja
avbyrging	sífongsul,fyribyrging
avbyrgja	sígera skilarúm,steingja
avbæra	síógvuliga
avbærur	sífrálíkur,hábærsligur
avdagast	sídimma
avdalur	sídalur,fjarleið
avdanka	síavtofta
avdankaður	síavtoftaður
avdankast	síavtoftast
avdálkaður	sískitin
avdegnast	sídimma
avdetting	sídetta av,drykkjuskapur
avdeyða	síaldrandi
avdeyðaaldur	síellisár
avdeyðadýr	sídjór
avdeyðahundur	síhundur
avdeyðakúgv	síneyt
avdeyðalag	símáttloysi
avdeyðalamb	síseyður
avdeyðaneyt	síneyt
avdeyðaross	síross
avdeyðaseyður	síseyður
avdeyðaskrinda	síseyður
avdeyðaær	síseyður
avdeyði	sígamalmenni,seyður
avdeyður	síaldrandi
avdottin	sídetta av
avdoymi	síluktilsi
avdráttarskái	sífrest
avdráttur	síframleiðsla,gjald
avdrivin	síburturvilstur,reka av leið
avdubba	Samheiti:avvápnaminka um herbúgving, krígsútgerð(rigga av)taka burtur, niður(avdubbaður)avvápnaður↔avdubbing,óvardur,verjuloysiAndheiti:búgva út
avdubbaður	síavdubba,ílatin
avdubbing	Samheiti:avvápnan,avvápning↔avdubba,óvardur,verjuloysiAndheiti:dubbing
avdukaður	síavbardur
avdúka	síavhylja
avdúking	Samheiti:opinbering,uppgreiðing,varsjón↔avhylja,framsýning,greiður,opinberur,síggjast,sjónligur
avdúna	síroyta
avdýpi	síbládýpi,helviti
avdøma	sílasta
avdøming	sídómur
avegndur	Samheiti:agnleysur,agnsettur,avetin,avneitaður,berur,óegndur,skeivur,spilturvið berum húkum;við ongum agni;○sum er í agnloysi, agnneyð, agnsetri;sum er í uppisetri við agn, hevur agntrot, hevur mist agnið;□beitan hongur uppi á nevi, uppi í bølli;tað er ikki agnaneitin, agnaseilin, neitin eftir↔agn,agnloysi,egna
aveimdur	síbrunnin
av einslistum	sívandaliga
aveldast	síeldast
aveldur	síaldrandi,avlagdur,niðurdottin
avetin	síavegndur,avgnagaður
avfaksa	síkuta
avfall	síregn
avfallin	sídetta av,dygdarleysur,litfarin,niðurdottin
avfaralepi	síhúð,lepi
avfararoð	síhúð
avfaraseyður	síbeinaræ,seyður
avfaraskinn	síhúð
avfaraskját	síhúð
avfarin	sístyggur
avfáing	sískíta
avfeitta	sívaska
avfeitting	sívasking
avfelling	sítøting
avferma	sílossa
avfiskaður	sísigra
avfita	síslakna
avfjaðra	síkuta
avflogin	sístyggur
avflongdur	síavbardur
avgaddaður	síavgnagaður
avgamal	síaldrandi
avgangandi	síhallur,umskiftiligur
avgangur	síendaúrslit
avgapiliga	síógvuliga
avgeingiligur	síumskiftiligur
avgera	Samheiti:avráða,áseta,fastseta,samtykkja,seta,viðtaka,ætlagera av;gera úrskurð;hava ætlan um;játta at;ráða av;ráða fyri;samtykkja at;semjast um at;seta eitt í seg;seta sær eitt fyri;skipa fyri;skipa so fyri at;taka avgerð um e-t;taka eina avgerð;taka (ta) støðu;taka til ráða;□tað skal eg vera, verða góður fyri↔avvitandi,ásettur,dómur,døma,seta í gildi
avgerandi	sítýðandi
avgerð	sídómur,reyp
avgerðarrættur	sírættindi,vald
avgingin	sísigra
avgirdur	síavbyrgdur
avgjald	Samheiti:arvagjald,ágáva,ársgjald,barnapeningur,barnaviðbót,blaðgjald,drykkjupeningur,eykagjald,gjald,haldaragjald,havnargjald,havnarpeningur,innflutningsgjald,íbindingargjald,keypsavgjald,kjølfestugjald,kúleiga,lestagjald,limagjald,línupartur,lunnatoskur,mundur,nýtslugjald,partagjald,sendipeningur,sjónvarpsgjald,stempulgjald,støðugjald,sølugjald,tarvapengar,undangjald,uppihaldspeningur,útvarpsgjald,vatngjald,veggjald,veiting(skattur)avlopsskattur,eykaskattur,hundaskattur,húsaskattur,inntøkuskattur,jarðarskattur,kelduskattur,kirkjuskattur,kommunuskattur,kongsskattur,landsskattur,meirvirðisgjald,nýtslugjald,nýtsluskattur,ognarskattur,rentuskattur,ríkisskattur,samtíðarskattur,sjómannaskattur,skattabyrða,skattaeftirstøða,skattapeningur,skattaseyður,skipaleiga,skjútsskattur,stuttleikaskattur,søluskattur,torvskattur,tvískattur,vegskattur(tíggjund)fiskatíggjund,fuglatíggjund,grindatíggjund,hvalatíggjund,kalvatíggjund,kirkjutíggjund,kongstíggjund,korntíggjund,kópatíggjund,neytatíggjund,ostatíggjund,seyðatíggjund,smørtíggjund,tálgartíggjund,tíggjundarfiskur,tíggjundarfjós,tíggjundarflak,tíggjundarkorn,tíggjundarlundi,tíggjundarull,tíggjundull,ullartíggjund,ulltíggjund(tollur)hvalatollur,innflutningstollur,løgmanstollur,nevtollur,ravnatollur,tollgjald,útflutningsgjald,verjutollur(tollmúrur)tollforðan,tollverja,tollvernd↔afturfyri,afturgjald,álíkna,álíkning,dýrka,endurgjald,forskot,gjald,gjalda,gjaldkomin,okra,partur,prísur,útreiðsla
avgjørdur	síavvitandi,ásettur,endaður,fastur,galdandi,sannur,vissur
avgjørt	síbart út,dyggiliga,sanniliga
avglasaður	sífrystur
avgleraður	sífrystur
avglering	sítáveður
avgloymdur	síavlagdur
avgnaddaður	síuppslitin
avgnagaður	Samheiti:avbitin,avetin,avgaddaður,avjaglaður,beittur,berur,bitin,etin,grasbeittur,grasbitin,neyðbitin,piðaður,rótbitin,trotetin,turrpiðaður,uppetin,várbitin(trátugdur)upptugduretin á svaðasvørði;piðaður at beini;sum gólvið;□har er so perkutórað↔burturmataður,eta,gnaga,slitin,uppslitin,veðurbardur
avgonga	síísáð,veðurhvíld
avgongudagur	síveðurhvíld
av góðvild	sívegna vinskap
avgreiða	síarbeiða,avrokna,enda,gjalda,selja
avgreiðsla	sítænastuveiting
avgreiðslufólk	síkeypmaður
avgreiðslugenta	síkeypmaður
avgreiðslugjald	sígjald
avgreiðslumaður	síkeypmaður
avgrevstrarflag	síflag
avgrevstrarhaki	síknívur
avgrevstur	sídyrking,flag
avgrund	síbládýpi,helviti
avgudadýrkan	síátrúni,heiðinskapur
avgudadýrkari	síheidningur
avgudaoffur	síoffurgáva
avgudatrúgv	síátrúni,heiðinskapur
avgudur	sígudur
avgustahøvd	síhøvur
avgustahøvur	síhøvur
avgustur	síhvalur
avgøta	síkoyrivegur
avhald	Samheiti:fráhald(kýskleiki)kynsligt fráhald(kýskur)kynsliga fráhaldandi;□tey eru fráløgst↔fráhaldsmaður,hava timburmenn,ódrukkin,timburmennAndheiti:drykkjuskapur
avhaldsfelag	sífelag,fráhaldsmaður
avhaldsfólk	sífráhaldsmaður
avhaldsmaður	sífráhaldsmaður
avhaldsrørsla	sífráhaldsmaður
avhalga	síspotta
avhamaður	síhugspentur
avhálkaður	síhálur
avhelli	síhola
avhenda	sígeva
avhending	sígáva
avhendingarbræv	síváttan
avhendingarskjal	síváttan
avhildin	sídáma
avhoyra	sítráspyrja
avhoyring	síspurningur
avhómaður	sílitfarin
avhómast	síavlitkast
avhúða	síkoyra uttanav
avhús	síavkrókur,høli
avhylja	Samheiti:avdúka,berka,birta,eyðsýna,opinbera,sýna,vísabera fram, lata koma fram, fram í ljós(ið), fyri ein dag, til sjóndar;birta upp;bjóða fram;gera greiðan, kláran, opinberan, sjónskan, o.fl.;geva til kennar, sjóndar;koma fram við e-m;lata kennast, síggjast;sýna, vísa fram↔avdúking,greiður,opinberur,síggjast,sjónligurAndheiti:krógva
avhæsaður	síendaður
avhøgdur	síbrotin
avhøvda	síavlíva
avhøvdari	síknívur
avi	sískyldfólk
av illum	Samheiti:bara,bert,enntá,fyrr enn ikki,um ikki annaðhóast alt;í hvussu (so) er;í minsta lagi
avillur	sívreiður
avindsjúkur	síøvundsjúkur
avinna	síólagna
avísaður	sífrystur
avjaglaður	síavgnagaður,brotin
avjavnaður	síflatur
avkanna	sílorka burtur
avkannast	sílorka burtur
avkappaður	síbrotin
avkappari	síknívur
avkavað	sífrystur,kavi
avklakaður	sífrystur
avklár	sígrugg
avklárnað	síljósglæma
avkliptur	síbrotin
avklæðast	sínekta
avkolaður	síbrunnin
avkollaður	síavtoftaður
avkom	síbarn
avkomi	síbarn
avkomin	síkraftleysur
avkoyrdur	sífrákoyrdur
avkógvið	sítokutur
avkrókur	sífjarleiðSamheiti:grúgvukrókur,horn,hornvegur,klædnakrókur,krókur,loynikrókur,roykstovuhorn,roykstovuskot,rúm,skammikrókur,skot,smog,vitra,vrá,avhús↔fjarleið,fjarskotin,høli
avkubbaður	síbrotin,endaleysur,kubbutur
avkutaður	síbrotin
avkvettur	síbrotin
avkvist	síavlop
avkvista	síkuta
avkvøðin	sísigra
avkyrktur	síavstoktur í...
avkøvdur	sítokutur
avlaga	síboyggja
avlagaður	síóskapiligur,ørvitisligurSamheiti:bendur,blóðskeivur,hornaskotin,hyrnisskotin,ráhallur,skeiklaður,skeivur,skjalgur,skjálgur,snaraður,sneiddur,snúaður,tryglaður,vindskur,vinkulskeivurfarin av lagi;farin eftir øðrum kjafti;ikki í vinkul, ikki vinkulrættur;skotin úr horni;○sum hevur skotið seg, skotist, stavskotist(skeivt slitin)avbeklaðurtraðkaður skeivur↔avlagast,avlaging,bogna,hallur,óskapiligur
avlagan	síavlaging
avlagast	Samheiti:avbronglast,avskeplast,broytast,lykkjuskjótast,skeiklast,skifta,skjótast,snarast,stavskjótast,tryglast,umskapast,umskiftast,umskiplastbera á annan bógv;broyta sinnalag, útsjónd o.fl.;broyta, skifta ham;fara av lagi, stellingini;fara úr horni;fara úr lið;fáa aðra hugsan, annað skap, annan lit o.fl.;blíva, gerast, verða skeivur, skjálgur, vindskur, øðrvísi, øðrvísini;gerast skeivur;glíða út annan vegin;kasta hamin, skortin;leggjast undan;skifta um hugsan, lit, skap o.fl.;skiplast um;skjóta hamin;skjóta, sláa seg;skjótast úr horni (sum rossleypur);verða annar maðurin;verða umskiplað;□nú er annað ráð komið í húsið;nú er broyting, vend komin í;nú er, gerst viðvent í holuni;nú er ikki sum áður, fyrr;nú koma, síggast hógvarnir undan(tvørberast)skeiklast,skjótast,tvørskipast,tvørstoytastfara eftir aðrari lið, eftir liðini, eftir øðrum kjafti;fara, koma skeivur, tvørur (fyri);koma fyri tvørt, tvørt fyri↔avlagaður,avlaging,ávirkast,bogna,broyta,broyting,førka,kastast,umskiftiligur
avlagdur	Samheiti:aveldur,avgloymdur,avoldaður,burturbeindur,burturblakaður,burturdeyður,burturdottin,burturfallin,burturfyrndur,burturgloymdur,burturkastaður,burturkoyrdur,burturlagdur,burturmistur,burturoldaður,burtursópaður,burturtveittur,farin,fjónaður,forfjónaður,fyrndur,gloymdur,hálvgloymdur,horvin,útdeyðurdottin burtur, niðurfyri;dottin, gloppin burturímillum;farin, gingin, tikin úr gildi;farin í gloymskunnar hav, í nábalskrók, í ommu sína;ikki til longur;útigloymdur t.e. burturúrlagdur av gloymsku;vorðin (ov) fornur, gamal(ótíðarhóskandi)abbaligur,avoldaður,fornaldarligur,fornligur,fornur,gamaldags,gamalsligur,miðaldarkendur,miðaldarligur,ommuligur,ommuturfarin av móta;ikki uppi í tíðini;tikin úr brúki(abbaliga)gamalsliga↔aldrandi,avtofta,avtoftaður,avtoftast,endaður,frákoyrdur,gloyma,missa starvið,niðurdottin,ósannlíkur,reka úr starvi,tíðarrák,toftAndheiti:tíðarhóskandi
avlagi	síógvuliga
avlaging	Samheiti:avbronglan,avlagan,avskepling,brongl,bronglan,brongul,ólag,reinging,skeikl,vanskepling↔avlagaður,avlagast,broyta,broyting,umskiftiligur
avlagna	síógvuliga
avlamdur	síavbardur
avlami	sílammilsi
avlamin	síbrekaður
avlamingi	síkryplingur
avlamis	síbrekaður
avlamiseftirløn	sígjald
avlamisfólk	síkryplingur
avlamishjálp	sígjald
avlamislag	sílammilsi
avlamismaður	síkryplingur
avlamisrenta	sígjald
avlamistrygging	sígjald
avlamningur	síkryplingur
avland	sífjarleið,statur
avlandsvindur	sívindur
avlandsætt	sívindur
avlangur	Samheiti:eggklingrutur,eggrundur,eggvaksin,langligur↔rundur
avlatingareldur	síeldur
avlatingarløn	sígjald
avlát	síbírætting
avláta	síanda
avleggur	sífræ
avleiðing	síárin,endaúrslit
avleiðis	sífjarskotin,til viks
avlendis	síburturstaddur
avliðin	síliðin
avlima	síkuta
avlitka	síavlitkast
avlitkaður	sílitfarin
avlitkast	Samheiti:avhómast,avlitka,blikna,følna,hvítna,litfarast,litifarast,líkblikna,ljótkablikna við;dámast, kámast burtur (í einki);fara við lit, liti;gerast bleikur, følin, hvítur, ljósur;kasta litin;missa dæmið, litin;sláa litir frá(skifta lit)bláma,blána,brúnka,dimma,dimmast,døkkast,fargast,grána,grønka,grønkast,gulna,kasta,litast,litbroytast,litskiftast,myrkja,myrkna,rodna,sortna,sólbrennabroyta lit;gerast bláur, gulur, reyður o.fl.;rodna sum ein droyri, sum korkaleivur;rodna upp;rodna upp um bæði oyru(r);skifta ymsar litir↔avmyrking,bleikur,dæmdur,lita,litaður,litevni,litfarin,ljótkast,myrkur,roði,skuggiAndheiti:fríðkast
avlittur	sílitfarin
avlíva	Samheiti:aloyða,avhøvda,avoyða,avrætta,avsiga,bana,blóðga,bráðdrepa,deyða,doyða,drápa,drepa,fella,fletta,hálshøgga,heingja,helja,heysa,jarðleggja,kála,kippa,kíla,krika,krikasnara,krossfesta,kvala,kyrkja,køla,meinstinga,morða,myrða,myrja,mønustinga,oyða,oyðdrepa,oyðidrepa,oyðileggja,ræna,sála,skera,slakta,slátra,snara,steindrepa,svevja,svæva,taka,týna,umkoma,vega,yppa,ørdrepa,ørfleyga,ørskjótabeina fyri;bróta á háls;drepa e-n inni;fáa, taka lívið av e-m;fella, høgga, ryðja niður;forgera, forkoma, umkoma e-m;gera av við;gera bart;gera enda, skil á e-m;geva e-m mønusting(in);hella út blóð;høgga hálsin, svíran av (á) e-m;ikki eira e-m ellina;kappa, skera, snara hálsin, krikan av (á) e-m, høvdið, heysin av e-m;kasta, stoyta oman;koma e-m at bana;køla út;leggja e-n á barkastokk;leggja e-n í grøvina áðrenn, fyri tíðina;leggja (e-n) í slys;leggja í oyði;leggja kaldan;leggja lím í heysin á e-m;lemja til heljar;líva e-m við elli;lúka burtur;oyða út;rista e-m blóðørn;ríva (fugl) út;roykja (rottur) út;rudda út;skera á háls;skera út úr kýlinum;skilja e-n við anda;sláa deyðan, í hel, kaldan, steinkaldan, til avlívis, avlívs;stinga niður;stinga til ólívis, ólívs;stytta e-m um lívið;taka av lívi, døgum;valda, volda bana, deyða;veita bana;vera e-m at bana(forgera sær)beina fyri sær (sjálvum);doyggja fyri egnari hond;drepa seg sjálvan;forgera, forkoma sær (sjálvum);fremja, gera sjálvmorð, sjálvmorðsroynd;fyrigera lívi sínum;heingja seg;kasta seg, sær oman;sjálvdrepa seg;taka lívið av sær;taka seg (sjálvan) av døgum, lívi;taka (sítt) egið lív;verða sær sjálvum at bana↔deyðamein,deyði,deyður,doyggja,dráp,drápsmaður,fiskaloysi,følna,gálgamatur,hálvdeyður,knúsa,oyðin,oyðsl,oyðsla burtur,oyðslusemi,sjúkur,skaða,søra,týningarhugurAndheiti:føða
avlívis	síavlíva
avlívs	síavlíva
avlogaður	síbrunnin
avlop	sívánamaður,yvirskotSamheiti:avkvist,avlopsbiti,avlopsmongd,avstøka,bakspónur,berskaki,dumba,dumbubos,eftirleivd,eftirsløð,eftirstøða,fiskaavlop,fiskaleivdir,fiskarusk,fiskarut,gólvsóp,graps,grindarut,hampastrýggjur,hams,hamsaknokkur,hamsi,hoyrusk,jøkil,jøkilgras,leivd,leiving,leivur,ljósadumba,matleivd,murtn,murtl,myrkadumba,rest,rut,seyðaleivur,skarnsdropi,skarnsoytil,smárusk,snøkil,sóp,taramurtl,taramurtn,urðarmurtne-t sum liggur og rekst;tað sum eftir er av...(burturkast)afturkast,avrisp,avsag,burturblak,fras,garnarúgva,kjarnorkuburturkast,ónytta,ónyttufjas,rusk,ruskdungi,rusl,skav,skrambl,skraml,skrambul,skruml,strandvarp,túnasóp,útskot,vraknyttuleysir lutir;ónyttigir lutir;ónyttugt fjas(órudd)dragsl,drasl,fras,hernaður,hersetur,hússetur,hyrnirúgva,órusl,órusla,órúm,rummalareiggj,rummanareiggj,rummarareiggj,rumsalareiggj,rus,rusk,rusl,sank,smáfrasóruddilig rúgva;vánaligt hússetur↔dygdarleysur,foruttan,leypa av,óneyðugur,órudda,óruddiligt høli,óruddiligur,yvirskot,øskaAndheiti:kjør
avlopsbátur	sísjófar
avlopsbiti	síavlop,matur
avlopsmaður	sívaramaður
avlopsmegi	símegi
avlopsmongd	síavlop
avlopspeningur	sípeningur,yvirskot
avlopsseyður	síseyður
avlopsskattur	síavgjald
avlopsskifti	síbýti
avlopsterri	síterri
avlopstorv	síbrenni
avloysa	síbírætta
avloysari	sívaramaður
avloysing	síbírætting,broyting
avlógvaður	síslitin
avlógvast	símatast burtur
avlukta	sílorka burtur
avluta	sílorka burtur
avlutta	sílorka burtur
avlýsa	Samheiti:strikafáa, hava forfall;geva avboð;havna boði;leypa frá;taka av skránni(avlýstur)tikin av skránni↔avboð,frest,fresta,hindraður (í at...)
avlýsing	síavboð,dimmi
avlýstur	síavlýsa
avlærdur	sílærdur
avlæsing	síendaúrslit,endi,tøting
avmakta	símáttsúgva
avmaktaður	síútmøddur
avmaktarsveitti	sísveitti
avmaktast	sítroyttast
avmanna	síranda
avmannaður	síavbyrgdur
avmarka	síbroyta,frámerkja,nágreina,randa,minka
avmarkaður	síavbyrgdur,ófullfíggjaður,tíðaravmarkaður
avmarkan	síminking
avmarki	síseyður
avmarking	símark,merking,minking
avmarvaður	síuppslitin
avmáaður	síuppslitin
avmáttaður	síútmøddur
avmegingur	sípinkulingur,seyður
avmergja	símáttsúgva
avmergjaður	sírakfallin,útmøddur
avmergjast	síslakna
avmintur	sígloymskur
avmona	síkuta
avmóður	síómóður
avmynd	síeftirgerð
avmynda	síendurgevaSamheiti:filma,kykmynda,ljósmynda,mála,mynda,teknagera, taka mynd av e-m;taka av, upp;taka bílæt;taka film↔avrit,eftirgerð,endurgeva,mynd,myndatøka,skera út,útskering
avmyndan	símyndatøka
avmyrking	Samheiti:mánamyrking,myrkalegging,myrking,ringmyrking,sólarmyrking,sólmyrkingfullkomin myrking↔avlitkast,myrkur,skuggi
avmæltur	símæltur
avmæri	símáttloysi,seyður
avmæringur	síseyður
avmærisær	síseyður
avmøddur	síómóður,uppfiskaður,útmøddur
avmøðingur	síseyður
avmøtt	síuppfiskaður
avneitaður	síavegndur
avnokta	síheidningur,nokta
avnoktan	sínoktan
avnoktari	síheidningur
avnor	sípinkulingur,seyður
avnotaspik	síspik
avnotastykki	síspik
avnotatálg	sífitievni
avnór	sípinkulingur,seyður
avnutaður	síuppslitin
avnøggaður	síuppslitin
avoldaður	síaldrandi,avlagdur
avoldast	síeldast
avoyddur	sífólkaoyðin
avoyða	síavlíva
avoyraður	síhaldaleysur
avoytt	síuppfiskaður
av órættum	síóreiðiliga
avpartaður	síóvanligur
avpiðaður	sírakfallin
avpláss	sífjarleið
avrak	sírakfallin
avráddur	síavvitandi,galdandi
avráða	síavgera,forbjóða
avráðing	sídómur
avreiddur	sílossa
avreiða	sílossa,selja
avreiðari	síkeypmaður
avreiðing	síhandilsskapur
avreiðingarprísur	síprísur
avreks-	sífrálíkur
avreksgerð	síroysnisgerð
avrekskappi	síavtakafólk
avreksmaður	síavtakafólk,kraftamaður
avreksverk	síroysnisgerð
avrenning	síódrukkin
avrik	sígerð,starv
avrika	síarbeiða
avrikamikil	síúrtøkugóður
avriksarbeiði	síarbeiði
avriksløn	sígjald
avringt	síkima
avrisp	síavlop,sindur
avrit	Samheiti:avskrift,eftirrit,endurrit,gjøgnumslag,kontoavrit,makaskjal,náptak,trygdaravrit,trygdarrit,tvítak(útskrift)úrskrift,útprent,úttak(ljósrit)ljóstak↔avmynda,eftirgerð,endurgeva
avrita	síendurgeva
avrokin	síbrunnin
avrokna	Samheiti:avgreiða,greiða,kvittaavgreiða endaliga;avgreiða til fulnar;fáa (endaliga) frá hondini;fáa liðugt;gera avrokning;gera klárt;gera upp;greiða av, til;klára upp↔gjalda
avrokning	Samheiti:ársuppgerð,kláring,lønaruppgerð,mánaðaruppgerð,nota,ognaruppgerð,sjálvuppgáva,støðuuppgerð,uppgerð,uppkláringendalig, fyribils uppgerð↔bókhald,roknskapur
avrot	sídeyði
avrovaður	sísárur
avrógvin	sísigra
avrók	sírók
avrundaður	sírundur
avrunnið	síódrukkin
avrunnin	síódrukkin
avrúm	síhøli
avryski	síóflýggjakroppur
avrætta	síavlíva
avrætting	sídráp
avrøkja	síjagstra
avrøkjast	sístyggjast
avrøkstra	síjagstra
avrøkstraður	sístyggur
avrøktur	sístyggur
avsag	síavlop
avsagaður	síbrotin
avsagdur	sífrákoyrdur
avsaka	sífyrigeva
avsakan	sífyrigeving
avsakaseg	síangra
avsanna	sínokta
avsannan	sínoktan
avsáddur	síavtakin
avseta	síband,skorpna
avseting	sísparing
avsetra	síband
avsettur	sífrákoyrdur,turrur
avsetur	síband
avsetutráður	síband
avsiga	síavlíva
avsigast	síeftirlíka
avsigldur	sídeyður
avsintur	sívreiður
avsíðis	sífjarskotin,til viks
avsíli	sígrugg
avskapa	síboyggja,broyta
avskapaður	síóskapiligur
avskapiliga	síógvuliga
avskapiligur	síóskapiligur
avskarving	síminking
avskáldaður	síoyðin
avskeiklaður	síóskapiligur
avskelvtur	sífrystur
avskepla	síboyggja
avskeplaður	síóskapiligur
avskeplast	síavlagast,ljótkast
avskepling	síavlaging
avskila	síógvuliga
avskilaður	sísundurbýttur
avskildraður	sísundurbýttur
avskipa	sílossa
avskipast	sídoyggja
avskiping	sílossing
avskjaldraður	sísundurbýttur
avskorin	síbrotin,uppslitin
avskotin	sígróðrarbúgvin
avskrift	síavrit
avskriving	síeftirgerð,minking,skrift
avskræmiliga	síógvuliga
avskræmiligur	símisháttur,ræðandi
avskurðarjørð	síjarðarstykki
avskurðarseyður	síseyður
avskurður	sídráp,gjald,seyður
avskøða	sínekta
avsláttarkort	síváttan
avsláttur	síminking
avsleipin	síhallur,hálur
avslipaður	sísliputur
avslitin	síuppslitin
avslættaður	síniðurtraðkaður
avsmurdur	síavbardur
avsmurningur	síduk
avsmyrjing	síduk
avsneiddur	síkílaskapaður,svika
avsnøggaður	síuppslitin
avsovnaður	sídeyður
avspáka	síhava frí
avspákan	sífrítíð
avstað	síburtur
avstaðarfólk	sífremmandamaður
avstaðfaring	sífráfaring
avstaðferð	sífráfaring,startur
avstaðsfólk	sífremmandamaður
avstarvaður	sídeyður
avstikaður	síavbyrgdur
avstilt	síblikastillur,góðviðrað
avstokkin	síbrotin
avstoktur	síavstoktur í...
avstoktur í...	Samheiti:helstunginavkyrktur í...;gjøgnumstungin, plágaður, uppetin, yvirtikin av...;hart tikin av...;ringur av...;sera illa fyri av...↔feingin,feingja,sjúka,sjúkur,smittaður
avstorkin	sískitin
avstoyttur	sífrystur
avstrokin	síavbardur
avstroyddur	síavtakin
avstubbaður	síuppslitin
avstøða	síárin,endaúrslit
avstøka	síavlop,minking
avstøktur	síbrotin
avsvarðaður	síoyðin
avsviðin	síoyðin
avsvunnin	sísvunnin
avsýra	sívaska
avtaglaður	síavtakin
avtaka	sídøma
avtaka-	sífrálíkur
avtakafólk	(megnarmaður)avburðarmaður,avrekskappi,avreksmaður,avtakamaður,avtaksmaður,avtøkumaður,birtingur,bragdamaður,bragdamenni,brandur,brynjubaldur,drongur,dugnamaður,einskilamaður,einsýnamaður,eldsál,eyðvalamaður,fagnarbóndi,fagnarmaður,físari,frágerðarmaður,fráskiladrongur,fráskilamaður,frælsishetja,garpi,garpur,gongumaður,greppur,hendingamaður,hendingsmaður,hendingur,hetja,jarn,kallmenni,kalur,kappi,kempa,knarki,knassi,knevil,koyrari,lagamaður,maktarmaður,manndómsmaður,mannfólk,mansevni,meistari,menjarbaldur,menjari,menni,merkismaður,morðjarn,orðakappi,ovurmenni,pressari,rekkur,reystkappi,reystkempa,reystmaður,reystmenni,risi,rokari,roysnismaður,roystmenni,røkkur,sáttarmaður,seggur,sellur,sepramaður,skaft,skiladrongur,skilamaður,snildingur,snillingur,stakmaður,stórmenni,svaramaður,søguhetja,tiltøkumaður,tjóðarhetja,tjóðhetja,tóvarabiti,undantaksmaður,úrgerðarmaður,úrmælingur,úrvalsmaður,útmælingsmaður,útmælingur,valamaður,vásmaður,yvirmenni,ønarihann er ímóti fleiri, sjey, tíggju, trimum, tveimum(megnarkvinna)dugnakona,fráskilagenta,fráskilakona,geggja,knerra,knørr,knørra,konubrot,kvennhetja,kvinnubrot,megnarkona,mentarsnót,mentarsprund,merkiskvinna,skilagenta,skilakona,tóvaraklógv,valakonahon er ein rættur, sannur kallmaður;hon er sum eitt mannfólk, sum ein kallmaður (í húsinum)(megnarfólk)dugnafólk,fráskilafólk,selli,sigg,skilafólk,úrmæli,valafólkdugnaligur, raskur maður;ein framúr maður;eingin bloyta, bløka, kastikleppur, kveiningur, nakkaroytingur o.fl.;ein harður hálsur, rættur maður, rættur vásmaður;ein sovorðin brennandi brandur, sovorðin koyrari, sovorðin rívandi ond;eitt skaft;eitt øgiligt sigg;ikki nøkur bløka;rættur maður;sjáldsama góður maður, gott fólk o.fl.;stak fólk, kvinna, maður o.fl.;□hann er ikki eingin maður, ikki hvør sum helst;hasin fær neyvan sín líka(handamaður)allahandamaður,hegnarmaður,hegnismaður,margsnillingur,meistari,snildingur,snillingursum dugir væl til hendurnar(vandahond)køn hond(konufólkahond)kvinnuhondlagalig hond↔álitismaður,frálíkur,hampafólk,kraftamaður,manniliga,oddamaður,raskur,slitmaður,tríalingur,vinnariAndheiti:barbrot,eftirbátur,ræðuskítur,vánamaður
avtakamaður	síavtakafólk
avtakandi	síhóskiligur
avtakaveður	síillveður
avtakin	Samheiti:avbreiddur,avsáddur,avstroyddur,breiddur,fjaldur,taktur(avvaksin)alvallaður,avtakin,undirgingin,undirgrógvin,undirvaksin,vaksin(tættbygdur)albygdur,avbygdur,ábygdur,áfastur,fjølbygdur,fólkaríkur,íbygdur,nærbýlt,ovbýldur,ovfólkaður,ovmannaður,samanbundin,samanbygdur,sambygt,samfastur,tættbýlduravvaksin, breiddur, undirgrógvin, undirvaksin, vaksin (við...);bygt áfast, samanhangandi;fastur í, við...;loðin av...;undur, undurgingin í...;○sum hongur saman við e-m;□har er so nærbýlt t.e. stutt ímillum húsini;tað er, stendur sum ein riparakjaftur;tað er sum at líta í ein riparakjaft, sum á riparanum;tað er sum hjá trøllunum í Hornalondum t.e. nógv í húsi(fuglaríkur)lomvigabygdur,lundabygdurtætt sett við fugli(avtaglaður)avteyggjaður,byrjaður,ovbyrjaður,ovklyvjaður,taglaður,tyngdur,týggjaður,undirborin,undirbyrjaður,undirdíktur,undirdongdur,undirgrýttur,undirkleksaður,undirklektur,undiroystur,undirrokin,yvirbyrjaðurtætt settur↔arbeiða,bera,loðin,nógvur,nøgd,ótøkur,samanhangandi
avtaking	símyndatøka
avtaks-	sífrálíkur
avtaksmaður	síavtakafólk
avtala	sísemja,tos
avtapa	sígloyma
avteipaður	síútmøddur
avteyggjaður	síavtakin
avtikin	sídoyggja,sárur,svunnin
avtíð	síseint
avtofta	Samheiti:avdanka,bróta,kannkolla,rívabróta, laða, leggja, ríva, rjúva, skræða, taka niður;leggja (hús) á grund;leggja lið á (garð)↔avlagdur,avtoftaður,avtoftast,falla,flata niður,niðurdottin,niðurríving,niðurtraðkaður,rapa,toftAndheiti:byggja,endurskapa
avtoftaður	Samheiti:avdankaður,avkollaður,burturveltur,kannkollaður,niðurbrotin,niðurlagdur,niðurrivin,niðurskræddur,niðurtikin,rivin,sundurskræddur,sundurtikinfarin í toftina;lagdur í grund, oyði, øsku↔avlagdur,avtofta,avtoftast,falla,flata niður,niðurdottin,niðurríving,niðurtraðkaður,rapa,toft
avtoftast	síoyðileggjastSamheiti:avdankast,dankast avbrotna, detta, rivna niður;verða avtoftaður, kannkollaður, niðurtikin o.fl.↔avlagdur,avtofta,avtoftaður,falla,niðurdottin,niðurríving,niðurtraðkaður,rapa,toft
avtrivnast	sívantrívast
avtrivni	símáttloysi
avtuskaður	síavbardur,útmøddur
avtøka	sísár,tøting,yvirskotSamheiti:burttøka,burturtekt,burturtøka,uppsøgn,úrliman,úrsøgn,útliman,útstriking(burtursøgn)burturvísing,útrakstur(ógilding)ógildan↔reka úr starviAndheiti:viðseting
avtøkumaður	síavtakafólk
avtøkuær	síseyður
avundsjúka	sítrá
avundsjúkur	síøvundsjúkur
avvaksin	síavtakin,loðin
avvallaður	síloðin
avvandur	síleggja av
avvarðandi	síáðurnevndurSamheiti:eftirsitandi,skyldur(húski)familja,heim,hús,húsfelagi,húsfólk,húsisfólk,hýski,innanhýsisfólk,næstingur,næstrafólk,næstringur,reiður,sambúgvi,skyldfólkalt heimið, húsið, reiðrið;húsins fólk;... og tey;tey á, í, undir, við o.fl.(navngivnum húsi, stað);tey hjá... (okkum, teimum o.fl.);tey í heiminum, húsinum;tey ið standa e-m nær;tey sum eftir sita, varða av(varða av)hoyra til húskið, o.fl.;liva, sita eftir;standa e-m nær;vera, hoyra til tey avvarðandi, eftirsitandi;vera húski o.fl.↔granni,húsbóndi,kvinna,móðir,pápi,persónur,skyldfólk,skyldskapur,ættaðurAndheiti:fremmandamaður
avvavdur	síumvavdur
avvápna	síavdubba
avvápnaður	síavdubba,óvardur
avvápnan	síavdubbing
avvápning	síavdubbing
avvegis	sífjarskotin,til viks
avvegur	sísniðgøta
avveittur	síturrleggja,turrur
avveltur	síalduturSamheiti:afturopin,afturøvutur,víðopin,øvigur,øvugur,øvuturdottin um koll, rygg;(opin) á rygginum↔aftureftir,endilangur,falla,kollvelta
avvenjing	síviðgerð
avverkað	síendaður
avviðaður	sískeivvaksin
avvik	síburturvik,frábrigdi
av vinskapi	sívegna vinskap
avvitandi	Samheiti:avgjørdur,avráddur,medvitin,miðvíst,tilvitaður,tilvitandi,tilvitin,tilætlað(ur),upplagdur,vitandi,vitvísurav fyrisettum ráði;avgjørdur, ætlaður frammanundan;við avráddum huga;við (fríum) vilja;við ráddum huga;vitandi og við vilja↔avgera,ásetturAndheiti:tilviljandi
avynna	síólagna
avynnubarn	síavynnumaður
avynnudagur	sívánatíð
avynnudýr	síavynnumaður
avynnuligur	sídygdarleysur
avynnumaður	Samheiti:avynnubarn,avynnudýr,avynnuting,fimbulsvætti,hornagestur,krossdragari,neyðarmaður,óeydnismaður,óeydnumaður,ólagabarn,ólagafólk,ólagamaður,óvætti,seiðatrøll,sorgarbarnneyðar, neyðars, stakkals...;□hann er ikki gævudýr(vaðskítur)vatnkráka,vavvur↔eydna,eydnast,eydnismaður,lagna,ólagna,óheppin,vánatíðAndheiti:eydnismaður
avynnuting	síavynnumaður
avynnutíð	sívánatíð
avyrktur	sísigra
avýtað	síýta
avýting	síýta
