eddukvæði	sísangur
ediliga	síhábærsliga
ediligur	síhábærsligur
edilingur	síaðalsfólk,hampafólk
edilsteinur	sígrót
edrúur	síódrukkin
eðiligur	síhábærsligur
eðilingur	síaðalsfólk,hampafólk
eðilsteinur	sígrót
effinett	síjúst
eftiransan	síeftirlit
eftiransin	Samheiti:ansin,árvakin,eftirhyggin,eftirskettin,eyghavin,framsíggin,framskygdur,framskyggin,framsýndur,framsýntur,fyribirgin,fyrihyggin,fyritonktur,fyrivarin,fyrivarur,gáin,hittin,hugvarin,hyggin,lagaklókur,langskygdur,nærhugaður,ovurvarin,skettin,tilsíggin,umhugsin,umhyggin,umsorgarfullur,vakin,vandaligur,vandamikil,varigur,varin,varisligur,varligur,varsamur,varsin,varugur,varurgáin um seg(vera eftiransin)ansa,gæta,sansa,sketta,skjøtta,vara,varðaakta, ansa, gáa eftir e-m;akta, ansa sær fyri e-m;akta, passa uppá (e-t);akta um;andøva streymin;ansa sær;binda um heilan fingur;fara hóvliga, sinniliga, varliga avstað, fram;festa seg við e-t;fylgja við;gáa (um) e-t;gera sær skammfar um...;geva akt, ans, gætur;geva e-m akt, ans, fær, gætur o.fl.;geva e-t í geyma;geva (sær) far um;goymsa, goymsast eftir e-m;hava eyguni við e-m, sær;hava fyrilit;hava gætur á e-m;hava hyggi, hyggju fyri sær;hugsa um;hyggja eftir;hyggja fyri sær;hyggja rundan, uttan um seg;hyggja seg um;ikki lata seg lumpa;ikki leypa framav;leggja (sær e-t) í geyma;leggja til merkis;sansa e-m, sansa um e-t;sigla við lágum seglum;síggja til;sketta, skjøtta eftir e-m, um e-t;taka seg vara;vara um seg;vara, varða seg (fyri e-m);vera ansin, gáin, hyggin, varin o.fl.;vera gáin um seg;vera oddur eldri t.e. duga at vara seg fyri svikum;□hann er ikki hvøns mans poki;hann er ikki lættur at lumpa;hann loypur ikki framav;hann setist aftur bara tað lotar úr hanakjafti;hann tekur eingi óráð fyri seg;hann trýr ikki øllum ið sagt verður;hann verður ikki fiskaður á, við ongum agni↔ansni,eftirlit,fyribyrging,klókur,lirka,nærlagdur,passa,røkiskapur,røkt,vaktarhald,vaktari,vandaliga,vanda sær,verja,verja annan,verja segAndheiti:dølskur,líkasælur
eftiransing	síeftirlit
eftiransingarmaður	sívaktari
eftiransingarnevnd	sívaktari
eftiransingarráð	sívaktari
eftiransingarstovnur	sívaktari
eftiransni	síansni
eftiransur	síeftirlit
eftiraping	síeftirgerð
eftirbati	síbati
eftirbátur	sísjófar,tapariSamheiti:ak,an,darl,deyda,deyðaválk,dilda,dirl,dirtl,dólgur,draguskítur,dratl,drál,drák,driftinivel,drongsl,dronkl,drontl,drosl,droypisíl,drumbur,drunsl,drúgneyt,drymbingur,duli,dull,døll,eftirbiti,eftirgangari,eyk,gáloysingur,gáloysiskroppur,halakongur,halastýrari,heimakúgv,hím,høsn,káv,løgg,løggur,morgunskav,ómenni,ómenska,pitla,pjak,pjakuvætti,pjankus,pják,pjøg,putla,seinabukka,seinsiringur,seinsirja,seinsíl,silla,skav,skítur,skreiðsl,smoguskítur,snáva,snubbulókur,springskítur,stóð,svøvnur,sýs,sýsa,tísturpjakut, pjákut, seinført fólk;□hann fær einki upp í lag(gloymiskítur)minnisskittur,minnisskítur↔bíða,bíðan,drál,gloyma,latur,letast,leti,letingi,seinpjakutur,tapari,vánamaðurAndheiti:avtakafólk,oddamaður,vinnari
eftirbiti	síeftirbátur,matur
eftirburður	síhinna
eftirbøtingur	sísjúklingur
eftirdømi	sífyridømi
eftirdøttur	síseinføðingur
eftirepli	síepli
eftirfarandi	sísannur,trúgvur
eftirferð	síhinna
eftirfesti	síískoyti
eftirfylgd	síendaúrslit
eftirfylgi	síeftirfylgja
eftirfylgja	síendaúrslitSamheiti:afturatkoma,avleiðing,avstøða,afturkembing,bakbrot,bakkast,bakstoytur,eftirfylgi,eftirkembingar,eftirleikur,eftirrák,eftirsjúka,eftirspæl,eftirstøða,eftirverkir,fylgdarsjúka,fylgja,tilslag(afturfall)afturstig↔árin,fast takist
eftirgangari	síeftirbátur,vánamaður
eftirgáan	síviðraking
eftirgáva	sífyrigeving
eftirgerð	sígandurSamheiti:avmynd,eftirmynd,eftirprent,endurmynd,keip,keipumynd,líking,mannmynd,mótbílæti,myndarlíki,myndil,myndlíki,speimynde-t eftirgjørt;e-t sum er í drekalíki, fuglalíki, mannalíki o.fl.(herming)avskriving,eftiraping,eftirgerð,eftirherming,eftirtøka,endurgáva,endurgeving,herman↔avmynda,avrit,endurgeva,líki,líkjast,líkskapur,líkur,mynd
eftirgeving	sífyrigeving
eftirgjalding	sígjald
eftirgjørdur	símanngjørdur
eftirgloyma	síkvinna
eftirgloymingur	sívánamaður
eftirgongusnúður	sísnúður
eftirgróður	síepli,gras
eftirherming	síeftirgerð
eftirhugdur	síkannaður
eftirhyggin	síeftiransin
eftirhyggingarmaður	sívaktari,veiðimaður
eftirkannaður	síkannaður
eftirkannan	síeftirlit,kanning
eftirkanning	síeftirlit,kanning
eftirkembingar	síeftirfylgja
eftirkomari	sískyldfólk
eftirkrav	síkrav
eftirlagan	síbroyting
eftirlagdur	sígloyma
eftirlátin	sílítillátin
eftirlátinskapur	síeftirlæti
eftirlátligur	sílítillátin
eftirlátur	sískellilátur
eftirleggin	síáhugaður,raskur
eftirleikur	síeftirfylgja
eftirleitan	síleitan
eftirleivd	síavlop
eftirlit	Samheiti:ansur,arbeiðseftirlit,bankaeftirlit,eftiransan,eftiransing,eftiransur,eftirkannan,eftirkanning,eftirskoðan,filmseftirlit,góðskueftirlit,hálvaseta,innaneftirlit,prísansing,príseftiransing,príseftirlit,skipaeftirlit,summarseta,tilsjón,tolleftirlit,trygdareftirlit,umsjón,yvirumsjónalment eftirlit(innlit)innsýni↔ansni,eftiransin,fyribyrging,passa,røkiskapur,røkt,vaktarhald,vaktari,verja,verja annan,verja seg
eftirlitaður	sídæmdur
eftirliting	sílitevni
eftirlitsmaður	sívaktari
eftirlitur	sílitevni,littóni
eftirlíka	Samheiti:akta,avsigast,bønhoyra,góðtaka,hoyra,játta,lurta,lýða,samtykkja,siga ja,slaka,virðaakta, lýða boð;boyggja seg;dúva undir;eftirlíka e-m;finna seg í;fylga ráðum, boðum;ganga undir e-t;ganga undir treytir;gera eftir boðum, vild, ynski;gera e-m til fylgnis, lags, vildar;gera sum e-m er sagt, sum e-r er biðin, sum sagt er;gera sum hini (gera, siga, ynskja);gera tað annar vil;gera tað sum ein er biðin (um);geva eftir;geva e-m eftirlæti;geva seg undir (treytir);geva, sláa seg til tols við;hava undirlutakenslu;hokka eftir;ikki mótmæla, ikki muta ímóti, ikki svara til;laga seg eftir;lata e-m e-t til vilgøði;lata e-t um seg ganga;lata seg lokka, yvirtala;lata sær eftirlíka;lata sær e-t eftirlíka, lynda, siga;lata sær lynda;lata um seg ganga;látast sum einki;lurta eftir;rætta seg eftir e-m;siga ja;siga ja og amen;smyrja seg við e-t;spilla e-n við eftirlæti;svølgja e-t;sætta seg, sættast við e-t;taka eftir ráðum eins;taka e-t;taka til takkar við;taka við kostum;tiga og samtykkja;tiga og tola;tiga til;vera e-m til vildar;vera hoyriligur, lýðin, undirbrotligur o.fl.;viðurkenna at...(taka av)siga ja (til e-t);smekka til;taka av tilboði;taka við kostum, tilboði↔eftirlæti,forkela,jabróðir,játtan,játtandi,lítillátin,lova,prógva,støðuveikur,villigur,vingliskølturAndheiti:mótmæla,nokta
eftirlíking	síeftirlæti
eftirlíkning	síálíkning
eftirljóð	síafturljóð
eftirlótir	síeftirlæti
eftirlútur	sívaskiløgur
eftirlýsing	síboðan
eftirlæti	Samheiti:eftirlátinskapur,eftirlíking,eftirlótir↔eftirlíka,forkela,lítillátinAndheiti:strangleiki
eftirløn	sígjald
eftirlønaraldur	síellisár
eftirlønargrunnur	sígrunnur
eftirlønartrygging	sítrygging
eftirløntur	síløntur
eftirmaður	sískyldfólk,varamaður
eftirmeta	síkanna
eftirmeting	síummæli
eftirmóður	síútmøddur
eftirmynd	síeftirgerð
eftirmæli	síámæli,ískoyti
eftirnavn	sínavn
eftirprent	síárit,eftirgerð
eftirráð	síleiðbeining
eftirráðin	síeftirsnarur
eftirrák	síeftirfylgja
eftirrit	síavrit
eftirrættur	símatur
eftirseturenta	sígjald
eftirsitandi	síavvarðandi
eftirsíðan	síikki enn,síðani
eftirsíðani	síikki enn,síðani
eftirsíður	síikki enn,síðani
eftirsíggin	Samheiti:drýggjaligur,fornur,fyribirgin,goymin,kravlítil,neyvur,nøgdsamur,pjøkin,røkin,røkjutur,smátøkin,sparin,sparingarsamur,sparsamur,tilsíggin,toyggin,umhygginnøgdur við lítið;røkin og pjøkin;○sum dugir væl at eiga inni, goyma (til verri tíðir);sum fer væl um;sum ikki nennir at brúka, nýta;sum ætlar (ov) lítið til;□hann dugir væl at fáa endarnar at røkka saman, halda hús, húsast;hann er nøgdur við lítið, etur seg ikki undan nagli;hann er so fornur;hann letur ikki tað síðsta↔afturhald,búskapur,drúgvur,drýggja,halda hús,húsligur,røkiskapur,sparing,trivamaður,nærlagdur,vandaliga,varandiAndheiti:oyðslutur,órøkjutur
eftirsjón	símissur
eftirsjúka	síeftirfylgja
eftirskettin	síeftiransin
eftirskjálvti	síristing
eftirskoðan	síeftirlit
eftirskoyti	síískoyti
eftirskrift	síískoyti
eftirskúli	sískúli
eftirsløð	síavlop
eftirsnarin	síeftirsnarur
eftirsnarur	Samheiti:eftirráðin,eftirsnarinklókur aftaná;○sum veit alt aftaná(beturvitin)
eftirsnúður	sísnúður
eftirspenna	síbinda,rætta
eftirspentur	síkannaður
eftirspurdur	síeftirynskjandi
eftirspurn	Samheiti:eftirspurningur,gravgangur,keypsáhugi,keypshugur,rovgangur□fleiri hava sýnt áhuga;fólk standa, stendur í røð at...;hann fekk kobbabýti;har, tað eru fleiri, mangir, nógvir um boðið;har verður lítið í part;har vóru ravnar um soðið;hatta er nógv eftirspurt, umbiðið;hatta verður smábýtt;tað er gravgangur, eftirspurningur eftir...;tað eru fleiri hundar um beinið;tað eru fleiri kettur um fiskin, trogið;tað eru mangir, nógvir murtar um agnið;teir vóru sum ravnar á deyðseyða, deyðseyði↔áhugaður,áhugaverdur,áhugi,eftirynskjandi,trá
eftirspurningur	síeftirspurn
eftirspæl	síeftirfylgja
eftirstjóri	síband
eftirstøða	síavlop,eftirfylgja,skuld
eftirstøðutorv	síbrenni
eftirtína	sískilja
eftirtorv	síbrenni
eftirtorva	síbrenni
eftirtøka	síeftirgerð,yvirskot
eftirútbúgving	sískúlagongd
eftirútrokning	síútrokning
eftirvatn	sívatn
eftirverkir	síeftirfylgja,pína
eftirviðgera	sírætta
eftirviðgerð	síviðgerð
eftirynskjandi	Samheiti:eyðseldur,ynskjandivæl dámdur;○sum ynskjandi er eftir(eftirspurdur)umbiðin↔áhugaður,áhugaverdur,áhugi,eftirspurn,trá
eftiryrking	sísangur
eftiryrkjari	sískald
eftna	sídimma,líða
eg	Samheiti:hesinhenda, hetta gamla;hesin gamli(undirritaður)undirskrivaður↔áðurnevndur,nakar,sjálvur,tú
egg	síútlinjaSamheiti:bjargaegg,bleytegg,brák,brákegg,hagaegg,krypilsegg,neyðaregg,páskaregg,pínegg,píningur,reiðregg,rúðregg,skellegg(eggkykna)eggbølla,eggbøllur,eggvølur(rogn)eygarogn,eygnarogn,gýting,gýtingarrogn,leggingaregg,linarogn,rognaboppa,rognabrók,rognabuppa,rognabyggkorn,rognakorn,rognkorn,sjórogn(lættisoppur)marsoppur(skøtuegg)vitunýrapungur(nitra)
eggbølla	síegg
eggbøllur	síegg
eggfuglur	sífuglur
egghvassur	síhvassur
eggja	síbrýna,elva,styrkja
eggjagrót	sígrót
eggjajarn	síknívur
eggjakalvi	sífiskur
eggjakassi	síkassi
eggjakoppur	síyvirflati
eggjamatur	símatur
eggjamettur	sídrukkin,mettur
eggjan	sííblástur
eggjandi	símennandi
eggjaprilla	síposi
eggjarjarn	síknívur
eggjarmaður	síveiðimaður
eggjarn	síknívur
eggjaroð	síposi
eggjarskalvur	síkavi
eggjarskítur	sísjófar
eggjartrepi	síútlinja
eggjartrom	síútlinja
eggjarær	síseyður
eggjaskal	síyvirflati
eggjast	sínørast
eggjasteinur	sígrót
eggjateinur	síknívur
eggklingra	síbugur
eggklingrutur	síavlangur,rundur
eggkykna	síegg
eggleysur	síóhvassur
eggmettur	sídrukkin,mettur
eggrassur	sífuglur
eggriva	síbrák
eggrundur	síavlangur
eggslitin	síóhvassur
eggvaksin	síavlangur,rundur
eggvákn	síknívur
eggvølur	síegg
egi	sígróðurnál,jarðarstykki
egin	síóvanligur,sjálvur
egináhugamál	síáhugi
eginfígging	sífígging
egingirnd	sísjálvgóðska
egingóðska	sísjálvgóðska
eginkona	síkvinna
eginkærleiki	sísjálvgóðska
eginleiki	síeyðkenni,sinnalag
eginligur	sísannur
eginlív	sígerandislív
eginmerki	síeyðkenni
eginnýtsla	sínýtsla
eginogn	síogn
eginpeningur	sípeningur
eginsinnaður	síharðhjartaður,ófúsur,óvanligur
eginskapur	síeyðkenni,sinnalag
eginumstøður	sílíkindi(r)
eginvild	sífrídómur
eginvilji	sífrídómur
eginvív	síkvinna
eglalív	síhampafólk
egna	sígeva,lokka,mata,mutur;egna eina setu;egna fyri kalva o.fl.;egna húk, línu, stamp o.fl.;egna seg;egna sær húkarnar;koyra, krøkja beitu á;krøkja agn, foragn á(egna av)krøkja, taka agn av;reinsa línu (í sjónum)↔agn,agnloysi,avegndur
egningarfløkja	sífløkja,vavstur
egningarskúr	síbygningur
egningarskúrur	síbygningur
egriða	sífiskur
egriði	sífiskur
ei	síikki
eiðabarur	sídygdarleysur,fátækur,kraftleysur,sørur,tápuligur
eiðadyggur	sídygdarleysur,fátækur,kraftleysur,sørur,tápuligur
eiðargerð	sílyfti
eiðasørur	sídygdarleysur,fátækur,kraftleysur,sørur,tápuligur
eiðfastur	sítrúgvur
eiðfesta	sígeva,lova,prógva
eiðisbakki	síbakki
eiðiskyrra	sígóðveður
eiðsvorin	síótøkur
eiður	síillbøn,lyfti
eiga	síføða,megna,ognSamheiti:havabera, hava kannu(na) av e-m;bera kannin av e-m;eiga á;eiga á goymslu, framíhjá, í handraðnum, til varavissu;eiga fótin fastan (í bygdini);eiga, hava í veranum;eiga inni;eiga sær;hava e-t undir fótunum t.e. eiga nakað av jørð;hava fingið;hava í hevd, ogn;ráða yvir;vera illa, væl birgdur, fyri, staddur, útgjørdur við...(eiga í e-m)eiga lut, part í;eiga saman við e-m;eiga uppií, uppi í e-m;føða (kúgv) saman við e-m;vera sameigari(eiga í felag)eiga felags, saman;vera felags, saman um e-t;vera sameigarar;vera tveir um at eiga(hava rætt til)eiga uppiborið,líknast,lutasteiga av røttum;hava rætt til, hava uppiborið;hava slitið fyri e-t↔eigari,fáa,ogn,peningur,ríkmaður,ríkur,rættindi
eigamál	sídýrgripur
eigandi	sívakur
eigarafelag	síeigari
eigari	Samheiti:ánari,áognari,eigarafelag,eigarmaður,handhavi,húsaeigari,húsánari,íognari,kravánari,luthavi,medeigari,ognari,partaeigari,partamaður,parteigari,parthavari,sameigari,samognarie-r sum er luteigandi, luthavandi(loyvishavi)e-r við loyvi↔eiga,fáa,ogn,partamaður,peningur,ríkmaður,ríkur
eigarmaður	síeigari
eiga uppiborið	síeiga
eiggiliga	sídyggiliga,ógvuliga
eiggiligur	sídýrur,vakur
eiggin	sívakur
eiggj	sísindur
eiggjamál	sídýrgripur
eigiligur	sívakur
eigindómsbygd	síbýur
eigindómsmaður	síjarðyrkismaður
eigindómur	síogn
eiging	síføðing
eik	síviður
eikikol	síbrenni
eikilunnur	sílunnur
eikimála	sípensla
eikitræ	síviður
eikiviður	síviður
eikja	sísjófar
eimast	síloga
eimingur	síeldur
eimur	síeldur
eimyrja	síeldur,smakkur
ein	síeinsamallur,líkur,nakar
eina	síeinans,einsamallur,næstan,umleið
einaferð	sífyrr,ikki enn,nakrantíð,umsíðir
einahandil	sísølubúð
einaharri	síóflýggjakroppur
einalærari	sílærarafólk
einans	Samheiti:aleina,bara,barasta,barastani,bert,eina,einast,einastaeina og aleina;eingin uttan;ikki annar, fleiri, meira enn...;nøgt og snøgt, nøggur og snøggur↔bart út,beinleiðis,einsamallur,einskærur,fáur,júst,lúkst,nakar,sjálvur,tú
einaræði	sívald
einarættur	sírættindi
einast	síeinans,semjast
einasta	síeinans
einastaðni	síymsastaðni
einastova	síhøli
einastur	síeinsamallur
einavald	sívald
einaveldi	sívald
einbeintur	síbeintur,brekaður
einbíldutur	sílitaður
einbíltur	sílitaður
einbílutur	sílitaður
einborin	síeinsamallur
einburðarlamb	síseyður
einburðlamb	síseyður
einburður	síseyður
einburi	síbarn
einbúgvi	Samheiti:einbýlismaður,einibúgvi,einsleingismaður,hellisbúgvi↔búgva,bústaður,einsamallur,íbúgvi,niðursetufólk,persónur
einbýli	síbýur
einbýlingur	síbýur
einbýlishús	síbygningur
einbýlismaður	síeinbúgvi
einbýttur	síóskerdur
eind	síeintak,felag,luteind
eindømi	sífrídómurSamheiti:serdømi,sjaldsemi,sjáldsemi,stakføri,undantak,undantaksføri,undantøka,úrdømi,ørdømieinstakt dømi;einstakt føri;einstakt undantak;sum er einsamallur, einstakur, stak, stakur,(serhending)merkishending,merkistilburður,sersýni,staksøgaløgin hending, tilburður;óvanlig, rár, rárig, sjáldsom hending;rárt hendilsi;sjáldsamt fyribrigdi;staksøga t.e. sjáldsamur tilburður(stakferð)hendingaferð,hendingaføri↔frábrigdi,hending,ógvuliga,sjáldsamur,viðhvørt
einermdur	síbrekaður
einevnisrit	sískriv
einfalda	gera einfaldari;gera greiðari;gera klárari;gera týðiligari↔greiðurAndheiti:dreiva
einfaldliga	síjúst
einfaldur	síeinsamallur,einsljóðandi,greiður,tápuligur
einfalt	síjúst
einfeldi	síbýttisskapur,góðtrúni
einfeldni	síbýttisskapur,góðtrúni
einføttur	síbrekaður
eingil	síævintýrhugtak
eingilskdansur	sídansur
eingin	síeinki
eingingerð	síletingi
eingjargarður	sígarður,mark
eingjarliða	síinngongd
einglaandlit	síandlit
einglabarn	síhampafólk
einglabrá	síyndi
eingonga	sígonga,kríggj
eingongdur	síeinsamallur
einhandil	sísølubúð
einhenda	sílyfta,tveita
einhentur	síbrekaður
einhús	síbygningur
einhvør	sínakar
einhvørsvegna	síonkursvegna
einhyrningur	síseyður,ævintýrhugtak
eini	sísemja,umleið
einiberviður	síviður
einibúgvi	síeinbúgvi
einihandil	sísølubúð
einingis	síeinsamallur
einirættur	sírættindi
einisúla	síviður
einitræ	síviður
einkabarn	síyndisbarn
einkadóttir	síyndisbarn
einkar-	síyndisbarn
einkarættindi	sírættindi
einkarættur	sírættindi
einkasonur	síyndisbarn
einkasøla	sísølubúð
einkavinur	sívinur
einkenniligur	síóvanligur
einki	Samheiti:nullals, púra, púrt einki;einki farvegis;einki petti;hvørki eitt ella annað;hvørki lítið ella stórt, lítt ella stórt, stórt ella lítið;hvørki rusk ella busk;ikki at blinda eygað við;ikki egi;ikki ein dropi, vetamoli o.fl.;ikki ein smitt, ikki smittin;ikki ein soytil, ikki soytilin;ikki eitt;ikki eitt einasta, livandi, livandi kykt;ikki eitt grett, petti, vet, vetasindur o. fl.;ikki (fáa) inn í síggjandi eygað, undir eygnalokið;ikki (fáa) upp í hundsmola, hundsmúla;ikki Guds náð;ikki hitt, tað minsta sindrið, sindur, vet, vetið;ikki hundsmoli av...;ikki inn í eygað;ikki petti, nakað;ikki so mikið sum, ikki tað sum blindar eygað, kann blinda eygað;ikki so mikið sum tú kundi væta eygað við;ikki tað sum eitur, er;ikki um hundsgron, tvøran fingurin av...;ikki undir naglin;ikki veturbland;slættis einki;□tað blindar ikki manseygað;tað er forbrendari, minni, verri enn so;tað er ikki so frægt;tað er so eiðasørt(eingin)hvørgin,onginals, púra eingin;eingin ein;eingin, ikki ein livandi kyka, sál, vera;einki, ikki eitt livandi kykt, menniskja;einki livandi;hvørgin, hvørkið (av teimum), (teirra);hvørki annar ella annar, annað ella hitt;hvørki ein ella annar, eitt ella annað;ikki ein;ikki ein kjaftur, kleyv;ikki ein kykur kjaftur;ikki ein (tann) einasti;ikki eitt kúbein;ikki eitt mannkykt, mannkyn, manskykt, manskyn;ikki manntal;ikki nakar;ikki seyðabein, seyðakleyv í haganum;slættis eingin;□har var gestaleyst, fólkaoyðið, manntómt o.fl.;har var hvørki mús ella kattur inni↔fólkaoyðin,innanopin,lítið,sørur,uppfiskaður
einkisleiki	sítómleiki
einkisligur	síbíligur,smáur
einkisverdur	síbíligur
einkisvirða	síspotta
einkja	síkvinna
einkjueftirløn	sígjald
einkjupeningur	sígjald
einkjusonur	síbarn
einkjuuppihald	sígjald
einklæddur	síílatin,nakin
einkróna	sípeningur
einkultur	síeinsamallur,einsljóðandi
einkyknudýr	sídjór
einkyknuplanta	síurt
einleiki	sífelag
einleikur	sítónalag
einlemba	síseyður
einlembulamb	síseyður
einligur	síeinsamallur
einlittur	sílitaður
einljóðandi	síeinsljóðandi
einmansføri	síarbeiði
einmanskamar	síhøli
einmansleikur	síkapping,sjónleikur
einmálsorðabók	síyvirlit
einmenniligur	sísjálvur
einmenningsligur	sísjálvur
einmælt	sísamdur
einnáttaður	síaldrandi
einnevni	sínavn
einnýtisbók	sískriv
einnýtistilfar	sítilfar
ein ogein	sífáur,rása
einoygdur	síheimføðisligur,oygdur
einraddaður	síeinsljóðandi
einráðin	síófúsur,stjórna
einrúm	síhøli
einræði	sívald
einræðisharri	síóflýggjakroppur
einrættur	sírættindi
einrøða	sítos
eins	sílíkur
einsamallur	(aleinaður)á partna,ein,eina,einastur,einborin,eingongdur,einingis einsamallur,einligur,einsamur,einsleingin,einsligur,einstaddur,einstakur,einsærur,hundleysur,ómakaður,óparaður,stakur(einfaldur)einkultur,einsligur,ósamansetturfyri seg;fyri seg sjálvan;fyri sítt egið;heilt einsamallur;í einrúmi;í sjálvdrátt(r)i(bara, bert, einans, júst ein)ein av...;ein einasti;eingin uttan ein;ein í parti, einsamallur í parti;einsamallur á, í einingi;hvør fyri seg, hvør í sínum lagi, hvør sær;ikki fleiri enn ein;í einingi, einsemi(tveir einir)undir fýra eygum;uttan fylgd, fylgi(frændaleysur)barnleysur,bróðurleysur,einborin,ervingaleysur,faðirleysur,foreldraleysur,móðurleysur,pápaleysur,sonarleysur,vinaleysur,ættarleysurí vinaloysi;○sum er foreldraloysingur, faðirloysingur, móðurloysingur, faðir- og móðurloysingur;sum ongan góðan eigur(piparmoy)piparmoyggjgomul genta;ógift kona;ein sum er leys, ógift, ómakað, pipar o.fl.(piparsveinur)drongur,geldsteggi,kveistur,sveinurein sum er leysur, ógiftur, ómakaður, pipar o.fl.;gamal drongur;leysur drongur;ógiftur maður(stakur)eingongdur,fráskildur,gásagiftur,konuleysur,leysagiftur,mannleys,ógiftur,ómakaður,óparaður,skildur,sundurlisin,verleys○sum er leysur kroppur, er staklingur, stakmaður(vera einsamallur)búgva í einingi;búgva, liggja í einhúsi;búgva, vera einsamallur í húsi;einki vilja hava við onnur at gera;ganga avparta;ganga fyri seg sjálvan;ganga fyri vág og vind, fyri vind og vág;ganga sum eitt hagalamb (um geilar);halda seg (langt) (burtur) frá øðrum;ikki koma fyri fólkaeygu;ikki koma saman við øðrum;ikki vilja síggja fólk;kenna seg forfjónaðan;ongan hava at hella seg til;passa seg sjálvan;sketta, skjøtta, skoyta seg sjálvur, sær sjálvur, sær sjálvum;vera forfjónaður(vera ógiftur)fara á bonkin;fara á skálabonk;ganga sum ein stakhosa;gerast gamal dongur, gomul genta;vera eingongd(ur), ógift(ur);vera stakur, støk↔einans,einbúgvi,fáur,nakar,rása,sjálvur,tú,uttanveltaður
einsamur	síeinsamallur
einsemd	síuttanveltaður
einsemi	síuttanveltaður
einsháttaður	síeinsljóðandi,líkur
einskendur	síeinsljóðandi,líkur
einskila	síógvuliga
einskila-	sífrálíkur
einskilaður	sífrálíkur,óvanligur
einskilagóður	sífrálíkur
einskilamaður	síavtakafólk
einskildur	sísjálvur
einskæraður	síeinskærur
einskærur	Samheiti:barur,berur,blaktabarur,blaktaður,blankur,blektabarur,blektaberur,blektaður,einskæraður,ektaður,óblandaður,ófalsaður,ósvikin,púrur,reinur,skærur(reingresin)reingresjaður,reingrøsuturbarur og blektaður;berur og blektaður;einki uttan...;heilt, púra berur, reinur;nøggur og snøggur;reinur og skærur;reinur og turrur...;við ongum...;□hatta er tann beri, einskæri, rami, turri...↔blýfríur,einans,einsljóðandi,jústAndheiti:blandaður
einsleingin	síeinsamallur
einsleingis	sífjarskotin
einsleingismaður	síeinbúgvi
einsliga	sífjarskotin
einsligur	síeinsamallur,fjarskotin
einsljóðandi	sílíkurSamheiti:einljóðandi,einraddaður,einsháttaður,einskendur,eintáttaður,eintónaður,eintónandi,einvorðin,fábroyttur,fáskiftur,fátónandi,javnskapaður,javnur,langligur,ófjølbroyttur(óbroytandi)óbrigdiligur,óbroytiligur,skiftisleysur(einfaldur)einkultur,ósamansettur↔einskærur,óbroytturAndheiti:fjølbroyttur
einsmansføri	síarbeiði
einsmansgerð	sígerð
einsmanskamar	síhøli
einsmansligur	sísjálvur
einsmansrúm	síhøli
einsmansverk	síarbeiði
eins og	sílíkur
einsongur	sísangur
einstaddur	síeinsamallur,óvanligur
einstaka	síógvuliga
einstakir	sífáur
einstaklingseyðkenni	síeyðkenni
einstaklingur	sípersónur
einstakur	síeinsamallur,nakar,óvanligur
einstavilsisorð	síorð
einstøðingur	síbýttlingur
einsvegna	síonkursvegna
einsýna	síógvuliga
einsýnamaður	síavtakafólk
einsýni	síheimføðisskapur
einsýntur	síheimføðisligur
einsýnur	sífrálíkur
einsæris	sífjarskotin
einsærur	síeinsamallur
einsøla	sírættindi
einsølumaður	síkeypmaður
eintak	Samheiti:eind,stykkiav hvørjum;einstakur gripur, lutur;eitt (av fleiri)
eintal	síorðaskifti
eintáttaður	síeinsljóðandi
eintevin	síganda
eintónaður	síeinsljóðandi
eintónandi	síeinsljóðandi
eintur	sínøgdur
eintættingur	sísjónleikur
eintølin	síganda
einusinni	sífyrr
einvaldsharri	síóflýggjakroppur
einveldi	sívald
einvera	síuttanveltaður
einvíggi	síkríggj
einvísur	síófúsur
einvorðin	síeinsljóðandi,líkur
eir	sísinnalag
eira	sídáma,rusturSamheiti:líva,loyva,náða,skóna,sparaeira, líva, loyva sær;fara væl við sær sjálvum;geva e-m grið, grið og frið;lata e-n leysan;lata e-n sleppa við lívinum, tiggja grið, lív;loysa e-n undan e-m;náða e-n;skoyta e-m leti;sleppa e-m leysum;sleppa e-m undan e-m;spara kreftir, seg↔bjarga,fríur,hjálp,hjálpa,hjálpsamur,hjálpsemi,verja
eirdur	sírustur
eirdømi	sírustur
eirgingin	sírustur
eirgrønur	sílitaður
eiri	síkærleiki
eiriliga	sívandaliga,yndisliga
eiriligur	sígóðsintur
eirin	sílítillátin
eirindaleysur	síharðhjartaður
eirindaloysi	síóndskapur
eirindi	sífyrigeving
eiring	sírustur
eirisliga	sívandaliga
eisini	síafturat,á sama hátt,til dømis
eista	Samheiti:bøllingur,eistasteinur,hvítanýra,hvítnýra,hvítunýra,køplingur,nossa,steinur(skólpur)eistnaskólpur,koddi,pungur,skølpurpurra t.e. eista (og skólpur)↔kallskøp
eistasteinur	síeista
eistnameltingur	sígeldingur,seyður
eistnaskólpur	síeista
eita	sínevna
eiti	síhykl,lyfti,navn,vánamaður
eitil	sísvullur
eitlagreipa	sívánamaður
eitlaspik	síspik
eitra	blanda við eitri;geva eitur;koyra, lata eitur í↔eitran,eitrandi,eitur
eitraður	síeitrandi
eitran	Samheiti:blóðeitran,blýggjeitran,eitring,mateitran,pylsueitran,roykeitran↔eitra,eitrandi,eitur
eitrandi	síógvuligaSamheiti:eitraður,eiturkendur,eiturkyndur,eiturligur,sjúkuelvandi,spilluelvandi↔eitra,eitran,eitur,torførur
eitring	síeitran
eittnú	sítil dømis
eittoyra	sípeningur
eitur	Samheiti:andeitur,banadrykkur,eiturbikar,eiturbland,eiturdrykkur,eiturevni,eiturgass,eiturkorn,gift,móteitur,músakorn,mølkúla,ormaeitur,óminnisdrykkur,rottueitur,rottukrút,skaðaevni,valmannadrykkurdrepandi evni;eitrandi drykkur;eitrandi evni;heilsuskaðiligt evni;lívshættisligt, skaðiligt, vandamikið evni(rúseitur)drekkaløgur,drøgg,rúsevni,rúsdrekka,rúsløgur↔eitra,eitran,eitrandi
eiturbikar	síeitur
eiturbland	síeitur
eiturblásin	síhovin
eiturdrykkur	síeitur
eiturevnavápn	sívápn
eiturevni	síeitur
eiturfínur	síúrklænur
eiturfon	síeiturkoppanet
eiturgass	síeitur
eiturhvassur	síhvassur
eiturkaldur	síkaldur
eiturkendur	síeitrandi
eiturkoppanet	Samheiti:eiturfon,eiturkoppanót,hím,hýggja,kongulvág,kongurvág,lokkanet,lokkaroykur,spinnilvevur↔fella
eiturkoppanót	síeiturkoppanet
eiturkorn	síeitur
eiturkuldi	síkuldi
eiturkyndur	síeitrandi
eiturligur	síeitrandi
eiturmein	sískaði
eiturmorð	sídráp
eitursettur	símannvándur
eitursmáur	sísmáur
eiturtonn	sítonn
eiturtunnur	síúrklænur
eiturvákn	síknívur
eiturvápn	sívápn
ekjuskip	sísjófar
ekkafullur	síbangin
ekkaleysur	síóttaleysur
ekkaloysi	sídirvi
ekkamikil	síbangin
ekkamóður	síútmøddur
ekkamøddur	síútmøddur
ekkamøði	símáttloysi
ekkasamur	síbangin
ekki	síræðsla,sorg
ekkja	síkvinna
ekkó	síafturljóð
ekkóa	síljóða
ekra	síjarðarstykki
ekrubakki	síbakki
ekrugás	sífuglur
ekrugras	sígras
ekrukúgv	síletingi,neyt
eksamia	sípróvroynd,váttan
ektaður	síeinskærur,frálíkur,sannur
ektakona	síkvinna
ektamaður	síhúsbóndi
ekurkúgv	síletingi,neyt
ekurneyt	síletingi,neyt
ekvator	síringur
elaklænur	síúrklænur
elaligur	sísmáur
elalítil	sísmáur
elapinkulítil	sísmáur
elapinkutur	sísmáur
elda	síhita,nøra,styrkja,tendra
eldast	Samheiti:aveldast,avoldast,fyrnastelda seg út;eldast ov tíðliga;fara úr gildi;gerast avoldaður, eldri, fornur, gamal o.fl.;níva við elli;slíta fullan aldur;verða eldri, gamal;víkja fyri aldri;□aldur er fallin á (ein);elli tekur at boyggja (ein);tað eldist (burtur) av honum↔aldrandi,barnaár,ellisár,fornminni,gamalmenni,tilkomin
eldáseting	síífesting
eldávaring	síávaring
eldband	síband
eldbrík	sísessur
eldbumba	síbumba
elddovin	sívátur
elddópur	síbyrjan,dópur
elddyggur	síeldtryggur
eldfastur	síeldtryggur
eldfimur	Samheiti:eldhættisligur,eldkvæmur,kvæmur↔eldførur,eldtryggur,eldur,loga,spreingikvæmur
eldfjall	síeldgos
eldfrensur	síkuldakráka
eldfressur	síkuldakráka
eldførisdós	síkassi
eldføriskistil	síkassi
eldførur	Samheiti:brennandi○sum er góður at brenna, kann brenna, brennast;sum hevur gott, stórt brennivirði;sum nyttar at brenna, til brenni;□hetta er gott at kynda við↔eldfimur,hitiAndheiti:eldtryggur
eldgamal	síaldrandi
eldgerð	síífesting
eldglæma	síeldur,ljósglæma
eldgos	síeldurSamheiti:eldfjall,gos,gosfjall,gosgrýti,goshálsur,gosop,gosoyggj,gosrøð,grótbræðing,runi,spreingigos
eldgrót	sígrót
eldgrúgva	síeldur
eldgrúvusteinur	sígrót
eldgrøv	síeldur
eldhav	síeldur
eldhol	síhol
eldhuga	sístyrkja
eldhugaður	síáhugaður
eldhugi	sííblástur
eldhugur	síáhugi,íblástur
eldhurð	sílok
eldhús	síhøli
eldhættisligur	síeldfimur
eldibrandur	síeldur
elding	sííblástur,ífesting
eldiviður	síbrenni
eldkattur	síkuldakráka
eldketta	síkuldakráka
eldkúla	síeldur
eldkvæmur	síeldfimur
eldloysi	sítørvur
eldmikil	síáhugaður
eldmurtur	sífiskur
eldneisti	síeldur
eldoffur	síoffurgáva
eldovnur	síeldur
eldreiða	síbrenni
eldreiggj	síbrenni
eldreyður	sílitaður
eldrok	síeldur
eldroynd	sípróvroynd
eldsaltur	sísaltur
eldsál	síavtakafólk
eldsbruni	síeldur
eldsjógvur	síeldur
eldskaði	sískaði
eldskáli	síhøli
eldskírn	sídópur
eldslogi	síeldur
eldslóð	síeldur
eldsovnur	síeldur
eldstaður	síeldur
eldstólpi	síeldur
eldtinna	sígrót
eldtolin	síeldtryggur
eldtryggur	Samheiti:elddyggur,eldfastur,eldtolin,ovndyggur○sum ikki brennur;sum tolir eld, (nógvan) hita, varma(frostdyggur)○sum tolir frost, (nógvan) kulda↔eldfimur,tryggurAndheiti:eldførur
eldtunga	síeldur
eldur	síaldrandiSamheiti:aning,avlatingareldur,bakingareldur,bál,bálaeldur,bálalogi,bálareldur,báleldur,bluss,brandaglóð,brandur,brenna,breyðeldur,brimbál,brimi,bryggjubál,drýlaeldur,døgurðaeldur,eimingur,eldglæma,eldgos,eldgrøv,eldhav,eldibrandur,eldkúla,eldrok,eldsbruni,eldsjógvur,eldslogi,eldslóð,eldstólpi,eldtunga,gasslogi,geisari,grúgvueldur,húsabruni,jarðareldur,jarðeldur,ketilseldur,ketilslív,kolaeldur,koleldur,lampulogi,legubál,lív,log,logi,lokkalogi,morguneldur,nátturðaeldur,nýggjársbál,nýggjárseldur,offureldur,sjóðingarlogi,skógareldur,skurðlogi,smiðjueldur,sorneldur,sprittlogi,torveldur,troðingareldur,trøllalogi,váðalogi,viti(eimur)eimyrja,glóðabak,glóðbak(eldstaður)alva,alvi,alvur,álva,árin,árnur,bál,bileggarovnur,bíleggjaraovnur,brenniovnur,eldgrúgva,eldovnur,eldsovnur,fýrstaður,gassovnur,grúgva,hitaverk,kabúss,kabússa,kolovnur,komfýrur,langeldur,oljufýr,oljufýrur,oljukynding,oljuovnur,ovnur,peis,petroliumsovnur,rundovnur(hirðing)hirðingartorva,náttarbrandur,náttbrandur(neisti)brandaglóð,brandakol,brandkol,brandsnev,brandur,eldneisti,glóð,gneisti,neistafok,neistaregn,neistarok,pípuglóð,sigarettglóð,smiðjuloppa,soyribrandur↔allogandi,brenni,brunnin,eldfimur,hita,hiti,hitna,ífesting,loga,sløkkja,sløkna,tendraAndheiti:køliverk
eldvandi	sívandi
eldvatn	sírúsdrekka
eldvápn	sívápn
eldverk	sífýrverk
elgja	sídrekka
elja	síleyslyntur persónur
eljastríð	sítrá
eljusjúka	sítrá
eljusjúkur	síøvundsjúkur
eljustríð	síósemja,trá
elli	síellisár
elliár	síellisár
ellibrek	síbrek
ellibrekaður	síútmøddur
ellidagar	síellisár
ellidøkkur	sílitaður,útmøddur
ellifarin	síútmøddur
ellifólk	sígamalmenni
elligamal	síaldrandi
elligráur	sílitaður,útmøddur
elliheim	síbústaður
ellihvítur	síaldrandi,litaður
ellikomin	síaldrandi
elliljótur	síaldrandi,litfarin,misháttur
ellimenni	sígamalmenni
ellimerktur	síútmøddur
ellisár	Samheiti:aldur,aldurdómsár,aldurdómur,avdeyðaaldur,ár,eftirlønaraldur,elli,elliár,ellidagar,ellisdagar,gamalsaldur,lívskvøld,síðseturá elliárum;á ellidøgum;á ellisárum;á ellisdøgum;á framkomnun árum;á gamalsaldri;í aldurdómsárum↔aldrandi,barnaár,eldast,fornminni,gamalmenni,tilkomin
ellisbrek	síbrek
ellisbrekaður	síútmøddur
ellisdagar	síellisár
ellisfólk	sígamalmenni
ellisgrógvin	síaldrandi
ellisheim	síbústaður,bygningur
ellisjón	síeyga
ellismaður	sígamalmenni
ellismerktur	síútmøddur
ellisrenta	sígjald
ellisrukka	sírukka
ellisvamm	síbrek
elliveikur	síútmøddur
elliviknaður	síútmøddur
ellubiti	síband,noða
elma	síjarðarstykki
elska	síásttikin
elskaður	sídáma
elskari	síleyslyntur persónur
elskast	síásttikin,fríggja
elskhugi	síkærleiki
elskhugur	síkærleiki
elskiligur	sígóðsintur
elskin	sígóðsintur
elskuliga	síyndisliga
elskuligur	sígóðsintur
elskulingur	síyndisbarn
elskur	síkærleiki
elstur	sífrumborin
elta	síásttikin,hamast,jagstraSamheiti:deiggja,knoða,leivadeiggja, elta, knoða, leiva saman (breyð, drýl);deigna (t.e.) leggja deiggj (deigna breyð);gera deiggj;loypa í ein fingur (t.e.) knoða drýl(røra)pískarøra, píska til, upp í skúm;røra saman(tyrla)toyta(kirna)gera, kirna smør↔matgera,røritólAndheiti:mala sundur
eltibløðra	Samheiti:driftinivel,nálg↔hamast,nærgongdur
eltin	sínærgongdur
elting	Samheiti:atsókn,forfylging,forfylgjan,happ,happing,jagstran,jagstur,mannajagstran,meinsókn,meinsøking(jødahatur)gýðingahatur↔hatur,jagstraAndheiti:rýming
eltingur	síhundur,leyslyntur persónur
elubiti	síband,noða
elv	síá
elva	Samheiti:ávirka,birta,evla,fáa,føða,gera,geva,íbirta,kosta,kveikja,loypa,magna,orsaka,skapa,valda,vekja,vinna,volda,yppaala av sær;bera í sær;bera (so) í band(i);birta í;elva av, eftir sær;elva, evla, virka til;føra, hava við sær;gera sítt;gera sítt til, hava ta ávirkan, tær avleiðingar at...;gera tað at...;geva byr undir;geva eitt hugnám, inntak (av e-m);hava skyldina, skyld í;hava til fylgju;hjálpa til, laga tað so, skipa so fyri, vera við til at...;vera atvoldin, atvoldnir í;vera atvold, orsøk í, til;vera grund til(áleggja)bjóða,krevja,mana,mána,ráða,skipagera av at...;geva (strong) boð um;krevja av e-m at...;skipa fyri(eggja)andstevna,elva,evla,lokka,mana,mána,ráða,ráðleggja,tilmæla,viðmælaávirka e-n til at...;birta, eggja, yppa undir, uppundir, upp undir;eggja, mæla, ráða e-m til at...;fáa e-n til (at gera e-t);flyta um, undir e-n;geva ráð;halda, stuðla e-m til;hurta, hvista, hæsa, koyra, skunda, yppa undir;koma við uppskoti um;leggja e-m orðini í munnin;leggja e-m ráð;leggja, seta fram uppskot;mæla til;ráða e-m (til) e-t;ráða ráðgerð t.e. geva, leggja, veita góð ráð;skjóta upp;skjóta uppá, upp á e-t;stimbra e-n í at...;studda e-m til;veita e-m ráð;□hon løðir og hann skjýtur(bjóða av)bjóða e-m av í einvíggi;bjóða til bardaga;eggja e-m til bardaga, hólmgongu, kappingar, stríð o.fl.;ekla seg inn á e-n;gera, fáa e-n illan, vreiðan;senda avbjóðing, krígsavbjóðing;skjóta mál til holmgongu;stevna e-m á hólm↔arga,árin,endaúrslit,henda,hending,íblástur,orsøk,styrkja,tessvegna
elvast	síhenda
elvi	sííblástur,megi
elviligur	sísterkur
elving	síillgruni,íblástur,orsøk
elvur	síá
emalja	síhinna
emaljera	síleggja á
emaljeraður	sígyltur
embæti	sístarv
embætisbróðir	sífelagslimur
embætisførur	síarbeiðsførur
embætisgarður	síbústaður
embætishús	síbústaður,bygningur
embætisjørð	síjarðarstykki
embætisleggald	sífínarimpa
embætisleið	sístarvsgrein
embætismannavald	sívald
embætisvald	sívald
embætisverk	sívald
emming	síveðurhvíld
enda	Samheiti:avgreiða,bremsa,fullfíggja,fullføra,fullgera,fullinna,fullkoma,lata enda,lúka,slíta,steðga,stoppa,støðga,støvda,útinna,útrættaarbeiða (e-t) undan;draga uppúr;fáa enda á e-m;fáa frá hondini;fáa, gera burtur av sær;gera bart;gera e-t burturav;gera, fáa liðugt;koma á mál;lata av;leggja seinastu, síðstu hond á verkið;lætta ljóðið av;seta rekspónin í;siga uppat (í dansi), uppatsagt;sláa botn í (e-t);steðga, støðga e-m(gevast)bremsa,steðga,stoppa,støðga,støvdageva, leggja frá sær;geva seg yvir;geva skarvin yvir;gevast á hendi, hendur, hondum;geva upp;hava deyðavatn í høvdinum, koma á deyðavatn t.e. ikki orka at hugsa (longur);ikki koma úr stað;ikki orka at huga ella minnast;ikki síggja nakran útveg;ikki vita (nøkur), (síni livandi) ráð;kappa kík;kasta bæði boga og stong;kasta bæði hendur og føtur (frá sær);kasta, leggja frá sær;laða uppí;laða upp í dyr, dyrnar;lata alt fara;leggja árar(nar) inn;leggja kongin;leggja stilt;missa bæði hond og fót;missa áræðið, hugin, mótið;mynstra av;renna seg fastan;tveita alt frá sær;yvirgeva e-t, seg(fáa enda)bráðtagna,bráðsteðga,bráðstøðga,skerda,skerja,slitna,steðga,steintagna,stoppa,støðga,støvda,tagna(hvørva)forsónast,sjálvhvørvablíva, verða burtur;detta av, burtur;dovna, doyggja, fána burtur;draga, fara burtur;falla burtur, niður, niðurfyri;fáa ein bráðan enda;fáa ein enda;gerast tigandi;gerast, verða liðugur við e-t;geva, halda uppat;hvørva, kámast, minka, támast burtur í einki;hvørva so líðandi;koma burtur í einki;koma fyri einki;koma, verða til einkis;lætta av;steðga upp;verða at, (av) ongum↔endaður,hava til úrslit,minka,nærkast endanum,tapa,tigaAndheiti:byrja,halda út
endaboya	síbløðra
endabrestur	síendi
endadagur	síendi
endaður	Samheiti:allur,av,avgjørdur,avhæsaður,avverkað,fullfíggjaður,fullførdur,fullgjørdur,fullkomin,fullliðugur,fullvirkaður,givin,gjørdur,liðugur,lokin,niðurlagdur,steðgaður,uppathildin,úti,yvirstaðinat enda komin;fingin frá hondini;førdur út í æsir;givin, hildin uppat;komin at enda;steðgaður upp;□hetta er, var alt;nú er søgan úti;nú er søgan øll;so er, var alt(í hæddini)fullversnaðurupp á tað besta, hægsta, mesta, versta o.fl.(komin í hæddina)komin at tí ringasta;komin í høvd, høvdina↔avlagdur,deyður,enda,hava til úrslit,liðin,nærkast endanum,svunnin
endafara	síkanna,leita
endafesti	sísessast
endakíkur	síbløðra
endaknútur	síendi,knútur
endalangur	síendilangur
endaleikur	síendi,kapping
endaleysa	síógvuliga
endaleysur	sínógvur,varandiSamheiti:avkubbaður,endleysurbrotin av;○sum endar brádliga, snópisliga
endaligur	sítíðaravmarkaður
endalína	síband
endaloysi	Samheiti:endloysi,markloysi,tíðloysi(ævinleiki)ævileiki(ódeyðileiki)ódeyðiligleiki↔lívstíð,løta,tíðarskeið,varandi,æviga
endalykt	sídeyði,endi
endaløn	sígjald
endamark	símark
endamál	Samheiti:aðalendamál,akt,baktanki,byggiætlan,endamið,eygnamið,fyriætlan,gerðarmál,heimagerð,heimangerð,hugsan,hyggja,høvuðsendamál,høvuðsmál,lívsmál,lívsmeining,lívsmið,loyniætlan,mark,markmið,mál,málpolitikkur,meining,meiningur,mið,politikkur,sak,samætlan,stevna,stevnumið,stórætlan,tilætlan,upplegg,vild,vilji,ætl,ætlan,ætling,ætlingurfelags ætlan;loynd ætlan, loyndur tanki (við e-m);mark og mið, mál og mið, mið og mál↔áhugi,felagsmál,stevnuleið,umrøðuevni
endamið	síendamál
endanekkur	síendi
endareisa	síreisa
endaskil	síendaúrslit
endaspæl	síendi,kapping
endastund	sídeyði,endi
endaúrslit	Samheiti:avgangur,avleiðing,avlæsing,avstøða,endaskil,endi,fylgja,heildarúrslit,niðurstøða,úrfáningur,úrleiðsla,úrskurður,úrslit,úrtøka,valúrslit,virknaðuralt samanlagt;endalig støða;í alt(reglufesti)avleiðing,avstøða,eftirfylgd,eftirfylgja,virknaðurreglubundin hugsan↔búnast,elva,endi,fast takist,grøði,hava til úrslit,úrtøkugóður,yvirskot
endaveggur	síveggur
endaveitsla	síveitsluhald
endavenda	síkanna,leita
endavendast	sífalla
enda við at...	síhava til úrslit
endaørindi	síendi,sangur
endi	síband,deyði,oddur,veggurSamheiti:arbeiðssteðgur,avlæsing,áramót,ársendi,árslok,banastingur,bani,bollabrestur,deyðastingur,deyði,endabrestur,endadagur,endaknútur,endaleikur,endalykt,endanekkur,endaspæl,endastund,endaørindi,finala,fundarslit,krígslok,leiklok,lívslok,lok,lønarsteðgur,mønubrestur,mønustingur,niðurløga,príssteðgur,slit,steðgur,stríðslok,trot,uppathalding,útgangur,vikuendi(afturlating)afturlatingartíð,gevingartíð,steinging,steingingartíð↔deyði,endaúrslit,hava til úrslit,íhald,undirgangur
endilangur	Samheiti:endalangur,barðlangur,útstrektureftir allari longdini;í allari síni longd(strektur)útrættur↔avveltur,falla,fatna,fattur
endiliga	sísanniliga,umsíðir
endleysur	síendaleysur,nógvur,varandi
endloysi	síendaloysi
endurbót	síafturbøting
endurbrot	síbrotsverk
endurbyggja	síendurskapa
endurbøta	síendurskapa,grøða
endurbøting	síafturbøting
endurdoypa	sídoypa
endurdópur	sídópur
endurferma	sílossa
endurferming	sílossing
endurfíggja	sígjalda
endurføddur	síumvendur
endurføða	síendurskapa,umvenda
endurføðast	síumvenda
endurføðing	síafturbøting,kristning
endurgáva	síeftirgerð
endurgera	síendurskapa
endurgerð	síafturbøting,endurgjald,gjald
endurgeva	Samheiti:apa,endursiga,endurtaka,herma,keipa,myndaapa, gera, taka eftir øðrum;apa seg, sær eftir e-m;gera, hava, siga, taka upp aftur;gera, siga um aftur;keipa seg eftir øðrum;skriva av(avmynda)avrita,trygdarrita,tvítakagera eftirmynd, gjøgnumslag, makaskjal, trygdaravrit, tvítak o.fl.;gera, taka avrit(fjølrita)margfaldagera fleiri, nógv eintøk av e-m(ljóstaka)ljósritagera ljóstak av e-m↔avmynda,avrit,eftirgerð
endurgeving	síeftirgerð
endurgjald	Samheiti:afturbót,dagbót,endurgerð,endurgreiðsla,endurrindan,grindaskaði,hansi,javnsýning,lívsbót,loysifæ,loysigjald,loysnargjald,manngjøld,mansbót,matarhvalur,mathvalur,munnpengar,narribót,narripengar,narripeningur,peningabót,sakaroyri,sakarpeningur,sallur,samsýning,sáttargjald,sekt,sektaroffur,sektarrenta,skaðabót,skaðavákn,skammbót,tryggingarveiting,uppgjald,viðurgerð,viðurgjald,viðurlag↔afturfyri,afturgjald,avgjald,gjald,gjalda,uppreisn
endurgjalda	sígjalda
endurgjaldskrav	síkrav
endurgreiðsla	síendurgjald
endurholding	síkristning
endurhugsa	síteinkja
endurkeyp	síhandilsskapur
endurleiga	síbúgva,hýsa
endurljóð	síafturljóð
endurljóða	síljóða
endurljóma	síljóða
endurljómur	síafturljóð
endurloysa	síbjarga
endurloysari	síbjargari
endurloysing	síbjarging
endurloysn	síbjarging
endurmenning	síbati
endurmeting	símeting,ummæli
endurminning	síminning
endurminningar	sífrásøgn
endurmynd	síeftirgerð
endurnýgging	síafturbøting
endurnýggja	síendurskapa
endurnýggjan	síafturbøting
endurnýta	sínýta
endurnýtsla	sínýtsla
endurprent	síárit
endurprenta	síprenta
endurprenting	síárit
endurpróvtøka	sípróvroynd
endurreisa	síbyggja,endurskapa
endurreising	síafturbøting
endurreisn	síafturbøting
endurrindan	síendurgjald
endurrit	síavrit
endurroyting	síull
endurroytingur	síseyður,ull
endursenda	síboða
endursending	sísending
endursiga	síendurgeva,endurtaka
endurskapa	Samheiti:endurbyggja,endurbøta,endurføða,endurgera,endurnýggja,endurreisa,endurskipa,endurstovna,uppnýggjabirta, kveikja lív í aftur;brynja seg aftur;byggja upp aftur;byrja aftur har ein slepti;byrja av nýggjum;byrja, royna (um) aftur;fara aftur til verka;fáa aftur á føtur, á rættkjøl;fáa á glið aftur;fáa glið, gongd á aftur;fáa naggatódnina úr aftur;gera av nýggjum;gera, skapa, smíða aftur, av nýggjum, um aftur;gera (sum) nýggjan aftur;herja á aftur;kveikja nýtt lív í;menna (seg) upp aftur;nýggja upp aftur;reisa aftur;royna aðru ferð;royna aftur;taka fram, upp aftur;taka upp annan tátt↔afturbøting,forma,grøða,hjálpa,styrkja,umvælaAndheiti:avtofta
endurskin	síafturskin,ljósglæma
endurskipa	síendurskapa
endurskipan	síafturbøting
endurskírn	sídópur
endurskoða	síkanna
endurskoðan	síkanning
endurspegla	síspegla
endurspegling	síafturskin,ljósglæma
endurstovna	síendurskapa
endursøgn	sífrásøgn
endurtaka	síendurgevaSamheiti:dalla,endursiga,jabba,japsa,jótra,júka,mala,maldra,mella,meyka,meyla,mikla,móka,níva,njótra,sjabba,sjagga,sjagla,skjølka,táta,tvítaka,vevjaeta, tyggja orðini upp aftur;hava e-t til uppkippingar, uppkipsan;rita, taka, tyggja uppaftur;roksa, siga, taka, tosa, tvassa, tyggja upp í saman (aftur);siga e-t umaftur og umaftur;sita og níva og níva;tosa upp í røkur;□e-m verður uppkipsað e-t t.e. havt til uppkipsan(orðgýtast)fussa,jagga,jangla,mjaldra,møsna,práta,roksa,rødda,rønta,sjóða,skúma,snurra,sussa,tístra,toyta,vevjaaldri, ikki, ongantíð halda gák, munn, aldri tiga;altíð hava okkurt at brúka seg um, at siga;brúka, mýkja geilatíkina, jemmilin, leikindini;brúka, ríva, skræða seg;brúka, sleipa gákin, kjaftin, munnin;júka og jabba;skræða gákin aftur at oyrum;tosa ein upp í ørviti;tosa hart, nógv;tosa javnt og samt, uttan íhald, slit, steðg, út í eitt;vera málamikil;vríggja leikindini;□hann leggur ikki leikindini saman;hann tigur ikki heldur enn ritan í berginum;hatta situr og ríkir sum ein gomul hjalshurð, eitt akurskritt;leikindini ganga í heilum, standa ikki still á hasum↔endurtøka,fara afturumaftur,fótatraðk,gremja seg,jabbaður,møsn,møsna,siga,umaftur
endurtrygging	sítrygging
endurtryggja	sítryggja
endurtøka	Samheiti:jabb,jabban,jagg,jótur,júk,júkan,kjøkr,meyl,meylan,munntami,neyring,sjagg,sjaggan,trúttan,tvítøka,uppafturtos,uppafturtøka↔endurtaka,fara afturumaftur,fótatraðk,jabbaður,møsn,møsna,umaftur
endurval	síval
endurvinna	síarbeiða
endurvinning	síframleiðsla
enduryrking	sísangur
enduryrkja	síyrkja
eni	sívreiði
enn	síafturat,framvegis,hvaðna,umaftur
enneru knotur	sílivst so spyrst
enni	síkneysur
ennigul ont	sífuglur
ennigulur	sífuglur
ennihvítur	sílitaður
ennisbrattur	sífattur
ennisfattur	sífattur
ennissvartur tyrningur	sífuglur
enntá	síafturat,av illum,hvaðna,sjálvt,tó
enntó	sító
enta	sísvara
epa	sískríggja
epistul	síluteind,skriv
epl	síepli
eplabing	sígoymsla
eplabløðka	sígróðurnál
eplabøur	síjarðarstykki
epladáli	sídáli
epladeild	síjarðarstykki
eplaertur	síepli
eplaflus	síyvirflati
eplafrukt	sígrøði
eplagoymsla	sígoymsla
eplagrøði	sígrøði
eplahaki	síknívur
eplahol	sígoymsla
eplahús	sígoymsla
eplakassi	sígoymsla,kassi
eplakovi	sígoymsla
eplakrubba	sígoymsla
eplaleypur	síkassi
eplamamma	síepli
eplamatur	símatur
eplamold	símold
eplamunni	símunni
eplanál	sígróðurnál
eplaneyð	sítørvur
eplaperla	síepli
eplapláss	síjarðarstykki
eplaposi	síposi
eplapottur	sípottur
eplarhol	sígoymsla
eplaryggur	Samheiti:hyppa,ryggur↔dyrka,epli,jarðarstykki
eplasandur	síjarðarstykki
eplasekkur	síposi
eplaskal	síyvirflati
eplaskiljing	sískiljing
eplasnórur	síband
eplasoð	sívatn
eplaspann	síspann
eplaspilla	sírot
eplaspíri	sígróðurnál
eplastykki	síjarðarstykki
eplateigur	síjarðarstykki
eplatrog	sígoymsla,kassi
eplatunna	sígoymsla,kassi
eplatøð	síkøstatøð
eplavatn	sívatn
eplaveður	sígóðveður
eplavelta	síjarðarstykki
eplavelting	sídyrking
eplaveltur	síjarðarstykki
eplaær	síseyður
epli	Samheiti:átepli,epl,etingarepli,flagepli,geldepl,hentepl,jørðepli,kulpa,matepli,moldepli,reimaepli,sandepli,sárlingur,setepli,siggepli,sleingingarepli,sniglaepli,snjóflekka,steikingarepli(eftirepli)eftirgróður,opinepli,vetrarepli,villepl(eplaertur)eplaperla,ertur,gásarepli,knas,perla(slokkepli)fræepli,toppepli(móðurepli)botnepli,eplamamma,mamma,mommuepl,móða,omma,skrukka↔dyrka,dyrking,eplaryggur,fræ,grógva
eplibing	sígoymsla
eplisfrukt	sígrøði
eplishús	sígoymsla
eplisong	síjarðarstykki
eplutur	sílitaður,prikkutur
erfínur	síúrklænur
erfornur	síaldrandi
erga	síoyðistaður
ergamal	síaldrandi
erji	sífiskur
erkieingil	síævintýrhugtak
erkvisin	sísmásárur,snarsintur
erkymla	síórógva
erla	sífuglur
erla kongsdóttir	sífuglur
erlamin	síbrekaður
erljótur	símisháttur
ermøri	símáttloysi
ernast	sílekjastSamheiti:erpnast,errast,herðast,livna,lívgast,megnast,mennast,pretna,reystna,rætna,stimbrast,styrkjast,styrkna,treystnabíta saman tenn;dirva seg (til e-t);draga til sín;ernast, erpnast, pretnast upp;ernast, hivna, kvikna, livna, vakna upp, við;erra, fata, herða, manna, menna, stinna seg upp (aftur);fáa dirvið, mótið aftur;fáa ferð á seg;fáa føturnar, hornini, høvdið fyri seg (aftur);fáa, hava viðrák;fáa (upp) á lag at...;fóta sær, koma aftur á føtur, upp undan aftur;gera seg til aftur;gerast kvikari, lívligari, raskari o.fl.;hava framgongd, framgongu;herða seg (í huga);koma aftur fyri seg, fyri seg aftur, koma seg aftur;livna, lívgast upp, uppaftur;móta, vinna seg aftur;rista letina av sær;rætna aftur;seta dirvi í seg;spenna, spíla seg út;stálseta seg;taka annað skinn um bak;taka dik á seg;taka eina rend á seg;taka fastatak á seg sjálvan;taka seg fram;taka sær um reiggj;taka vatn yvir høvdið;vera í menning;vinna fram;vinna frama(vaksa við uppgávuni)mennast av mótgangi, mótstøðu↔búnast,lekjast,læra seg,lætta,styrkjaAndheiti:sjúklast
erni	sístoltleiki
erpa	síreypa
erpikjaftur	síreypari
erpin	sístoltur
erpinskapur	sístoltleiki
erpiskítur	sífínarimpa
erpisliga	Samheiti:errisliga,stoltsliga↔fínarimpa,manniliga,reypa,stoltleiki,stoltur,upp á rós
erpisligur	sístoltur
erpnast	síernast
erpni	sístoltleiki
err	sísár
erra	síreypa,styrkja
errast	síernast
errin	sístoltur
errinskapur	sístoltleiki
errisliga	síerpisliga
errisligur	sístoltur
ersmáur	sísmáur
erta	síarga
ertari	síargapetti
ertin	síargingarsamur
erting	síarging
ertingarsamur	síargingarsamur
ertisamur	síargingarsamur
ertnabúkur	síátari
ertnakíkur	síátari
ertnastampur	síkassi
ertur	síepli
erur	sísvakur
erva	sífáa
ervaberg	síberg
ervabit	síjarðarstykki
ervaboð	síboðan
ervað	síbaksan
ervafylgi	síseyður
ervahagi	síjarðarstykki
ervakavi	síkavi
ervakrógv	sígoymsla
ervalamb	síseyður
ervaljós	síljósglæma
ervamikil	síførligur
ervamjørki	sítoka
ervarók	sírók
ervaseyður	síseyður
ervasjógvur	síhav
ervaær	síseyður
ervi	síhátíð,veitsluhald
ervingaleysur	síeinsamallur
ervingi	sískyldfólk
ervingur	sískyldfólk
ervisseyður	síseyður
esil	síross
esja	sírotna,skvagga,stinka
esjan	síljóð,luktur,rot
eskja	síkassi
espingur	sísjófar
eta	síslíta uppSamheiti:beita,bíta,fressa,gadda,gloypa,jøkla,keksa,kelka,kelkja,kíka,kurta,lógva,matla,mjatla,mjeska,namma,nátta,njóta,oyðeta,piða,pikka,roppa,skaffa,skrotta,slafsa,slambra,slapsa,slúka,smakka,stóreta,súpa,svølgja,tærabelgja, kála, keksa, kíka, kíla, koyra, kulka, ríva í seg;bera at munni;bera í munn;bert fáa flótandi føði;beyka, fressa, fylla, klesja, kleska, loka, skræða í seg;bíta sær í;draga strá;eta afturvið;eta eftir ráni;eta e-t sum, til marglæti;eta, fáa niður í seg;eta, gadda, jøkla, at rótini, svørðinum, niður í rótina;eta grammliga;eta heming, hundsku, vaml á seg;eta niðurfyri;eta og drekka;eta ov mikið;eta seg bjølgfullan, bjølgmettan, mettan, steinmettan;eta seg undir angarnar, tindina, yvir rygg(in);eta sum eitt grasdjór;eta sum ross bryður tara, tongul;eta tærisliga;eta upp í hít;fara til borðs;fáa (at smakka);fáa (ein bita) niðurum;fáa ein smakk;fáa krava sín;fáa mat;fáa mettuna;fáa niður;fáa niður á ágarnarnar;fáa niður á, fyri hjartað;fáa okkurt í búkin, vombina;fáa sær;fáa sær at eta;fáa sær (ein) bita, mat, okkurt etandi;fáa sær e-t niður í skrottuna, stelkin;fáa sær okkurt í skrøltin;fáa sær okkurt til matna;fáa upp í seg;fylla, koyra í leggaldið, skrøltin;fylla seg;ganga og mýla;gera sær til góðar;góðga sær;herkja niður;herkja, noyða, skora, skrotta, stappa, stúgva, stúva í seg;kekka, kelka, kelkja í seg;kjafta e-t í seg;koyra í hítina, hungrið á sær;leggja afturáaftur (at eta);leggja at livrini, á livrina;leggja at sær;leggja í vaðið;leggja niður í seg;liggja á biti;liggja á sama mati;liggja, sita í moðáti, moðæti;liggja, standa á beiti;loypa í seg;loypa sær ein bita í munnin;matla sær;munna seg;munnbera seg;oveta, ovsúpa seg;pikka, proppa, ríva, rúska, slafsa, slapsa í seg;púrgera sær;ríva seg á tamb;sita og fylla í ílatið;skræða seg út av áti;smakka (burtur) av e-m;smakka uppá (e-t);stappa, stúva í seg;taka dúgliga til sín (av mati);taka føði til sín;taka nál;telgja niður í seg;vera sum fressur í beitarfiski, beitufiski;vera sum fressur í línuleypi, opnahjalli, tvøstlykkju;vera sum kúgv í akri(eta í tarvloysi)eta burtur, upp í íveru;eta e-t burtur í tarvloysi;eta, fáa sær ein bita burtur í siðsømi, burtur úr siðsømi;eta fyri marglæti;eta millum máltíðir(etin)farin í moðát t.e. etin í tarvloysi;farin um hálsar t.e. svølgdur;gloyptur, kíkaður, svølgdur o.fl.;□tað er farið í vambardal, vambarskor t.e. etið↔avgnagaður,át,átari,burturmataður,drekka,etandi,gnaga,herkja,lættfóðraður,mata,matast burtur,matfegin,matur,metta,mettur,óát,óetandi,slitin,slíta upp,svangur,tystur,uppslitin
eta í tarvloysi	síeta
eta lítið	síherkja
etan	síát
etandi	Samheiti:átbærur,borðberandi,borðbærur,borðførur,eyðátin,matarkendur,matkendur,matkynt,munnbærur,nevberandiberandi at munni;til at eta;til ábit, døgurða o.fl.;til mat(ar), matna(r);○sum kann etast↔át,eta,matfegin,matur,mettur,svangurAndheiti:óetandi
etin	síavgnagaður,eta
eting	síát
etingaramboð	síamboð
etingarepli	síepli
etja	sírustur
etjast	símatast burtur
etjing	sírustur
europakort	síatlas
europameistari	sívinnari
evangelistur	sírithøvundur
evangelium	síboðan
evars	síógvuliga
evarska	síógvuliga
evja	sídálk,grugg
evjudíki	síkelda
evjutur	síbleytlendur,skitin
evla	síelva
evna	síarbeiða,forma,megna
evnabroyting	síbroyting
evnaður	síklókur
evnagóður	síklókur,prúður,ríkur,sterkur
evnaheimur	síverøld
evnaleysur	sídygdarleysur,fátækur
evnaligur	síarbeiðsførur,haldgóður,klókur,prúður,sterkur
evnalítil	síbrekaður,dygdarleysur,kraftleysur
evnaloysi	sífátækt,vansketni
evnaríkur	síklókur
evnasamband	sísamband,tilfar
evnaskifti	síbroyting
evnasøla	sísølubúð
evnaveikur	sísvakur
evni	síklókskapur,líkindi(r),tilfar,umrøðuevni
evning	síframleiðsla
evnisbroyting	síbroyting
evnisfang	sítilfar
evnisheimur	síverøld
evnisligur	síprúður,sterkur
evnismentan	símentan
evnismikil	síjavnstrokin
evnismisnýtari	sídrankari
evnisogn	síogn
evnisskifti	síbroyting
evnisskipan	síflokkan
evnisskrá	sískrá
evnisvika	síverkevni
evnisyvirlit	síyvirlit
evri	síovarlaga
evst	síovarlaga
evstaljóð	síljóð
evstamark	símark
evurklænur	síúrklænur
evurlítil	sísmáur
evurslítil	sísmáur
evursmáur	sísmáur
evurspinkulítil	sísmáur
evurssmáur	sísmáur
eydmjúkur	sílítillátin
eydmýkja	síeyðmýkja
eydmýkt	síeyðmýkt
eydna	sílagnaSamheiti:barnaeydna,eydni,eydnusæla,farsæla,fiskieydna,fólkaeydna,fólkaskepna,fóra,gifta,góðlukka,gæva,happ,hepni,konufólkaeydna,lívseydna,lukka,lukkukensla,lukkurám,lukkusæla,mannfólkaeydna,manntokki,mateydna,neytaeydna,sáligheit,seyðaeydna,sæla,veiðieydna,viðburður,viðgangur,viðgongd,viðrák,vælgongd(vælvera)triv,trivnaður,trivni,vælveran,vælferð(sigursæla)sigursvissagóð eydna, fóra, lagna, lukka o.fl.;happ í óhappi;□tað var góð fóra at...↔avynnumaður,eydnast,eydnast væl,eydnismaður,eydnuberandi,eydnuleikur,eydnulutur,innløgutíð,lagna,lukkuynskingAndheiti:ólagna
eydnast	Samheiti:árna,árnast,folda,frukta,ganga,gangast,gignast,hepnast,hilnast,hyldnast,kurtast,legnast,lukkast,rigga,roynast,skerast,skúrsast,standast,vignastarta, árna, fanta, hátta, laga, legna seg;bera ávøkstur, frukt;bera, falla, ganga, koma í lag;bera, vilja til;ganga í hond;geva til úrslit;koma, spyrjast, verða burturúr;spæla av;taka seg upp;vera eyðin (eyðið)↔avynnumaður,eydna,eydnast væl,eydnismaður,hilnast illa,lagna,lukkuynsking
eydnast væl	Samheiti:hepnast,lukkast,ærastarta, árna, fanta, hátta, laga, legna seg væl;árnast, gegnast, gignast, hilnast, legnast, roynast, skerast, vignast væl;bera, falla, ganga, koma (væl) í lag;bera ávøkstur, frukt;bera (væl) til;folda, frukta væl;ganga lættliga, strúkandi, sum smør, upp á stás, væl (í hond);ganga(st) betur enn væntað, væl;ganga sum á jólum, sum eftir ánni, sum eftir einum tráði, sum smurt,;ganga sum eg veit ikki hvat, sum fótur í hosu;gerast veruleiki;geva gott úrslit;geva góða frukt;hepnast, lukkast væl;javna, rætta seg;koma (aftur) á rætt, í rætt lag;koma afturíaftur (hjá tveimum);koma í fasta legu, skipan;koma í lag, rættlag;kurtast, skúrsast væl;rigga væl;roynast, standast væl;spyrjast væl burturúr;spæla væl av;vilja væl til;□alt er í besta, fínasta, stakasta lagi;alt stendur væl upp og niður;hann er ikki so ræddur sum illa klæddur;nógv, væl kemur burturúr;tað er góð støða, góður standur;tað er væl statt;tað gongur sum eftir smurdum lunni, sum fótur í hosu;tað stendur væl til, veit væl við↔eydna,eydnast,eydnismaður,eydnuberandi,lukkuynskingAndheiti:hilnast illa,miseydnast
eydni	síeydna,lagna
eydnisdagur	síinnløgutíð
eydnisfullur	síeydnuberandi
eydnisgóður	síeydnuberandi
eydnisligur	síeydnuberandi
eydnismaður	Samheiti:eydnumaður,fíggjarmaður,lukkubarn,lukkudýr,lukkumaður(fiskiklógv)fiskikongur,fiskikrókur,fiskimaður,fiskirót,kalvamaður,rokmaður,rokskipari,veiðiklógv,veiðimaður,veiðirót,øðukongurein sovorðin kalvamaður;fiskisamur, fiskisælur maður;góður miðamaður;góður seyðabóndi;□fiskur loynir sær ikki fyri honum;hann er fiskigrammur, útróðrarhugaður;hann er (væl) fyri fiski;hann hevur góða fiskieydnu;tað fløðir upp undir hann↔avynnumaður,eydna,eydnast,eydnast væl,eydnuberandi,fiskihugur,innløgumaður,lagna,sjómaðurAndheiti:avynnumaður
eydnismikil	síeydnuberandi
eydnuberandi	Samheiti:eydnisfullur,eydnisgóður,eydnisligur,eydnismikil,eydnudrúgvur,eydnugóður,eydnuligur,eydnumikil,eydnuríkur,eydnusamur,eyðin,gævumikil,happadrúgvur,heppin,heppiligur,lukkusamur,sæluríkur○sum fær, gevur, hevur við sær eydnu, happ, hepni, lukku o.fl.(lukkusleingin)fiskisamur,fiskisælur,heppin○sum hevur góða fiskieydnu, mateydnu;□fiskur loynir sær ikki fyri honum;tú kanst saktans;tú kanst siga sjey;tú kanst vera glaður(vera heppin)kunna ríkamannareiggj t.e. hava góða fiskieydnu;taka Gud um fót;vera fyri happinum;□lukkan slettist ofta upp á lort↔eydna,eydnast væl,eydnismaður,eydnuleikur,eydnulutur,glaður,lagna,lukkuynskingAndheiti:óheppin
eydnuborin	síglaður
eydnudagur	síinnløgutíð
eydnudís	síævintýrhugtak
eydnudrúgvur	síeydnuberandi
eydnugóður	síeydnuberandi
eydnugripur	síeydnulutur
eydnuleikur	Samheiti:eydnuspæl,happadráttur,lukkuspæl,spæl,váðaspæl(lutakast)lutkast↔eydna,eydnuberandi,eydnulutur,kasta lut
eydnuleysur	síóheppin
eydnuligur	síeydnuberandi
eydnuloysi	síólagna
eydnulutur	Samheiti:eydnugripur,eydnutal,fiskikrókur,lukkupengi,lukkutal,megingjørð,sigurhandski,sigurskjúrta,sigursteinur,verndardís,verndargripur,vitinýra,vísdómssteinur(gandagripur)gandabók,gandaorð,gandkvæði,gandasteinur,gandaørindi,ríkamannareið,ríkamannareiði(rúnabelti)rúnabjálvi,rúnabók,rúnakelvi,rúnastavur(verndarandi)varðeingil,verndareingil,verndarkvinna,verndarvættur↔eydna,eydnuberandi,eydnuleikur,gandakallur,gandur,lukkuynsking,spámaður,vernd
eydnuløta	síinnløgutíð
eydnumaður	síeydnismaður
eydnumikil	síeydnuberandi
eydnuríkur	síeydnuberandi,glaður
eydnusamur	síeydnuberandi
eydnuspæl	síeydnuleikur
eydnustund	síinnløgutíð
eydnusæla	síeydna
eydnusælur	síglaður
eydnutal	síeydnulutur
eydnuynski	sílukkuynsking
eyðátin	síetandi,smakkgóður
eyðbiðin	síhjálpsamur,villigur
eyðborin	sílættur
eyðboygdur	síbrákaligur,linur
eyðbrotin	síbrákaligur
eyðbýttur	síeyðfingin,sundurbýttur
eyðfimur	sískjótførur
eyðfingin	Samheiti:eyðbýttur,eyðgjørdur,eyðsøktur,eyðteknaður,eyðtikin,eyðvaldur,eyðvalur,eyðvolað,eyðvunnin,lættfingin,lættgjørdur,lættlisin,lættvunnin,skjótfingin,skjótgjørdur,skjótlisinlættur fáa, gera, lesa, taka, velja o.fl.;skjótur at gera, lesa o.fl.;□hatta er einki fyri;tað er ikki helvtarstríð av hasum↔atkomandi,lættliga,ómakaleysurAndheiti:ábyrgdarmikil
eyðfittur	sídygdargóður
eyðfunnin	sígreiður,sjónligur
eyðførur	sísjógóður
eyðgitt	síeyðvitað
eyðgjørdur	síeyðfingin
eyðgongdur	síatkomandi
eyðgreiddur	sígreiður
eyðhoyrdur	sígreiður
eyðhugsaður	sígreiður
eyðin	síeydnuberandi
eyðkendur	síóvanligur
eyðkenna	Samheiti:sermerkjabera vitnisburð um;vera eyðkendur fyri;vera eyðkennandi;□tað er eyðkent, sermerkt, serstakt fyri...↔eyðkenni,eyðmerking,frámerkja
eyðkennandi	síeyðkenna
eyðkenni	Samheiti:aðaleyðkenni,bragd,brennimerki,bringumerki,búmerki,dagmerki,eginmerki,einstaklingseyðkenni,eyðkennisbúni,eyðkennislag,eyðkennismerki,fingrafar,fingramerki,fótmark,frábrigdi,frámerki,fylkingarmerki,fyritøkumerki,hamarsmerki,heiligdagslinja,hermerki,hitlersmerki,hjámerki,høvuðseyðkenni,ímerki,kennimerki,kenningarmerki,kenningarstavur,krossmerki,málmerki,merki,móðurmerki,navnamerki,nummarpláta,nummarspjaldur,persónstal,p-tal,sereyðkenni,sermerki,skjaldarmerki,tjóðareyðkenni,tjóðfuglur,tjóvsmerki,vatnmerki,váknaprógv,vápnaprógv,virkisbúmerki,vørumerkieyðkent merki(búni)armbind,eyðkennisbúni,eyðkennishúgva,studentahúgva,tjóðbúnibind um armin;føroysk klæði(r), føroyskur búni;hermannabúni, løgreglubúni, skótabúni o.fl.(flagg)bannari,fáni,fiskaflagg,hentleikaflagg,høgleikaflagg,mjóflagg,pappírsflagg,tjaldursflagg,tjaldursmerki,tjóðarflagg,tjóðmerki,veðraflagg,veðramerki,vimpil(dámur)ánám,drag,eginleiki,eginskapur,eyðkennisskapur,farr,farra,farri,hugbragd,huglag,lagdámur,lyndiseyðkenni,serdrag,staðardámur,staðdámur,yvirbragd,yvirbragð,yvirbrá(seyðamerki)blóðmerki,døttur,hagamark,hagamerki,hagansmark,herðakloddi,hjalsmerki,húsmerki,kenningarmark,kenningarmerki,lagdur,lokkur,mark,mordaramark,ognarmark,røktingarmark,seyðamark,sløður,spjaldur↔allýsing,eyðkenna,eyðmerking,frámerkja,ímynd,nummar,seyðamark,skelti,slagorð
eyðkenniligur	síóvanligur
eyðkenningur	síkendur persónur
eyðkennisbúni	síeyðkenni,klæði(r)
eyðkennishúgva	síeyðkenni
eyðkennislag	síeyðkenni
eyðkennismerki	síeyðkenni
eyðkennisskapur	síeyðkenni
eyðkeyptur	síbíligur
eyðlind	sígagn
eyðlisin	sígreiður
eyðlýsa	sínágreina
eyðlýsing	síallýsing
eyðmerking	Samheiti:grindamerking,ímerking,marking,merking,talmerking,uppmerking↔eyðkenna,eyðkenni,frámerkja,skelti,nummar
eyðmintur	sígreiður
eyðmjúkleiki	síeyðmýkt
eyðmjúkligur	sílítillátin
eyðmjúkur	sílítillátin
eyðmýking	Samheiti:dráttur,háð,háðan,háðsemi,illkenning,klikkur,knæfall,landaskomm,lítilsvirðing,mannminkan,minkan,minkur,misbjóðing,misboð,mismæli,misvirðing,narr,negling,niðran,níð,ógværa,ólíkligskapur,ósómi,ósømd,óvirðing,skamm,skammarblettur,skemd,skemdarblettur,skemdarmerki,skemdarskriving,skomm,smeitur,spei,speilyndi,speirák,speireking,speisemi,spotskleiki,spott,spottan,spæ,tjóðarskomm,tortur,undirmeting,undirvirðing,vanheiður,vanmet,vansømd,vanvirða,vanvirði,vanvirðing,vanæra,æruloysi,ærumeiðing,æruskemdbæði háð og spott;bæði spott og spei↔arga,arging,argingarsamur,eyðmýkja,forhánisliga,halgibrot,hugsæra,kastibløka,spotta,spottaður,spottari,spottorð,vanæruligur,verða happaðurAndheiti:heiðursløn
eyðmýkja	Samheiti:eydmýkja,illkenna,kreinkja,misbjóða,mýkja,nasa,órættaeyðmýkja seg (fyri e-m);gera e-m fyri skommum;gera e-m órætt;gera e-m til skammar;gera eyðmjúkan;gera firtnan;gera knæfall (fyri e-m);gera mannminkan;gera til láturs;klæða, lata ein úr↔arga,arging,argingarsamur,eyðmýking,forhánisliga,gera sær fyri skommum,hugsæra,spotta,spottaður,spottari,spottorð,vanæruligurAndheiti:lovprísa
eyðmýkjandi	sívanæruligur
eyðmýkt	Samheiti:eyðmjúkleiki,eydmýkt,lágleiki,lítillæti,undirgeving,undirgivni↔lítillátin,smædni,smæðast,smæðin,undirlutakenslaAndheiti:frekleiki,maktgirnd,stoltleiki
eyðnýttur	síódrúgvur
eyðnæmur	sígreiður,næmur
eyðræna	símáttsúgva
eyðrænari	sítjóvur
eyðræning	sístuldur
eyðræningi	sítjóvur
eyðsagdur	sígreiður
eyðseldur	síeftirynskjandi
eyðsjónliga	sítýðiliga
eyðsjónligur	sísjónligur
eyðskildur	sígreiður
eyðsvaraður	sígreiður
eyðsveipin	sívilligur
eyðsýna	síavhylja
eyðsýndur	sígreiður,sjónligur
eyðsýnt	síeyðvitað,góðviðrað
eyðsæddur	sísjónligur
eyðsæð	síeyðvitað
eyðsætt	síeyðvitað
eyðsøktur	síeyðfingin
eyðteknaður	síeyðfingin
eyðtikin	síeyðfingin,spakur
eyðtrúgvið	sísannur
eyðtýddur	sígreiður
eyðtøkin	síódrúgvur
eyðtøkur	síódrúgvur
eyður	sífólkaoyðin,ogn,oyðin,uppfiskaður
eyðvalamaður	síavtakafólk,hampafólk
eyðvaldur	síeyðfingin,frálíkur,spakur
eyðvalur	síeyðfingin,spakur
eyðvitað	Samheiti:eyðgitt,eyðsýnt,eyðsæð,eyðsætt,givið,greitt,klárt,óivað,sjálvandi,sjálvsagt,sjónskt,skilligt,týðiligt,vitiliga,vitiligt,vitiligvís,vituliga,vituligt,vituligvísá tig og tala ikki;ei dáni, undur í;eyð veri tað;fyrr var illa;gaman í;hevði tú væntað annað;hvat segði eg;hvat tá;hvør, hvat heldur tú;ikki tær at siga;líkt er til at...;man tað ikki vera;nú tú sigur tað;rætt hevur tú;satt at siga;sjálvandi tað;spyr eftir;sum (tað) skilst, sæst;sum tú sært, veitst;sum vera man;sum vitiligt, vituligt (er);sært tú;□alt bendir á, røkist fyri at...;eg hugsi, ætli so við;eg trúgvi tí tú sigur, trúgvi tær;eingin sigur tær ímóti;ein, mann kann ikki vænta annað;ein, mann sær hvønn veg tað ber;hatta er einki nýtt;hatta er ikki fyrstu ferð;hatta hugsaði, segði eg altíð;hatta mundi meg gruna;hatta, tað sigur seg sjálvt;hatta veit eg væl, veitst tú væl, vita øll;nú er gátan gitin;nú er gátan øll;nú skilji eg betur;nú veit eg;rætt hevði tú;sjáldan rýkur av ongum brandi;sjón gongur fyri søgn;so er sum tú sigur;tað ber á tað borðið;tað dylist, dylst ikki (burtur);tað er einki at leggja niðurvið;tað er einki at undrast á, yvir;tað er einki, ikki skrøgg;tað er einki løgið í tí, ikki (so) løgið;tað er ein sjálvfylgja;tað er eyðsæð, sjálvsagt, vitiligt, vituligt o.fl.;tað er fyri hvønn mann;tað er honum (so) líkt, vant;tað er ikki at siga;tað er ikki at taka munnin ov fullan;tað er ikki at undra, ikki at undrast á, yvir, ikki (so) undarligt, ikki undur í;tað er ikki eftir, um at spyrja;tað er ikki frítt at...;tað er ikki meira enn vón (at honum);tað er ikki meira enn væntandi er, var;tað er ikki so løgið. merkiligt, undarligt;tað er ikki yvir at dylja, hylja;tað er lætt at fata, síggja, skilja;tað er ongum líkari, mætari enn at...;tað er sjálvandi;tað er sjálvsagdur lutur;tað er slúttiligt, týðiligt at...;tað er (so) natúrligt, náttúruligt, rímiligt, vitiligt, vituligt;tað er so púra vist;tað eru øll tekin til at...;tað gongur sjón fyri søgn;tað gongur tann vegin;tað grunaði, óraði, órdi meg;tað haldi eg;tað hevði eg (altíð) rokna við;tað hugsaði, tonkti, væntaði eg altíð, roknaði eg altíð við;tað kann eg hugsa, slútta mær;tað kann líkjast honum;tað kann, skal eg ætla;tað kann so væl henda seg, vera (at so er);tað kanst tú ætla;tað kemur mær fyri;tað kundi eg sagt mær sjálvum, sjálvur;tað man, má meg líða;tað man, plægdi so vera;tað mátti, skuldi, vildi so verið, tað vil so vera;tað segði eg altíð;tað skilir, sær hvør maður;tað skuldi so verið;tað slútti eg mær;tað sær út sum...;tað sæst á skræðuni;tað sæst á øllum brøgdum;tað sæst týðiliga at...;tað undrar ikki meg, undrar ongan;tað var altíð at vænta, altíð væntandi;tað var ikki annað at vænta, ikki annað væntandi;tað var tað ið eg helt, hugsaði, tonkti;tað veitst tú helst (sjálvur);tað vildi eg hildið, meint, sagt;tað vildi hann Dávur sagt;tað vil so vera;tað vita øll;tað vísir í somu ætt at...;tað vóru líkindi til;tað væntaði eg altíð;tak fyri tað↔greiður,kanska,meina,nevniliga,sannføring,sanniliga,sannindi,sannur,skynsamliga,týðiliga,vita
eyðvísur	sísjónligur
eyðvolað	síbíligur,eyðfingin
eyðvunnin	síeyðfingin
eyðætlað	sígreiður
eyga	síblettur,fiskatorva,fiskileið,hol,munni,reiður,rók,torveygaSamheiti:eygnakoppur,eygnasteinur,glísa,glísur,glóma,glósa,gluggi,gluggur,glýsa,tálgeyga(sjón)ellisjón,eygu,fjarskygni,fráskygni,hyggi,nærskygni,samsjón,sjónd(skeiting)dapan↔blunka,hyggja,oygdur,sansingargagn,síggja
eygabakki	síbakki
eygaboltur	sínagli
eygagóður	sígóðsintur
eygarogn	síegg
eygatonn	sítonn
eygbera	síhyggja
eygbragð	síútsjónd
eygbrúnur	sílitaður
eygfara	síhyggja
eygfarin	síkannaður
eygfesta	síhyggja
eyggráur	sílitaður
eyghavin	síeftiransin
eygleiða	síhyggja
eygleiðari	síáskoðari
eyglit	síútsjónd
eyglitaður	sílitaður
eyglittur	sílitaður
eygljótur	símisháttur
eyglýsa	síboða
eyglýsing	síboðan
eygmorreyður	sílitaður
eygna	síhyggja,síggja
eygnablunk	síløta,staran,viðbragd
eygnabragd	síløta,staran,viðbragd
eygnabragð	síløta,staran,viðbragd
eygnabrá	sístaran,viðbragd
eygnafjarur	síhugfjarur,hugsanarsamur
eygnagløs	sísjóneyka
eygnahagur	síklókur
eygnahár	síhár
eygnahædd	síhædd
eygnakast	sístaran,viðbragd
eygnaklaffur	sívernd
eygnakoppur	síeyga
eygnalag	síútsjónd
eygnalappi	síklútur
eygnalepi	síklútur
eygnaleysur	síblindur
eygnalitur	sílitevni
eygnamið	síendamál
eygnamørur	sífitievni
eygnariv	síargapetti,dýrgripur,ræðumynd,stakkalastás
eygnarívandi	síáhugaverdur
eygnarogn	síegg
eygnasjúka	sísjúka
eygnaskeyti	síklútur
eygnaskot	sístaran,viðbragd
eygnaskuggi	sílitevni
eygnasteinur	sídýrgripur,eyga,yndisbarn
eygnatonn	sítonn
eygnatænari	síhyklari
eygnatænasta	sísmikur
eygsjónliga	sítýðiliga
eygsjónligur	sísjónligur
eygsvartur	sílitaður
eygsýniliga	sítýðiliga
eygsýniligur	sísjónligur
eygsýnur	sígreiður
eygutur	síholutur
eygvermutur	sílitaður
eyk	síeftirbátur
eyka	síafturat,leggja afturat,ógvuliga
eykaaðalfundur	sífundur
eykaarbeiði	síarbeiði
eykaágóði	síyvirskot
eykaálit	síálitismaður
eykaárin	síárin
eykabind	sískriv
eykablað	síískoyti
eykadystur	síkapping
eykafundur	sífundur
eykagjald	síavgjald
eykahjálp	síhjálp
eykahjól	síringur
eykainntøka	sígjald
eykakostnaður	síútreiðsla
eykaligur	sítorførur
eykaloyvi	sírættindi
eykalutur	Samheiti:tiltak,tiltaksarmur,tiltaksár,tiltakslutur(tilhoyr)tilhoyring↔afturat,hoyra til,til varavissu,trygd,trygging,tryggja
eykalækni	sívaramaður
eykalærari	sílærarafólk,varamaður
eykaløn	sígjald
eykamaður	sívaramaður
eykan	síískoyti
eykanavn	sínavn
eykapersónur	sívaramaður
eykaprógv	síváttan
eykasamsýning	sígjald
eykaskattur	síavgjald
eykast	síarbeiða,størrast
eykastarv	sístarv
eykatingseta	sívald
eykatími	sískúlagongd
eykaútreiðslur	síútreiðsla
eykavaldur	sívaldur
eykavinna	sívinnulív
eykdovin	sílatur
eyki	síískoyti
eyknevna	sínevna
eyknevndur	sínevna
eyknevni	sínavn
eyks	síafturat
eyksmaður	sívaramaður
eyksum	síafturat
eykutur	sítorførur
eymd	sífátækt
eymingi	sívánamaður
eymk	sígremjan,stynjan
eymka	sígremja seg
eymkan	sífyrigeving,gremjan,stynjan
eymkiliga	sísára
eymkiligur	sífátækur
eymking	sígremjan
eymleiki	síkærleiki
eymliga	sísára,yndisliga
eymligur	sífátækur
eymur	sífátækur,góðsintur,sárur,smásárur
eyra	síleka
eyrbakki	síbakki
eyrblandaður	síoyðin
eyrborin	sísandstroyddur
eyrbotnur	sígrót
eyrfløta	síjarðarstykki
eyrgrýti	sígrót
eyrgøta	síkoyrivegur
eyrheyggjur	sígrót
eyrhol	sígrót
eyrkendur	síoyðin
eyrlendi	síjarðarstykki
eyrlind	sígrót
eyrmikil	síoyðin
eyrmold	símold
eyroyða	síoyðistaður
eyrriða	sífiskur
eyrriðamið	sífiskileið
eyrriðasild	sífiskur
eyrriði	sífiskur
eyrrok	sírokilsi
eyrrúgva	sígrót
eyrryggur	sígrót
eyrsáld	sísjófar
eyrskriða	sígrót,omanlop
eyrskruv	sígrót
eyrsteinur	sígrót
eyrur	sígrót
eyrutur	síoyðin
eyrvegur	síkoyrivegur
eyrveka	símold
eyrvika	símold
eyrvikujørð	símold
eyrvikukent	síoyðin
eyrvikukynt	síoyðin
eyrvøka	símold
eyrvøkujørð	símold
eyrvøkut	síoyðin
eysrúmsbekkur	sísessur
eystan	síeystureftir,vestureftir,ættir
eystanalda	sísjóvarilska
eystanbrim	sísjóvarilska
eystandráttur	sístreymur
eystanduni	sítorusláttur
eystaneftir	sívestureftir
eystanfyri	síeystureftir
eystanífrá	sívestureftir
eystanlond	sístatur
eystanlot	sívindur
eystannátt	sívindur
eystanódn	sísjóvarilska
eystanpíningur	sívindur
eystanrótan	sísjóvarilska
eystanstormur	sívindur
eystantil	síeystureftir
eystantømingur	sívindur
eystanveður	sívindur
eystanvindur	sívindur
eystanæl	síregn
eystarlaga	síeystureftir
eystfall	sístreymur
eystfalsbroddur	sístreymur
eystfalskyrrindi	sístreymur
eystligur	síættir
eystur	síeystureftir,morgun,skarð
eysturbygd	síbýur
eysturbýur	síbýur
eystureftir	Samheiti:eystur,eystanav, úr vestaru helvt, síðu;av, úr vestri, vesturætt;eysturav, -á, -frá, -fyri, -um, -undir, -við, -yvir;eystur av, á, eftir, frá, fyri, um, undir, við, yvir...;í ein eystan;í eystan, eystanætt, eystur, eysturætt,;móti eystri;úr einum vestan, úr vestri;vestan av, frá, undan, úr...;vestaneftir, -ífrá;vestaru megin frá(eystanfyri)eystantil,eystarlagaá eystursíðuni;á, í eystara parti;á, í eystaru helvt, síðu;eystan...;eystan fyri...;eystanvert á, við...;eystaru megin;eysturi á, hjá, í, við o.fl.;eystur úr...;fyri eystan;har eysturi;í ein eystan úr;móti eystri↔norðureftir,suðureftirAndheiti:vestureftir
eysturgerð	sístreymur
eysturhallur landnyrðingur	síættir
eysturhallur landsynningur	síættir
eysturhallur norðan	síættir
eysturhallur sunnan	síættir
eysturlandstúrur	sítúrur
eysturlega	síhvíld,lega
eystursjógvur	síhav
eysturætt	sívindur
eytt	síuppfiskaður
