fabrikk	síverkstaður
faddur	(gubbi)faddur,gudfaðir,gudpápi,halagubbi(gumma)berigumma,faddur,gudmamma,gudmóðir,halagumma,kýsagummavitni til (barna)dóp(guddóttir)dóttir gubba, gummu(gudsonur)sonur gubba, gummu↔doypa,dópur
faddurgáva	sígáva
faðir	síGud,hvíld,oddamaður,pápi,skyldfólk
faðirarvur	sígáva
faðirbróðir	sískyldfólk
faðirfólk	sískyldfólk
faðirhús	síbústaður
faðirkærleiki	síkærleiki
faðirleivd	sígáva
faðirleysur	síeinsamallur
faðirliga	síyndisliga
faðirligur	sígóðsintur
faðirsgarður	síbústaður
faðirskapur	sískyldskapur
faðirsnavn	sínavn
faðirsystir	sískyldfólk
faðirvár	síbønarhald
faðirætt	sískyldfólk
fafta	síivast
faftra	sígloyma,ivast
fagna	sílovprísa;biðja, siga góðan dag, morgun, gott kvøld, vælkomin;biðja vælkomnan vera;bjóða e-m inn, innar, innum;bjóða e-m sess, sess og sæti;bjóða e-m vælkomnan at vera;fagna e-m;gleðast um, við e-t;heilsa e-m vælkomnum;klappa fyri e-m;leypa um hálsin á e-m;rætta e-m hondina;siga væl fagnaður, vælkomin;taka blídliga, hjartaliga, væl ímóti e-m;taka e-n í favn;taka fegin, glaður ímóti e-m;taka um hálsin á e-m;vera blíður við e-n(vera væl fagnaður)fáa blíðskap,njóta blíðskap,vera vælkominfáa góða ímótitøku, móttøku;kenna seg vælkomnan;vera væl móttikin↔blídni,gleðirómur,góðsintur,lovprísa
fagnaðarár	síinnløgutíð
fagnaðarboð	síboðan
fagnaðardagur	síinnløgutíð
fagnaðarfundur	sífundur
fagnaðargestur	sígestur
fagnaðarheilsan	síheilsan
fagnaðarkvøða	síheilsan
fagnaðarmikil	símennandi
fagnaðaroffur	síoffurgáva
fagnaðarrómur	sígleðirómur
fagnaðarróp	sígleðirómur
fagnaðarrøða	sígleðirómur
fagnaðarskot	síbyrsuskot
fagnaðarsongur	sígleðirómur
fagnaðarstund	síinnløgutíð
fagnaður	sífundur,gleði,gleðirómur,mótitøka
fagnarbiti	símatur
fagnarboð	síboðan
fagnarbóndi	síavtakafólk
fagnardagur	sígóðveður,innløgutíð
fagnardýr	síhampafólk
fagnarhús	síbústaður
fagnarleysur	símótfallin
fagnarløta	sígóðveður
fagnarmaður	síavtakafólk
fagnarmáltíð	símatur
fagnartími	síinnløgutíð
fagnarveður	sígóðveður
fagur	síáleypandi,vakur
fagurbláur	sílitaður
fagurbókmentir	síbókaheimur
fagurgrønur	sílitaður
fagurgulur	sílitaður
fagurlátin	sígóðsintur
fagurlátur	sígóðsintur
fagurleiki	síyndi
fagurliga	síyndisliga
fagurligur	sívakur
fagurlitaður	síáleypandi,litaður
fagurlittur	síáleypandi,litaður
fagurlæti	síblídni
fagurorðaður	sígóðsintur
fagurreyður	sílitaður
fagurskrift	sískrift
fagurskriving	sískrift
fak	sílærdómur
fakfelag	sífelag
faks	síboðan,ull
faksa	síkuta
faksaband	síband
faksareip	síband
faksaterna	sífuglur
faksateymur	síband
faksállur	sífiskur
faksálur	sífiskur
faksi	sífiskur
faktaligur	sípyntaður
faktir	sílótir
falda	sígera brot á,randa,rokna,seyma
faldalín	síkvinna
faldari	sískriv
faldfjøll	sífjall
falding	síseyming,útrokning
faldur	sírukka
falkur	sífuglur,sjófar
fall	sídeyði,minking,rukkaSamheiti:bergfall,bjølgakast,bráðfall,bums,dums,døttur,hiv,jarðfall,jarðvarp,klums,kvams,omandøttur,pums,rap,rapul,reyvarfall,sending,skvams,smápums,snáv,stúrtningur,vambarkast,veiðifall(snávan)misspor,misstig,snáving(botnkav)kav,skarvslop,skálkakav,stórkavbarometurfall, blóðfall, prísfall, rentufall o.fl.↔falla,kastast,kollvelta,søkka
falla	sídoyggja,floyma,maka,minka,søkkaSamheiti:bumsa,detta,deysa,dumsa,endavendast,kollbólta,kollveltast,koppa,kvamsa,pumsa,róta,slysa,smella,sparla,stoytast,sturta,sturtna,sturtnast,stúrtna,tumbla,tumla,tveitastbólta, detta, fara um;dansa, ganga á breiðafóti;detta aftureftir, aftur eftir nakka, afturyvir;detta á afturpartin, dintilin, kláruna, rassin, reyvina;detta, falla aftur á døv, aftur um døv, á døvina;detta, falla fram, inn, niður, oman, út av e-m;detta, falla hóvliga, róliga, spakuliga, tungliga o. fl.;detta, fara afturav, afturá, afturopin, afturøvutur, víðopin, øvutur o.fl.;detta, fara eftir høvdinum, nakkanum, nøsini, reyvini, o.fl.;detta, fara fram eftir grúgvu, grúvu, rammanum, rommum;detta, fara, sparla, spæla útav, útfyri;detta, fara, stoytast á høvdið, eftir høvdinum;detta, fara um koll, rygg;detta kirnuflatur, skerflatur;falla aftur á bak, í elmuna, til jarðar;falla í básin (um kúgv);fara bóltandi, sparlandi;fara eftir høvdinum;fara fyri sløður;fara, taka av fótum, fótunum;fáa eitt jarðfall, reyvarfall, veiðifall o. fl.;liggja, falla, smella sum fyri kúluni, skotinum, sum skotin;liggja, smella sum himpan, hítin, lellan, lellið, keylan, krukkan o.fl.;missa flogið;seta á núvuna;smella niður, sum fyri kúluni, til jarðar;spæla á sjógvin(hokna)boyggja knø,bukka,knæleggjast,neya,níga,signa,sígaboyggja seg framá í bønarlegu, vera í bønarlegu;bukka niður í knæ;falla á knæ;falla e-m til kníggja;falla framá;leggja seg á knæ, leggjast á knæ, á knøini;leggja seg, leggjast (fram) á grúgvu, fram á grúgvudrekk;liggja á knæ, fram á grúgvu, fram eftir rommum;hokna í knøunum;hokna, signa niður, til jarðar;síga saman sum kruvdur kíkur;síga, smokka, søkka saman;□beinini bóru hann ikki(holvast)hvølvast,kantra,kantrast,kollsigla,koppafara um;koppa, venda sær á↔avtofta,avtoftaður,avtoftast,avveltur,bólt,endilangur,fall,flata niður,flatur,ganga,innføttur,kastast,kollvelta,niðurdottin,niðurríving,niðurtraðkaður,omanlop,óstúttur,rapa,seta,snáva,søkka,toft,útføttur,vinglanAndheiti:reisa
falla av	sídetta av
fallagrús	síljósglæma
fallandi	síminkandi
fallferð	sískjótleiki
fallhædd	síhædd
fallin	sídeyður
fallkomin	síhálvdeyður,sjúkur,tvílívað,útmøddur
fallskíggjahermaður	síhermaður
fallur	sísinnalag
falløks	síknívur
fals	sísvik
falsa	síboyggja,svika
falsan	sísvik
falsari	sísvikari
falsfingin	sísvikafullur
falsgudadýrkan	síheiðinskapur
falsgudadýrkari	síheidningur
falsgudur	sígudur
falsk	sísvik
falska	sísvika
falskleiki	sísvik
falskleysur	sítrúgvur
falskur	símisljóðandi,ósannur,svikafullur
falsleyst	síheiðurligur
falsleysur	sítrúgvur
falsloysi	sírættvísi,trúskapur
falslótir	síhykl
falslærari	sísvikari
falslæti	síhykl
falsmæli	síósannindi,svik
falsnari	sísvikari
falsorðaður	sísvikafullur
falssnóta	sísvikari
falsur	sírukka
falsvitni	sísvikari
falsvætti	sísvikari
falur	sítøkur
familja	síavvarðandi,skyldfólk
fanakendur	símannvándur
fananskendur	símannvándur
fanansliga	síógvuliga
fanansligur	símannvándur
fanansskapur	síóndskapur
fananstíð	sínoktan
fang	sífongur,føvning
fanga	sífleyga,grípa,veiða
fangabúr	sífongsul
fangahús	sífongsul
fangahøli	sífongsul
fangaklivi	sífongsul
fangalega	sífongsul
fangarúm	sífongsul
fangasessur	sísessur
fangaseta	sífongsul
fangatippi	sífongsul
fangatorn	sífongsul
fangavaktari	sívaktari
fangavørður	sívaktari
fangi	Samheiti:gísli,herfangi,krígsfangi,revsifangi,samfangi,samvitskufangihertikin maður↔dómur,fongsul,revsing,sita í fongsli,trælur,tyktaAndheiti:frímaður
fangilsi	sífongsul
fanglast	síleita,putla
fangslast	síleita,putla
fani	síóflýggjakroppur
fanin	síSátan
fann	síkavi
fannakavi	síkavi
fannaskái	sítáveður
fannaslit	sítáveður
fannhvítur	sílitaður
fannkavi	síkavi
fannmikil	sífrystur
fansa	síarbeiða óvandaliga
fansur	síkallskøp
fanta	síumvæla
fantaður	sískikkaður
fantaligur	sívælvirkin
fantilsi	sístandur
far	síansni,flutningur,sjófar,spor
fara	síførka,henda,líða,ríva,slóðaSamheiti:flyta,flytja,flytta,rýmabiðja, heilsa, siga farvæl;biðja um farloyvi, frí;falla frá;fara av garði, av húsunum, rókini, fara heiman, heimani, heimanífrá;fara av (reiðri, skipi o.fl.);fara burt, burtur, fjarvegis, langvegis, út;fara frá (eina løtu);fara frá e-m;fara frá (sum...);fara, halda avstað;fara í land, til sjós;fara í longdina;fara land av leið, land av leni, langt burtur;fara, loysa frá húsum;fara niðurúr (dansi);fara, siga seg, taka seg burturúr;fara sína kós, leið, sín veg;fara úr starvi o.fl.;fjóna, forfjóna, pakka, sjugga, sjúgga, sjúgva seg, sleppa sær (burtur);forláta e-n, e-t;leggja, siga arbeiði, embæti, starv frá sær;leggja til brots;melda, siga, taka seg (burtur) úr (felagsskapi o.fl.);pakka seg (avstað) (burtur);ríða sína leið, sín veg;senda inn uppsøgn, siga seg frá, úr embæti, starvi;siga upp;sleppa sær avstað, burtur, út o.fl.;snúgva sær frá e-m;stinga í sekkin;úrlima seg;venda e-m bakið, reyv;venda sær burtur t.e. horva seg burtur(bogna)isa,svigna,svigta,svíkja,víkjabogna, detta, fara, glíða, skrambla undan;geva eftir;geva, liða seg;ísa í;leggjast í legu;leggjast undan t.e. fáa skeivt bend;vera óálítandi(flýggja)firta,flyta,leypast,rýmabróta út;fara í bátin, bátarnar;fara, rýma av bygdini, landinum, skipinum o.fl.;flyta burtur;flyta í fjøllini, finna sær uppihald í óbygdum;hvørva seg burtur;leggja sjógv ímillum seg og...;leggjast út;seta bátin, bátarnar út;seta burturúr (t.e.) fara úr gonguni (um seyð);sleppa sær til rýmingar;taka til beinini, beins, rýmingar(hvørva)bráðhvørvafara aftur um hurðarbak;fara afturundir, burtur, framvið;fara um sýn;fara úr eygsjón, eygsýni, skotmála o.fl.;fara úr eygunum á e-m;verða burtur;□eg sá ikki aftur í halaferðina, halataglið á honum(víkja)bakka,dvína,fíra,røkkadvína, fíra, stinga upp, víkja fyri e-m;dvína, hopa, hopra, opra, renna, røkka, víkja undan;fara, flýggja, halda, krúpa, støkka undan;føra, hava seg undan;førka seg, fara, ganga, hava seg, víkja av vegnum fyri e-m;ganga aftur eftir hæli, afturøvugt;geva eftir;hopa aftur á hæl, aftur eftir hæli;hopra á;hopra, stíga afturá, aftureftir;sleppa, snara, snúgva sær undan;snúgva aftur;taka seg aftur, burtur, undan;venda aftur, við aftur;venda frá↔burtur,burturstaddur,farstøð,ferðast,flóttafólk,flyting,fráfaring,rýming,sleppa leysur,venda afturAndheiti:búsetast,hamast,koma,nærkast,verja seg
fara afturumaftur	Samheiti:byrja aftur,byrja av nýggjum,halda áfram,taka afturíafturhalda á við at...;halda fram;halda fram har ein slepti;ikki gevast á hendur;taka aftur í orðið↔endurtaka,endurtøka,umaftur
fara á húsagang	aka á knøunum;fara av knóranum, píllinum, stellingini;fara á heysin, navarin, reyvina, tinnuna;fara á, í húsagang;fara á kommununa, ørmundarhús;fara á tvingsilssølu, undir hamaran;fara í svartapott, undir kong;fara út á heyggin (t.e.) gerast húsvillur;gerast armur, fátækur o.fl.;húka undir skuldarbyrðu;ikki hóra undan, ikki klára tað fíggjarliga;koma illa fyri fíggjarliga;koma undir gjaldtrot, vera fyri gjaldtroti;missa alt, húsini, hus og heim, ognir;sita, standa eftir á berum, við ongum;sita við kaldar steinar;vera komin á knøini;verða koyrdur á bygdina;verða volaður↔fátækafólk,fátækt,fátækur
farakund	sírekavætti
farakunda	sírekavætti
farakundi	sírekavætti
farakundur	sírekavætti
farandi	síatkomandi
fara regluvillur	sívillast
farast	sídoyggja,oyðileggjast
fara úr seingini	sívakna
farbann	síforboð
farbróðir	sískyldfólk
farg	sílittóni,trýst,tyngd
farga	sílita,tyngja
fargaður	sídæmdur
fargafiskur	sífiskur
fargfiskur	sífiskur
farging	Samheiti:bleiking,blik,grøning,gylling,litaseting,liting,litpriking,málingararbeiði,pensling,sorting↔lita,litaður,litevni,littóni,málaður,pensla
fargipottur	sípottur
fargjald	sígjald
farhólm	síviðføri
farhólmur	síviðføri
farin	síavlagdur,deyður,liðin
farlag	síspor
farleið	síferðaleið
farlíkindi(r)	sígóðveður
farloyvi	sífrítíð
farmabátur	sísjófar
farmaður	sísjómaður
farmaflutningur	síflutningur
farmagjald	sígjald
farmannaluttur	síluktur
farmasigling	sísigling
farmaskip	sísjófar
farmaveður	sígóðveður
farmavørður	sívaktari
farmur	síbyrði,kenningSamheiti:bátsfarmur,bunki,deksfarmur,fiskafarmur,flogfarmur,føra,førningur,góðs,grindafarmur,grindaførningur,kornfarmur,last,oksafarmur,oljufarmur,postførningur,sendigóðs,sending,skipsfarmur,skipslast,stykkjafarmur,stykkjagóðs,torvfarmur,tvøstfarmur,viðarfarmur,vørufarmur,vørusending↔lossa,lossing
farmynd	símynd,yvirlit
farólvur	sínøgd
farr	síeyðkenni,hinna,illgruni,lag,spor
farra	síeyðkenni,hinna,illgruni,lag,spor
farri	síeyðkenni,hinna,illgruni,lag,sindur,spor
farsálmur	sísangur
farseðil	síváttan
farslóð	síspor
farsótt	sísjúka
farstaður	sísár,spor
farstrika	símynd,yvirlit
farstøð	Samheiti:fráfaringarhøll,jarnbreytargarður,jarnbreytarstøð,komuhøll,komustaður,tokstøð(bilstøð)bussstøð,leigubilastøð(steðgipláss)busssteðgipláss,busssteðgistað,steðgistað,stopp,støðgingarpláss,støðupláss(víkipláss)vendipláss(flogstøð)floghavn,flogbreyt,flogvøllur,lendingarbreyt,tyrlupallur↔fara,flúgving,fráfaring,lenda,sigling
farsund	sífjørður
farsæla	síeydna
farsælur	síglaður
farsøgn	sífrásøgn
farta	síferðast
fartan	sítúrur
fartast	síferðast
fartur	sísigling,skjótleiki
farumkring	sírekavætti
farvatn	síhav
farvegis	síeinki
farvegur	síspor
farvæl	síheilsan
fast	sídyggiliga,reglubundin,tó
fasta	síhungra
fastakast	síblak
fastaklettur	sígrót
fastandi	sísvangur
fastarond	síútlinja
fastasamband	sísamband
fastastøði	síundirlag
fastasýning	síframsýning
fastasøkk	síblak
fastatak	sítak
fastatøk	sítak
fastatøkur	sítak
fastboltaður	sífastur
fastgrógvin	sífastur,staðfastur
fasthentur	síófúsur
fastir	sískyldfólk
fastlagdur	síásettur
fastleiki	símegi,stinnleiki
fastliga	sídyggiliga
fastligur	sífastur
fastløga	síásetan
fastløntur	síløntur
fastmæltur	símálmikil,mæltur
fastna	síharðna
fastnaðarband	sítrúloving
fastnaðarorð	sítrúloving
fastnartøkur	sítak
fastnegldur	sífastur
fastogn	síogn
fastseta	síavgera
fastseting	síásetan,fongsul
fastsettur	síásettur
fastskrúvaður	sífastur
fastsvøvntur	sísvøvntungur
fast takist	Samheiti:ró nú snopprikkur□breið teg nú;devulstíð, fananstíð, illanstíð komi tær aftur;fast standi á tær, taki, takist á tær;fast svíði, taki;gakk, ligg, sit, statt nú;hasum kanst tú hava so gott av;hasum kanst tú takka tær sjálvum fyri;hav hann nú so góðan;hav tað nú so gott;hetta hevði hann, tú uppiborið;hvat segði eg;ikki annar skaði enn tað;nú kanst tú hava ein (beinan) lort, skitt;nú kanst tú skíta, tiga o.fl.;nú situr tú penur, prúður;nú stendur á hjá tær;nú sært tú sjálvur (avleiðingarnar);royn teg nú;sjálvgjørt er vælgjørt;skít teg nú;soleiðis er at vera...;statt nú breiður, penur;tað er pass í lagi fyri teg;tað var makur hansara;tú hevur gott av tí;tú liggur sum tú hevur reitt;tú skuldi betur, heldur...;vís nú hvat dugur er í tær, hvat tú dugir;væl gagnist honum, tær↔árin,eftirfylgja,endaúrslit,fáa mótstøðu,standa fyri skotum
fasttøkin	síbusutur
fasttøkur	síbusutur
fastur	síásettur,harður,natin,ótøkur,reglubundinSamheiti:bergfastur,botnfastur,fastboltaður,fastgrógvin,fastnegldur,fastskrúvaður,festur,grundarfastur,grundfastur,grundfestur,jarðfastur,jarðgrógvin,naglafastur,óskakandi,ongulfastur,órørligur,óvikandi,óvikiligur,rimmarfastur,skorðafastur,stinnur,stovnfastur,stúttur,støðufastur,trygguruppfestur;bundin, leinkjaður, límaður, sveisaður o.fl. fastur;fastur sum bergið, sum í berginum;grógvin fastur (í jørð);ikki flytandi, ikki leysur, ikki til at vika;○sum ikki dettur, fer um koll, rørist, vikast o.fl.;□hann er sum fastnegldur, negldur;tað stendur sum í berginum;tað vikast ikki(bundin)atkyrktur,ábundin,bakbundin,bógbundin,fjøtraður,fótbundin,haftbundin,íbundin,kjaftbundin,leinkjaður,niðurbundin,snørdurbundin á hond(um) og fót(um)(sálarsterkur)avgjørdur,fastligur,hugsterkur,lyndisfastur,lystarsterkur,óskakandi,óvikandi,óvikiligur,standfastur,sterkur,stevnufastur,stinnur,støðufastur,tryggur,viljafastur,viljagóður,viljasterkurandaliga, andliga, sálarliga sterkur;við stálherdum vilja↔binda,grundfesta,haldgóður,harðna,harður,mótmæla,skorða,skorpna,stinnleiki,stívari,styrkja,trúgvurAndheiti:sveimandi
fata	sígrípa,raka,rína við,røkka,vita
fatalepi	sílepi
fataleppur	sílepi
fatan	síáskoðan,klókskapur
fatandi	sígreiður
fatiligur	sígreiður
fatl	síband,umvav
fatla	síbinda
fatlaður	síumvavdur
fatling	síumvav
fatlingargrót	sígrót
fatlingarsteinur	sígrót
fatna	Samheiti:bendast afturá,rakna,rætnabendast upp;fatna afturav;gerast beinur, fattur, rættur;rætna upp↔beinur,beinvaksin,endilangur,fattur,útrætturAndheiti:bogna
fattast	sítróta
fattur	Samheiti:afturábendur,afturáboygdur,andbráður,brattur,bringubrattur,ennisbrattur,ennisfattur,kappnósin,lendafattur,loftskotin,nakkafattur,rankur,reystur,roysin,ryggjarfattur,rættur,saðilbogin,saðilborin,saðilboygdur,sterrin,steyrrættur,tumlafattur,uppfattur,upprendur,upprættur,uppskotin,uppsneiddurbendur uppeftir, uppbendur;fattur í lendunum, rygginum;fattur og hábærsligur;□hann gongur upp afturá, hevur rættan rygg;hann hevur fatt enni, fatta hond, fattan nakka, fattar tumlar(fattur (um bát))ov høgur á miðjuni;við ov lágari reising;sum hevur ov lítið spring↔beinur,beinvaksin,endilangur,fatna,útrætturAndheiti:framyvirboygdur
fatuligur	sígreiður
fatur	sískefti,tak
favna	sífevna,máta
favnabundi	síhálmur
favnhøgur	síhøgur
favnlag	síkroyst
favntjúkkur	síførligur
favnur	síband,føvning
fá	sífáa
fáa	síelva,geva,grípa,megna,upplivaSamheiti:arva,erva,fá,hava,líknast,ljóta,lutast,njóta,ognastfáa alt borið upp í hendurnar, alt gjørt fyri seg;fáa at eiga, í gávu, ogn, til gávis, ognar;fáa givið, tillutað,;fáa, hava frá e-m;fáa í arv, sín lut, part;koma til búgvið borð og skorin klæði;sleppa at eiga;taka av, ímóti, við;taka við arvi, festi;taka við eftir undanfarnan;verða borin á lógvum, uppi á hondum;verða lyftur og lættur;□e-m burðast, eydnast, hepnast, lukkast, unnast at...;e-m gevst, líkast, líknast, lutast, ognast, unnast e-t (t.e.) e-t fellur e-m í lut, til;e-n er e-m lagin, e-t er e-m lagað, lagið;e-n fær slysa sær e-t t.e. er so heppin at fáa...;e-t legst til e-n, legst til hjá e-m;tað fall í hans lut at...(líknast)lutasteiga, hava uppiborið;hava rætt til(seyrga)barva,berva,bragda,leska,smakka,sørga,tiggja↔arvaborin,arvingi,eiga,eigari,gáva,geva,gevari,móttakari,ognAndheiti:geva
fáa blíðskap	sífagna
fáa enda	síenda
fáa kirkjugarð	síjarða
fáa mótstøðu	fáa (aðrar) bøkur í at lesa;fáa aðrar dreingir at dragast við;fáa annað at hoyra, síggja;fáa annað latín at lesa;fáa av at vita, úr at gera;fáa drong at dragast við;fáa hart ímóti sær;fáa seg royndan;fáa, sleppa at sanna at...;ikki rósa av ferðini;sleppa at royna seg;□dýrt manst tú hann keypa;hann gongur tær ein skarpan gang;hann hølvar, høvlar, smyr teg av;hann ristir teg sum hundur ristir skóklút;hann verður tær ein tungur kleppur;hasin er ikki uppvaksin av grælingafjaðrum, siropsvatni;hatta verður tær ein berkin biti;hatta verður tær hart hoyggj at draga;ongan skalt tú søtan sova;skarpur verður hildarleikur;tað verður hart ímóti hørðum;tað verður mong súr (løtan áðrenn...);tú verður ovkyrktur av honum;tú verður smáur í hansara hondum↔álop,fast takist,fullkønur,halda út,javnviga,livst so spyrst,mótmæla,mótmæli,mótstøðumaður,standa fyri skotum,svara,treiskast,verja seg
fáa seg til at...	sívága sær
fáastaðni	síongastaðni
fáa stundir	sínáa
fáa uppreisn	síuppreisn
fábroyttur	síeinsljóðandi
fábýlt	sífólkaoyðin
fáfeingiligur	síforgeingiligur
fáfongd	sítómleiki
fáfongdur	síforgeingiligur
fáin	síøvundsjúkur
fáir	sífáur
fákunna	síbýttisskapur
fákunni	síbýttisskapur
fákunnigur	sítápuligur
fákunnugur	sítápuligur
fákunnur	sítápuligur
fálátaður	sífámæltur
fálátur	sífámæltur
fáleittur	sífámæltur,fløktur,nipin
fáliga	síljódliga,róliga
fáligur	sífámæltur,fløktur,mótfallin,nipin,sorgarbundin
fálkur	sífuglur
fálma	síleita,nema
fám	sírokilsi
fáma	sífúka,leita
fámenni	sítørvur
fámenska	sítørvur
fámentur	sífáur,fullmannaður
fámælskur	sífámæltur
fámæltur	Samheiti:fálátaður,fálátur,fáleittur,fáligur,fámælskur,fáorðaður,fátalandi,fáur,innanhokin,innibyrgdur,innihokin,innitokin,málveikur,munnstillur,orðafáur,orðalítil,orðfáur,smámæltur,spakmæltur,stuttorðaður,tigandi,tvistur,tøgiligur,tøgin,tøgnmikil,tøguligur,undirtrútsligur,veikmæltursnultin á málinum;við veikari rødd;○sum sigur, talar lítið;□hann er sum jørðin, tigandi sum grøvin;tað er lítið um hann(hulin)dulin,dylin,hulisligur,hulligur,hulur,loyndarfullurikki opinskáraður;○sum dugir at goyma inni við seg, dugir at tiga, dugir yvir at dylja(ómælandi)tíðindaleysur↔fólkaligur,hóvsamur,kvirrur,ljódliga,nipin,tiga,tøgn,spakurAndheiti:bersøgin,opinskáraður,orðkringur,tíðindafróður
fán	síminking
fána	síminkaSamheiti:gerast, verða fyri ongum,hvøkka,snópnastdetta burtur úr rovum;detta, falla burturímillum, burtur ímillum;detta undir sjálvdømi, falla í sjálvdømi, geva seg undir sjálvdømi;einki fáa sagt, noyðast at tiga;fáa sum vátan vøtt á gákin, kjaftin, frammaná;gerast avkomin, máttleysur, ússaligur, veikur o.fl.;gerast fáligur, hugfallin, mótfallin, stúrin o.fl.;gerast málleysur, ráðaleysur, ráðvillur, teptur o.fl.;hvørva í rúgvuni;ikki eiga, hava, vita orð (fyri e-m);ikki fáa fullsagt um...;ikki fáa orðið fram, fyri seg, upp;ikki fáa uppnos;ikki verða fullsagdur av e-m;missa áræðið, mótið, sjálvsálitið, virkishugin o.fl.;missa bæði mál og megi, mátt og megi;missa hug og evni;missa pippið;standa fastur;standa, sita og gapa, gána, glana, gløa;standa sum ein fíllur, sum eitt býtt, sum eitt ið býtt er;vera sum lamdur, sum lamsligin;vera sum ósmurdur skeyti;□hann seig saman sum ein kruvdur kíkur;hann stóð bara;hann stóð bara og gapaði;málið stakk aftur í hann;tá var lítið um hann↔bilsin,bilsnast,her gerst einki,nipin,ræðast,smæðast,troyttast,uppikastaður,útmøddur
fánaður	símótfallin
fánasligur	sínipin
fáni	síeyðkenni
fáningur	sífongur,minking
fánisligur	sínipin
fánutur	sítápuligur
fánytur	sítápuligur
fánýti	sívánamaður
fánýtur	sítápuligur
fáorðaður	sífámæltur
fár	síbýttlingur,dáragerð,lótir,seyður,vreiði
fáragudda	síflennibítur,vingliskøltur
fárakæti	sígleði
fáralátur	sískellilátur
fáraligur	sítorførur
fáralóti	sílótir
fáralótir	sílótir
fárasmør	sífitievni
fári	sívandi
fáskiftur	síeinsljóðandi
fáskýrdur	sítápuligur
fáskýrin	sítápuligur
fáskýrugur	sítápuligur
fáskýrutur	sítápuligur
fástaðni	síongastaðni
fátalandi	sífámæltur
fátonktur	sítápuligur
fátónandi	síeinsljóðandi
fátrúgvin	síilltrúgvin
fátt	sílítið
fáttur	símótloysi,sinnalag
fátækadýr	sífátækafólk
fátækadømi	sífátækt
fátækafólk	Samheiti:armóðsmaður,barbak,fátækadýr,fátæksmansbarn,fátæksmanssonur,fæloysingur,hárarevur,húsagangsmaður,knæbóndi,molamaður,ognarloysingur,ómagi,rakbóndi,rakreyv,roðstúkufólk,skuldamintur,skuldareyv,skuldari,smáfólk,smámaður,torpari,trotamaður,veðskuldarifátækt fólk↔fara á húsagang,fátækt,fátækurAndheiti:ríkmaður
fátækdómur	sífátækt
fátækdømi	sífátækt
fátækrabýlingur	síbýur
fátækrahjálp	síhjálp
fátækrahús	síbygningur
fátækratíggjund	síhjálp
fátæksliga	sífátækur
fátæksligur	sífátækur
fátæksmansbarn	sífátækafólk
fátæksmanssonur	sífátækafólk
fátækt	Samheiti:armadómur,armadømi,armóð,evnaloysi,eymd,fátækadømi,fátækdómur,fátækdømi,gjaldføristrupulleiki,gjaldtrot,hungurskor,matloysi,neyð,neyðarlív,neyðarstøða,ognarloysi,ómagaskapur,peningaloysi,peningatrot,peningatrongd,peningatrupulleiki,vesaladómur,vesalakor,vesaldómur,vesaldømifíggjarlig(t) hall, hóttafall, hundaskil, óføra, óføri, óskil;hungur og hall;ring livilíkindi(r), lívskor;ring, torfør støða, ringt, vánaligt skil, ringur standur;tronglig, vána kor(húsagangur)skrædl↔fara á húsagang,fátækafólk,fátækur,hall,hungur,lorka burtur,missur,tróta,tørvurAndheiti:ogn
fátækur	Samheiti:armóðsligur,armur,bátleysur,berur,blóðfátækur,eiðabarur,eiðadyggur,eiðasørur,evnaleysur,eymkiligur,eymligur,eymur,fátæksligur,hvassur,ísakaldur,jarðarleysur,jarðleysur,kannkollutur,kjøtfátækur,klædnaleysur,knappur,kollutur,kúleysur,neyðarligur,neyðarsligur,ognarleysur,ómúgvandi,pengaleysur,peningaleysur,púrsørur,skarpur,skuldabundin,skuldbundin,skuldigur,skuldugur,smáligur,snøggur,sparligur,spurvaligur,steinkollutur,steinsørur,svørur,sørur,tiptur,trongligur,ússaligur,útarmaður,várveikur,vesalligur,vesallur,vesalur,vesasligur,ørfátækurarmur, fátækur sum ein kirkjurotta, sum kirkjurottan;á húsagangi, farin á húsagang;á knøunum, reyvini;bundin av skuld;fátækur sum nálin ið ongan hevur tráðin, sum nál uttan tráð;ikki bótarførur, bótarmaður;ikki rúmur við pengum;illa birgdur, staddur við...;illa staddur, stillaður (fíggjarliga, peningaliga);í uppisetri við...;neyðiliga, neyðuliga staddur;neyðstaddur (vegna fátækt);niðurundirkomin fíggjarliga;uppráddur við...;várveikur t.e. í uppisetri við mat;við sviðið soð;□børnini eru bæði mong og svong;hann eigur ikki fyri lúsasalvu;hann ekur á knøunum;har er berligt innanveggja, smátt við mat;har er matleyst, matringt í húsinum, ringt mathús;tað er fátt um eyðið;tað er ikki matartuggan, núvan, oyrað í húsinum;tað er illa ástatt, statt, tað stendur illa til, veit illa við hjá honum;tað er smátt fyri hjá honum;tá var hvøkkur í vøtti(fátæksliga)berliga(vera fátækur)aka á knøunum, reyvini;eiga lítið av;eiga lítið av...;eiga lítið bæði at bíta og brenna, lítið gott at liva av, lítið og einki;einki hava á landinum, ikki eiga fótin fastan;einki, lítið eiga inni, hava at bjóða, hava til valdararáð;einki vegligt eiga, hava;hava fult hús av børnum, nógvar munnar at metta;hava ilt við at bjarga sær, bjarga sær føðina, føða seg;hava (ov) lítið til matna, lívsins uppihald;hava stóra skuld, tungt hús;hava trong (fíggjarlig) kor;hvørki eiga grís ella gás, hár ella strá, kúgv ella súgv;ikki eiga at leggja um doddafinnuna;ikki eiga bitan í munnin, sýru í vegg(i);ikki eiga eina krónu, eitt fimmoyra;ikki eiga eitt klovið, reytt, spanskt oyra, tveyoyra;ikki eiga fótin fastan;ikki eiga fótmál(a)(an), fótsmál(a)(an) (í bygdini);ikki eiga fyri lúsasalvu;ikki eiga jarðgimbri, jarðgimbur;ikki eiga klæði(r) upp á kroppin, nakað at fara í;ikki eiga oyra í veranum;ikki eiga reyvina á sær sjálvum;ikki eiga upp á stokkarnar;ikki hava nógv at taka av;ikki hava ráð;ikki hava tað so rúmsátt, rúmt;ikki klára, megna, orka at føða seg, gjalda, lívbjarga sær;ikki rísa undir e-m;ikki sita eftir í rúmum sessi;ikki smyrja knívin;liva á hungursmarkinum, niðan fyri hungursmarkið;liva, balast, sita í ringum, trongum korum;liva í armadømi, armóð, fátækdømi, neyð o.fl.;líða bæði hungur og hall;sita illa eftir;sita, standa eftir á berum, við ongum;sita, vera við sviðið soð, við sviðusoð;sita við tunnan greyt;síggja niður í svart gólv;vera armur, fátæksligur, kannkollutur, skuldabundin o.fl.;vera so spurvaligur, vera sørur fyri, við e-t(gerast fátækur)armastfara á húsagang;fara á kommununa;gerast armur, fátækur, skuldabundin, sørur o.fl.;koma í armadømi, armóð;missa hús og heim(svangligur)barligur,berligur,náðiligur,neyðarsligur,sipisligur,sipligur,skarpligur,slættisligur,slættligur,ússaligur,vánaligur□har er einki matkent, ikki matargrein í húsinum;har er einki, lítið til matna, trongligt við mati;har er ikki bitin, matarbitin, matarmolin, matartuggan, matmolin eftir;hetta er barligt, neyðarsligt, sipligt, skarpligt, slættligt, svangligt at bjóða;tað er ringt borðhald í húsinum, smáligt við mati↔arvaleysur,dygdarleysur,fara á húsagang,fátækafólk,fátækt,hall,hungur,kloddakot,lorka burtur,missur,skuld,sørur,tróta,tørvur,uttanhandaAndheiti:ríkur
fáur	sífámælturSamheiti:ein og ein,fámentureingin, fáur uttan...;ikki mangur;ikki nógvur;í lítlum tali;lítið av...;mestsum, nærum, næstan eingin;nakað fáir;onkur einstakur;□hann er mestsum einsamallur;tað var nóg illa tøluført (sum teir høvdu fiskað);teir kunnu teljast á aðrari hond(ini), einari hond;teir vóru bæði fáir og smáir;teir teljast sum...(fáir)einstakir,nakrir,onkrir,ørfáirfáir og spjaddir;heilt, ov, ógvuliga, sera fáir↔einans,einsamallur,fullmannaður,nakarAndheiti:nógvur
fávitska	síbýttisskapur
fávitskulátur	sískellilátur
fávitskutur	sítápuligur
fedraarvur	sígáva
fedrabygd	síbústaður
fedragarður	síbústaður
fedraheim	síbústaður
fedrajørð	síjarðarstykki
fedramál	sítungumál
fedrar	sískyldfólk
feðgar	sípar,skyldfólk,vinur
feftra	sírista
fegin	sígjarna,glaður
feginkensla	sígleði
feginleiki	sígleði
feginskapur	sígleði
feginsróp	sígleðirómur
fegna	sígleða ein
fegnast	sígleðast
fegni	sígleði
feia	sírudda
feiftra	sígloyma
feigd	sídeyði
feigdarár	sídeyði,vánatíð
feigdarboð	síboðan,spádómur
feigdarbrot	sísjóvarilska
feigdardagur	sídeyði
feigdarferð	sítúrur
feigdarfongur	sífongur
feigdarfuglur	sífuglur,spámaður
feigdargerð	síbrotsverk
feigdarhøgg	síduk
feigdarlús	síspámaður
feigdarmaður	sígálgamatur
feigdarnátt	sídeyði
feigdarsól	síspámaður
feigdarspor	sídeyði
feigdarstund	sídeyði
feigdartíðindi	síboðan
feigdarveður	síillveður
feigð	sídeyði
feigðarveður	síillveður
feigur	síhálvdeyður
feila	síórógva
feilur	síbrek,skeivleiki,vavstur
feima	síbráðna
feimin	sílinur
feimur	sílinur
feingin	Samheiti:feingjandi,kvæmur,smittandi,smittuførur,viðfeingin○sum lættliga smittar(viðkvæmur)illkvæmur (um sár),ljósskjarur,ljósviðkvæmur,ovurviðkvæmur○sum líður av ovurviðkvæmi(móttøkiligur)móttøkubúgvin↔avstoktur í...,bruni,feingja,fongd,órin,sjúka,sjúkur,smásárur,smittaður
feingja	Samheiti:ganga,ígera,smittabera smittu;elva ígerð;ganga sum pestin;vera feingin, feingjandi, smittandi o.fl.;□sótt, sjúka gongur↔avstoktur í...,bruni,feingin,fongd,órin,sjúka,sjúkur,smittaður
feingjandi	sífeingin
feitikúgv	síneyt
feitilendi	síjarðarstykki
feitilendisgimbur	síseyður
feitilendiskyrra	sígóðveður
feitilendisseyður	síseyður
feitimeti	símatur
feitineyt	síneyt
feitiseyður	síseyður
feitiær	síseyður
feitt	sífitievni,smelt
feittskón	síhinna
feittstift	síkrem
feitur	sífitikendur,hovin
fektir	sílótir
felag	sífelagsskapurSamheiti:akademi,altjóðafelagsskapur,arbeiðskvinnufelag,arbeiðsmannafelag,avhaldsfelag,áhugafelag,bandalag,bátsfelag,bókmentafelag,bóltfelag,bóndasamfelag,býráðssamgonga,dótturfelag,eind,einleiki,fakfelag,felagsskapur,fylking,heild,heimafelag,ídnaðarsamfelag,íognarfelag,ítróttafelag,ítróttasamband,kvinnufelag,kvinnurørsla,landsfelag,landsfelagsskapur,landsstýrissamgonga,lesiringur,listafelag,mannasamfelag,mannfelag,meginfelag,móðurfelag,nútíðarsamfelag,næmingafelag,partafelag,partalag,regla,reiðarafelag,riddararegla,ringur,ríkissamband,rættarsamfelag,rørsla,samanløga,samansvørjing,samband,sameining,samfelag,samgonga,samlag,samløga,samløgufelag,samskipan,samtak,samtøka,samvinnufelag,sjómannafelag,sjónleikarafelag,smápartafelag,smásamfelag,starvsmannafelag,stjórnarsamgonga,studentafelag,stuðulsfelag,stættasamfelag,systurfelag,talvfelag,telvingarfelag,tollsamgonga,tryggingarfelag,tryggingarsamband,ungmannafelag,urtagarðsfelag,útróðrarfelag,valfelag,vatnfelag,veljarafelag,verjusamgonga,verkamannafelag,vinnufelag,vísindafelag,yrkisfelag↔felagslimur,felagsskapur,granni,samanlegging,samansjóðaðir,semjast,umgangast,vinur
felagi	sífelagslimur,vinur
felagsandi	síblídni
felagsarbeiði	síarbeiði
felagsblað	sískriv
felagsbúgv	sífelagsskapur
felagsformaður	síoddamaður
felagsfundur	sífundur
felagsgjald	sígjald
felagshagi	síjarðarstykki
felagsheiti	sínavn
felagshús	síbygningur
felagshøli	síhøli
felagsligur	síalmenniligur
felagslimur	Samheiti:arbeiðsfelagi,bátsfelagi,bátsfeli,embætisbróðir,felagi,felagsmaður,floksfelagi,handilsfelagi,heiðurslimur,lagsbróðir,lestrarfelagi,liðfelagi,limur,luttakari,nevndarlimur,nevndarmaður,reglubróðir,samgongufelagi,samlimur,samrúmsmenn,seingjarfelagi,skúlafelagi,songarfelagi,songarfeli,starvsbróðir,starvsfelagi,starvssystir,stovufelagi,stuðulslimur,telefonfelagi,trúarfelagi,trúfelagi,verkfelagi,yrkisbróðir,yrkisfelagi↔felag,manning,partamaður,samansjóðaðir,semja,umgangast,vinur
felagslív	sígerandislív
felagslærugrein	sílærdómur
felagsmaður	sífelagslimur,vinur
felagsmarknaður	síhandilsskapur
felagsmál	Samheiti:almannamál,ríkismál,sammál,sosialmálfelags áhugamál↔áhugi,endamál,umrøðuevni
felagsmenniskjaligur	síalmenniligur
felagsmentan	símentan
felagsmerki	síímynd
felagsnavn	sínavn
felagsnevnari	sínevnari
felagsogn	sífelagsskapur,ogn
felagssangur	sísynging
felagsskapur	síblídni,felagSamheiti:búfelag,ríkisfelagsskapur(samogn)felag,felagsbúgv,felagsogn,felagstriðingur,feli,samanløga,samløga,samognarbúgvfelags búgv(samstarv)samanspæl,samarbeiði,samgonga,samleikur,samskifti,samspæl,samveiða,samverk,samvinna,samvirki,samyrki,torvfeli(samlag)samlív,samvera,samvering(luttøka)luttak(limaskapur)nevndarsessur↔blídni,felag,friður,granni,partamaður,samanlegging,samansjóðaðir,samdur,sameina,semja,semjast,umgangast,vinur
felagsskúli	sískúli
felagssongur	sísynging
felagsstova	síhøli
felagstriðingur	sífelagsskapur
felagstrygging	sítrygging
felahagi	síjarðarstykki
felaseyður	síseyður
felastaknútur	síknútur
felddjór	sídjór
feldur	síhúð
feldvøra	sívøra
feli	sífelagsskapur,seyður
fella	síavlíva,kollveltaSamheiti:fótongul,hjálmi,lokk,lokkagarn,lokkudorg,lokkur,lomvigasnara,músafella,ritufella,ritufelli,ritusnara,rottufella,rottufelli,rúsa,snara,snerra,veiðigrøv↔agn,eiturkoppanet,lokka,lokkuboppa,veiða,veiðing
felli	sídeyði,haldari,krampi
fellidýr	sífiskur
fellifiskur	sífiskur
felligrein	sílærdómur
felliknívur	síknívur
fellimuddur	síknívur
felling	sírukka,skoyti
fellisár	sívánatíð
felliskalvi	sífiskur
felliskráka	sífuglur
fellistoskur	sífiskur
fellisvetur	sívánatíð
fen	síkelda
fenaður	sídjór
fendíki	síkelda
feni	sídjór,kelda
feniksfiðri	síævintýrhugtak
fenjutur	síbleytlendur,skitin
fepur	síhiti
fepurfríur	síarbeiðsførur
fepurheitur	síheitur
fepurhiti	síhiti
fepurmikil	síheitur
fepurríð	síhiti
ferastaknútur	síknútur
ferbýti	síbýti
ferð	sígonga,medferð,rák,reis,sigling,skjótleiki,startur,túrur
ferðabátur	sísjófar
ferðabúgvin	sítilbúgvin
ferðafiskur	sífiskur
ferðafjáltur	síferðahugur
ferðafólk	sígesturSamheiti:ferðagarpur,ferðalag,ferðamaður,ferðastreymur,ferðingarmaður,gongufólk,krossfari,langfarafólk,langfaramaður,langferðamaður,pálmari,pílagrímur,pílgrímur,vallari,valtrari,ævintýramaður,ævintýrari↔burturstaddur,ferðafúsur,ferðahugur,ferðapláss,ferðast,rekavætti,túrur,víðfarin
ferðafólkaflutningur	síflutningur,sigling
ferðafólkaflúgving	síflúgving
ferðafólkaskip	sísjófar
ferðafólkatal	síyvirlit
ferðafrásøgn	sífrásøgn
ferðafuglur	sífuglur
ferðafúsur	Samheiti:ferðfúsin,ferðfúsur,ævintýrhugaður↔ferðafólk,ferðahugur,ferðast,víðfarin
ferðagarpur	síferðafólk
ferðagessur	síferðahugur
ferðagestur	sígestur
ferðagóðs	síviðføri
ferðahugur	Samheiti:ferðingarhugur,útferðarhugur,úthugur,útlongsil,útlongsul,úttrá,ævintýrhugur,ævintýrlongsul(ferðafjáltur)ferðagessur↔ferðafúsur,ferðafólk,ferðast,rekavætti,víðfarin
ferðakalvi	sífiskur
ferðaklæddur	síílatin
ferðaklæði(r)	síklæði(r)
ferðakostnaður	síprísur,útreiðsla
ferðalag	síferðafólk,túrur
ferðaland	sístatur
ferðaleið	Samheiti:afturleið,afturvegur,farleið,ferðavegur,flogleið,fólkaleið,gonguleið,heimleið,heimvegur,leið,omanleið,omanvegur,rás,rýmingarvegur,ruta,sjóleið,stevna,stevnileið,stevnuleið↔ferðapláss,ferðast,koyrivegur,landvegin,sniðgøta,stevnuleið
ferðalíkindi(r)	sígóðveður
ferðaloyvi	sírættindi,váttan
ferðalærari	sílærarafólk
ferðamaður	síferðafólk
ferðamannaland	sístatur
ferðamannasigling	sítúrur
ferðamannaskip	sísjófar
ferðamannaskrivstova	síbygningur
ferðamannavitjan	sívitjan
ferðamatur	símatur
ferðamikil	sískundmikil
ferðaminni	síminning
ferðamóður	síútmøddur
ferðan	sígonga,skjótleiki,túrur
ferðandi	síheimleysur,umskiftiligur
ferðapass	síváttan
ferðapeningur	síútreiðsla
ferðapláss	Samheiti:almannapláss,annaðpláss,dekspláss,fyrstapláss,koyggjupláss,sitipláss,standipláss,triðjapláss↔ferðafólk,ferðaleið,ferðast
ferðarbúgvin	sítilbúgvin
ferðarloyvi	síváttan
ferðasamband	sísamband
ferðaseðil	síváttan
ferðaskip	sísjófar
ferðaskjátta	síviðføri
ferðaskrivstova	síbygningur
ferðaskrín	síviðføri
ferðaskundin	sískundmikil
ferðaskundur	sískjótleiki
ferðast	síførka,gangaSamheiti:farta,fartast,fjakka,flakka,mala,ranka,rankast,reika,reisa,rekast,renslast,rentlast,reyla,reyvast,róka,skóka,slanka,slankast,sleingjast,strúka,sveima,sældast,vakka,valla,valtra,vanka,vappafara at vitja;fara á rekningi;fara, flúgva, ganga, rógva, sigla (sær) ein túr;fara fyri bjørg;fara heiman;fara niður, vera niðri;fara oman av landi;fara sum sleggja hús úr húsi;farta, flakka, reika, rekast (víða) um;ferðast yvir áir og gjáir;ganga, liggja og rekast;ganga og mala sum ein havtyrðil;ganga og reika, róka;gera eina ferð, reisu, rend;gera ein túr;gera eitt legg, rend, rensl;koma úr hundaljóði;kvitta á, frá, heiman, úr o.fl.;liggja og ranka, rankast, reyvast;ongastaðni støðast;reika, strúka, sveima, øna um;rekast, sleingjast, vera sum bukka, landbukka millum seingir, sengur;sjáldan vera undir taki;slanka húsanna millum;strúka sum ein skotabrundur, útiløgukattur;strúka um bygdina;sveima, vera sum sildreki;vera av bygd, av landi, í útlondu(nu)m;vera avlendis, uttanlands, uttanlendis, útlendis;vera á ferð, reikum;vera burturi, burturstaddur, fjart av landi skotin;vera í hvørjari útreiggj↔burtur,burturstaddur,fara,ferðafólk,ferðafúsur,ferðahugur,ferðaleið,ferðapláss,fótafet,ganga,gonga,landvegin,rekavætti,skunda sær,spor,túrur,vitja,víðfarinAndheiti:búgva
ferðastaknútur	síknútur
ferðasteyp	síheiðursløn
ferðastreymur	síferðafólk
ferðasøga	sífrásøgn
ferðasølumaður	síkeypmaður
ferðataska	síposi,viðføri
ferðatrygging	sítrygging
ferðaútreiðslur	síútreiðsla
ferðaveður	sígóðveður
ferðavegur	síferðaleið
ferðavistir	símatur
ferðaætlan	sískrá
ferð eftirferð	síupp í slag
ferðfúsin	síferðafúsur
ferðfúsur	síferðafúsur
ferðgevi	síístig
ferðigur	síarbeiðsførur,skjótførur,tilbúgvin
ferðing	sígonga,túrur
ferðingardrongur	sígestur
ferðingarhestur	síross
ferðingarhugur	síferðahugur
ferðingarkalvi	sífiskur
ferðingarlíkindi	sígóðveður
ferðingarmaður	síferðafólk,gestur
ferðingarveður	sígóðveður
ferðkanning	síkanning
ferðkøttur	sírekavætti
ferðmark	símark
ferðmikil	sískundmikil
ferðsla	sítúrur
ferðsludeyði	sídeyði
ferðsluljós	sílampa
ferðslulóg	sílóg
ferðslumálaráð	sívald
ferðslumentan	símentan,vani
ferðsluóhapp	síólagna
ferðsluproppur	síhindur
ferðslusiður	sívani
ferðslutrygd	sítrygd
ferðslutøppur	síhindur
ferðsluvanlukka	síólagna
ferðsluvegur	síkoyrivegur
ferðtálmi	síhindur
ferðugur	síarbeiðsførur,skjótførur,tilbúgvin
ferðuleiki	síheilsustandur
ferðøking	sívøkstur
ferfaldur	sífleirfaldur
ferføttur	síbeintur,ketta
ferga	sísjófar
fergja	sítyngja
ferhyrningur	sífýrkantur
ferhyrntur	sífýrkantur
feria	sífrítíð
feril	síillgruni,sindur
ferja	síflyta,sjófar
ferjuflutningur	síflutningur,sigling
ferjulega	síbryggja
ferjusamband	sísamband
ferjuskip	sísjófar
ferma	sílossa
fermast	sídoypa
fermdur	sílaðin
fermenningur	sískyldfólk
ferming	sídópur,lossing
fermingaraldur	síbarnaár
fermleiki	Samheiti:fimi,fimleiki,fótfimleiki,kringleiki,kvikleiki,smidleiki(handafimi)handahógv,handahóv,hegni,hegnislag,kynstur,køni,kønleiki,mentir,snild,snildi,snildleikigott handalag, handarbragð, handarbrá, hegni;hegni og handahógv↔arbeiðslag,list,skjótførur,skjótleiki
fermur	sífullkønur,skjótførur
fernisa	sípensla
fernisera	sípensla
fesil	sífløkja
fesj	síbarbrot
fesja	sídreiva,ótrivavætti
fesjutur	síbusutur,frísutur,illa ílatin
feskfiskabátur	sísjófar
feskfiskasøla	síhandilsskapur
feskfiskaveiða	sífiskiskapur
feskfiskur	sífiskur
feskmatur	símatur
feskur	sísmakkleysurSamheiti:daggamal,frískligur,frískur,nýfingin,nýggjur,nýmjólkað,nýur,nýveiddur,nývorpin,óspiltur,rotfríurbeint úr boppuni, sjónum;góður (enn);nýdripin, -fiskaður;nýtilgjørdur↔nýggjurAndheiti:saltur
fest	síveitsluhald
festa	síbiðla,binda,grundfesta,lás
festarband	sítrúloving
festarfæ	sígáva
festargáva	sígáva
festargenta	síunnustar
festari	síarvingi
festarmaður	síunnustar
festarmál	sítrúloving
festarmoy	síunnustar
festarmoyggj	síunnustar
festarorð	sítrúloving
festarøl	síveitsluhald
festast	sírótfestastSamheiti:dreivast,heftast,netjastbíta, koma, taka á, gerast ongulfastur, taka;blíva, gerast, koma, verða fastur;dreivast, fløkjast uppí, upp í e-t;festa, netja seg;hanga, vera fastur í e-m;ikki sleppa av, burtur, leysur, úr aftur;knýtast at e-m↔búsetast,grípa,rótfestast,staðfastur
festi	síband
festibræv	síváttan
festifalur	sítøkur
festiførur	sítilkomin
festigarður	síbústaður
festijørð	síjarðarstykki
festileiga	síútreiðsla
festileysur	sítøkur
festingarførur	sítilkomin
festirættur	sírættindi
festiskifti	síbýti
festnarband	sítrúloving
festnari	síarvingi
festnarorð	sítrúloving
festur	sífastur
feta	síganga,máta
feti	síband,noða
fetil	síband
fetlaband	síband
fetlateyggja	síband
fetta	síreypa
fevna	Samheiti:favna,hálsfevna,klemma,kroystafevna um;flúgva um hálsin á e-m;halda, sláa, taka armarnar tvørtur um e-n;halda, taka (inn) at sær;halda, taka (tvørtur) um;hava e-n í ørmunum;taka í favn(hálsa)ganga, liggja háls um háls t.e. tætt saman;taka um hálsin á e-m(fevnast)haldast,hálsfevnast,klemmast,kroystast↔kroyst
fevnan	síkroyst
fevnast	sífevna
fevni	síføvning
fevning	síkroyst
fevningur	síføvning
fikka	sílummi
fikkubók	sískriv
fikkuriddari	síboðberi,svikari
fikta	síkríggjast
fiktast	síkríggjast
filaður	síullaður
filing	síhárvøkstur
filla	síhúð,ífylla,knúsa,skræða
fillur	sílepi,smildur
filma	síavmynda,bákna
filmseftirlit	síeftirlit
filmstjørna	síkendur persónur
filmsýning	síframsýning
filmur	símynd
filpur	síknykil
filputur	síójavnur
filsni	síævintýrhugtak
filtra	sískilja
filtur	sískiljari
fimbulsvetur	sívánatíð
fimbulsvætti	síavynnumaður
fimi	sífermleiki
fimisrokning	síútrokning
fimlast	síivast
fimleikafagnaður	sífundur
fimleikaframsýning	síframsýning
fimleikahøll	síbygningur
fimleikakapping	síkapping
fimleikaklæði(r)	síklæði(r)
fimleikalið	símanning
fimleikalærari	sílærarafólk
fimleiki	sífermleiki
fimligur	sískjótførur
fimmburi	sískyldfólk
fimmfaldur	sífleirfaldur
fimmfimtingsleypur	síkassi
fimmfimtsleypur	síkassi
fimmkróna	sípeningur
fimmmannafar	sísjófar
fimmogtjúguoyra	sípeningur
fimmoyra	sípeningur
fimmrimaleypur	síkassi
fimsligur	síómakaleysur,snotiligur,vælvirkin
fimt	síforboð,frest
fimta	síforbjóða,friða
fimtaður	sífriða,ólógligur
fimtingsbýti	síbýti
fimtingsmál	síkassi
fimtingur	síluteind
fimur	sífullkønur,skjótførur
finala	síendi
findar-	sífrálíkur
findarblíður	sígóðsintur
findardagur	sígóðveður
findarfegin	síglaður
findarglaður	síglaður
findarlag	sísinnalag
findarløta	sígóðveður
findarríkur	síríkur
findarskálkur	síóflýggjakroppur
findarskelmur	síóflýggjakroppur
findartjóvur	sítjóvur
findarveður	sígóðveður
findarvinur	sívinur
finglast	síleita,putla
fingrabjølgur	síumvav
fingrafar	síeyðkenni,spor
fingrafimur	sívælvirkin
fingrahít	síumvav
fingralangur	síhanddragin,tjóvskur
fingraliður	síliður
fingramál	sítungumál
fingramerki	síeyðkenni,spor
fingraskeyti	síumvav
fingrasnippur	síoddur
fingrastaðir	síspor
fingrastavir	síspor
fingrasterkur	síklófastur,sterkur
fingravatn	sívatn
fingur	Samheiti:aftastifingur,fiskitummil,fremstifingur,grøðifingur,langatong,lekifingur,lítlifingur,longutong,rokkafingur,sleikifingur,spinnifingur,spinningarfingur,tummil,tummilfingur,ytstifingur(døslafingur)gággufingur,skeytafingur,trotafingur
fingurbjølgur	síumvav
fingurgómur	síoddur
fingurhít	síumvav
fingursnippur	síoddur
fingurtroti	síknykil
finka	sísnildarbragd
finkur	sílótir
finkuriddari	sífínarimpa,svikari
finkutur	sísvikafullur
finna	sífinna veg,knykil,pinkulingur,síggja,vitja
finnari	sífinningarmaður
finnast	síhópast,liva
finna upp á ráð	síupphugsa
finna veg	Samheiti:finnafinna aftur (á staðið);finna á;finna, fara røttu leiðina;finna heim (aftur);finna, koma aftur á beint, afturíaftur, á rætta leið;finna leið;finna til hús(a)(ar);finna veg(in) fram;ganga húsini upp aftur;hitta, koma á aftur;koma beinur;leita upp hús;raka, treffa við aftur;síggja at ganga↔stevnuleið,varði,venda aftur,vinna heim,viti,ýta,ýtiAndheiti:villast
finningarbátur	sífinningarmaður,sjófar
finningarfiskur	sígjald,hvalur
finningarløn	sígjald,takk
finningarmaður	Samheiti:finnari(finningarbátur)bátur sum hevur funnið (grind)↔finningur
finningarspik	sígjald
finningur	Samheiti:fundurfunnin lutur;góður finningur, fundur↔finningarmaður
finnukistil	síkassi
finnulás	sílás
finnur	síknykil
finnuskrín	síkassi
finnutur	síójavnur
finskur	sílistumlærdur,vanæruligur
fipa	síganga
fipan	sírørsla
fiplast	sígloyma,ivast
firnast	síræðast,smæðast
firni	sísmædni
firning	sísmædni
firningarsamur	sísmæðin
firningarsemi	sísmædni
firningur	sísmædni
firra	síjagstra,strekki
firrast	síræðast,smæðast
firta	sífara,skýggja
firtin	sívreiður
firtisliga	síóvinarliga
firtnagørn	síklandursvætti,snarsintur
firtni	símótvilji
firvaldssvimjing	sísvimjing
fisali	sísár
fiska	sívísa áSamheiti:avbrodda,brodda,dyrgja,dýva,flóta,kasta,kirna,loysa,murta,nabba,partrola,pilka,rógva,samtrola,syfta,toga,tóva,trítrola,trola,veiða(trároyna)kringlumala,togseta(royna eftir fiski)ala við beitu;dreggja eftir kræklingi, øðu o.fl.;dyrgja fyri smátt;dyrgja, royna eftir reyðfiski, reyðum, stinga niður fyri reytt;dyrgja við runddorg;fanga, fiska síl;fara á bát, til báts;fara fyri áir;fara, ganga í áir;fara omanfyri;fara út at flóta, á flot, í fjørðin;fara (út) at vaska øskuna av sær;fara, vera til fiskiskap, umborð (á...), við...;fáa, leggja, royna, taka ein rakstur, rekstur, røkstur;fáast við útróður;fiska á broddi;fiska goggu, kúving;fiska murt, seið, síl, skrubbu o.fl.;flota, floyta út;gera eitt legg;gera leyst, loysa endarnar, sleppa endunum;halda á stokki, útá, út á stokkin, halda snørið úti á stokkinum;halda (ongulin) út;halda snøri;halda, vera uppi í sjónum, við botnin;hava hjallin á sjónum;hava snørið úti;hála av, leggja, setast;kasta niður;kasta nót;kasta snøri;loysa frá bryggju, landi, teymi, loysa høvdið, loysa út á hav;royna eftir fiski, kalva, seiði, toski o.fl.;royna eftir, vera á sild;royna við agni, beitu, flugu, maðki, spinnara o.fl.;royna við gørnum, línu, snøri, tráðu o.fl;rógva havróður;rógva út;røkja sjógv(in), útróður;seta línu;skjóta trol(ið);standa, vera á murtabergi, seiðabergi;syfta seið;trola eftir fløtum;veiða fisk;vera á dyrging, floti, sjógv, sjónum, útróðri, útróðrum, útrøðri o.fl.;vera á havinum, havmiðum, til havs, uttarlaga, úti á havi;vera á tí bleyta;vera burtur, burturi (við...);vera í ánni, fjørðinum;vera leysur úr landi;vera, liggja á báti;vera til sjós, skips, útróðrar, útrógvar o.fl.;vera umborð;vera út at rógva, útirógvin, útrógvin;vera úti við línu, nót, tráðu, runddorg, rúsum, snøri, troli o.fl.;vera við bát(i), línuskipi, nótarskipi, trolara o.fl.;□har fór hvør fjøl á flot, á sjógv(draga fisk)brenna, bresta í at draga;brenna, koma í fisk;draga, hespa, teina snørið inn;draga leyshentur;draga línu;kasta, renna (beint) í kjaftin á honum;koma, seta í fisk;koma upp við fiski;sita og fleyga (við seiði);vera (fastur) í fiski(fáa fisk)fáa at kóka, kroysta, fáa á pannuna, í pottin;fáa eina kóking, eitt kók, kroyst;fáa eitt bragd, kenn, nabb (av fiski);fáa fulla last, fullan bát, fult skip;fáa sær at kóka, fáa sær pottin á loft, reiggj;fáa upp á træið, upp í pottin;fáa uppí, upp í skipið, fáa hana fulla;fylla seg;ikki vera krøktur, ongul í reyv, sørur o.fl.;kunna halda pottin;leggja ein ravarakstur;vera málaførur, nátturðaførur(krøkja)ongulfesta,pilkafáa á, fáa fisk, fáa fisk á;fáa fisk í renningini;seta í fisk(kenna)kenna í heinta(num);□hann hongur í kjaftseilini;tað stendur illa í;tað stendur í kjaftseilini(kennast)kjaftbera,kjagla,nartla,nartlast,nilvast,nippa,roytagramla á, í beituni;ikki vera ongulfastur;kjagla á;nartla, nippa, royta í beituna;nartlast uppi í beituni;nippa á, í húk;vera framvið;□hann er agnvandin, agnvandur, sleiskin, sleiskur, tjóvskur;hann er varbeitin, varbeittur, varbitin;hann, tað nippir í;hann vil ikki taka(taka)gloypa,kíka,kjafttakabíta, koma, vera á;vera bráðbeittur;vera fastur, ongulfastur;□fiskur er í heinta, heintan(num);fiskurin er, gongur, svimur uppi undir borði;fiskurin gongur á land;hann er sum í urðini;tað bragdar;tað er fiskur á hvørjum húki, jarni;tað er góður fiskiskapur;tað er nógvur fiskur at fáa↔fiskaloysi,fiskiskapur,fíla,flota,fongur,seta í botn,sigla,sjómaður,sørur,umborð,veiða,veiðing
fiskaagn	síagn
fiskaalari	síalari
fiskaaling	sídjórahald
fiskaavlop	síavlop
fiskabúr	sígoymsla
fiskafarmur	sífarmur
fiskaflagg	síeyðkenni
fiskaflógv	sístápil
fiskaflutningur	síflutningur
fiskafongur	sífongur
fiskaføði	símatur
fiskagreipa	sífiskur,par
fiskahjallur	sígoymsla,turkirúm
fiskahús	síbygningur
fiskahøvd	síhøvur
fiskakar	síkassi
fiskakassi	síkassi
fiskakeypari	síkeypmaður,viðskiftafólk
fiskakrógv	sígoymsla
fiskaleivdir	síavlop
fiskaleypur	síkassi
fiskaloysi	Samheiti:fiskaoyði,fiskiloysi,fiskioyði,oyða,oyði,sildaloysi,steinoyða,ørfiskitað turra oyði;□har er oyðið við fisk, uppfiskað;har er so perkutórað;tað er so eiðasørt til fisk↔avlíva,fiska,fiskiskapur,oyðin,søra,sørur,tøma,uppfiskaður
fiskamarknaður	síhandilsskapur,sølubúð
fiskamatur	símatur
fiskamurtur	sífiskur
fiskaoyði	sífiskaloysi
fiskapartur	sípartur
fiskapláss	sístað,turkirúm
fiskaprísur	síprísur
fiskar	sífiskur
fiskari	sísjómaður
fiskarí	sífiskiskapur
fiskaríkur	síúrtøkugóður
fiskaroykur	síluktur
fiskarusk	síavlop
fiskarut	síavlop
fiskaslipa	síslím
fiskasoð	sívatn
fiskastakkur	sístápil
fiskastertur	sífiskur
fiskastovnur	sískipan
fiskastykki	sístað,turkirúm
fiskastøði	sístað,turkirúm
fiskasøla	síhandilsskapur
fiskaterri	síterri
fiskateyggja	sífiskur,tyssi
fiskatíggjund	síavgjald,partur
fiskatorva	Samheiti:eyga,landrenning,loppur,kimbil,seiðakimbil,seiðatorva,sildatorva,sildavað,skreið,stimi,titil,torva,toskatorva,upsatorva,vaðrend av fiski;rensl av fiski↔fiskur,fuglaflokkur
fiskatrog	sítrog
fiskatræ	síturkirúm
fiskauppboðssøla	síhandilsskapur
fiskavasi	sífløkja
fiskaveiða	sífiskiskapur
fiskavirki	síverkstaður
fiskavøra	sívøra
fiskaørn	sífuglur
fiski	sífiskiskapur
fiskibátur	sísjófar
fiskidagur	síinnløgutíð
fiskieydna	síeydna
fiskifar	sísjófar
fiskifloti	sísjófar
fiskigávur	síklókskapur
fiskigrammur	síraskur
fiskigruður	sífiskileið
fiskigrunnur	sífiskileið
fiskiháttur	síarbeiðslag
fiskihugur	Samheiti:útróðrarhugurhugur til sjógvin(veiðihugur)grindahugur,veiðilyst↔áhugi,eydnismaður,trá
fiskiídnaður	síframleiðsla
fiskikapping	síkapping
fiskiklakkur	sífiskileið
fiskiklógv	síeydnismaður
fiskikongur	síeydnismaður
fiskikrókur	síeydnismaður,eydnulutur,húkur
fiskikvota	sípartur
fiskileið	Samheiti:áraleið,banki,bátaleið,brondingsleið,brosmuleið,dulur,dyrgingarleið,dyrgingarpláss,eyga,eyrriðamið,fiskigruður,fiskigrunnur,fiskiklakkur,fiskimið,fiskipass,fiskipláss,fiskiøki,fjarðarleið,fjarleið,flundrumið,garnaleið,gogguleið,goggumið,gruður,grunn,grunnur,grynka,grynna,gýtingargrunnur,hald,hav,havleið,havmið,heimasjógvur,heystmið,hjámið,hýsugruður,hýsugrunnur,hýsuleið,innmið,innsjógvur,kalvaleið,kalvamið,kassi,klakkur,landleið,landstrát,langfaraleið,línuleið,longumið,loynimið,mið,miðaleið,miðhav,miðhavsleið,námmið,nærmið,oyða,oyðuleið,pass,pligga,plinka,plinki,plinkur,rákaleið,rákarhald,reyðfiskaeyga,reyðfiskaleið,repp,róðrarleið,ryggur,sandeyga,sandgruður,sandgrunn,sandgrunnur,seiðapláss,sildagruður,sildagrunnur,sildaplinkur,skalli,skipaleið,skøltur,smábátaleið,smáfiskaleið,smáfiskamið,smáfiskarák,snørisleið,strát,stráti,strøttur,teistasjógvur,torragruður,torragrunnur,torraleið,torramið,toskamið,útmið,útróðrarleið,valamið,várfiskaleið,várgrunnur,várgrynna,várleið,vármið,vetrarmiðá fjarleiðum;á reyðfiskaleið;á ytstu havmiðum;inni á reyðfiski;í heimasjógvi;úti á hvítum (t.e.) uttan fyri reyðfisk(aleið)(seiðaberg)murtaberg,seiðabergsklettur,seiðabergspallur,seiðabergspláss↔aldutur,bládýpi,djúpur,fjarskotin,fjørður,hav,sjóvarilska,streymur,uttansyndis,ýta,ýti
fiskilíkindi(r)	sígóðveður
fiskiljóst	síljósglæma
fiskiloysi	sífiskaloysi
fiskiloyvi	sírættindi
fiskimaður	síeydnismaður,sjómaður
fiskimark	símark
fiskimási	sífuglur
fiskimið	sífiskileið
fisking	sífiskiskapur
fiskioyði	sífiskaloysi
fiskipartur	sípartur
fiskipass	sífiskileið
fiskipláss	sífiskileið
fiskirót	síeydnismaður
fiskirættindi	sírættindi
fiskisamur	síeydnuberandi
fiskisessur	sísessur
fiskiskapur	Samheiti:bátaveiða,dyrging,feskfiskaveiða,fiskarí,fiskaveiða,fiski,fisking,fiskiveiða,fíling,garnafiskiskapur,garnaveiða,grønlandsfiskiskapur,grønlandsútróður,havferð,havfiskiskapur,havróður,hál,hemaraveiða,heystróður,húkaveiða,hýsuveiða,ísfiskaveiða,kalvaróður,kalvaveiða,kast,kenn,kenning,kyrrindaroynd,kyrrindaróður,kyrrindaseta,laksaveiða,langfarafiskiskapur,línubrúk,línuróður,línuveiða,lýsingarseta,nabb,náttarseta,nótarkast,ovfisking,ovveiða,partroling,rakstur,ránsveiða,ránveiða,rekstur,reyvarfíl,reyvfíl,rokfiskiskapur,roktúrur,rokveiða,roynd,royndarfiskiskapur,royndartroling,royning,rækjufiskiskapur,rækjuveiða,røkstur,saltfiskaveiða,seta,seting,sildaveiða,sjálvdráttur,sjóróður,skeljaveiða,skipsfiskiskapur,skýmingardyrging,sluppfiskiskapur,snelluveiða,snørisfiskiskapur,snørisróður,stórfiskiskapur,summarróður,summartúrur,summarútróður,torraróður,toskafiskiskapur,toskaveiða,tóv,trároynd,trítroling,trolarafiskiskapur,trolfiskiskapur,troling,trolveiða,upsaveiða,útiróður,útróðrarferð,útróður,várfiski,várróður,veiða,veiði,veiðiferð,vetrarróður↔fiska,fiskaloysi,fongur,innløgutíð,umborð,veiðing
fiskiskip	sísjófar
fiskisnøri	síband
fiskistøð	síbryggja
fiskisælur	síeydnuberandi
fiskitummil	sífingur
fiskitúrur	sítúrur
fiskivarði	sívarði
fiskiveiða	sífiskiskapur,fongur
fiskivinna	sívinnulív
fiskivinnunevnd	sívald
fiskivinnuskúli	sískúli
fiskiøki	sífiskileið
fiskiørn	sífuglur
fiskmeti	símatur
fiskur	(állur)álakálvur,álladrumbur,állakálvur,álli,álur,álvinda,álvindi,álvindur,blankállur,búgválur,faksállur,faksálur,faksi,gulállur,havállur,haválur,klænkállur,vatnkálvur(blágóma)blágómi,blágómur,blágumma(blátomba)reyðtomba(brosma)brosmukálvur,hálarumpa,hornabrosma,úlvfiskur(búrfiskur)skjaldbrystingur(drekafiskur)floyfiskur(flatfiskur)áarskrubba,glaskvoysa,hvassasprek,hvasskvoysa,kalvasandflundra,klípa,klípi,kvoysa,lálla,ósaskrubba,reyðsprøka,sandflundra,sandsprek,sandsprøka,skrubba,stórikjaftur,tindaskalli,tunga,øvutikjaftur(háur)brugda,brugða,glíggjháur,gráháur,hamari,hábrandur,háfiskur,hái,hákallur,hákelling,hávur,hemar,hemari,nevhávur,skrubbháur(hvítingsbróðir)stinksild,toskasild(hýsa)hýslingur,hýsuhvølpur,hýsukálvur,hýsumurtur,hýsuungi,málingshýsa,smáhýsa,summarhýsa,torrahýsa(kalvi)agnaspjaldur,agnaspragga,búkalvi,eggjakalvi,fellidýr,fellifiskur,felliskalvi,ferðakalvi,ferðingarkalvi,flundra,flundrufiskur,flæsa,fløta,geiraspjørr,grábein,grunnakalvi,hond,hveita,kalvaflundra,kalvaspjaldur,kalvaspragga,kalvasprek,karðalok,klovningur,kubbi,kubbingur,kutingur,kølva,legudýr,legufiskur,legukalvi,legukølva,limaspjaldur,lógvi,løgd,mjálkakalvi,nebba,rangur kalvi,rognakalvi,rognkalvi,sandflundra,sandlok,sandsprek,sildakalvi,sildaspjaldur,silkalvi,smákalvi,snorgron,snubba,spjað,spjaldur,spragga,spraka,sprek,sprøka,spæk,stórkalvi,stybbingur,stýva,stývari,stývingskalvi,stývingur,sundurtøkukalvi,svartkalvi,togkjaftur,urni,vaðanskalvi,vaðhaldskalvi,vatnkalvi(karpa)vatnkarvi(kombikk)beinmurtur,eldmurtur,eyrriðasild,horngeil,horngeili,horngeir,hvasssíl,kombikki,kombikkja,kombikkur,strentingur,trøllasíl(kongafiskur)karvi,trantkongafiskur(lodna)lodnasild(longa)blálonga,brúðgómssnilli,longukálvur,smálonga,vaðanslonga(lýrur)hvítseiður,lini(multa)grámulta,pusalaknektur(rognkelsi)grárognkelsi,reyðrognkelsi,rognkilsi,tindarognkelsi(rossamakrelur)tindamakrelur(sild)agnsild,ansjós,breiðasild,brislingur,bræðingarsild,fjarðarsild,garnasild,havnebbasild,havsild,heystsild,ídnaðarsild,lomvigasild,lundasild,matarsild,matsild,mjálkasild,nebbasild,sardin,sildatorva,sildavað,smásild,streymsild,tummasild,vársild(síl)andriða,anriða,áarsíl,bleika,bleikja,busi,búsíl,egriða,egriði,erji,eyrriða,eyrriði,grásíl,gýtungi,hagasíl,havsíl,kúlulaksur,laks,laksur,maðkadrumbur,maðkapirra,maðkasíl,miðlingasíl,pirra,runusíl,sjógveyrriði,sjósíl,smásíl,snerra,stórsíl,undirmálslaksur,unglaksur,vatnasíl,ælabogasíl(sjónál)nevdregil,tarasproti(skøta)halahvassa skøta,hvítaskøta,íshavsskøta,klingruskøta,lógvaskøta,naglaskøta,nebbaskøta,pinnaskøta,ravmagnsskøta,sandskøta,spískaskøta,svartaskøta,tindaskøta(steinbítur)hundfiskur,hundur,rabbassi,steinbítahvølpur(steinbítsbróðir)liri(sterril)sildakongur,sildasterril(súgari)nígginieyga(súgálur)kjølsúgari,slímállur,súgállur,súgválur(tarabrosma)bremma(toskur)bankafiskur,bankatoskur,berggylta,berggyltumurtur,bollingur,brondingur,bulingur,bøllingur,fellistoskur,fiskamurtur,fiskastertur,flakningur,flotfiskur,gilla,gillumurtur,glýsufiskur,gráfiskur,grunnafiskur,grunnfiskur,grunningur,grynnufiskur,havtorri,havtoskur,heystfiskur,heystsmáfiskur,hvítfiskur,illveðursfiskur,íslandsfiskur,íslandsrennari,íslandstoskur,kroppur,kryvlingur,landfiskur,landskránur,landtorri,lippufiskur,lunnatoskur,lurkur,lurtingarfiskur,lurtingur,lúnukongur,málfiskur,málingur,málsfiskur,miðalfiskur,miðaltoskur,miðatoskur,miðlingafiskur,miðlingatoskur,millumfiskur,mosabarki,rakmurtur,rákafiskur,rennari,renningur,reyðbelta,reyðfiskur,reyðkot,roddi,rut,seiðabergsfiskur,sildafiskur,sjógangari,skinnfiskur,skránur,slánur,smáfiskagreipa,smáfiskur,smædd,stórfiskur,strøttlingur,stútingur,tertlingur,torratoskur,torri,toskafiskur,toskamurtur,undirmálsfiskur,várfiskur,vetrarfiskur,øðutjóvur(ulka)brynjukrutt,grottupil,íshavskrutt,kluftarpil,klunta,krutt,krøkilskrutt,kuntupil,kuntupill,murrikrutt,ulkufyl,ulkukrutt,ulkupil,ulkupill(upsi)anguri,beituseiður,bergseiður,blámari,bláseiður,bulur,dyrgingarseiður,grónseiður,heystseiður,kalur,kamsseiður,livurseiður,murtur,nótarseiður,palli,pálur,pisumurtur,seiðateyggja,seiðabergsseiður,seiðakimbil,seiðamurtur,seiðarúgva,seiðasmátt,seiðatorva,seiðatyssi,seiður,sildaseiður,smámurtur,smáseiður,stivli,stórseiður,streymseiður,støðumurtur,støðuseiður,summarseiður,ternumurtur,træveturseiður,tvæveturseiður,upsatorva,várseiður,vendingarseiður,vetrarseiður(hin) bráðsterki(aðrir fiskar)áburra,bláriddari,bramafiskur,fjaðragrúkur,flogfiskur,gedda,gestfiskur,gullfiskur,gulllaksur,havtaska,háfjaðraði stubbi,hornfiskur,hvítingur,kikarafiskur,knurrhani,kryttlingur,laksastyrja,langasporl,lodna,longubróðir,lýsingur,makrelur,mánafiskur,prikkafiskur,sandstubbi,silvurkalvi,sjóhestur,sjóprónur,skeggfiskur,stinglaksur,stubbi,styrja,súgfiskur,svartkjaftur,svørðfiskur,tindabak,tunfiskur,tvíprikkuti stubbi,tvørmuður,tvørmunnur,varrafiskur(nýtslufiskur)aftansfiskur,átufiskur,fargafiskur,fargfiskur,feskfiskur,fiskagreipa,fiskateyggja,fjørufiskur,gagnfiskur,greipafiskur,greipingarfiskur,greipufiskur,grónseiður,hellufiskur,hýsugreipa,ídnaðarfiskur,ídnaðarsild,jólafiskur,kamsseiður,knettafiskur,luftingur,luftna,luftningur,lunnatoskur,matfiskur,ráfiskur,seiðateyggja,seiðatyssi,teyggjufiskurluftnaður, ræstur, spikførur, turrur, visnaður fiskur o.fl.(annar fiskur)alari,alifiskur,andróðursfiskur,andøvsfiskur,áarfiskur,bátafiskur,bátfiskur,bátsfiskur,beitarfiskur,beitufiskur,botnfiskur,botnskav,bróskfiskur,búfiskur,dammfiskur,djúpfiskur,djúphavsfiskur,djúpvatnsfiskur,ferðafiskur,garnafiskur,gloypingur,grams,grámurtur,grell,grunnát,grunnklór,grunnslóð,grunnsóp,grunnæti,grús,gýtingarfiskur,hannfiskur,havfiskur,havtorri,húkafiskur,ísfiskur,kallfiskur,kenningarfiskur,knappafiskur,krabbafiskur,kvennfiskur,línufiskur,lívfiskur,miðadýr,miðafiskur,mjálkafiskur,mjólkafiskur,nabbafiskur,náttarfiskur,nótarfiskur,nýgýta,nýgýtt,pirrikurri,rakslánur,rekafiskur,rekfiskur,risafiskur,rognafiskur,rognfiskur,rottutrónur,silafiskur,sildafiskur,silfiskur,siljafiskur,sjálvdráttra(r)fiskur,skaðafiskur,skipafiskur,smágrell,smáæti,smolt,snellufiskur,snørisfiskur,stertur,stimi,stundari,støðufiskur,summarfiskur,taralonga,tíggjundarfiskur,torrafiskur,tráari,triðjalandsfiskur,trolarafiskur,trolfiskur,ungfiskur,uppsjóvarfiskur,útróðrarfiskur,vaðfiskur,vaktarfiskur,vatnfiskur,vrakfiskur,vøkufiskur,æti↔fiskatorva
fit	sífótur,húð,kelda
fita	símata
fitfuglur	sífuglur
fiti	sífitievni
fitibiti	símatur
fitibjølgur	Samheiti:bjølgur,bósi,bumba,dillari,fitigrísur,frethít,gorsekkur,gøltur,heyggja,huglingur,ísturbjølgur,ísturbúkur,ísturkíkur,klístur,kuprilsi,kúpsa,kúpsi,køgga,køplingur,køpsa,køpsur,lubbi,lubbur,oyggj,rulkur,smelli,vambarkelkurfeitt fólk;tjúkkur maður↔fitievni,fitikendur,hovin,hovna,tríalingurAndheiti:rakdirðil
fitievni	Samheiti:bála,bløðrumørur,brá,bráa,bringuskalvur,eygnamørur,fløt,gásarsmoltur,gulleyga,høvdafløt,kertnafløt,lírasmoltur,mjólkarfiti,nakkaspik,oyralust,oyrnalust,oyrnamørur,plantufiti,pylsubræur,pylsufløt,smolt,smoltur,tálgarfløt,tálgarsmelt,togskittingur,ullarfiti,ullartálg(fiti)feitt,flikr,flikur,glærfiti,hagafiti,hvølpafiti,landfiti,leysafiti,tálgarfiti(flesk)fleskabiti,svínafeitt(ístur)gásarístur,líraístur,súluístur(margarin)plantumargarin,smørlíki(mergur)blóðmergur,mergjarfiti,neytamergur,rossamergur,seyðamergur(olja)matolja,palmin,pálmaolja,plantuolja,steikifeitt(smør)børkasmør,fárasmør,hagasmør,heimasmør,klíningur,maimánaðarsmør,neyðarsmør,oskasmør,rásmør,smer,smørbitil,smørklíningur,smørklunkur,smørmoli,smørnartl,summarsmør,titil,vetrarsmør(tálg)avnotatálg,bløðrumørur,bløðrutálg,bótartálg,fárasmør,fløttálg,fornatálg,garnatálg,garnatálgardrýlur,garnmørsoyra,garnmørur,hjartamørur,hjartnamørur,kálvanetja,kálvsnetja,keppnetja,kokumørur,kokutálg,kultur,kultursbiti,lambstálg,leysatálg,mørur,netja,neytanetja,neytatálg,nýrmørur,nýrumørur,rein tálg,salttálg,seyðatálg,sperðilsavnot,sperðilstálg,tálgarbiti,tálgarklunkur,tálgarkøka,tálgarmoli,tálgarstykki,tjónetja,veðranetja,ærtálg↔fitibjølgur,fitikendur,lýsi,smelt,spikAndheiti:soltinskapur
fitigrísur	sífitibjølgur
fitikendur	Samheiti:drivin,feitur,glisutur,lýsutur,snykaður,snykblankur,snykdálkaður,snykutur↔fitibjølgur,fitievni,hovin
fitilókur	síhinna
fitispreinging	sívarðveitsla
fitisteinur	sígrót
fitja	síbinda,dreiva,fótur,húð
fitjing	sífótur,húð
fitjingarendi	síband
fitjingur	síhúð
fitjufuglur	sífuglur
fitla	síhúð,ivast,ífylla
fitna	síhovna
fitnaður	síhovin
fitta	sípynta
fitt av vindi	sívindur
fitt gul	sívindur
fittliga	síríkiliga
fittligt gul	sívindur
fittligur	sísnotiligur,úrklænur
fittur	sígóðsintur,úrklænur,vakur
fíandi	sífíggindi
fíggindaherur	síherlið
fíggindaliga	síóvinarliga
fíggindaligur	símannvándur
fíggindaskapur	síhatur
fíggindaskip	sísjófar
fíggindi	Samheiti:deyðafíggindi,fíandi,fíindi,hatari,illvildarmaður,illviljamaður,óvinur,øvundarkona,øvundarmaður,øvundismaður,øvundsmaðurargasti fíggindi(triðingsvinur)falskur vinur↔atsóknarmaður,harðhjartaður,hjartaloysi,illsemjast,mannvándur,mótstøðumaður,ósamdur,ósemja,óvinarliga,yppa klandurAndheiti:vinur
fíggindskapur	síhatur
fígging	Samheiti:eginfígging,fæfeingisíløga,ílegging,íløga,íløgupeningur,peningaílegging,peningaíløga,rakstrarfígging,umfígging,váðafætilfluttur peningur;váðafúsur peningur(peningajáttan)peningsveitan↔fíggjarviðurskifti,gjalda,ogn,peningur
fíggja	sígjalda,hata
fíggjaður	síríkur
fíggjarhall	síhall
fíggjarjavni	síjavnvág
fíggjarkreppa	sívandi
fíggjarliga	sífíggjarviðurskifti
fíggjarligur	sífíggjarviðurskifti
fíggjarlóg	sílóg
fíggjarmaður	síeydnismaður,ríkmaður
fíggjarmál	sífíggjarviðurskifti
fíggjarmálaráð	sívald
fíggjarnevnd	sívald
fíggjarorka	sílíkindi(r)
fíggjarskaði	símissur
fíggjarstandur	sífíggjarviðurskifti,líkindi(r)
fíggjarstøða	sífíggjarviðurskifti,líkindi(r)
fíggjarsvik	sístuldur,svik
fíggjarvánir	sílíkindi(r)
fíggjarviðurskifti	Samheiti:fíggjarstandur,fíggjarstøða,lánføribúskaparlig, fíggjarlig, peningalig viðurskifti;ogn og skuld;støða í peningamálum(fíggjarmál)búskaparmál,peningamál(fíggjarligur)búskaparligur,peningaligur(fíggjarliga)búskaparliga,peningaligaviðvíkjandi búskapi, fígging, peningi↔búskapur,fígging,framtíðarútlit,líkindi(r),ogn,peningur,standur
fíggjarætlan	sískrá
fíindi	sífíggindi
fíindskapur	síhatur
fíla	síraspaSamheiti:svarvafíla langafíl, reyvfíl, reyvarfíl;fíla langan og seigan;halda snøri;standa sum ein sagarmaður;standa við snøri(kirna)dyrgja↔fiska
fílabeinstorn	síveruleikaflótti
fílari	sísjómaður
fíling	sífiskiskapur
fínafólk	sífínarimpa
fínalótir	sístoltleiki
fínalæti	sístoltleiki
fínarimpa	Samheiti:apuspjót,embætisleggald,erpiskítur,finkuriddari,fútakráka,kíkatøppurskaput, uppgjørt fólk(fínafólk)stórgubbar,stórfólkfín fólk;fínt fólk;tað betra fólkið;tað betra slagið;tey fínu;tey stóru í ondini↔erpisliga,kjør,stoltleiki,uppgjørdur
fínasmíð	síbygging
fínastova	síhøli
fínka	síforma,pynta,umvæla
fínka e-t	síminka
fínkambur	síkambur
fínkast	síminka
fínkavi	síkavi
fínklæddur	sípyntaður
fínlátin	síforkela
fínlátur	síforkela
fínligur	síúrklænur
fínmæltur	símæltur
fínnappa	sískilja,tøta
fínskilja	sískilja
fínsligur	síúrklænur
fínt	sífrálíkt
fíntelja	síramsa upp
fínteljing	síuppreksan
fíntentur	síinnskorin
fínullaður	síullaður
fínur	síhábærsligur,pyntaður,smákornutur,úrklænur
fíra	sífara,førka
fís	síanding,ljóð
físa	síanda,fúka,spræna,storma
físan	síanding,ljóð
físari	síavtakafólk
físibjølgur	síklandursvætti
físin	sívreiður
físpa	síarbeiða óvandaliga,fúka
físur	síillsinnisgleps
fívil	síbýttlingur,undirhaldari
fjaðaleysur	símótfallin
fjaðra	sístørrast
fjaðrabátur	sísjófar
fjaðrabotnur	síbotnur
fjaðrabóltur	síbóltur
fjaðrabúni	sífjaðrast,húð
fjaðraður	sífjaðrast,loðin
fjaðragrúkur	sífiskur
fjaðraleysur	sífjaðrast,nakin
fjaðrandi	Samheiti:gyrðin,lastiskur,linur,toyggiligur○sum kann tambast, toyggjast, víðkast o.fl.↔kvapsutur,linur
fjaðrapuutur	síloðin
fjaðrarok	sírokilsi
fjaðrast	fáa fjaðrar;gerast flogbúgvin, floygdur, fullfjaðraður, stinnfloygdur;kasta, missa dúnið(fjaðraður)fjaðrutur○sum hevur fingið fjaðrar, kastað, mist dúnið;við fjaðrabúna, fjaðrum, fjaðurbúna(dúnast)fáa dún(dúnaður)dúnutur,fjaðraleysur,fjaðurleysur,húgvuhvítur,ófloygdur(staputur)stapaðurvið stapum(skifta hamin)fáa, hava fjaðursæri;gerast fjaðursárur, fjaðurskotin, fjøðursárur;hava hamskifti;missa, skifta fjaðrarnar↔floygdur,flúgva
fjaðrutur	sífjaðrast,loðin
fjaðurbúni	sífjaðrast,húð
fjaðurhamur	síhúð,klæði(r)
fjaðurleysur	sífjaðrast,nakin
fjaðursárur	sífjaðrast,frísutur,sárur
fjaðurskotin	sífjaðrast,sárur
fjaðursæri	sífjaðrast
fjakk	sígonga,rekavætti,seyður,vavstur
fjakka	síferðast,ganga,stikla steinar
fjakkandi	síheimleysur
fjakkari	sírekavætti
fjala	síkrógva
fjalabotnur	síbotnur
fjalarsprek	síviður
fjalarstubbi	síviður
fjaldur	síavtakin,fløktur,hinumegin,krógvaður
fjall	síseyðaraksturSamheiti:ásur,faldfjøll,fjalladyngja,fjallakambur,fjallagarður,fjallagrein,fjallaknúkur,fjallakrúna,fjallarust,fjallaryggur,fjallarøð,fjallatindur,fjallatoppur,fjallatrom,fjallavídd,fjallgarður,fjallrust,fjallryggur,fjallrøð,fjalltrom,grein,háfjall,høgi,kambur,kjølur,klakkur,knappur,knúki,knúkur,kolli,kollur,kjølur,núgva,risafjall,rust,ryggur,røð,tindur,toppur,tvørfelli(fjallaskarð)skarð(heyggjur)bringur,bunga,búlga,bøkkur,grastúgva,grótherða,grótheyggjur,herða,heygur,hóllur,hólur,hválur,hædd,hækki,hørg,høttur,høvd,kráarheyggjur,kráarheygur,mosabøkkur,mosatorva,mosatúgva,mølheyggjur,núgva,pjonkur,ryggur,sandheyggjur,sandheygur,sandryggur,skalli,stópur,teiggjur,túgva,túva,vál,válur,vørða(hálendi)fjallalendi,háfløta,hálond,háslættidøttur t.e. síðki↔berg,drangur,forræði,grasvaksin blettur,jarðarstykki,kneysur,rókAndheiti:dalur
fjalladalur	sídalur
fjalladun	síljóð
fjalladuni	síljóð
fjalladyngja	sífjall
fjallaferð	sítúrur
fjallafylgi	síseyður
fjallagarður	sífjall
fjallagjólingur	síseyður
fjallagrein	sífjall,útlinja
fjallagróður	sígrøði
fjallagrót	sígrót
fjallagul	sívindur
fjallagøta	síkoyrivegur
fjallahagi	síjarðarstykki
fjallakambur	sífjall
fjallakavi	síkavi
fjallaknúkur	sífjall
fjallakrúna	sífjall
fjallalamb	síseyður
fjallaland	sístatur
fjallalendi	sífjall
fjallalíri	sífuglur
fjallamjørki	sítoka
fjallamurra	sífuglur
fjallarust	sífjall
fjallaryggur	sífjall,útlinja
fjallarýpa	sífuglur
fjallarøð	sífjall,útlinja
fjallaseyður	síseyður
fjallasíða	síhalli
fjallaskarð	sífjall
fjallaskuggi	sískuggi
fjallasmoga	síhola
fjallatindur	sífjall
fjallatoppur	sífjall
fjallatrom	sífjall,útlinja
fjallatussi	síævintýrhugtak
fjallavídd	sífjall
fjallaær	síseyður
fjallband	síband
fjallbátur	sísjófar
fjallboð	síboðan
fjallbúgvin	sítilbúgvin
fjallbygdur	síójavnur
fjallfólk	símanning
fjallførur	sífullmannaður,tilkomin
fjallgarður	sífjall
fjallgildi	síveitsluhald
fjallgonga	síseyðarakstur,seyður
fjallgøta	síkoyrivegur
fjallhagi	síjarðarstykki
fjallhøgur	síhøgur
fjallklæddur	sítilbúgvin
fjallklæði(r)	síklæði(r)
fjalllamb	sígjald,seyður
fjalllíkindi	sígóðveður
fjallljóst	síljósglæma
fjalllýsi	síljósglæma
fjallløn	sígjald
fjallmannagildi	síveitsluhald
fjallmatur	símatur
fjallmikil	síójavnur
fjallmurra	sífuglur
fjallrok	síkavi,rokilsi
fjallrust	sífjall
fjallryggur	sífjall
fjallrøð	sífjall
fjallseyður	sígjald,seyður
fjallsíða	síhalli
fjallskipan	símanning
fjallskítur	sívánamaður
fjallskøddur	sítilbúgvin
fjallstavur	sístavur
fjallsterkur	síhaldgóður,sterkur
fjalltog	síband
fjalltrom	sífjall,útlinja
fjallull	sígjald
fjallveður	sígóðveður
fjallveggur	síveggur
fjallær	sígjald,seyður
fjallærarlamb	síseyður
fjandansskapur	síóndskapur
fjandin	síSátan
fjandskapur	síhatur
fjant	síbýttlingur,dáragerð
fjantast	sífjákast,fríggja
fjantavesin	sídáragerð,hykl
fjantutur	síuppgjørdur
fjara	sífjøra,søkka,tømast
fjaraður	sífjøra
fjarandi	síminkandi
fjarbláur	sílitaður
fjarborin	síinnfluttur
fjarbygd	síbýur,fjarleið
fjarbýlt	sífólkaoyðin,spjaddur
fjarðaragn	síagn
fjarðarbátur	sísjófar
fjarðarbotnur	síbotnur
fjarðarbygd	síbýur
fjarðarleið	sífiskileið
fjarðarmunni	síinngongd
fjarðarsild	sífiskur
fjarðarveður	sígóðveður
fjarðført	síatkomandi
fjarðrøtt	síatkomandi
fjarhiti	síhiti
fjarhoyrdur	sífjarskotin
fjarlagdur	sífjarskotin
fjarlagin	sífjarskotin
fjarleið	sífiskileiðSamheiti:avbygd,avdalur,avkrókur,avland,avpláss,fjarbygd,úthorn↔avkrókur,fjarskotin
fjarleiki	sístrekki
fjarljós	sílampa
fjarlægur	sífjarskotin
fjaroygdur	síhugfjarur,hugsanarsamur
fjarrit	síboðan
fjarrita	síboða
fjarsemil	síboðan
fjarsettur	sífjarskotin
fjarskifti	sísamband
fjarskotin	Samheiti:avleiðis,avsíðis,avvegis,burturfrá,einsleingis,einsliga,einsligur,einsæris,fjarhoyrdur,fjarlagdur,fjarlagin,fjarlægur,fjarsettur,fjarstaddur,fjarur,handarlaga,kloykt,uttari,uttarlaga,uttast,uttastur,ytri,ytst,ytsturfyri seg sjálvan;í fjarleikanum, fjarsýni;langt av landi, leið skotin;langt burtur(i);langt úr landi↔avbyrgdur,avkrókur,fiskileið,fjarleið,krógvaður,strekki,uttaná,uttansyndis
fjarskygdur	síblindur
fjarskygni	síblindleiki,eyga
fjarskyldur	síættaður
fjarstaddur	sífjarskotin,hugfjarur
fjarstýrdur	sísjálvvirkandi
fjarstøða	sístrekki
fjartøkin	sífólkaskýggin
fjarur	sífjarskotin,hugfjarur
fjas	síástarlív,dáragerð,ítriv,ljóð
fjasa	sífjákast,fríggja,letast,putla
fjasamikil	síófriðarligur
fjasan	síítriv,ljóð
fjasarulkur	sísigarett
fjasast	sífríggja,letast,putla
fjatla	sídreiva,fuglur,leita,putla
fjatlast	síputla
fják	síbýttlingur,dáragerð
fjáka	sífjákast
fjákalátur	sískellilátur
fjákalótir	sídáragerð,hykl,lótir
fjákast	Samheiti:fjantast,fjasa,fjáka,glentast,hóreiggja,keipa,skemta,skørtaapa, skapa seg, sær;bara sita og gapa og gálva, gera stúkállar;bera seg at sum tað ið býtt er;bera seg barnsliga, býttisliga, fjákut at;hava fár á sær;hava, sýna býttisligan, fjákutan, skaputan atburð;hóreiggja, keipa sær;ganga, leika í sum ein fávitska, eitt býtt;gera keipur;sita og koksa t.e. láta við kroppinum;spæla býtt, býttur;vera sum børnini;□nú er fárakæti(ð) á honum, komið á hann;nú eru fáralótini, fárini á honum, komin á hann;tað er bæði láturligt og grátuligt, ikki at flenna at↔barnaskapur,býttisskapur,býttlingur,dáragerð,lótir,tápuligur,uppgjørdur
fjákavesin	sídáragerð,hykl
fjákutur	sítápuligur,uppgjørdur
fjálga	síhita,passa
fjálgan	síhiti,viðgerð
fjálgur	síheitur
fjáltra	sírista
fjáltraður	síbangin
fjáltrutur	síbangin,skundmikil
fjáltur	síristing,ræðsla
fjálturkendur	síbangin
fjálturskotin	síbangin
fjálturstungin	síbangin
fjálva	síhita,passa
fjendin	síSátan
fjeppast	síhamast,tráa
fjeppin	síáhugaður
fjetur	sífjøtur
fjón	síhatur
fjóna	síreka úr starvi,spotta
fjónaður	síavlagdur,frákoyrdur
fjórburi	sískyldfólk
fjórbýti	síbýti
fjórðingsbýti	síbýti
fjórðingsleypur	síkassi
fjórðingsmál	síkassi
fjórðingssáta	síhoyggj
fjórðingur	síluteind
fjórðungur	síluteind
fjórfaldur	sífleirfaldur
fjórhyrningur	sífýrkantur
fjórhyrntur	sífýrkantur
fjórir	síárrisin,grulva
fjórtoymi	síross
fjós	síbygningur,spik
fjósdyr	síinngongd
fjóshurð	sílok
fjóshøna	sífuglur
fjósklæði(r)	síklæði(r)
fjósluktur	síluktur
fjósrenna	síá
fjósroykur	síluktur
fjósskammil	sísessur
fjóstøð	síkøstatøð
fjósveggur	síveggur
fjøður	sískrúvugangur
fjøðurhamur	síhúð,klæði(r)
fjøðursárur	sífjaðrast,frísutur,sárur
fjøðurseyming	síseyming
fjøðurtari	sítari
fjøðurtættur	sítættur
fjøgga	síótrivavætti
fjøggur	síkloddakot
fjøggutur	síilla ílatin
fjøkin	sírúmligur
fjøkjaligur	sífløktur
fjøl	síkvinna,sjófar,viður
fjølbrekaður	síbrekaður
fjølbroytni	Samheiti:fjølleiki,margfeldi↔fjølbroyttur,óvanligur,umskiftiligur
fjølbroyttur	Samheiti:alskyns,fjølgreindur,fjølkynjaður,fjøllyndur,fjøllyntur,fjølmentaður,fjølstrendur,fjøltáttaður,fjøltýddur,margbroyttur,margháttaður,marghøvdaður,margkynjaður,margliðaður,margtáttaður,margtýddur,misjavnur,skiftandi,víðfarin,víðfatandi,víðfevndur,víðgreindur,víðsveimin,víðtøkin,víðtøkur,ymis,ymisháttaður,ymiskur,ymisligur,ymissur,ymisvorðin↔annarleiðis,broyting,fjølbroytni,mislyntur,óvanligur,umskiftiligurAndheiti:einsljóðandi
fjølbygdur	síavtakin
fjøld	sínøgd
fjøldin	síhvør einasti,meginpartur
fjølframleiðsla	síframleiðsla
fjølfrøðingur	sífróðarmaður
fjølga	síleggja afturat,nørast
fjølgast	sínørast,størrast
fjølgongdur	síniðurtraðkaður
fjølgreindur	sífjølbroyttur
fjølkunna	sígandur
fjølkunnugur	síganda
fjølkynjaður	sífjølbroyttur
fjølleiki	sífjølbroytni
fjøllittur	síprikkutur
fjøllítil	sísmáur
fjøllyndur	sífjølbroyttur,mislyntur
fjøllyntur	símislyntur
fjølmangur	sínógvur
fjølmenni	sínøgd
fjølmentaður	sífjølbroyttur,lærdur
fjølmentur	sífullmannaður,nógvur
fjølmiðil	síboðberi
fjølmiðla	síboða
fjølmikið	síógvuliga
fjølmæli	síillgruni
fjølrita	síendurgeva
fjølsamskifti	sísamband
fjølstrendur	sífjølbroyttur,tríkantur
fjølstrentur	sítríkantur
fjøltáttaður	sífjølbroyttur
fjøltýddur	sífjølbroyttur
fjøppast	síhamast
fjøppin	síáhugaður
fjøra	sístrondSamheiti:fjara,flidnafjøra,flóðfall,gøfjøra,háfjøra,kyrindasjógvur,kyrindi,kyrrindasjógvur,kyrrindi,meginfjøra,megin fjøra,mysingarfjøra,streymfjøra,sundafjøra,torrafjøra,turrfjøra,útdrag,várfjøraflóð og fjøra;hægsta fjara, fjøra;høg fjøra;stór fjara, fjøra;á hægstu fjøru;á megnari fjøru;í fjaruni t.e. á fjøru(fjara)fjara turrur;fjara út;fallandi, fjarandi sjógvur;□hann fjarar sjógvin;nú, tað fjarar;tað fløðir og fjarar(fjaraður)fullfjarað,fullfjaraður,hálvfjarað,hálvfjaraður,megin,turrfjaraður,útfjaraðfjaraður, fullfjaraður sjógvur;fjaraður uppi;á fjaraðum, hálvfjaraðum sjógvi;□fjøran er megin;flóðin er (næstan) niðurfallin;tað er fjarað, útfjarað↔flóðAndheiti:flóð
fjørbrot	sídeyði
fjørðfart	síatkomandi
fjørður	Samheiti:deyðavatn,deyðavatnsfjørður,farsund,flógvi,geil,innfjørður,kyrrufjørður,kyrrupláss,miðfjørður,mittfjørður,rimil,streymfjørður,sund,trongiinni á deyðavatni(havn)akkersgrunnur,bátahylur,bátahavn,bingjuhavn,fríhavn,grindavág,havnarlag,hvalrakstur,hvalvág,hvalvágur,høvn,kós,kyrruvík,lega,maki,neyðhavn,pollur,red,skipahavn,skipalega,útflutningshavn,úthavn,vág,vágsbotnur,vágur,vetrarhavn,vetrarlegagóður, ringur akkersbotnur(vík)bugur,bukt,innvik,innviki,kelkur,lón,viki,víkarlag,víkarskapilsi↔bládýpi,bryggja,fiskileið,hav
fjørubakki	síbakki,strond
fjørubrestur	síljóð
fjørufiskur	sífiskur
fjørugarður	sígarður
fjørugrátítlingur	sífuglur
fjørugrót	sígrót
fjørukona	síævintýrhugtak
fjørulógv	sífuglur
fjørumatur	símatur
fjørusandur	sígrót
fjøruseyður	síseyður
fjørusjóð	síljóð
fjøruslætt	síflatur
fjørusteinur	sígrót
fjørutjaldur	sífuglur
fjørutrøll	síævintýrhugtak
fjøruturrur	síturrur
fjøs	sífløkja,ótrivavætti,vavstur
fjøsi	sífløkja,ótrivavætti,vavstur
fjøsismikil	síhovin
fjøss	síkloddakot
fjøssa	símøsna
fjøsutur	sífrísutur,illa ílatin
fjøtra	síbinda,ganda,hugtaka,kúga
fjøtraður	sífastur
fjøtur	Samheiti:band,bóghaft,bógvhaft,fjetur,fótfjøtur,handjarn,leinkja,jarn,jarnband,kyrringarfjøl,kyrringarrim,køkingarfjøl,køkingarrim,køkingartræ(tjóður)boð,teymur↔keta
flabbi	símunnur
flag	Samheiti:avgrevstrarflag,avgrevstur,bakkatorva,bøkkur,flagbøkkur,flagtorva,flak,forutorva,garðatorva,gosbøkkur,grasbøkkur,hvannabøkkur,hvannatorva,kráarflag,plógtorva,mønuflag,mønutorva,reinaflag,síðuflag,skjaki,skjakatorva,støkkingarbøkkur,takflag,torva,tyrvingarflaggott, ringt flagfeingi↔mold
flaga	síbjølga,dyrka,leggja á,stikla steinar,storma
flagbyrgja	síkjala
flagbøkkur	síflag
flagd	síævintýrhugtak
flagdaskáli	síævintýrhugtak
flagdkona	síævintýrhugtak
flagepli	síepli
flagfeingi	síflag
flagg	síeyðkenni
flagga	símánasjúka,stikla steinar;flagga fyri e-m;flagga í hálvari, fullari stong,flagga lágthava flaggið á stong, uppi;□fløggini blaktra, bleiktra, leiftra, veittra o.fl.
flagga lágt	síflagga
flaggarður	sígarður
flaggberi	síoddamaður
flaggboya	síbløðra
flaggdagshald	síhátíð,veitsluhald
flaggdagur	síhátíð
flaggingin	síbatnaður
flagglína	síband
flaggrevstur	sídyrking
flaggrógvin	síbatnaður
flaggskip	sísjófar
flaggskrýddur	sípyntaður
flagreyv	sílatur
flagsa	síflúgva,førka
flagskurður	sídyrking
flagsutur	sífrísutur,illa ílatin
flagtak	sítekja
flagtaktur	síleggja á
flagtekja	sítekja
flagtorva	síflag
flagveggur	síveggur
flagvelta	sídyrka,jarðarstykki
flagvelting	sídyrking
flak	síflag,toft
flakaførur	sítilkomin
flakaskering	sískering
flakaskurður	sískering
flakatrolari	sísjófar
flakavirki	síverkstaður
flakførur	sítilkomin
flaki	síkavi,lag,sjófar,toft
flakka	síferðast,ganga,stikla steinar
flakkandi	síheimleysur
flakkari	sírekavætti
flakna	sírapa,søkka
flaknaður	síniðurdottin
flakningur	sífiskur
flakr	síillgruni,vindur
flakra	síflúgva,førka,stikla steinar
flana	síflogsa,leyslyntur persónur
flangra	síflúgva,førka
flanóður	sívreiður
flata	síflata niður
flatalendi	síjarðarstykki
flata niður	Samheiti:bóla,flata,flekja,javna,legsa,slættabóla, fella, javna, leggja, legsa, rassa, slætta, traðka, vevja niður;fáa at liggja;flata, slætta niður, útum;gera javnan, javnari, slættan, slættari o.fl.;javna, slætta e-t við jørðina;leggja flatan;legsa niður;vevja niður;□grasið er bólað niður, liggur á bóli(flekja (seg) útum)breiða seg;gera seg breiðan↔avtofta,avtoftaður,beinka,falla,flatur,kollvelta,niðurdottin,niðurtraðkaður,søkkaAndheiti:reisa
flatatekning	símynd
flatborur	síborur
flatbotnaður bátur	sísjófar
flatfiskur	sífiskur
flatgjørð	síringur
flatgyrði	síviður
flati	síjarðarstykki,veggurSamheiti:ánám,ánámi,flatsíða,viðberaflatiflatur endi, fløt síða↔flatur,veggur
flatlendi	síjarðarstykki
flatmynd	símynd
flatna	sísøkka
flatnaður	síniðurdottin
flatnalendi	síjarðarstykki
flatnavelta	síjarðarstykki
flatnavelting	sídyrking
flatsíða	síflati,veggur
flatstøð	síbryggja
flattalendi	síjarðarstykki
flatur	síjarðarstykkiSamheiti:alslættur,avjavnaður,áflatur,beinur,fjøruslætt,fláur,gólvslættur,jarðslættur,javnslættur,javnur,slættlendur,slættur(lágligur)láglendurnoðin og snoðin;(slættur) sum gólvið;snøggur og slættur;○sum skráar líðandi;□tað er sum á gólvinum↔falla,flata niður,flati,kollvelta,niðarlaga,niðurdottin,niðurtraðkaður,vatnrætturAndheiti:hallur,ójavnur,rukkutur
flatvegin	sívatnrættur
flatvegis	sívatnrættur
flá	sílag
fláa	sígera skráan,koyra uttanav
fláartorva	síbrenni
flábátur	sísjófar
flái	síhalli,rók
fláka	síførka
flákr	sírekavætti
flákra	síflúgva,førka
flána	sígisna,søkka
fláur	síflatur
fleima	sísmikra
fleimandi	sísmikrandi
fleinging	síduk
fleingja	síberja,duk
fleirfalda	sírokna
fleirfaldur	sínógvurSamheiti:dupultur,døpul,døpult,samanlagdur,tveytráðað,tvinnanda,tvinnandi,tvíbakað,tvíballaður,tvífaldaður,tvífaldur,tvíflættaður,tvíhvølvdur,tvílagdur,tvískrokkaður,tvísporaður,tvítáttaður,tvítrátt,tvítætturdupult so, tvey so, tvífalt so breiður, høgur, langur, nógvur o.fl.;helmingin, helvtina dýrari, fleiri, longri, størri o.fl.;í tveimum;tvífalt samanlagdur;tvær ferðir, reisir, reisur so...(hálva aðru ferð so...)eina helvt afturat;hálva aðru ferð tað;helmingin, helvtina afturat(trífaldur)trídupultur,trífaldaður,tríflættaður,trísligin,trítáttaður,trítráðað,trítrátt(fjórfaldur)ferfaldur,margfaldur,sekstrátt(fimmfaldur, seksfaldur, sjeyfaldur o.fl.)flerir ferðir so...;mangt slíkt↔par
fleirgudatrúgv	síátrúni
fleiri	símeginpartur
fleiristaðni	síallastaðni
fleirtølin	síganda
flekiknívur	síknívur
fleking	sískering
flekingarknívur	síknívur
flekja	síflata niður,kuta
flekjandi	sítilkomin
flekka	síneyt
flekkur	síblettur,Sátan
flekkutur	sílitaður,prikkutur
flenn	síflennibítur,skellilátur
flenna	síflennibítur,leyslyntur persónur,smílast
flennan	sískellilátur
flennibiti	síflennibítur
flennibítur	Samheiti:fáragudda,flenn,flenna,flennibiti,flennifyl,grínibítur,láturfressur,neggilær,neggjasum er argur at flenna, grína, sum hevur stutt til láturs;sum er skjótsmírin, hevur flenningarhug(tannglenningur)tannglettursum glettir á tonn, skelkir, sum vísir tenn↔halda gleim,láturmildur,skellilátur,smílast
flennifyl	síflennibítur
flenningarhugur	sígleði
flensa	síkoyra uttanav,kuta
flepra	síbiðla,gráta,leyslyntur persónur,royna
fleprast	síbiðla,royna
flerra	síkvennskøp,sár
fles	sísker,tríalingur,útlinja
flesk	sífitievni
fleskabiti	sífitievni
flestallir	símeginpartur
flestastaðni	síallastaðni
flestur	símeginpartur
flestustaðni	síallastaðni
flet	síseingjarstaður
fletta	síavlíva,koyra uttanav,kryvja
fletting	síkryvjing
flettingarknívur	síknívur
flettingarlamb	síseyður
fleyg	síbakkagonga
fleyga	Samheiti:bera,neta,netfesta,netja,ørfleygabera (stong) eftir fugli;bera upp;bera upp á lám;bera uppfyri;fara, ganga, vera á fleyg;fáa fugl at netjast;fleyga havhest, lomviga, lunda, náta o.fl.;fleyga heimafleyg;fleyga, taka, veiða fugl;halda (stongina) út;henda (stongina) inn;kasta um arm;leggja út;lofta lomviga;sita í snarafleyggj;søkja lomvigafleyggj;taka á flogi;taka í omanfleyg, omanfleyggj;taka niðurav(vera eftir fugli)blóðræna,fanga,fygla,glúpa,kevja,nabba,oyðræna,ræna,veiða,vera til bakkadraga, fleyga dimmilunda;draga (líra, lunda);draga, taka dimmilíra, vera í dimmilíra;fara á fuglaveiði;fara eftir eggjum;fara, síga, taka omanbergs;fara, vera til bakka, bjarga, fugla(r);fara, vera til skarva(r);kevja gás;raka niður (rituungar);ræna omaneggja;røkja bjørgini;sláa havhest(aungar);sleingja fugl;stilla at;stilla lunda;søkja bakka, bjørgini;søkja lomviga, líra;taka egg;taka hellufugl;taka skarvsungar (í urð);veiða skarv;veiða við lokki, lokkudorg, lomvigasnaru, ritufelli o.fl.;vera burtur í bakka, bjørgunum;vera eftir fugli, hellufugli, lundapisum, rituungum, skørvum o.fl.;vera, stima eftir havhestaungum, nátaungum, nátungum(síga)reiggjahanga í lofti;missa reiggið;reiggja inn á rókina;síga niður;taka loft(handka seg)labba,lappahanda seg;taka seg (eftir bandi, bjálka o.fl.)(klintra)klintrast,klíva,kljúgva,klóra,klúgva,krøkjast,krøklast(lesa seg)hanga sum kráka í opnahjalli;hækka seg;lærlesa seg;nýta lesning;taka seg niður, upp(lina)gretta,lora,síga,strikageva eftir, geva út;lata e-n fáa meiri enda, línu;lata e-t gretta, síga o.fl.;lata, lina, lora, síga e-n niður (í bandi)(sita undir)halda eftir;halda í línuna;sita við;vera á línuni↔bakkagonga,fongur,veiða
fleygabyrur	sívindur
fleygafuglur	sífuglur,geldingur
fleygagonga	síbakkagonga
fleygagul	sívindur
fleygalot	sívindur
fleygalundi	sífuglur
fleygamaður	síveiðimaður
fleyganáti	sífuglur
fleygapláss	sísessur,stað
fleygasessur	sísessur
fleygaætt	sívindur
fleyggj	síbakkagonga
fleyggja	síleyslyntur persónur,ótrivavætti
fleyging	síbakkagonga
fleygingarbátur	sísjófar
fleygingarmaður	síveiðimaður
fleygingarsessur	sísessur
fleygingarætt	sívindur
fleygisessur	sísessur
fleyr	síillgruni,vindur
fleyra	síklára í,storma
fleytadylla	síspann
flidnafjøra	sífjøra
flidnagjar	síagn
flidnaknívur	síknívur
flidnakyrra	sígóðveður
flidnamuddur	síknívur
flidnasker	sísker
flidnasoð	sívatn
flidnatomba	sítari
fliðra	sídáli,kuta,sár
fliðujarn	síknívur
fliðuknívur	síknívur
fliðuløgur	sívatn
fliðusoð	sívatn
flika	síbíta,kuta,sár
flikr	sífitievni,spik
flikur	sífitievni,spik
flindra	sísindur
flindur	sísindur
flingra	síblettur,grasvaksin blettur
flintur	sísindur
flippubrotsmaður	síbrotsmaður
flíggj	símunnur
flím	síivasemi,skálkaskjól
flís	sídáli,lag,sindur
flísa	síkuta
flísagrót	sígrót
flísalagdur	síleggja á
flísalím	síklistur
flísna	síflosna,missa skalið
flísutur	síójavnur
fljóð	síkvinna
fljótt	sískjótt
fljótur	sískjótførur
fljúga	síflúgva
fljúgva	síflúgva
flog	síflúgving,fræ,pína,veingjavídd
floganssnar	síband
flogálop	síálop
flogbátur	sísjófar
flogberi	sísjófar
flogblað	síboðan
flogboð	síboðan
flogboða	síboða
flogbreyt	sífarstøð,flogvøllur
flogbúgvin	sífloygdur
flogdjarvur	sídjarvur
flogdreki	síævintýrhugtak
flogdýpi	síbládýpi
flogfarahús	síbygningur
flogfarmur	sífarmur
flogfeitur	síhovin
flogfenaður	sídjór,fuglur
flogferð	síflúgving,túrur
flogferðaseðil	síváttan
flogferðsla	síflúgving,túrur
flogfiskur	sífiskur
flogfyl	síleyslyntur persónur
floggávaður	síklókur
flogharður	síveðurringur
floghavn	sífarstøð,flogvøllur
flogherur	síherlið
flogkendur	sísveimandi
flogklókur	síklókur
flogkvikur	sískjótførur
flogkykt	sídjór
flogleið	síferðaleið
flogmeis	síhár
flognæmi	sínæmi
flognæmur	sínæmur
flogpostur	sípakkapostur
flográn	sítvingsil
flogrit	síboðan,skriv
flogræddur	síbangin
flogrænari	sítjóvur
flogsa	síganga,leyslyntur persónurSamheiti:flana,slettastganga eftir, hanga uppi í, vera óð, ør eftir mannfólki;slettast uppi í hvørjum dreingi;vera flogsut, leys á nálini, leyslynt, útsveimin o.fl.;vera sum bukka, landbukka millum seingir, sengur;□hon er sum várull, (liggur og) sløðist allastaðni↔flogsutur,horast,leyslyntur persónur,óreglulív
flogsáð	sífræ
flogseðil	síboðan,skriv
flogskjótur	sískjótførur
flogsnarur	sískjótførur
flogstingur	sípína
flogstyggur	sístyggur
flogstøð	sífarstøð
flogsutur	Samheiti:leyslátaður,leyslyndur,leyslyntur,slettutur,útsveiminleys á nálini;□hon er sum bukka, landbukka millum seingir, sengur;hon er sum várull, (liggur og) sløðist allastaðni↔flogsa,horast,leyslyntur persónur,óreglulív,ósømiligur
flogtreystur	síarbeiðsførur
flogvel	síkvinna
flogvit	síklókskapur,vísmaður
flogvitigur	síklókur
flogvøllur	sífarstøð
flogøska	síøska
flokka	Samheiti:bólka,fylkjabýta, greina, skifta, skilja sundur í bólkar, flokkar;fylkja e-t, seg (í bólkar, fylki);leggja í bunkar fyri seg;skilja burturúr;skilja epli, fisk, ull o.fl.;skipa í bólkar, flokkar, fylkingar;taka burtur úr størri heild↔nágreina,flokkan,skilja,skiljing
flokkabýti	síflokkan
flokkadráttur	síósemja
flokkan	Samheiti:evnisskipan,flokkabýti,flokking,fylking,greining,sergreining,sundurgreining,sundurliðing↔allýsing,flokka,nágreina,skilja,skiljing
flokkast	síhópast
flokking	síflokkan
flokkur	síluteind,nøgd,skúlaflokkur
floksfelagi	sífelagslimur
floksfundur	sífundur
floksherji	síhermaður
flokshernaður	síkríggj
flokshøli	síhøli
flokslærari	sílærarafólk
floksmaður	sítjóvur
floksrúm	síhøli
floksting	sífundur
floksundirvísing	sífrálæring
flongdur	síavbardur
flosna	Samheiti:flísna,flusna,rakna,travna,travsast,trevsast,tægastdetta, losna sundur;flosna, loysast, rakna, trevsast upp(uppraknaður)upprakturí fillum, lepum o.fl.↔losna,ójavnur
flossi	símunnur
flot	síbløðra
flota	Samheiti:floytadraga, taka bát av lunni, á sjógv, oman;fara á flot;fara, leggja frá landi;fáa at flóta;flota, floyta, skjóta, skúgva bát;koyra, seta á flot;lata fara av, úr bakkastokki, barkastokki;seta bát á sjógv, út;skjóta bát frá landi, út↔fiska,flotna,flóta,siglaAndheiti:draga bát
flotadeild	síherlið
flotamálaráð	sívald
flotbrúgv	síbrúgv,bryggja
flotbúni	síklæði(r)
flotfiskur	sífiskur
floti	síherlið,kelda,nøgd,sjófar
flotkelda	síkelda
flotkúla	síbløðra
flotkøstur	sígoymsla
flotlína	síband
flotna	byrja, fara at flóta;fara upp á flot;flotna av (aftur);flotna, fløða út (á sjógv);flotna upp;koma undan kavi;koma uppundan(uppflotnaður)flotnaðurkomin undan kavi, upp↔flota,flóta
flotnaður	síflotna
flotoyggj	síævintýrhugtak
flotsteinur	sígrót
flottøð	síkøstatøð
flotvátur	sívátur
floy	sísjófar
floyfiskur	sífiskur
floygdur	Samheiti:flogbúgvin,fullfjaðraður,stinnfloygdur↔fjaðrast,flúgva,loðin,lættfloygdur
floyggja	sítveita
floyma	Samheiti:falla,flóta,fløða,fossa,hvella,oysa,renna,springa,spríkja,sprutta,streyma,stroyma,tysa,tysja,vellaflóta, renna um tremur, yvir;fløða upp um áarbakkarnar;marra (niður eftir...);springa, spríkja, vella uppúr (jørðini);vella fram, upp;□áin rennur yvir, svølgir ikki, leypur(standa á svølgi)standa á borð og breddar;standa upp á svølg;standa, vera á tremur;vera um at leypa↔áarføri,froysan,leka,skvagga,spræna,regna,vatna,ventilur
floymur	síáarføri,nøgd
floyt	síbríksl,skríggj
floyta	síbríksla,flota,flyta,lyfta,skríggja,vatna
floytifullur	síjavnstrokin,laðin
floytivátur	sívátur
flóð	síkvinnaSamheiti:háflóð,meginflóð,megin flóð,mysingarflóð,streymflóð,sundaflóð,trongdarflóðflóð og fjøra;fløddur, fullfløddur, háfløddur sjógvur;hægsta flóð;høg, stór flóð;á flóð(ini), háflóð(ini);á fullari, hálvari, megnari flóð(fløða)fløða undir;□nú, tað fløðir;tað er fløðandi sjógvur;tað fløðir og fjarar(fløddur)afturfløddur,fullfløddur,fullfløtt,háfløddur,hálvfløddur,hálvfløtt,megin,undirfløddur□flóðin er megin;tað er nógvur løgur í sjónum↔fjøraAndheiti:fjøra
flóðalda	sísjóvarilska
flóðarmáli	sístrond
flóðarsteinur	sígrót
flóðarveður	síregn
flóðaræl	síregn
flóðdreki	sísjófar
flóðfall	sífjøra
flóðfríur	Samheiti:brimfríur,sjófríur,turrfasturdrigin flóðfríur, niðanfrá;drigin, tikin framí, fram í lunnbótina, upp á land, lunn, turt;for í bakkanum, berginum, klettinum;leysur av briminum, flóðini, sjónum;uppi á landi, turrum;□báturin var drigin turrfastur, tikin fastur↔bátadráttur,draga bát
flóðgarður	sígarður
flóðvaska	síberja
flógv	sílag
flógva	síhita
flógvi	sífjørður,hiti,rók
flógvur	síheitur
flók	síótrivavætti
flókafyl	síross
flókaseyður	síseyður
flókaskýggj	sítoka
flókatrøll	síótrivavætti,seyður
flóki	síótrivavætti,toka,ull
flókur	sívánamaður
flókutur	síullaður
flóleiki	síhiti
flóligur	síheitur
flóna	síhitna
flónaður	síheitur
flóni	síhiti
flórdøttur	síneyt
flórgarðland	síkøstatøð
flórgarðrenna	síá
flórgarð(s)steinur	sígrót
flórgarður	sígarður
flórgrin	sískellilátur
flórgrína	sísmílast
flórgrøv	sígoymsla
flórland	síkøstatøð
flórur	sígoymsla
flósa	síloga
flóta	sífiska,floyma;flóta, liggja í vatnskorpuni;flóta omaná;halda sær flótandi, uppi;ikki søkka;vera á floti↔flota,flotna,kavstoytast,svimja,svimjing
flótandi	sílinur
flótta	sípara
flóttafólk	Samheiti:flóttafólkastreymur,flóttamaður,rýmingurein flýggjandi(útiløgumaður)skógarmaður,útiløgudrongurfriðleysur maður(útiseti)útfari,útiføroyingur(flóttafólkalega)fyribils lega hjá flóttafólki↔burturstaddur,fara,flyting,rýming,sleppa leysur
flóttafólkalega	síflóttafólk
flóttafólkastreymur	síflóttafólk
flóttamaður	síflóttafólk
flóttaroynd	sírýming
flótti	sírýming
flótur	sískjótførur
fluga	síhúkur
fluggur	síútlinja
flugugap	síbýttlingur
fluguskáp	sígoymsla
flugusurr	síljóð
flugutættur	síholutur,tættur
flukt	síárrisin,vreiður
flukta	síspæla bólt
flundra	sífiskur
flundruagn	síagn
flundrufiskur	sífiskur
flundrumið	sífiskileið
flundrutak	síátak
flus	síhinna,yvirflati
flusmógvur	símógvur
flusna	síflosna,missa skalið
flutningsband	Samheiti:renna,sliska,sloka(renningarstrongur)rennistrongur,togbreyt,torvtráður(lyfta)rennistólur(rullitrappa)rennitrappa↔flyta
flutningsbátur	sísjófar
flutningsfar	sísjófar
flutningsgjald	sígjald
flutningskeyp	sígjald
flutningsskip	sísjófar
flutningur	Samheiti:akstur,bilferðsla,bilkoyring,bingjuflutningur,brúðarkoyring,bukkukoyring,burtflutningur,burturflyting,burturkoyring,burturkoyrsla,far,farmaflutningur,ferðafólkaflutningur,ferjuflutningur,fiskaflutningur,fólkaflutningur,føra,føring,hálkukoyring,høgrakoyring,javnflyting,kongsflutningur,koyring,koyrsla,loftbrúgv,postflutningur,prestferð,prestflutningur,privatkoyring,rukkukoyring,ruskkoyring,rúsdrekkakoyring,skjútsferð,skjútsur,skúlakoyring,tilflutningur,torvføring,tyrluflutningur,útkoyring,vinstrakoyring,vøruflutningur↔flyta,flyting,túrur
fluttur	síburturstaddur
flúður	sísker
flúga	síflúgva
flúgva	síflyta,skunda særSamheiti:fljúga,fljúgva,flúga,keksa,larra,ringjafara á flog;fara flaksandi, keksandi, larrandi;flúgva í ring;flúgva tungliga, tungt;flúgva upp;lætta sær á;royna, spenna flogið, veingirnar;taka seg uppfrá;vera á flogi(sveima)leinkja,svívahanga á veingjunum;lofta sær;sveima um(svíva framvið)strúka framviðfara tætt framvið;(næstan ) bera við;súsa, svíða framvið(flagsa)flakra,flangra,flákra,flykra,kveistra,kveistrastblaka, sletta við veingjunum;blaka veingirnar;breiða veingirnar út;brenna salt;lamma, lemja seg;spenna sítt veingjaflog(gevast at flúgva)falla av, frá↔fjaðrast,floygdur,lenda,lættfloygdur,sveimandi,tyngdarloysi,veingjavídd
flúgvandi	sílandvegin,sveimandi
flúgving	Samheiti:ferðafólkaflúgving,flog,flogferð,flogferðsla,rúmdarferð,sigflog,tyrluflúgving↔farstøð,lenda,sigling
flúrur	sísker
flúrutur	síatgrunnur
flúsa	síloga
flykkjast	síhópast
flykra	síflúgva,førka,kava,kavi,sindur,stikla steinar
flykringur	síkavi
flykrukavi	síkavi
flyksa	síkava,kavi,stikla steinar
flyksingur	síkavi
flyksutur	síójavnur
flysa	síkoyra uttanav
flysja	síkoyra uttanav
flyta	síbaktala,doyggja,fara,førka,lasta,sigaSamheiti:ferja,føra,rógva,sigla,stima,skjútsaflyta e-t við ferju, føringarbáti, lossibáti, skipi o.fl.;rógva undir e-m;seta e-n um, yvir um fjørðin (við skjútsbáti);seta e-n yvirum;sigla við e-m(floyta)floyta eftir á(nni)(sunda)bátsrógva,sleipasunda aftur úr báti(flúgva)flyta e-t við flogfari, tyrlu o.fl.(koyra)flytja,flytta,føraflyta e-t við bili, toki o.fl.(reiða)lassaflyta, reiða e-t við klyvjarossi, reiðingarrossi, rossi(senda)flyta e-t við boði, posti o.fl.(sleða)draga, flyta e-t á sleðu, sletu (við hundi, rossi)(trilla)trilla e-t í, við børu o.fl↔flutningsband,flutningur,flyting
flytast	síførka,kastast
flytifuglur	sífuglur
flyting	Samheiti:atflutningur,burtflutningur,burturflyting,búflutningur,fólkaferð,fólkaferðing,fólkaflutningur,javnflyting,niðurflyting,peningaflutningur,peningaflyting,tilflutningur,tjóðflutningur,uppflyting,útflyting(framflutningur)uppflutningur↔burturstaddur,fara,flóttafólk,flutningur,flyta,rýming
flytingarløn	sígjald
flytja	síbaktala,doyggja,fara,flyta,førka,lasta
flytta	síbaktala,doyggja,fara,flyta,førka,lasta
flýggja	sífara,geva
flýggjaligur	sígóðsintur
flýggjan	sírýming
flæa	síbjølga
flærin	sísvikafullur
flæsa	sífiskur,koyra uttanav,kuta
flætta	síhárSamheiti:bregda,kerva,snara,tólvta,tólvtra,virkaflætta hár;gera flættu;gera, leggja tólvtráðaband;gera músatrappu;kerva saman;knýta (smøl) bond↔binda
fløa	síhita
fløddur	síflóð
fløða	sífloyma,flóð
fløðandi	sívaksandi
fløðing	sístreymur
fløðufall	sískjótt,streymur
fløga	sílag
fløgugingin	sísamankomin
fløgugrót	sígrót
fløguhoyggj	síhoyggj
fløguleir	sígrót
fløgurunnin	sísamankomin
fløguskýggj	sítoka
fløgusteinur	sígrót
fløkgreytur	sívavstur
fløkja	sídreiva,vavsturSamheiti:dreiv,døsi,døsil,egningarfløkja,fesil,fiskavasi,fjøs,fjøsi,føsil,hópakoming,hundaspýggja,kimbil,kisa,kishøvd,knørvald,kuril,rekil,skiparafløkja,søpil,søpul,tóskitja,uppgávugørtur,vasi↔blandaður,blandast,blandingur,dreiva,fløktur,vavstur
fløkjaliga	síóskilliga
fløkjaligur	sífløktur
fløkjasliga	síóskilliga
fløkjasligur	sífløktur
fløkjast	síblandast
fløkjudirðil	síótrivavætti
fløkjutur	sífløktur
fløkjuvasi	sívavstur
fløktur	síaldutur,frísuturSamheiti:blandaður,burturblandaður,fjøkjaligur,fløkjutur,frísaður,frísutur,føsilmikil,innispunnin,kisut,kisutur,ógreiddur,ógreiður,óskildur,rundveltur,samanblandaður,samandreivaður,samanfløktur,samankurlaður,samantvinnaður,samanvavdur,samanvovin,tvíbuktaður,tvørbuktaður,uppikastaður,uppkastaðurfløktur, koyrdur upp í ein døsa, vasa;hvørt um annað;í blandi;komið í hóp (við e-t), til hópar;komin í bland, fløkju, hurlivasa, nokkasnúður, trol o.fl.;so fløkt sum eitt hømiliutyssi;vavdur upp í eina fløkju, ein ellubita;□alt er av lagið, blandað, fløkt, í fløkju, ólagi o.fl.;alt er fesjað, rutlað, rørt, svansað, tvinnað, vavt saman;alt er í einari hópakoming, hundaspýggju, skiparafløkju o.fl.;alt í einum dreivi, hurlivasa, ruðuleika, søpli, vasa, vavgreyti o.fl.;alt er tveitt í eina hyrnirúgvu;beitan er komin upp í bøll, rulk, hongur uppi á nevi, uppi í bølli;brøkur, fløkja, frensur, kiska, sekt, sperðil o.fl. er (komin) í;eg finni, síggi hvørki høvur ella hala á hesum;har er, liggur hvørt um annað;har kom tvískinningur í;har vendir alt upp og niður;hetta er hvørki eitt ella annað, hitt ella hatta, líkt ella ólíkt;hetta líkist ongum;tað er hvørki fuglur ella fiskur, rátt ella soðið, soð ella súpan;tað er sum í Runsival;tað liggur í leggbragði;tað sum vendi niður vendir upp;tað sæst ikki hvat er upp og hvat er niður (á hesum)(loyndarfullur)dularfullur,duldarfullur,duldur,fjaldur,gátuførur,heimiligur,huldur,loyndarmikil,loyndarsamur,loyndur,loyniligur,loynisamur,løgin,margháttligur,merkiligur,ófatandi,ófatiligur,ókendur,ónevndur,skjóldur,torgitin,undarligur□e-t er blint, dult, ókent o.fl. fyri e-m;mangt er forborgið;tað er meira millum himmal og jørð enn...(óskiljandi)ballutur,dreivutur,fløkjaligur,fløkjasligur,fløktur,kronglutur,krutlutur,ógitandi,ógitin,ógittur,ógreiðandi,ógreiðiligur,ógreiðsamligur,ógreiðsamsligur,ógreiður,ógreiniligur,ókanniligur,óloysandi,óloystur,órannsakandi,órannsakiligur,óráðiligur,óskiljandi,óskilligur,óyvirlítandi,óyvirsýniligur,samansettur,torgreiddur,torlisin,torloystur,torsagdur,torskildur,torskilin,tortýddur,trupul,trupulsligur,tunglisin,tvørnæmur,villandi,villingarsamur,ørkymlandiikki beingongdur;ikki til at greiða, loysa, ráða, týða;ikki til at, ringur, torførur, trupul at fata, læra, skilja o.fl.;□e-t er fløkt upp í, innflættað, innvavt í e-t(kámur)fáleittur,fáligur,hálvkámur,kámleittur,kámligur,kámutur,kornutur,óblankur,ógreiður,ókenniligur,óklárur,ólesandi,ólesiligur,óskiljandi,óskilligur,óskyggin,ótýðiligur,sorlutur,sorutur,támur,támutur,torkendur,torsæddurhuldur av, í...;ikki gjøgnumskygdur;□tað sæst ikki ígjøgnum;tað sæst botnur á "stykki vatn"↔blandaður,blandast,blandingur,dreiva,fløkja,krógvaður,óskilliga,óskipaður,vavstur,villastAndheiti:greiður,nákvæmur,opinberur
flørgrin	sískellilátur
fløska	Samheiti:boppufløska,borðfløska,bøllufløska,drekkafløska,dropaglas,gassfløska,gosfløska,hitafløska,killari,killur,landfløska,leðurfløska,likkari,luktilsisglas,lummafløska,lummaglas,lýsifløska,mjólkarfløska,peglafløska,pisa,pottafløska,rekafløska,rommfløska,stubbafløska,súrevnisfløska,tátufløska,trípeglafløska,tvípottafløska,varmafløska,vínfløska,æðrafløska,ølfløska(glas)hálvpeglaglas,krystallglas,kvartaglas,peglaglas,skeinkiglas,triðingsglas,vatnglas,vínglas,ølglas(krukka)alabasturkrukka,glaskrukka,haldakrukka,leirkrukka,rómakrukka,smørkrukka(vasi)blomsturvasi,blómuvasi↔kassi,pottur,rúsdrekka,spann,trog
fløskubrot	síglas
fløskugass	síbrenni
fløskuglas	síglas
fløskupostur	sípakkapostur,strandvarp
fløskutættur	sítættur
fløt	sífitievni,smelt
fløta	sífiskur,jarðarstykki
fløtbrá	sísmelt
fløtljós	sílampa
fløtpottur	sípottur
fløttálg	sífitievni
fløttur	sígrasvaksin blettur,jarðarstykki
fløva	síhita
fløvan	síhiti
fløvandi	síuggandi
fløvi	síhiti
fok	sírokilsi
fokin	síglataður,smittaður
fokka	sísegl
fokkaður	síútmøddur
fokkast	síarbeiða
fokkavi	síkavi
fokn	símótvilji,smædni
foksandur	sígrót
fola	sínørast
fold	sígrøði,verøld
folda	síeydnast
foldarligur	síforgeingiligur
foldarlív	sígerandislív
foli	síross,tjóvagóðs
fon	sísindur
fona	sískunda sær
fonandi hvítt	sílitaður
fongd	Samheiti:smitta,tuberklasmitta,smittuevni(smittuleið)smittuberi,smittukelda(smittuvandi)smittubreiðsla(ovurviðkvæmi)vantandi mótstøðuføri (ímóti ávísum evnum)↔bruni,feingin,feingja,órin,sjúka,sjúkur,smittaður
fongdur	sísmittaður
fongfrøi	sígleði
fonglast	síleita,putla
fonglítil	síbíligur
fongríkur	síúrtøkugóður
fongsamur	síúrtøkugóður
fongsla	sísita í fongsli
fongslaður	síavbyrgdur
fongslast	síleita,putla
fongsling	sífongsul
fongsul	Samheiti:brumma,fangabúr,fangahús,fangahøli,fangaklivi,fangalega,fangarúm,fangatippi,fangatorn,gegl,hol,steinstova,tippi,torn(betranarhús)tukthús(týningarlega)týningartippi(fangaseta)bráðhald,fangilsi,fastseting,fongsling,fongsulsseta,trygdarvarðhald,varðhaldbráðfeingis varðhald(handtøka)fongsling,varðhaldsfongsling(avbyrging)byrging,frábyrging,innibyrging,innilæsing,innisteinging,steinging↔fangi,revsing,sita í fongsli,tykta
fongsulsrevsing	sírevsing
fongsulsseta	sífongsul
fongur	sídygdSamheiti:bráð,fang,fáningur,feigdarfongur,fiskafongur,fiskiveiða,fuglaveiða,giti,heildarveiða,herfang,herfongur,herveiða,hjáveiða,kast,rokfiskiskapur,rokveiða,sjófleyg,sjófongur,stórveiða,tilløga,upptøka,veiða,veiði,veiðing,vinningurgott legg, góð seta, góður rakstur o.fl.(kvett)heppibragd,kubb,pis,roff,roktúrur,skrædl,tøgg□hetta var vorðið sum grind (t.e. fongur, innløga, slakt) at fáa↔bakkagonga,fiska,fiskiskapur,fleyga,veiða,veiðing
fonhvítur	sílitaður
fonlættur	sílættur
fonn	síkavi,skúm
for	sílúkst,skarð
fora	sídyrka,órógva,skarð
foragn	síagn
forarga	síarga
forargaður	sívreiður
forargiligur	síargingarsamur
forargilsi	síargapetti,ræðumynd
forbankað	síógvuliga
forbankaður	símannvándur
forbannaður	símannvándur
forbanniligur	símannvándur
forbannilsi	síbannan,ólagna
forbardur	síveðurbardur
forbeiggjaður	símannvándur
forberg	síberg
forbiðið	síógvuliga
forbiðin	símannvándur
forbjóða	Samheiti:banna,fimta,forða,lógbanna,meina,neikta,nokta,synja,sýta,tvørnoktabanna við lóg;einki, ikki vilja at...;forða, nokta, sýta o.fl. e-m;gera, geva, leggja, seta forboð (fyri);lýsa bann fyri;lýsa sølubann;rista við høvdinum;seta bann, forboð fyri;siga, svara kortanei, korta nei, nei, tvørt nei(mæla frá)avráða,ráða frábiðja e-n lata vera;biðja e-n um ikki at...;eggja e-m frá at...;fáa, tala e-n frá at...;gera, geva frámæli, koma við frámæli;mæla ímóti, undan↔forboð,friða,friður,galdandi,lóg,nokta,noktan,ólógligur,seta í gildi,skipanarloysiAndheiti:loyva
forboð	Samheiti:albann,bann,farbann,fimt,fútabann,fútaforboð,handilsbann,handilsstongsil,innflutningsbann,landingarbann,leikbann,lógbann,stongsil,sølubann,útflutningsbann,útgongubann,veiðibannfullkomið bann↔forbjóða,friða,friður,galdandi,lóg,nokta,noktan,ólógligur,seta í gildi,skipanarloysiAndheiti:rættindi
forboðin	sífriða,ólógligur
forborgin	síóvanligur
forbókstavur	síbókstavur
forbrendur	símannvándur
forbrongla	síboyggja
forbøllaður	símannvándur
forbøn	síbønarhald,verja annan
fordánt	síog so framvegis
fordómaleysur	sífrílyntur
fordómur	sísannføring
fordrógvaður	símannvándur
fordøma	síbannseta,lasta,vanda
fordøming	sídómur
forða	síbjarga,forbjóða,hindra,verja
forðaður	sídarvaður,hindraður (í at...)
forðan	síhindur
forðarenning	sírenning
forðing	síhindur
forðum	sífyrr
foreintur	sínøgdur
foreldrafundur	sífundur
foreldraleysur	síeinsamallur
foreldur	sískyldfólk
forelskaður	síásttikin
forendi	síoddur
forfaðir	sískyldfólk
forfall	síhindur,ólagna
forfang	síhindur
forfarast	síoyðileggjast
forfardur	síbangin
forfedrar	sískyldfólk
forfesti	síískoyti
forfjóna	síreka úr starvi,spotta
forfjónaður	síavlagdur,einsamallur,frákoyrdur,spottaður
forfjøl	síútlinja
forfumma	síspilla fyri sær
forfylging	síelting
forfylgja	síjagstra
forfylgjan	síelting
forganga	síoyðileggjast
forgangari	síbløðra
forgarður	sítún
forgeingiligur	Samheiti:deyðiligur,fáfeingiligur,fáfongdur,tímaligur,tímiligur(veraldligur)foldarligur,jarðarbundin,jarðarligur,jarðbundin,jarðgrógvin,jarðiskur,jarðligur,moldbundin,veraldarligur,veraldligur,verðsligurav hesum heimi↔likamligur,ófeigurAndheiti:varandi,yvirjarðligur
forgera	síoyðsla burtur
forgera sær	síavlíva
forgjúaður	símannvándur
forgjúgvaður	símannvándur
forgjørdur	síganda,mannvándur
forgongurættur	sírættindi
forgreiðsla	síforskot
forgróður	sígróðurnál
forgyltur	sígyltur
forgøvgaður	síforkela
forhang	Samheiti:duratjald,dúkur,fortjald,fyriklæði,gardina,gluggaklæði,gluggaskeyti,gluggatjald,kappi,myrkingartjald,rimatjald,rullugardina,sparlak,teppi,tjald,tjaldváð,umhang,vindeygastykki,vindeygatjald↔teppi
forharmaður	sísorgarbundin
forhánisliga	Samheiti:háðandi,háðiliga,háðliga,háðuliga,hánisliga,hánliga,speiliga,speirekandi,spotskliga,spottandi,vanvirðisligaupp á háð;upp á spott;upp í háð;við háðandi, spottandi smíli, yvirbragdi o.fl.;við speisemi↔arga,arging,argingarsamur,eyðmýking,eyðmýkja,hugsæra,ósmidliga,spotta,spottaður,spottari,spottorð,vanæruligurAndheiti:høviskliga
forhánisligur	sívanæruligur
forherðaður	símannvándur
forherðilsi	síótangi
forherðing	sítvørlyndi
forherðingur	síótangi
forhoyr	síspurningur
forhoyra	sítráspyrja
forhøll	síhøli
fori	síjarðarstykki
forkanning	síkanning
forkapping	síkapping
forkela	Samheiti:spillageva (e-m) eftirlæti;spilla við eftirlætum(forkelaður)fínlátin,fínlátur,forgøvgaður,heimakelaður,heimaspiltur,spilturspiltur av, við eftirlæti, eftirlætum;□hann er ein forkelaður lortungi↔eftirlíka,eftirlæti,kelivætti,kræsin,kventil,kventlutur
forkelaður	síforkela
forkeypa	síspilla fyri sær
forkeypsrættur	sírættindi
forkirkja	síhøli
forklaga	síslatra
forkolaður	símannvándur
forkoma	síknúsa,lorka burtur,oyðsla burtur
forkroystur	síbangin
forkunnigur	sísjáldsamur
forkunnleiki	síklókskapur
forkunnugur	sísjáldsamur
forkutur	síóskapiligur
forkøkur	síhøli
forlag	sílagna
forlagatungur	sísvárur
forláta	sífyrigeva
forlátilsi	sífyrigeving
forleikur	síinngangsorð
forligheit	sísemja
forliptur	síásttikin
forljóð	síinngangsorð,sangur
forlova	síbiðla,spilla fyri sær
forlovaður	síbiðla
forlovari	síáskoðari
forlovilsi	sítrúloving
forlovilsismaður	síáskoðari
forløg	sílagna
forma	Samheiti:evna,formgeva,forsniða,gera,haga,laga,mynda,skaffa,skapa,skikka,skøffa,sniða,sniðgeva,sniðskapa,sníðafáa at passa, sita;geva skap, snið;haga, evna, forma, skøffa e-t til;seta saman;skera til(snikka)fínka,hampa,snidra,snota,snotra,snøgga,telgja↔endurskapa,formskipa,formur,kuta,pynta,skera út,skikkaður
formaður	síoddamaður
formana	sítykta
formaning	sífrálæring,uppaling
formansbátur	sísjófar
formanspallur	síhækkað gólv,sessur
formanspartur	sípartur
formanssessur	sísessur
formansskapur	sívald
formansval	síval
formáa	símegna
formálamikil	síseinpjakutur
formáli	síinngangsorð
formbroyting	síbroyting
formelda	síspilla fyri sær
formerkja	síuppliva
formgeva	síforma
formlist	sílist
formóðir	sískyldfólk
formskipa	fáa í fasta legu;fáa í fastan form;gera reglur fyri;leggja til rættis;skipa í...↔formaAndheiti:dreiva
formskrift	sískrift
formur	síútsjóndSamheiti:bakiformur,breyðformur,hosutræ,hólkalag,húkaformur,jarnleistur,kakuformur,kambalag,kambastólur,karðalag,knappaformur,kúluformur,leistur,ljósaformur,maljuformur,naglajarn,ostafarg,ostaformur,ostakoppur,ostkista,pilkaformur,randarformur,randformur,seymaløð,seymlað,seymløð,skabilkhøvd,slíðratræ,spónalag(naglalag)onglalag,tindakelvi,tindalag↔forma,fyridømi
formæli	síinngangsorð
fornaldarligur	síaldrandi,avlagdur
fornaldarsøga	sífrásøgn
fornatálg	sífitievni
fornavn	sínavn,orð
fornbókabúð	sísølubúð
fornbræv	sískriv
fornbrævasavn	sígoymsla
fornfedrar	sískyldfólk
fornfólk	sígamalmenni
fornføroyskur	síføroyskur
forngripagoymsla	sígoymsla
forngripasavn	sígoymsla
forngripur	sífornminni
forni	síjarðarstykki
fornkirkja	síkirkja
fornklássa	síaldrandi
fornklæddur	síilla ílatin
fornkvæði	sísangur
fornleivd	sífornminni
fornligur	síaldrandi,avlagdur
fornlutur	sífornminni
fornmál	sítungumál
fornmentir	símentan
fornminni	Samheiti:forngripur,fornleivd,fornlutur,fornrit,fornskjal,jarðarfundur,savngripur,skriftminni,steinaldarhús,søguminnigamal gripur;jarðfunnið fæ;jarðfunnin lutur↔aldrandi,eldast,ellisár,gamalmenni
fornminnissavn	sígoymsla
fornplagg	síkloddakot
fornrit	sífornminni,skriv
fornskjal	sífornminni
fornskógvur	síkloddakot
fornsøga	sífrásøgn
fornur	síaldrandi,avlagdur,eftirsíggin,niðurdottin
fororð	síinngangsorð
fororða	síspilla fyri sær
forpallur	síhækkað gólv
forpilkaður	síruddiligur
forpøstur	síútmøddur
forrendur	símannvándur,nipin
forrenna	síspilla fyri sær
forræði	síhindur,valdSamheiti:óføri,óføristorva,ótøka,ótøki,skorfesti,svølti,vargapláss↔berg,fjall,grasvaksin blettur,uppikastaður
forræðisgarður	sígarður
forrættindi	sírættindi
forrættur	sírættindi
forsagdur	síbangin
forsangari	sísangari
forsdyr	síhøli
forsegl	sísegl
forsendi	síband
forsending	síinngangsorð
forseta	sívald
forsetaval	síval
forseti	síoddamaður
forsi	síørskapur
forsignaður	símannvándur
forsin	síbusutur
forsíða	síveggur
forsíðugrein	sískriv
forsjón	sílagna,spádómur
forsjónari	síhúsbóndi,innløgumaður
forska	sírot
forskammaður	sínipin
forskeri	síknívur
forskot	Samheiti:forgreiðsla,fyribilsgjald,lønarforskotgjald, løn frammanundan↔avgjald,løn
forskoyti	síískoyti
forskrift	sílóg
forskúli	sískúli
forsligur	síbusutur,óskapiligur
forsmáa	sívanda
forsmáttaður	símannvándur
forsniða	síforma
forsorg	síhjálp
forsorgarhjálp	síhjálp
forsova	sísova
forsóna	sílorka burtur
forsónaður	síburturvilstur
forsónast	síenda
forsprákari	síoddamaður
forspæl	sítónalag
forstaður	síbýur
forstanda	sívita
forstandari	síoddamaður
forstjóri	síoddamaður
forstova	síhøli
forstríddur	síútmøddur
forstýra	síórógva
forstýraður	síørvitisligur
forstýrisligur	síørvitisligur
forstøðumaður	síoddamaður
forsuffaður	símótfallin
forsutur	síbusutur
forsvar	sífyribyrging,vernd
forsvara	síverja,verja annan,verja seg
forsvarliga	sítryggliga
forsvarligur	sítryggur
forsvølgdur	sínipin
forsvørja	síósannlíkur
forsyndaður	sívreiður
forsyndast	síilskast
forsæti	sívald
forsøga	sífrásøgn
forsøgn	síspádómur
forsøguligur	síaldrandi
forsøla	síhandilsskapur
forsøma	sílorka burtur
forta	Samheiti:skjótka,títtaganga ov skjótt;stíga fram;□klokkan er ov skjót(sakta)seinkaganga ov seint, spakuliga;stíga aftur;□klokkan er bein, gongur beint, rætt;klokkan er ov sein;klokkan er skeiv, gongur skeivt;klokkan er steðgað, gongur ikki
fortala	síinngangsorð
fortapast	síoyðileggjast
fortaping	síundirgangur
forteipaður	sínipin,útmøddur
fortelja	sígreiða frá
fortina	síleggja á
fortinaður	sígyltur
fortjald	síforhang
fortligur	síbusutur,óskapiligur
fortorga	Samheiti:dáma,tola,torgahalda e-t út;kunna (nóg) (væl) við e-t;kunna síggja (e-n) fyri eygunum, fyri eins eygum;kunna síggja, tola, torga (gronina á e-m);orka fyri e-m;vera (nóg) (væl) nøgdur við e-t↔áhugaður,ásttikin,dáma
fortreð	síbrotsverk,hindur,levind
fortreyt	sílíkindi(r)
fortrongdur	síneyðkomin
fortrot	síóndskapur,trá
fortugdur	síjabbaður
fortur	síbusutur
fortún	síkoyrivegur,tún
forutorva	síflag
foruttan	Samheiti:neman,umfram,umframt,uttanannað enn;annað enn tað at...;□tá ið tað er frá, frároknað, undantikið↔avlop,leypa av,tróta,tørvur,yvirskotAndheiti:hoyra til
forveiggjaður	símannvándur
forveita	síforvinna
forvinna	Samheiti:forveita,tjena,vinnaarbeiða fyri løn;arbeiða fyri, tjena, vinna pening;eiga í haldi t.e. sita við haldi t.e. hava hald í garði;fáa, hava fyrimun, inntøku, vinning (av e-m);fáa nógv av skafti, á skaftið;fáa nyttu av, burtur úr e-m;hava ágóða, vinning av...;hava nakað fram um ein annan;leggja inn;leggja til húsið;liva av rentu;røkja egin áhugamál, gagnsmál;skaffa mat til húsið(nýta gagnliga)gagnnýtadraga sær gagn úr, vinning av e-m;duga væl at fáa, gera burturúr;fáa nógv, væl burturúr;nýta til fulnar;skera góðan akur av e-m↔arbeiða,arbeiði,starv
forvinningur	sígjald
forviti	síviti
forvitin	Samheiti:alspurin,frættin,gjørvitin,gørvitin,gørvitur,sneytutur,spurin,spurutur,tráspurinsum fegin vil vita (um onnur);□ikki stingst fingur(in) í øsku(na) fyri honum(forvitni)forvitinskapur↔áhugi,ha,njósnan,njósnari,nærgongdur,sneyta,spurningur,tráspyrja
forvitinskapur	síforvitin
forvitnast	sísneyta
forvitni	síforvitin
forvitnisligur	síáhugaverdur
forvíta	sílasta
fossa	sífloyma
fossadun	síljóð
fossafar	síspor
fossaguv	sítoka
fossamagn	símegi
fossfella	síkóka
fosskóka	síkóka
fossur	Samheiti:áarfossur,lækjabláur fossur;tann blái fossur↔áarføri,vatn
fostbróðir	sívinur
fostbrøðralag	síblídni
fostra	síbarn,fosturmóðir,nøra,uppihalda
fostraður	síuppalin
fostri	sífosturmóðir
fostur	síuppfostran,viðsetingSamheiti:blóðlamb,drúvufostur,misburður,misføðingur,ófødningur,tvíburafosturóføtt avkom;sum er í eggi, stropa;sum er í móðurlívi, óføddur, undir belti;□eggið er komið í eyga, stropa;eggið er troðið;eggið er ungað, yngt t.e. ungi er í egginum;ungi er (komin) í↔føða,kviðin,missa fostur,nørast,tvílívað
fosturbarn	síbarn
fosturbróðir	síbarn
fosturdóttir	síbarn
fosturfaðir	sífosturmóðir
fosturforeldur	sífosturmóðir
fosturjørð	síheimland
fosturland	síheimland
fosturlandsalskur	síkærleiki
fosturlandskærleiki	síkærleiki
fosturlát	símissa fostur
fosturmamma	sífosturmóðir
fosturmóðir	Samheiti:barnfostra,fostra,fosturmamma,stjúkmamma,stjúkmóðir(barnagenta)dadda,didda,sómadadda(fosturfaðir)fosturpápi,stjúkfaðir,stjúkpápi(fostri)barnauppalari,barnagarðslærari,barnakennari,barnalærari,fosturforeldur,uppalari,uppvenjari(dagrøktarmamma)kvinna sum ansar børnum (um dagin)↔frálæring,uppalin,uppaling,uppfostran,uppihalda
fosturpápi	sífosturmóðir
fosturshús	síbústaður
fostursonur	síbarn
fostursystir	síbarn
fostursystkin	síbarn
fosturtøka	símissa fostur
fosturvatn	sívatn
foyggin	sínipin
foyggjur	sínipin
foykingartrog	sítrog
foykja	sífúka,skilja
foyra	sídyrka,rukka,skarð
foyrutur	síójavnur,rukkutur
foysa	sífúka,skúma,spræna
foysur	síregn
foyur	sínipin
fóðra	síleggja á,mata
fóðraður	síleggja á
fóðring	sírøkt
fóður	símatur
fóðurevni	símatur
fóðurfrekur	símatfegin
fóðurgóður	sídygdargóður
fóðurlættur	sílættfóðraður
fóðurneyð	sítørvur
fóðursmaður	síjarðyrkismaður
fóðurtari	sítari
fóðurtrot	sítørvur
fóðurtungur	símatfegin
fóðurvirði	sídygd
fólk	sííbúgvi,manning,nakar,nøgd,persónur,skyldfólk
fólka	síbúsetast
fólkaalskin	síspakur
fólkaansur	sívirðing
fólkaatkvøða	síval
fólkabein	síbeinaræ
fólkabærur	síalmenniligur
fólkaeftirløn	sígjald
fólkaeydna	síeydna
fólkaferð	síflyting,rýming,skyldfólk
fólkaferðing	síflyting,rýming
fólkaferðsla	sítúrur
fólkaflokkur	sííbúgvi,nøgd
fólkaflutningur	síflutningur,flyting,rýming
fólkafundur	sífundur
fólkaføði	símatur
fólkagangur	sígonga
fólkagonga	sígonga
fólkagongd	sífótafet
fólkagongdur	síatkomandi
fólkahár	síhár
fólkaháskúli	sískúli
fólkahjálp	síhjálpari
fólkakirkja	síkirkja
fólkakroppur	sílikam
fólkaleið	síferðaleið
fólkalið	sískyldfólk
fólkaliga	síhøviskliga
fólkaligur	Samheiti:agafastur,beskeðin,bæriligur,bærligur,dandiskur,hampa,hampaligur,hampiligur,hámentaður,háttvarin,høviskligur,høviskur,kurteisligur,lagaligur,mentaður,penligur,penur,riddaraligur,sámiligur,siðaður,siðalagsligur,siðaligur,siðareinur,siðavandur,siðgóður,siðiligur,siðmentur,siðprúður,siðregluligur,siðsamur,siðuligur,siðvandur,skikkiligur,skilagóður,sømiligur,vælsiðaður,vælvandur,æruturgóður í sær;lagaligur, siðiligur, varin í orð og tal;stillur og róligur;undir, við góðum aga;við góðum atburði;væl siðaður, vandur;○sum dugir, kann borðsið, fólkaskikk, magamál, kurteisi o.fl.;sum dugir, kann (væl) at bera seg millum fólk, manna;sum hevur góðan, siðaðan atburð, skikkar sær væl(borðbærur)borðberandi,stovubærurtakandi í munn↔afturhald,fámæltur,hábærsliga,hábærsligur,hóvsamur,høviskliga,mannsømandi,mentan,skikka sær,smæðinAndheiti:kravmikil,nasadjarvur,ósømiligur,reyputur,vanæruligur
fólkalítil	sífólkaoyðin
fólkalív	sígerandislív
fólkalortur	sílortur
fólkaloysi	sítørvur
fólkalyndi	sísinnalag
fólkamatur	símatur
fólkamál	sírødd
fólkameingi	sínøgd
fólkamentan	símentan
fólkaminni	símentan,minning,minnismerki
fólkamongd	sínøgd
fólkamunnur	símunnur
fólkamúgva	sínøgd
fólkanavn	sínavn
fólkaogn	síogn
fólkaoyðin	Samheiti:avoyddur,eyður,fábýlt,fjarbýlt,fólkalítil,fólkatómur,gestaleysur,mannleysur,mannoyðin,mannoyddur,manntómur,oyðin,oyður,óbygdur,strálbygt,tómur□har er ónomið land;tað er langt ímillum húsini↔einki,søra,sørur,tøma
fólkarán	sítvingsil
fólkaríkur	síavtakin
fólkarúgva	sínøgd
fólkarúm	síhøli
fólkaræddur	sífólkaskýggin
fólkaræði	sístatur,vald
fólkarænari	sítjóvur
fólkasangari	sísangari
fólkasiður	sísømileiki,vani
fólkasjúka	sísjúka
fólkaskaði	sídeyði,skaði
fólkaskapilsi	sípersónur,útsjónd
fólkaskepna	síeydna
fólkaskikkur	sísømileiki,vani
fólkaskittur	sílortur
fólkaskúli	sískúli
fólkaskýggin	Samheiti:burturbýttur,fjartøkin,fólkaræddur,fólkastyggur,huldisligur,huldukendur,hulduligur,hulisligur,hvørvin,innanhokin,innitokin,kvørkvisin,mannræddur,mannstyggur,trølskur,trølsligur↔bangin,mótfallin,mótloysi,ræða,ræðast,ræðsla,ræðuskítur,smásárur,smædni,smæðast,smæðin,styggjast,styggur,vargur
fólkaslag	sííbúgvi,skyldfólk
fólkastuttleiki	sístuttleiki
fólkastyggur	sífólkaskýggin
fólkatal	sííbúgvi,yvirlit
fólkateljing	síuppreksan
fólkating	sívald
fólkatingslóg	sílóg
fólkatingsval	síval
fólkatos	síáskoðan,slatur
fólkatómur	sífólkaoyðin
fólkatónleikur	sítónalag
fólkatrot	sítørvur
fólkatrúgv	sísannføring
fólkatrygging	sítrygging
fólkavaldur	sívaldur
fólkavalt ting	sívald
fólkavit	síklókskapur
fólkavold	símanngjørdur
fólkavøkstur	sívøkstur
fólkayvirlit	síyvirlit
fólkið	síhvør einasti
fólkkunna	síklókskapur
fólksligur	síalmenniligur
fólskur	sítápuligur
fóma	sískúma omanav
fómur	sískúm
fóra	síeydna
fóta	símáta,standa
fótabað	sívasking
fótabragd	síarbeiðslag
fótabugur	síbugur
fótaburður	síbering
fótaður	síalvakin
fótafar	síspor
fótafastur	sískjótførur
fótaferð	síarbeiðslag,fótafet
fótafesti	sífótaspenni
fótafet	Samheiti:fólkagongd,fótaferð,fótaspor,fótastig,fótatraðk,gin,gleiv,risagleiv,spor,stetl,stev,stig↔ferðast,ganga,gonga,skunda sær,spor,túrur
fótafimur	sískjótførur
fótagóður	sískjótførur
fótakuldi	síkuldi
fótaleysur	síóstúttur
fótalunnur	sífótaspenni
fótalætir	síódrúgvur
fótarbløðra	síbløðra
fótarøkt	síreinføri
fótaskammil	sísessur
fótaspenni	(fótafesti)støða(fótalunnur)fótatræ,fótfjøl,fótskorða(hælkoyta)hælgrópa,hælgøta,hælkulla↔ístig
fótaspor	sífótafet,spor
fótasterkur	sísterkur
fótastig	sífótafet
fótasveitti	sísveitti
fótatraðk	sífótafetSamheiti:beinatugga,táta,tugga(yndisorð)afturróður,munntami,uppikipping,uppikipsan↔endurtaka,endurtøka,jabbaður,umaftur
fótatræ	sífótaspenni
fótatváttur	sívasking
fótaull	síull
fótavatn	sívaskiløgur,vatn
fótbað	sívasking
fótbóltsdystur	síkapping
fótbóltskapping	síkapping
fótbóltslandskapping	síkapping
fótbóltslið	símanning
fótbóltsvøllur	sístað
fótbóltur	síbóltur
fótbundin	sífastur
fótbøllur	síil
fótfastur	sískjótførur
fótfermur	sískjótførur
fótfimleiki	sífermleiki
fótfimur	sískjótførur
fótfittur	sískjótførur
fótfjøl	sífótaspenni
fótfjøtur	sífjøtur
fótgóður	sískjótførur
fóthvítur	sílitaður
fótkvikur	sískjótførur
fótleggjarsár	sísár
fótleysur	síóstúttur
fótliður	síliður
fótlisti	síútlinja
fótlættur	sískjótførur
fótmark	síeyðkenni
fótongul	sífella
fótreyður	sílitaður
fótsíður	sísíður
fótskammil	sísessur
fótskorða	sífótaspenni
fótskør	sísessur
fótur	síundirlagSamheiti:afturfit,afturfitja,afturfitjing,afturfótur,afturhógvur,afturkleyv,afturlabbi,bankur,bekil,bekl,bjarnarbuna,fit,fitja,fitjing,framfitja,framfitjing,framkleyv,framlabbi,hegl,hekil,hekl,hestahógvur,hógvur,hóvur,hundslabbi,kettulabbi,kettulámur,klárbankur,klárbekil,kleyv,klivfótur,klombribankur,kópafitja,krypilsfótur,labbi,lálla,lámur,líggjafótur,mannafótur,mansfótur,músarlabbi,pleirur,pleyrur,prámur,rossahógvur,runubankur,setufótur,seyðafótur,seyðakleyv,skankur,skarvsfótur,slættil,stetlingar,tásærabankur,tótur,tøðbankur,tøðbekil,tøssingar,tøtlingar,vaðfótureinar løppur(innfit)útfit↔gongulimur,il,lógvi,negl,sóli
fragd	sígleði
fragdarboð	síboðan
fragdarljóð	sígleðirómur
fragdartíð	síinnløgutíð
frakkakot	síkloddakot
frakkaslyðr	síkloddakot
fram	síframeftir,liðin,seint
framaling	sínøring,viðseting
framast	sílekjast
framasøkin	síófúsur
framasøkni	símaktgirnd
framá	síframeftir
frambein	sígongulimur
frambit	sítonn
framboygdur	síframyvirboygdur
frambrot	síbati
frambræði	sídirvi
framburðarfúsur	síframfúsur
framburðarhugaður	síframfúsur
framburðarhugur	sífrælslyndi
framburðarsinnaður	síframfúsur
framburðarstrev	sídirvi
framburður	síbati,málnýtsla
framdráttur	sídirvi
frameftir	Samheiti:aftanífrá,áleiðis,ávegis,fram,framá,framí,framyvir,uttar,uttareftiraftanífrá og fram;á leið, veg fram;fram at, frá, í, til o.fl.;longur burt, burtur, fram, út o.fl.;úr aftara enda, bak, rongini, skutinum o.fl.↔ímóti,niðaneftirAndheiti:aftureftir
framendi	síoddur
framfaks	síull
framfarin	síbatnaður,hovin
framferð	síarbeiðslag,bati,medferð
framferðarháttur	síarbeiðslag,medferð
framferðarhugur	sídirvi
framfitja	sífótur
framfitjing	sífótur
framflutningur	síflyting
framfúsin	síframfúsur
framfúsur	Samheiti:framburðarfúsur,framburðarhugaður,framburðarsinnaður,framfúsin,framfýsin,framsøkin,framtakshugaður,framtakssamur,framtøkur,stórætlaður,søkin↔áhugaður,frílyntur,raskur,villigurAndheiti:hóvsamur
framfýsi	sídirvi
framfýsin	síframfúsur
framfýsni	sídirvi
framføri	sífrekleiki
framførsla	síframsýning
framførur	síkravmikil,nasadjarvur
framgangur	síbati
framgonga	síbati
framgongd	síbati
framgráur	sílitaður
framhald	síískoyti
framhaldandi	síalsamt,framvegis,samanhangandi,skjótt
framhaldsflokkur	sískúlaflokkur
framhaldsgrein	sískriv
framhaldssending	sísending
framhaldsskeið	sískúlagongd
framhaldsskúli	sískúli
framhaldssøga	sífrásøgn
framherji	síatsóknarmaður
framhokin	síframyvirboygdur
framhvítur	sílitaður
framhædd	síhædd
frami	síbati,gagn,heiður,játtan
framí	síframeftir
framífrá	síógvuliga
framíhjá	síafturat
framíhjáarbeiði	síarbeiði
framíhjáløn	sígjald
framíhjáprógv	síváttan
framíhjárættindi	sírættindi
framíhjárættur	sírættindi
framíhjástarv	sístarv
framíhjáørindi	síørindi
framímóti	sínæstan
framjakslur	sítonn
framkleyv	sífótur
framklógv	sínegl
framkoma	síbati,koming
framkomandi	síatkomandi
framkomin	síaldrandi,alvakin,lærdur,tilkominSamheiti:afturvendur,heimkomin,innkominkomin á mál;komin heim;komin leiðina heim;○sum er frammi;sum hevur vunnið húsini upp (aftur)(afturíafturkomin)afturfingin,afturfunnin,afturkomin,afturmøttur,heimafturkominkomin afturíaftur(atkomin)atlagstur,innkomin,lendurkomin at landi, heim, inn, til lands;○sum hevur lagt at, lent(niðurkomin)lendur,setstur↔koming,lenda,nærkast,nærkast endanum
framlabbi	sífótur
framleidni	símegi
framleiða	síarbeiða
framleiðing	síframleiðsla
framleiðis	síframvegis
framleiðsla	Samheiti:ársframleiðsla,evning,fiskiídnaður,fjølframleiðsla,framleiðing,grótídnaður,hópframleiðsla,ídnaður,jarnídnaður,krígsídnaður,matídnaður,ovframleiðsla,skapan,skaping,stálídnaður,tilevning,tilskapan,tilskering,tjóðarframleiðsla,tungídnaður(nýskapan)nýgerð,nýroynd(orðagerð)orðasmíð(uppfinning)páfinning(úrdráttur)avdráttur,endurvinning(útvinning)úrvinning,útvinsla↔ídna,verkstaður
framleiðsluamboð	síamboð
framleiðsluár	sítíðarfesting
framleiðslukostnaður	síútreiðsla
framleiðsluorka	símegi
framleiðslutól	síamboð
framleiðsluvinna	sívinnulív
framleiðsluvøra	sívøra
framleiga	síbúgva,hýsa
framleingja	sírúmka
framleistur	sísóli
framliðið	síliðin,seint,útliðið
framligur	sílærdur,nasadjarvur,stoltur
framlitaður	sílitaður
framlittur	sílitaður
framlítil	sísmáur
framljós	sílampa
framlopin	sínasadjarvur
framlunnur	sílunnur
framlykt	sílampa
framman	síaftureftir
frammanífrá	síaftureftir
frammansneitt	síseyðamark
frammanundan	sífyrr
frammastur	símastur
frammi	síalvakin
frammikil	síførligur
frammorreyður	sílitaður
framprúður	síførligur,hovin
framreyður	sílitaður
framrokna	sírokna
framrokning	síútrokning
framrong	sísessur
framsegl	sísegl
framseting	síframsøgn,frásøgn
framsettur	sílaðin
framsetur	sísessur
framsíða	síveggur
framsíggin	síeftiransin
framsjón	síveggur
framskák	sístrika
framskriva	sírokna
framskygdur	síeftiransin
framskyggin	síeftiransin
framskygni	síansni
framsókn	síbati
framstaddur	sílærdur
framstig	síbati,medferð
framstoytur	síbati
framstórur	síførligur
framsvartur	sílitaður
framsýndur	síeftiransin
framsýning	Samheiti:fastasýning,filmsýning,fimleikaframsýning,framførsla,frumframførsla,frumsýning,hersýning,ídnaðarframsýning,leiksýning,listaframsýning,málningaframsýning,midnáttarframførsla,midnáttarsýning,neytasýning,seyðasýning,sjónleikaframførsla,sýning,søluframsýning,vørusýningfimleika-, mótaframsýning o.fl.↔avdúking
framsýntur	síeftiransin
framsæti	sísessur
framsøgn	Samheiti:framseting,orð,orðing,søgn,útlát,útsøga,útsøgn(orðaval)málsligt útlát↔frásøgn
framsøgumaður	síoddamaður
framsøkin	síframfúsur
framsøkni	sídirvi
framtak	síbati
framtaksandi	sídirvi
framtakshugaður	síframfúsur
framtakssamur	síframfúsur
framtakssemi	sídirvi
framtá	sítá
framtíð	síframtíðarútlit
framtíðardreymur	síveruleikaflótti
framtíðarhugsan	síveruleikaflótti
framtíðarlagna	síframtíðarútlit
framtíðarmynd	síframtíðarútlit
framtíðarstarv	sístarv
framtíðarútlit	Samheiti:ánir,framtíð,framtíðarlagna,framtíðarmynd,framtíðarvánir,framtíðarvón,kansur,kjansur,líkindi(r),sannlíkindi,tekin,útlit,vánir,vónviðurskifti í framtíðini;□livst so spyrst;tað fer, kemur tíðin at vísa, skal tíðin vísa(illvánir)døpur, einki, ringt, vánaligt útlit fyri...;ringar framtíðarvánir;ringar vánir;vánalig(t) útlit;□alt sær so dapurt, myrkt út↔fíggjarviðurskifti,livst so spyrst,líkindi(r),standur,vón
framtíðarvánir	síframtíðarútlit
framtíðarvón	síframtíðarútlit
framtíðis	sískjótt
framtjúkkur	síhovin
framtonn	sítonn
framtungur	sílaðin
framtøka	síbati
framtøkur	síframfúsur,raskur
framundir	síímóti,næstan
framundirróður	Samheiti:ábending,hálvbrokk,tilsipan,tilsiping,tilvísinghálvkvøðin vísa↔óbeinleiðis,vísa á
framur	síklókur
framúr	sífrálíkur,ógvuliga
framúrskarandi	sífrálíkur,ógvuliga,óvanligur
framvegis	sískjóttSamheiti:alsamt,alt,enn,framhaldandi,framleiðis,støðugtenn á døgum;enn sum áður;enn um sinn;fram, heilt, líka til dagin í dag, til hetta, til nú;heilt, líka frá, síðan, síðani...;sum altíð;sum tað plagar;sum vanligt;sum vant;við sama lag(longur)enn,meir,meira,meirihann er ikki... longur(meira og meira)í størri og størri mun;□tað stendur bara við og versnar↔alsamt,fyrr,higartil,leingi,nú,síðani,skjótt
framvisin	síúrklænur
framvøkstur	síbati
framyvir	síframeftir
framyvirboygdur	Samheiti:bendur,bogin,boygdur,framboygdur,framhokin,framyvirkropnaður,herðasligin,hokin,hoykin,kroppin,kroykin,krókutur,krýkin,kúlutur,lendahokin,loftskotin,lútandi,niðurboygdur,rundbøllutur,samanhokin,samankropin,samankropnaður,samankúlaður,samansokkin,samanstungin,steinkúlutur,tríkrókuturbendur, bogin, bognaður, hokin, kropnaður framyvir;bendur niðurá;hokin í lendunum;hokin, krýkin, sligin, skotin í herðunum;krýkin sum ein nævurskrukka;○sum fer kúlandi, lútandi, samankrympaður;sum gongur hokin framyvir, lútar framyvir;□hann er sum lagdur í spónalag;hatta er tann hundsryggurin ið er(niðurbukkaður)bogin,bukkaður,framyvirbukkaðurvið reyvini hægst(høvurhallur)vangahallursum hellir høvur, vanga;við lútandi høvdi↔bogna,boyggja høvurAndheiti:fattur
framyvirbukkaður	síframyvirboygdur
framyvirkropnaður	síframyvirboygdur
framýti	síýti
framæs	síhol
framæsa	síhol
fransa	síútføttur
fransaskip	sísjófar
fransaskonnart	sísjófar
fransaterna	sífuglur
franshúkur	síhúkur
fransmaður	sísjófar
fransur	sísjófar
fras	síavlop,dáragerð
frata	Samheiti:freta,fretla,prumpa,pruta,smáfretlaavláta seg;loysa fret;sleppa luft(hava garnaskrambul)hava bralingar í maganum;vera fullur av luft (í maganum)↔fretur
fratbýttur	sítápuligur
fratóður	sísvakur,vreiður
fratørur	sísvakur,vreiður
frá	síburtur,burturav,við hávirðing
fráber	síbroyting
fráboðan	síboðan
frábregði	sífrábrigdi
frábregðilsi	sífrábrigdi
frábregðingur	sífrábrigdi
frábrigdi	síeyðkenniSamheiti:avbrigdi,avbroyting,avvik,frábregði,frábregðilsi,frábregðingur,frávik,serføri,serstøða,tilbrigdi,undantak,úrbregði(úrkynjan)illbregði,úrskepingsum er úrkynjað;sum úrkynjast, úrskepast↔eindømi
frábyrging	sífongsul,fyribyrging
frábyrgja	sígera skilarúm
frábýtisrættur	sírættindi
frábýttur	sísundurbýttur
frádráttur	síútrokningSamheiti:barnafrádráttur,lønarfrádráttur,skattafrádrátturfrádráttur fyri, vegna...↔frároknaðurAndheiti:ískoyti
frádrigin	sífrároknaður
frádyr	síinngongd
fráfall	sídeyði
fráfallin	sídetta av
fráfarardagur	sífráfaring
fráfaring	Samheiti:avstaðfaring,avstaðferð,burturferð,fráferð(fráfaringartíð)fráfarardagur,fráfaringardagur↔burturstaddur,fara,farstøð,starturAndheiti:koming
fráfaringardagur	sífráfaring
fráfaringarhøll	sífarstøð
fráfaringarroynd	sípróvroynd
fráfaringartíð	sífráfaring
fráfarni	sífyrrverandi
fráferð	sífráfaring
frágangari	sísvikari
frágangur	sístandur
frágarður	sígarður
frágerð	síarbeiði
frágerða	sífrálíkur,ógvuliga
frágerðar-	sífrálíkur
frágerðargóður	sífrálíkur
frágerðarmaður	síavtakafólk,hampafólk
frágjørdur	síhindraður (í at...)
frágongdur	síatkomandi
frágreiðing	síallýsing,frásøgn
frágreiðsla	síallýsing,frásøgn
fráhald	síavhald
fráhaldandi	síódrukkin
fráhaldsfelag	sífráhaldsmaður
fráhaldsfólk	sífráhaldsmaður
fráhaldsmaður	Samheiti:avhaldsfólk,avhaldsmaður,brennivínshatari,fráhaldsfólk(avhaldsfelag)fráhaldsfelag(avhaldsrørsla)fráhaldsrørsla↔avhaldAndheiti:drankari
fráhaldsrørsla	sífráhaldsmaður
frákanna	sílorka burtur
frákoyrdur	Samheiti:avkoyrdur,avsettur,burturrikin,burturtrokaður,frárendur,frárikin,koyrdur,rendur,rikin,uppsagdurkoyrdur frá, settur av;koyrdur í ókunnuvarða;koyrdur, rendur, rikin av bátinum, skipinum, í land;koyrdur, settur frá, úr embæti, starvi;rikin á flótta;skúgvaður til viks;sum hevur fingið durafjórðingin, høgar dyr (frá e-m);sum hevur fingið fótin, sekkin, sparkið, reyða kortið, uppsøgn(burtursagdur)avsagdur(aftursjúgvaður)afturrikin,aftursjuggaður,burturkveistraður,burturlýddur,fjónaður,forfjónaður,heimkoyrdur,vrakaðurburturkoyrdur, -rendur, -sagdur, -sjúgvaður, -vístur o.fl.;koyrdur, rendur, rikin á dyr, gátt;rikin burtur, heim, út;útblakaður, -koyrdur, -rendur, -skotin, -tveittur, -vístur o.fl.↔avlagdur,heimleysur,missa starvið,reka úr starvi,spottaður
frálandavinna	síarbeiði
frálandsvinna	síarbeiði
fráleiki	sístrekki
fráliðin	síliðin
frálittur	sílitaður
frálitur	sílittóni
frálíka	síógvuliga
frálíkt	Samheiti:fínt,gott,óført,veldigtalt gott um tað;einki ilt um tað;í besta, fagrasta, fínasta, lagi;í lagi, ordan;□hann kann saktans;har er einki at finnast at, klaga um, peika fingurin á;hatta, tað man fara at laga seg;nú er gamansleikur, lagamanna, lagamanni, lagamannin at...;nú kann hann liva og láta sum hann vil;tað ber saktans til;tað er alt í lagi;tað er eingin neyð fyri tí;tað er einki uttan (alt) gott at siga um hatta;tað er sum tað eigur (at vera);tað gongur eftir vild↔frálíkur,fyri neyðini,tíbetur
frálíkur	síannarleiðisSamheiti:avbærur,baldur,bestur,deiligur,dugandi,dugnaligur,dýrdarfullur,dýrdargóður,dýrdarríkur,dýrdligur,dýrmætur,einskilaður,einskilagóður,einsýnur,ektaður,eyðvaldur,framúr,framúrskarandi,frágerðargóður,fráskilaður,frekur,fyridømiligur,fyrimyndarligur,glæsiligur,góður,grovur,gævigur,gæviligur,gævuligur,gævur,hampa,hendinga,hendingagóður,ítarligur,kjørligur,kærur,makaleysur,meistaraligur,ordiligur,óførur,ósigraður,raskur,rósverdur,rættiligur,rættuligur,rættur,setuligur,signaður,signingarmikil,signingarríkur,stakgóður,stórfingin,stórlátin,stórmerkiligur,sælur,undurfullur,undurmikil,undurríkur,undursamligur,undursamur,undurverdur,úrgerðargóður,úrlíkur,úrmæltur,úrskarandi,úrsýndur,úrvaldur,útmælagóður,útvalagóður,útvaldur,útvalin,valdur,valin,veldigur,veruligur,viðgitaður,viðgitin,virkuligur,vælsignaður,øvundarverdurfrálíkur bæði til hond og fót;ólíkur øðrum;tikin úr leiki, leikum;úr leiki, leikum tikin;við miklari dýrd;□hann, tú verður biðin aftur(ordans)frágerða(fráskila-)avreks-,avtaka-,avtaks-,bragda-,dugna-,dygdar-,dýrdar-,einskila-,findar-,frágerðar-,fráskila-,hampa-,hendinga-,hendings-,megnar-,menjar-,merkis-,ordans-,ovur-,skila-,stak-,stás-,vala-↔arbeiðsførur,avtakafólk,dýrgripur,frálíkt,hampafólk,kjør,munadyggur,ógvuliga,ólýsandi,óvinniligur,sigra,snotiligur,valaverk
frálýsing	síboðan
frálæra	sífrálæring
frálæring	Samheiti:byrjanarundirvísing,floksundirvísing,frálæra,heimauppaling,kenning,kensla,serundirvísing,undirvísing,upplæring,uppvenjing,útbúgving(frálæruháttur)kenslulag(formaning)áminning↔byrjari,fosturmóðir,fróðarmaður,gera skúlating,lærarafólk,læra seg,lærdómur,lærdur,menningarstig,próvroynd,sibbi,skúlagongd,skúli,uppalin,uppaling,uppfostran,uppihalda,upplæra
frálæruamboð	síamboð
frálæruháttur	síarbeiðslag,frálæring
frálærutilfar	síamboð
frálærutími	sískúlagongd
fráløgst	síavhald
frámarka	sífrámerkja
frámerki	síeyðkenni
frámerkja	Samheiti:avmarka,brennimerkja,frámarka,ímerkja,krossa,lagda,marka,merkja,ringmerkja,sløðra,talmerkja,tráðdragabinda, knýta lagd á, uppá;binda sløður á;draga tráð;draga tráð (út) í oyrað;gera frámerki á;heingja, seta spjaldur á;knýta døtt;leggja lag á;seta av;seta forbókstavir, navn á, í;seta kross við;seta merki á, í, við;seta tal, raðtal á↔eyðkenna,eyðkenni,eyðmerking,nummar,skelti
frámæli	síforbjóða
frárendur	sífrákoyrdur
frárenna	sívatnleidningur
frárenning	síá,vatnleidningur
frárensl	síá,vatnleidningur
frárikin	sífrákoyrdur
frároknaður	sísundurbýtturSamheiti:frádrigin,frátaldur,undantikindrigin frá;ikki roknaður uppí;ikki taldur við;lagdur burturúr↔frádráttur,partur,sundurbýtturAndheiti:afturat
frásagnarlist	símálkynstur
fráskarvur	síslatrivætti
fráskila	síógvuliga
fráskila-	sífrálíkur
fráskiladrongur	síavtakafólk
fráskilaður	sífrálíkur
fráskilafólk	síavtakafólk
fráskilagenta	síavtakafólk
fráskilakona	síavtakafólk
fráskilamaður	síavtakafólk
fráskildur	síeinsamallur
fráskiljing	sískiljing
fráskot	sístreymur
fráskygdur	síblindur
fráskygni	síeyga
fráslag	sískyldfólk
frástaddur	síburturstaddur
frástøða	sístrekki
frásøga	sífrásøgn
frásøgn	Samheiti:afturfrásøgn,aftursøgn,endursøgn,fundarbók,gerðabók,greinargerð,greining,hvítbók(endurminningar)lívssøga,sjálvsævisøga,ævisøga(frágreiðing)álit,ársfrágreiðing,forsøga,framseting,frágreiðsla,fundarfrásøgn,lýsing,nevndarálit,sjófrágreiðing,útgreiðing(halgisøga)ápostlasøga,átrúnaðarsøga,jólaboðskapur,jólaevangelium,krýnikubók,pínslusøga(lýsing)bókmentasøga,bygdarsøga,ferðafrásøgn,ferðasøga,fornsøga,heildarlýsing,heimssøga,jarðarsøga,kongasøga,krýnika,krønika,landssøga,listasøga,mannasøga,mannlýsing,málsøga,mentanarsøga,náttúrulýsing,nútíðarsøga,persónlýsing,riddarasøga,rukkusøga,samsøga,samtíðarsøga,siðasøga,siðsøga,siglingarsøga,skaðasøga,skapanarsøga,søga,veraldarsøga,ættarsøga,ættsøga(minningarrit)minnisgrein,minnisrit(skrøggsøga)býttlingasøga,daddusøga,krýnika,krønika,lygisøga,skemtisøga,skotasøga,skrøgg,spøkilsissøga,stuttleikasøga(søga)ástarskaldsøga,ástarsøga,barnasøga,brotsmálasøga,brotssøga,drápa,dømi,dømisøga,forsøga,framhaldssøga,frásøga,harmasøga,kærleikssøga,langsøga,líknilsi,lykilsøga,menningarskaldsøga,myndasøga,sannsøga,skaldaverk,skaldsøga,skaldverk,smásøga,sólskinssøga,stuttsøga,stuttsøgusavn,søgubrot,søgusavn,teknisøga(søgn)arvasøgn,arvmentir,farsøgn,fornaldarsøga,frumsøgn,gudasøga,gudasøgn,hamgongusøga,hemingasøga,hetjusøgn,huldusøga,mannasøgn,munnsøgn,mýta,sagnaringur,sannsøgn,trøllasøga,ævintýr,ævintýrsøgaferða-, fundarfrágreiðing, -frásøgn o.fl.;gomul søgn;munnborin søgn↔framsøgn,greiða frá,heimild,skriv
frásøgufólk	síheimild
frásøgugleði	síprátsemi
frásøguháttur	síarbeiðslag,málnýtsla
frásøgukvæði	sísangur
frásøgukynstur	símálkynstur
frásøgumaður	síheimild
frásøguyrking	sísangur
frátaldur	sífrároknaður,sundurbýttur
frávaksin	síhøgur,mikil
frávenjing	síviðgerð
frávera	sífrítíð
fráverudómur	sídómur
frávik	síburturvik,frábrigdi
frebbi	sífuglur,reypari
fregatt	sísjófar
fregn	síillgruni
fregna	sífrættast,tráspyrja
fregnaður	sífrættast
fregnartænasta	sínjósnari
fregnast	sísneyta
freist	sífrest
freista	sífresta,lokka,royna,svika
freistaður	sífresta
freistandi	síatdráttarmikil
freistari	Samheiti:froystari,tølariein ið freistar, froystar, tølir;sum leiðir (e-n) í freistingar, froystingar↔atdráttarmikil,freisting,lokka
freistarin	síSátan
freisting	Samheiti:froysting,hugtøling,lokkan,lokking,tøling,útgjaring,yvirtaling↔atdráttarmikil,freistari,lokka
frekleiki	Samheiti:áræsni,framføri,nasadirvi,óhøviskleiki,ósmædni,skammloysi,trábeitniovbeiðsla t.e. ov stór bøn, stórt krav↔dirvi,djarvur,kravmikil,nasadjarvur,óttaleysur,vága særAndheiti:eyðmýkt,smædni
frekur	sífrálíkur,førligur,kravmikil,mikil,nasadjarvur,ósømiligur,ræðandi,úrtøkugóður
frell	sívánamaður
frella	síkvinna,leyslyntur persónur
frelsa	síbjarga,bjarging,kristning,umvenda
frelsari	síbjargari,Jesus
frelsarmaður	síbjargari,Jesus
frelstur	síumvendur
fremja	síarbeiða
fremjing	sígerð
fremmandafólk	sífremmandamaður
fremmandahatur	síhatur
fremmandamaður	Samheiti:avbygdarfólk,avbygdarmaður,avstaðarfólk,avstaðsfólk,fremmandafólk,innflytari,komumaður,ókka,ókunnufólk,ókunnukona,ókunnumaður,uttanbíggjar-,uttanbíggjarfólk,uttanbíggjargenta,uttanbíggjarkona,uttanbíggjarmaður,uttanbygdar-,uttanbygdarmaður,uttanhýsisfólk,uttanmaður,útlendingur,útoyggjarmaðurfremmant, ókent fólk↔danskur,fremmandur,innflutturAndheiti:avvarðandi,granni
fremmandamál	sítungumál
fremmandaorð	síorð
fremmandavald	sívald
fremmandsligur	sífremmandur
fremmandur	Samheiti:fremmandsligur,fremmindur,óføroyskur,óheimligur,ókendur,ókunnigur,ókunnugur,ókunnur,útlendskur,útlendur,villfremmandurikki hvønndagsgestur;komin hendan vegin, higar til lands;komin langvegis, uttaneftir, uttanífrá;uttan úr heimi;úr tí stóru verð(søguleysur)□e-t er ein býur í Russlandi fyri e-m↔danskur,fremmandamaður,innflutturAndheiti:navnframur
fremmindur	sífremmandur
fremstatá	sítá
fremstifingur	sífingur
frensageldari	síknívur,pinkulingur
frensast	síputla
frensur	síkallvera,ketta,skeivleiki
fressa	síeta
fressageldari	síknívur
fressast	síputla
fressur	síkallvera,ketta
frest	Samheiti:avdráttarskái,bráðfeingisdvøl,dvøl,fimt,freist,froyst,fyrningarfreist,fyrningartíð,gjaldfreist,gjaldfrest,gjaldskái,innsendingarfreist,kærufreist,kærutíð,rentuskái,skái,skotbragd,skotbragð,skotbrá,tekningarfreist,tíðarfreist,umráðingartíð,uppsagnarfreist,uppsagnartíð,útsetingseinasta, síðsta freist, frest, froyst;tíð at umráða seg (í)(kredittur)kassakredittur(tillagingartíð)skiftistíð,yvirgonga,yvirgongd↔avboð,avlýsa,fresta,mark,náa,tíðaravmarkaður
fresta	Samheiti:drýggja,freista,froysta,seinka,útsetabíða við e-m;drála, leingja tíðina;drála, steðga (á) við e-m;flyta fram (fund);frysta skuld t.e. veita skuldara dvøl;gera e-m fimt;geva e-m freist, froyst, tíð o.fl.;lata bíða, koma í aðru røð, liggja á láni;seinka fyri e-m;seta út;súlta t.e. goyma (partvís við vilja) til seinni(útsettur)drálaður,freistaður,frestaður,longdur,súltaður,toygdurlatin bíða↔avboð,avlýsa,frest
frestaður	sífresta
freta	sífrata
frethít	sífitibjølgur
fretl	síband
fretla	sífrata,putla
fretlast	síputla
fretstingir	sípína
fretur	síandingSamheiti:prumpur↔frata
fridliga	síróliga
fridligur	sígóðsintur,kvirrur
friða	Samheiti:alfriða,fimta,friðhalga,friðlýsa,summarfriða,vetrarfriðabanna at gera e-m ónáðir;gera e-t til friðskjól;lýsa frið (yvir e-m);lýsa tingfrið;verja ímóti...(friðaður)friðhalgaður,friðheilagur,friðlýstur,summarfriðaður,vetrarfriðaður(bannaður)fimtaður,forboðin,noktaður↔forbjóða,forboð,friður,ólógligur
friðaður	sífriða
friðan	sífriðing
friðaravtala	sísemja
friðarboð	síboðan
friðarboði	síhampafólk,semingsmaður
friðardúgva	síhampafólk
friðardýr	síhampafólk
friðarfólk	síhampafólk
friðargerð	sísemja
friðargonga	símótmæli
friðarhøvdingi	sísemingsmaður
friðarliga	síljódliga,róliga
friðarligur	síkvirrur,spakur
friðarløta	sígóðveður
friðarmaður	síhampafólk
friðarsamráðing	sítinging
friðarsáttmáli	sísemja
friðarskip	sísjófar
friðartingingar	sítinging
friðhalga	sífriða
friðhalgaður	sífriða
friðhalgi	sífrídómur
friðheilagur	sífriða
friðil	síunnustar
friðing	Samheiti:friðan,friðlýsing,náttúrufriðing,veiðibann,vetrarfriðing↔semja
friðingarlóg	sílóg
friðingarnevnd	sívald
friðleysur	síheimleysur
friðloysi	síheimloysi
friðlýsa	sífriða
friðlýsing	sífriðing
friðlýstur	sífriða
friðsamur	sígóðsintur,kvirrur
friðsemi	sísemja
friðskjól	sílívd
friðsæla	sífriður,hugni
friðsælur	sígóðsintur,kvirrur
friður	sídeyði,hvíld,semja,tøgnSamheiti:arbeiðsfriður,arbeiðsnáðir,friðsæla,gongufriður,griður,gudsfriður,heimsfriður,hjartafriður,hugró,jólafriður,jólagriður,kvøldarfriður,kvøldfriður,lestrarfriður,mak,matfriður,matnáðir,matstundir,náð,náttarfriður,náttarrógv,næturfriður,ró,rógv,samvitskufriður,sálarfriður,songarfriður,summarfriður,sunnudagsfriður,svøvnfriður,svøvnnáðir,sælumynd,tingfriður,vápnahvíldfriður á jørð;friður í hjartanum;friður við ein, seg sjálvan;Guds friður;ró í sinni(gravarfriður)helró↔blídni,felagsskapur,forbjóða,forboð,friða,semja,semjast,tøgnAndheiti:kríggj,levind
frilla	síleyslyntur persónur
frillulív	síóreglulív
fritlast	síarbeiða óvandaliga,putla
frittur	síborur,pinkulingur
fría	síbjarga
fríaður	sífríur
fríborin	sífríur
fríbóndi	sífrímaður,jarðyrkismaður
frídagur	sífrítíð
frídansur	sídansur
frídómur	Samheiti:ampaloysi,blaðfrælsi,fræls,frælsi,handilsfrælsi,heimafrælsi,keypfrælsi,kvinnufrælsi,prentfrælsi,ritfrælsi,samvitskufrælsi,sjálvstøða,sjálvstøði,skrivifrælsi,talifrælsi,talufrælsi,tjóðarfrælsi,tjóðfrælsi,trúarfrælsi,trúfrælsi,valfrælsi,viljafrælsi,vinnufrælsi(sjálvræði)eginvild,eginvilji,eindømi,friðhalgi,sjálvavgerðarrættur,sjálvbjargni,sjálvdømi,sjálvstýri,sjálvtykki,sjálvval,sjálvvilji,viðtøkuførifríur vilji til at...;persónligt frælsi;rættur til at...↔frílyntur,frímaður,fríur,frælslyndi,rættindi,uttanveltaðurAndheiti:tvingsil
frídøma	sídøma
frídømdur	síósekur
frídøming	sídómur
fríðdæmdur	Samheiti:fríðholdaður,fríðlitaður,fríðlittur,fríður,kinnareyður,kinnfríður,kinnreyður,kjálkareyður,mussareyður,reinholdaður,reyðdæmdur,rómareyður,skinnfríður,slættholdaður,vældæmdurfríðliga littur;við kinnroða, reyðum kinnum, roða á kinn, róma, rósudæmi o.fl.;væl dæmdur;○sum hevur frískan lit, gott dæmi, sær væl út(upprodnaður)heitur, reyður um kjálkarnar;reyður í andliti↔fríðkast,pyntaður,snotiligur,vakur,yndi,yndisligaAndheiti:misháttur
fríðføttur	sípyntaður
fríðholdaður	sífríðdæmdur
fríðka	sífríðkast,pynta
fríðkan	síreinføri
fríðkanarorð	síorð
fríðkast	Samheiti:fríðka,prúðkagerast penari, penur, prúðari, prúður, vakrari, vakur;síggja betur úr fyri hvønn dag (sum gongur)(yngjast)bera seg væl (hóast aldurin);gerast, verða sum ungur aftur;yngjast sum ørnin t.e. eldast væl;yngjast upp, uppaftur↔fríðdæmdur,pyntaður,snotiligur,ungligur,vakur,yndi,yndisligaAndheiti:avlitkast,ljótkast
fríðlitaður	síáleypandi,fríðdæmdur
fríðlittur	sífríðdæmdur,vakur
fríðoygdur	sívakur
fríður	sífríðdæmdur,vakur
fríganga	síhava frí
frígering	síbjarging,spjaðing
frígging	síástarlív,trúloving
fríggingarførur	sítilkomin
fríggingarmyrkt	síljósglæma
fríggj	síástarlív
fríggja	síbiðlaSamheiti:elskast,fjantast,fjasa,fjasast,góðast,hokkast,snurlast,unnast,yndast,ynnastbinda, leggja ást við;elska, unna, ynda, ynna hvørt annað;fara, ganga at fríggja (við);fjasast við konufólk, mannfólk;fjeppast uppi í dreingjum, gentum, konufólki, mannfólki;fjeppast uppi í hvørjum øðrum;fríggja við e-m;ganga, halda saman;ganga tvey saman;ganga við e-m;ganga við dreingjum, gentum, konufólki, mannfólki;knýta ástarbond;leggja ástir saman;vera drongur og genta;ver(ð)a ásttikin;vera (ein sovorðin) gentulókur, mannfólkarippa, revur o.fl.;vera forelskað;vera forlovað(ur) (við...);vera fríggjarafólk, fríggjarapar, par;vera góð;vera og fríggja;vera saman við dreingi, gentu;vera úti og flogsa;□ástir renna saman;har er blivið varmt;tey eru (blivin) góð↔ástarlív,ásttikin,biðla,dáma,kossur,kyssa,kærleiki,par,samansjóðaðir,trúloving,umgangast,unnustar,vinur
fríggjadagsbað	sívasking
fríggjadagsbarn	síbarn
fríggjadagsfoli	síbarn
fríggjadagslátur	sískellilátur
fríggjarabragd	síátak,roysnisgerð
fríggjarabrestur	síátak
fríggjarabræv	sískriv,trúloving
fríggjaraferð	sítrúloving,túrur
fríggjarafólk	sípar,unnustar
fríggjaraføri	síátak
fríggjarapar	sípar,unnustar
fríggjarapíka	síkvinna,unnustar
fríggjararoysni	síátak
fríggjarastavur	sístavur
fríggjari	síbarn,unnustar
frígjørdur	sífríur
frígonga	sífrítíð
frígongd	sífrítíð
fríhandil	sísølubúð
fríhavn	sífjørður
fríkast	síblaking,spæla bólt
fríkendur	síósekur
fríkenna	sídøma
fríkirkja	síkirkja
fríkort	síváttan
fríkorter	sífrítíð
fríkvøld	sífrítíð
frílesing	sískúlagongd
frílestur	síbókalestur,skúlagongd
fríloyvi	sífrítíð
frílyndur	sífrílyntur
frílyntur	Samheiti:frílyndur,frísinnaður,frælslyndur,frælslyntur,loysingarsinnaður(víðskygdur)fordómaleysur,rúmskygdur,tollyndur,tollyntur,upplýsturvið ongum fordómum;við víðum sjónarringi;væl upplýstur↔framfúsur,frídómur,frímaður,fríur,frælslyndi,uttanveltaður
fríløta	sífrítíð
frímaður	Samheiti:fríbóndi,mínsjálvsmaður,sínsjálvsmaðureins egin harri, svaramaður;fríborin, frælsur, óheftur, ókúgaður, sjálvstøðugur maður(frælslyndismaður)loysingarmaður↔frídómur,frílyntur,fríur,frælslyndi,uttanveltaðurAndheiti:fangi,trælur
frímerki	síváttan
frímerkjasavn	sígoymsla
frímerkjaútgáva	síútgáva
frípostaður	sínasadjarvur
frísa	sídreiva,frísutur,hár,ótrivavætti
frísaður	sífløktur
fríshattur	síhár
fríshetta	síhár
frísinnaður	sífrílyntur
fríska	sístorma
frískleiki	síheilsustandur
frískligur	sífeskur,svalligur,vindur
frískt lot	sívindur
frískumegin	síøðrumegin
frískur	síarbeiðsførur,feskur
frískur vindur	sívindur
frískúli	sískúli
fríspark	sísparka,spæla bólt
frísur	síhár
frísutur	síaldutur,fløkturSamheiti:bustutur,fesjutur,fjaðursárur,fjøðursárur,fjøsutur,flagsutur,fløktur,funsutur,hálvrísin,illfjøsin,illfjøskutur,illpjøskutur,ófjøsaligur,ófjøsasligur,ógreiddur,ókembdur,óslættur,ótrivaligur,óvandaligur,rísin,rísutur,stríður,stríggjur,strýggjutur,trivsutur,ývinóhampaður (um hárið);við hárinum í andarisi;□hatta líkist hálvroyttari hønu;hatta sær út sum illimaður í mánalýsi;hárið er sum ein fløkt vefthespa;hárið er sum ein legmeis, meis, rísakustur, ullarmeis, sum veggjagras;hárið er ývið, stendur í andarisi;hárið stendur beint upp í loft;hárið stendur sum ein meis um skøltin, sum strúgvi um høvdið(tæguskalli)frísa,tæguskøltur↔hár,illa ílatin,kemba,ójavnur,purlutur,skegg,snák,ull,ullaður,ývna
frísvimjing	sísvimjing
frísøla	síhandilsskapur
fríteinkjari	síheidningur
frítíð	Samheiti:barnsburðarfarloyvi,farloyvi,feria,frídagur,fríkorter,fríkvøld,fríloyvi,fríløta,frítími,frívika,heimloyvi,heystfrí,heystfrítíð,jólafrí,jólafrítíð,kaffiløta,kaffisteðgur,landloyvi,leysaløta,limadagur,matarsteðgur,mánaðarfrí,mánaðarloyvi,orlov,páskafrítíð,summarferia,summarfrí,summarfrítíð,vetrarfrí,vetrarfrítíð(frígonga)avspákan,frígongd(frívakt)koyggjuvakt,lúrivakt(frávera)burturvera↔hava frí,hvíla,hvíld
frítíðararbeiði	síítriv
frítíðaravloysari	sívaramaður
frítíðarferð	sítúrur
frítíðarheim	síbygningur
frítíðarítriv	síítriv
frítíðarløn	sígjald
frítíðarskúli	sískúli
frítíðarstarv	síítriv
frítíðarvanlukkutrygging	sítrygging
frítími	sífrítíð
frítt	síopinberur
fríur	síkostnaðarleysur,óttaleysur,tøkurSamheiti:fríborin,frælsur,nýfrælsur,óbundin,óheftur,ókúgaður,sjálvstýrandi,sjálvstýrdur,sjálvstøðugur,sjálvstøðuligurborin, føddur (sum) fríur, frælsur (maður);fríur og frælsur;leysur av, frá, úr e-m, við e-t;sín egin;sín egin harri;○sum er fríborin, frælsur maður, frímaður;sum hvørki hevur grís ella gás;□hann er sín egni svaramaður;tað hongur einki á honum(sjálvbjargin)hjálpin,sjálvhjálpin(skuldafríur)skuldaleysur,skuldfríuruttan skuld(frígjørdur)fríaður,leysgivin,leyslatingjørdur fríur;latin, sleptur, sloppin leysur;loystur frá skyldum;loystur úr bandi, fjøtrum;○sum hevur slitið tjóðrið;sum ikki kennir seg bundnan (av...);□hann er sum hundur sloppin av bondum;hann er sum loystur, sloppin úr bondum, hafti, sloppin úr skógvabandi;hann hevur sett føtur undir egið borð;hann kennir seg sum føddan av nýggjum↔bjarga,bjargari,bjarging,eira,frídómur,frílyntur,frímaður,frælslyndi,loysa,óbindandi,ósekur,óskalaður,uttanveltaðurAndheiti:kúgaður,darvaður
frívakt	sífrítíð,vaktarhald
frívika	sífrítíð
froða	sískúm,skúma
froðandi	sískúmutur
froði	sískúm
froðubarn	sívaktari
froðuskot	sískúm
froðutur	sískúmutur
fros	síanding,froysan
frosin	sífrystur,kaldur
froskmansbúni	síklæði(r)
frost	síkavi,kuldi
frostbakki	síbakki
frostbitin	síburturmataður
frostbleiking	síljósglæma
frostbleiktur	síbleikur
frostdyggur	síeldtryggur
frosteta	símatast burtur
frostetin	síburturmataður
frostherðingur	síkavi
frosthús	síkøliverk
frostkaldur	síkaldur
frostkavi	síkavi
frostkendur	sífrystur
frostkylingur	síkuldi
frostleki	síleki
frostmark	símark
frostmýri	síkelda
frostnám	síkavi
frostsár	sísár
frostskriði	sískriði
frostsprongdur	síbrotin
frosttærdur	síburturmataður
frostvatn	sívatn
frostveður	síkuldi
froyða	sígera aldu,skúma
froyðandi	sískúmutur
froyður	sískúm
froys	síanding,froysan
froysa	síanda,fúka,gera aldu,skúma,spræna
froysan	síandingSamheiti:fros,froys,froysur,gos,goysan,nos,sjósprænur,skvampur,skvettur,skvølpur,skvøttur,slettur,sproti,sprutt,spræn,spræna,sprænur,strála,svølgur,vatnslettur,vatnsprænur↔aldutur,bakbrot,dropi,floyma,fúka,sjóvarilska,spræna,vatna
froysandi	sískúmutur
froysa útúr	sísmílast
froyst	sífrest
froysta	sífresta,royna,svika
froystandi	síatdráttarmikil
froystari	sífreistari
froystarin	síSátan
froysting	sífreisting
froysur	sífroysan,vindur
fródleiki	síklókskapur
fródliga	sígjarna
fródligur	síglaður,klókur,lærdur,mennandi,tíðindafróður
fróðarmaður	Samheiti:akademikari,bókamaður,fjølfrøðingur,frøðimaður,frøðingur,granskari,kannari,lærdómsmaður,mentafólk,mentamaður,mentanarmaður,rannsóknari,rannsóknarmaður,vísindafólk,vísindakona,vísindamaðurvitskaparmaður(málfrøðingur)málgranskari,málmaður,málmeistari,málvinur,málvísindamaður,tvímælinguravbærur stílmeistari;alis-, bú-, hag-, lív-, mál-, verkfrøðingur o.fl.;fróður, lærdur, vitandi maður;upplýst, vitandi fólk;sum er málkønur, mállærdur, málkringur, tvímæltur↔frálæring,klókskapur,klókur,lærdómur,lærdur,skúlagongd,vísmaðurAndheiti:býttlingur,sibbi
fróðskaparrit	sískriv
fróðskaparsetur	sískúli
fróðskapur	síklókskapur,lærdómur
fróður	síklókur,lærdur,tíðindafróður
fróleiki	sígleði
fróliga	sígjarna
fróligur	síglaður
frómleiki	síátrúni
frómur	síandligur,góðsintur
fróur	síglaður
frukna	síblettur
fruknutur	síprikkutur
frukt	sígrøði
frukta	síeydnast
fruktaár	síinnløgutíð
fruktagóður	síúrtøkugóður
fruktaleysur	sígróðrarlítil
fruktapláss	síjarðarstykki
fruktbarur	síúrtøkugóður
fruktliting	sílitevni
fruktlitur	sílitevni
fruktmold	símold
fruktsaft	sídrekkivatn
fruktte	sídrekkivatn
frumborin	Samheiti:elstur,frumgitin,fyrstiføddurvið frumburðarrætti↔arvaborin,arvingi,frumburður,rættindi
frumburðarrættur	sírættindi
frumburður	elsta barn;hin fyrstaføddi↔arvaborin,arvingi,frumborin,rættindi
frumbúgvi	sííbúgvi
frumevni	sítilfar
frumfólk	sííbúgvi
frumframførsla	síframsýning
frumgitin	sífrumborin
frumgjørdur	sífrumkendur
frumgróður	sígrøði
frumhandrit	síheimild
frumhav	síhav
frumítróttir	síkapping
frumkendur	Samheiti:frumgjørdur,frumligur,fyrstrunnin,upphavligur,upprunaligur,villurí upprunaligum líki, standi;ónomin av mannahond(frumstaddur)stuttkomin,tilafturskominlítið á leið komin, lítið útbygdur;ónortin av siðmenning(frumskapur)villskapur↔byrjan
frumkirkja	síkirkja
frumligur	sífrumkendur
frummaður	sííbúgvi
frummál	sítungumál
frummynd	síheimild,mynd
frumrit	síheimild,skriv
frumskapur	sífrumkendur
frumskógarfólk	sííbúgvi
frumskógarmaður	sííbúgvi
frumstaddur	sífrumkendur
frumsyngja	sísyngja
frumsýning	síframsýning
frumsøgn	sífrásøgn,heimild
frumtekstur	síáskrift,heimild
frumútgáva	síútgáva
fruntur	síhár
frú	síkvinna
frúa	síkvinna
frúarhundur	síhundur
frúarsnar	síband
frúgv	síkvinna
frygd	sígleði
frykt	síræðsla
frykta	síræðast
fryntliga	síyndisliga
fryntligur	sígóðsintur
frysta	síkólna,køla
frystari	síkøliverk
frystiboks	síkøliverk
frystidiskur	síkøliverk
frystigoymsla	sígoymsla,køliverk
frystihús	sígoymsla,køliverk
frystikassi	sígoymsla,kassi,køliverk
frystikista	síkøliverk
frystilast	sígoymsla,køliverk
frysting	síkøling
frystiposi	síkøliverk,posi
frystirúm	síkøliverk
frystiskáp	sígoymsla
frystitunnil	síkøliverk
frystiútbúnaður	síkøliverk
frystivirki	síkøliverk
frystivøra	sívøra
frystur	Samheiti:alkavaður,alklakaður,avglasaður,avgleraður,avísaður,avkavað,avklakaður,avskelvtur,avstoyttur,beinfrystur,fannmikil,frosin,frostkendur,gallfrystur,gallharður,glasaður,glerfrystur,glerlagdur,glerlokaður,glersettur,glerstoyttur,grótfrystur,harðfrystur,ísaður,ísafrystur,ísagleraður,íslagdur,ísmikil,ísstokkin,ístaktur,kavakendur,kavaklæddur,kavamikil,kavatakin,kavataktur,klakabardur,klakaður,klakataktur,omankavað,samsnjógvað,snjóklæddur,sporsnjógvað,starfrystur,stálfrystur,steinstirdur,stirðnaður,stirvin,stokkfrystur,stórsnjógvað,undirkavaður,undirklakaður,undirskelvturavtakin við ís;fjaldur undir, lagdur við gleri, ísi, kava;lagdur í ís;undir í kava;□hitin er, liggur niðan fyri frostmark(ið);tað er stirvið á jørðini↔kaldur,kava,kavi,kólna,krillutur,kuldakráka,kuldi,køla,køling,køliverk,svalligurAndheiti:ísfríur
frýggja	sílasta
frýnaður	síupplagdur
frýntaður	síupplagdur
frýntliga	síyndisliga
frýntligur	sígóðsintur
frýntur	síupplagdur
frýnur	sísinnalag
frýsa	síanda
fræ	Samheiti:frækorn,grasfræ,hvannafræ,kálfræ,korn,línfræ,ráfræ,rótafræ,sáð,sáðkorn,sólblómufræ(set)fræepli,setepli(flogsáð)dust,flog,matarmýggjblómufræ, rótafræ o.fl.(grókorn)gró(gróhópur)grógoymsla(avleggur)gróðurkvistur,gróðurteinur,ípot,setkvistur↔dyrka,dyrking,epli,gróðurnál,grógva,grøði,ísáð,spíringarføri,urt
fræa	sínørast
fræaður	sígróðrarbúgvin
fræast	sínørast
fræepli	síepli,fræ
frægd	síheiður
frægleiki	síbati
fræguleiki	síbati
frægur	síhóskiligur,navnframur
frækorn	sífræ
fræls	sífrídómur,frælsi
frælsa	símata
frælsi	sífrídómurSamheiti:bergfrælsi,bøbit,fræls,gásarfrælsi,neytarakstur,oksafrælsi,rossafrælsi,seyðafrælsi,veðrafrælsi,vetrarfrælsi,veturfrælsi,ærfrælsifrælsi undir gás, seyð o.fl.;rættur til beiti, bit↔rættindi
frælsisandi	sífrælslyndi
frælsisbardagi	síkríggj
frælsishetja	síavtakafólk
frælsiskríggj	síkríggj
frælsislogi	sífrælslyndi
frælsisstríð	síkríggj
frælsistrá	sífrælslyndi
frælsítróttir	síkapping
frælslyndi	Samheiti:framburðarhugur(frælsisandi)frælsislogi,frælsistrá(sjálvbjargnisandi)sjálvbjargnishugsan,sjálvbjargnishugur,sjálvbjargniskensla,sjálvbjargnistrá,sjálvbjargnistráan(sjálvstýrisandi)sjálvstýrishugsan,sjálvstýrishugsjón(tjóðskaparkensla)tjóðskaparandi,tjóðskaparromantikk↔frídómur,frílyntur,frímaður,fríur,mikilleiki,uttanveltaðurAndheiti:undirlutakensla
frælslyndismaður	sífrímaður
frælslyndur	sífrílyntur
frælslyntur	sífrílyntur
frælsur	sífríur
frænarormur	síævintýrhugtak
frændaleysur	síeinsamallur
frændi	sískyldfólk,vinur
frænir	síillgruni
frænutur	síprikkutur
fræsa	síanda
frætta	síboðan,frættast,njósnari
frættast	Samheiti:fúka,gramlast,hoyrast,ljóða,orðast,ryktast,sigast,spyrjastfara, ganga (sum slatur) um bygdina;fara sum grindaboð um landið;førast út í orð;ganga sum eldur um bygdina;ganga sum rótasúpan;gerast kunnugt;hoyrast, frættast sum slatur;hoyrast graml um;koma upp;koma (út) í mannaróp, orð, spargament;leka út;vera á mannatungu;verða havt á, við orði, verða sagt;□e-t ber orð fyri at...;e-t berst e-m fyri oyru, kemur fyri oyruni á e-m;fólk, leysatíðindi, menn halda, siga, vilja vera við;gomul søgn, vanlig áskoðan er at...;mann, onkur heldur, sigur at...;orð er havt um, gongur av at...;so er sagt at...;søgnin sigur (frá) at...;søgur, tíðindi ganga frá, um at...;tað er ført út í orð;tað er manna søgn at...;tað er snakk, hoyrist manna millum, millum fólk, millum manna;tað feyk, fýkur (ímillum) at...;tað fór skjótt um bygdina at...;tað gramlast um at...;tað hevur ligið á ljóði;tað hevur ljóðað at...;tað verður hildið at...;talað hevur verið um(frætta)fregna,hoyra,sannspyrja,spyrjafáa at frætta, hoyra, vita o.fl.;fáa e-t stungið í oyrað;fáa frænir, sprakk av e-m, frætta leysliga um e-t;fáa sannspurt t.e. frætta sannleikan;fáa uppspurn, uppspurning um;fáa uppspurt;fáa vitan um;hoyra gitið, grett, sagt, umrøtt, umtalað o.fl.;hoyra graml um;spyrja upp(uppspurdur)fregnaður,frætturkomin fram í ljósið;komin fyri ein dag;□nú er gátan gitin↔boða,boðan,boðberi,hoyra,lurta,millum manna,mær vitandi,opinskáraður,slatrivætti,slatur,tíðindafróður,tos
frættin	síforvitin
frættindi(r)	síboðan
frættur	sífrættast
frøa	sígleða ein
frøast	sígleðast
frøðiheiti	sínavn
frøðimaður	sífróðarmaður
frøðingur	sífróðarmaður
frøðiorð	sínavn
frøi	sígleði
frøkna	síblettur
frøknutur	síprikkutur
frøkun	síkvinna
fubb	síreyp
fubba	síreypa
fubbari	síreypari
fuga	sískoyti
fuglaagn	síagn
fuglaberg	síberg
fuglabjørg	síberg
fuglabyrða	síbyrði
fuglabyrði	síbyrði
fuglabýti	síbýti
fugladúrur	sísvøvnur
fuglafleyg	síbakkagonga
fuglaflokkur	Samheiti:fuglameingi,fuglaringur,fuglavað,gásabøli,gásaflokkur,hvítfylgi,krákuting,lomvigagarður,lomvigarás,lomvigatorva,lomvigatyssi,lundaringur,skrápatorva,staraflokkur,súluvaðmongd av fugli↔fiskatorva,fuglur
fuglahamur	síhúð
fuglahundur	síhundur
fuglahøvd	síhøvur
fuglakrógv	sígoymsla
fuglaland	síberg
fuglalát	sískríggj
fuglalistir	sítungumál
fuglalíkindi	sígóðveður
fuglaljóð	sískríggj
fuglaljómur	sískríggj
fuglamaður	síveiðimaður
fuglamatur	símatur
fuglamál	sískríggj,tungumál
fuglameingi	sífuglaflokkur,fuglur
fuglaoyðin	síuppfiskaður
fuglapláss	síberg,reiður
fuglaringur	sífuglaflokkur,fuglur
fuglaríkur	síavtakin
fuglarók	síreiður,rók
fuglaræða	síræðumynd
fuglasessur	sísessur
fuglasetur	síberg
fuglasjongur	sískríggj
fuglaskarn	sílortur
fuglaskjóting	síveiðing
fuglaskræpa	sílortur
fuglasoð	sívatn
fuglasongur	sískríggj
fuglaspor	síspor
fuglastovnur	sífuglur,skipan
fuglastyggja	síræðumynd
fuglatíggjund	síavgjald
fuglaungi	sífuglur,ungi
fuglavað	sífuglaflokkur
fuglaveiða	síbakkagonga,fongur,veiðing
fuglaæti	símatur,yngul
fugletin	símótfallin
fuglhundur	síhundur
fuglur	Samheiti:akurhøna,akurhøsn,akurskrift,akurskritt,albatrossur,alifuglur,alipisa,antarfuglur,antarpar,antarsteggi,antarungi,apingarfuglur,arnarbøga,arnarungi,atkomufuglur,áarpisa,álka,álkupisa,álkustebba,álkusteffa,ársungi,bakfuglur,bakkalundi,baksskuri,baksungi,bakur,bansi,bárabjarti,bárafjatla,bárafjertur,beinsi,beltilundi,beltislundi,bibbur,bidna,birna,bjargafuglur,bjargalíri,bláa heimi í túni,blábøka,bládúgva,bliki,blikur,bløðruskalli,bløka,bramgás,brandgás,breiðingarlundi,brimont,bringureyði,brævdúgva,búfuglur,búlundi,búravnur,búrhøsn,byggingarálka,byggingarfuglur,byggingarlomvigi,byggingarlundi,bøga,bøgás,bøguungi,digga,dimmilíri,dimmilundi,dirðil,dráttrarlíri,dráttrarlundi,drunnhvíti,dunna,dunnubilla,dunnupar,dunnusteggi,dunnuungi,dúgva,dúgvuungi,dúnungi,dúva,dúvuungi,døggreyv,eggfuglur,eggrassur,ekrugás,ennigul ont,ennissvartur tyrningur,erla,erla kongsdóttir,faksaterna,falkur,fálkur,feigdarfuglur,felliskráka,ferðafuglur,fiskaørn,fiskimási,fiskiørn,fitfuglur,fitjufuglur,fjallalíri,fjallamurra,fjallarýpa,fjallmurra,fjatla,fjóshøna,fjørulógv,fjørugrátítlingur,fjørutjaldur,fleygafuglur,fleygalundi,fleyganáti,flogfenaður,flytifuglur,fransaterna,frebbi,fuglameingi,fuglaringur,fuglastovnur,fuglaungi,fulkobbi,fulkubbi,fyglingarfuglur,gagga,gagnfuglur,gás,gásabøli,gásaflokkur,gásapar,gásarbøga,gásarfuglur,gásarsteggi,gásarungi,gásasteggi,geirfuglur,geldfuglur,geldgás,geldhani,geldskrápur,geldskúgvur,geldsteggi,gestur,geykur,gjør,glibbari,gneggjus,gorfuglur,gorpur,grasálka,gravont,grábøka,grágás,grágrælingur,grálógv,gráspurvur,grásúla,grátítlingur,grátyrningur,grindubøka,grýtissmyril,grælingsungi,grælingur,gyllingur,gøðingarungi,hagafuglur,hagri,hakaspjað,hanapullur,hanaungi,hani,hanungi,havgás,havhestaungi,havhestur,havskrápur,havtyrðil,havørn,hálsareyði,hárloypingur,hegri,heiðafuglur,heimafuglur,heimagás,hellufuglur,helsareyði,helsigás,helsingagás,helsiont,helsión,herfuglur,heykur,heystkjúklingur,hin bláa,hin bláa á køstinum,hin blábøkuta,(hin) svarti,hin tunguleysi,hin vangagrái,hiplingur,hjallalíri,hjaltakráka,hjaltlandskráka,hornugla,húsfenaður,húsfuglur,hvítibúkur,hvítkjógvi,hvítkjói,hvítravnur,hvítsúla,høganev,høna,hønuungi,høsn,høsnafuglur,høsnarungi,illbrimil,illfuglur,illveðursfuglur,illveðurskráka,imbrimil,innskotsfuglur,ígða,íslandslomvigi,íslandsmási,jaðrakona,jarðarkona,jarðarlundi,jarmari,jói,kalkun,kalkunur,kalkúnur,kanariufuglur,karkarassur,karkareyði,karkur,kattugla,kattúla,kjarnbítur,kjálkagrái,kjóapisa,kjógvapar,kjógvi,kjói,kjósungi,kjúklingur,kjúlingur,klivfuglur,klófuglur,knópsvanur,knubbsvanur,kolont,kongalundi,kongaørn,koparsnípa,korðuvongur,korðvongur,korngás,kot,kráka,krákukárn,krákungi,krákuungi,krikkont,krikont,krossnev,krummi,krunkur,krypilsont,kryplingsont,kverkveggja,kvøldlundi,kvørkveggja,kvørkvekkja,kvørkvikkja,kvørkviski,kvørkvisni,køstafuglur,landørn,larrassi,lavrassi,lá,láartrælur,láarungi,lár,lára,látufuglur,láturita,leggingarhøna,legufuglur,leguhøna,lerkur,liðarfuglur,liggingarhøna,likka,likkuskuri,likkuungi,líri,lokkingarfuglur,lomviga,lomvigagarður,lomvigakneppa,lomvigakneppi,lomvigapisa,lomvigarungi,lomvigastebba,lomvigasteffa,lomvigatorva,lomvigatyssi,lomvigi,lortamási,loynilíri,lógv,lómur,lundapisa,lundatorva,lundi,lúsamunkur,lúsaskarvur,lynghøsn,lýsifuglur,lýsilomvigi,matfuglur,mánadúgva,mánansdúgva,másaskuri,mási,máur,mávur,meyrus,mintafuglur,morbøkutur tyrningur,morgunlundi,mortítlingur,munkur,músabróðir,músvákur,myrisnípa,myrrusnípa,mýrisnípa,nalvungi,nápur,náta,náti,náttarfuglur,náttargali,náttargalur,náttarlíri,náttarlundi,náttfuglur,náttskarvur,nátungi,nærindislundi,oddagás,okn,oljulomvigi,omanbergsfuglur,ompil,ont,orri,oyðifuglur,oyðimási,oyðiskrápur,oyðisúla,óðinshani,óella,óerla,ógvella,ógvølla,óveðursfuglur,óveðurshani,óveðurskráka,pallalomvigi,pappageykur,páfuglur,pelikánur,pingvin,pippa,pippur,pippus,pisa,pisulundi,polladunna,posafuglur,pullur,pumpuringur,puppuringur,rakfuglur,rakhøna,ravnsungi,ravnur,ránfuglur,ránsfuglur,rásarfuglur,rásarlundi,rekafuglur,reyðbrystingur,reyðkollur,reyðspógvi,ringlomvigi,rita,ritupisa,rituungi,roðbuksuskarvur,rovfuglur,rúðurbori,ryta,rýpa,ræfuglur,rægammur,røtugás,sagont,sandgrælingur,seiðafuglur,setrafuglur,setralundi,setulundi,sigga,sildafuglur,sildahøna,sildberi,síltringur,sjófuglur,sjógrælingur,sjógvhøna,sjóhøna,skaðafuglur,skarnskortur,skarvakneppa,skarvsungi,skarvur,skata,skatumási,skeiva,skjóra,skrápatorva,skrápur,skrukka,skrukkhøna,skuggafuglur,skurapisa,skuri,skúgvur,skúlvtyrningur,skúvsungi,skúvur,smáfuglur,smyril,snípa,snjófuglur,snjótítlingur,snjóugla,snældukjógvi,snælduont,sótdirðil,sóttræ,spegilsont,spetta,spjørr,spógvi,spói,spónont,spósreyv,spósungi,spritlundi,spritulundi,spurv,spurvafuglur,spurvur,spæta,staraflokkur,stari,starvongur,stálkoka,stebba,steffa,steggi,steggjaungi,steikifuglur,steikipisa,steinstelpa,steinstólpa,stelkur,sterruvongur,steyrvongur,stikkont,stinkur,stjórafuglur,stokkont,storkur,stórfuglur,stórskrápur,stórvongur,strandfuglur,strálundi,strokalundi,strokfuglur,strokhavhestur,strokungi,strutsur,støðufuglur,summargrátítlingur,sutlont,súgont,súla,súlukongur,súluompil,svala,svalbarðsgás,svali,svanur,svartbaksskári,svartbaksskuri,svartbakur,svartfótafuglur,svartfuglaætt,svartfuglur,svarthálsa,svartstakkur,sveimari,svøvnskarvur,sýldur drunnhvíti,sæðingur,tangspógvi,tannont,teistapisa,teisti,terna,ternubøga,ternupisa,ternuungi,teymont,tíggjundarlundi,títlingskongur,títlingur,tjaldur,tjaldursflokkur,tjaldursgrælingur,tjaldurspar,tjaldursungi,tjóðfuglur,tjørulomvigi,tommur,toppa,toppalundi,toppont,toppskarvur,toppudunna,toppusteggi,tornfalkur,trani,trastaætt,trastur,troyggja,trælalógv,trøllont,trøstur,turkadúgva,turtildúgva,turtildúva,tyrningur,ugla,ugli,uglubóndi,ullarkona,ungagás,ungamamma,ungapipp,ungfuglur,ungi,unglomvigi,unglundi,upsarlundi,urðarkona,urðarlundi,urðnakona,úla,vaðfuglur,vaktil,valmásaskuri,valmási,vatnskalli,vatnskøltur,vattarbak,válkapisa,válkur,várfuglur,várklukka,vátiskalli,veðurfuglur,veiðifalkur,velhvítaungi,velhvíti,vendingarfuglur,verpingarfuglur,verpingarhøna,vetrarfuglur,vetrarlógv,vetrarnáti,vetrarsnípa,vetrartjaldur,villdunna,villdúgva,villdúva,villgás,villidunna,villinifuglur,vípa,vætuskøltur,æða,æðubliki,æðublikur,æðuflokkur,æðukongur,æðuungi,ørn↔fuglaflokkur
fukka	símakast
fulkobbi	sífuglur
fulkubbi	sífuglur
fullamannatvass	símøsn
fullbatnaður	síbatnaður
fullbirgur	síarbeiðsførur
fullborin	sífullkomin,gróðrarbúgvin
fullbúgvast	síhenda
fullbúgvin	sígróðrarbúgvin,tilbúgvin
fullbúnaður	sígróðrarbúgvin,tilkomin
fulldyggur	símunadyggur
fulldøkkur	sílitaður
fullfeitur	síhovin
fullfermdur	sílaðin
fullfermur	sískjótførur
fullfíggja	síenda
fullfíggjaður	síarbeiðsførur,endaður,fullkomin,fullmannaður
fullfjaðraður	sífloygdur,tilkomin
fullfjarað	sífjøra
fullfjaraður	sífjøra
fullfløddur	síflóð
fullfløtt	síflóð
fullfrískur	síarbeiðsførur
fullføra	síenda
fullførdur	síendaður
fullførur	síarbeiðsførur,tilkomin
fullgera	síenda
fullgildi	sígildi
fullgildigur	sísannur
fullgildur	sísannur
fullgingin	sítvílívað
fullgjølla	sítýðiliga
fullgjørdur	síendaður,fullkomin
fullgóður	sídygdargóður,tryggur
fullgrasaður	síloðin
fullgreiður	sígreiður
fullhugaður	síáhugaður
fullinna	síenda
fullkoma	síenda,nøkta
fullkomast	síbúnast
fullkomileiki	sífullkoming
fullkomiliga	síógvuliga
fullkomin	síendaður,tryggurSamheiti:fullborin,fullfíggjaður,fullgjørdur,heilborin,heildargóður,heilrendur,heilrunnin,heilskapaður,heilsligur,hugaheilurførdur út í æsir;□hann var einki upp á hálvt↔samanhangandi
fullkoming	Samheiti:fullkomileiki,fylling,tíðarfyllingfylling tíðarinnar;tá ið tíðin er komin
fullkønur	Samheiti:alkunnugur,alkunnur,alkønur,bátsvandur,byggikønur,byggingarkønur,dugnaligur,fermur,fimur,fullroyndur,fullsigldur,hákønur,kringur,kunnugur,kønur,køstugur,læknakønur,margkønur,meinkunnigur,meinkunnugur,meinkønur,royndur,serkønur,servandur,sjóvandur,streymkunnugur,streymkønur,vandur,vanur,verkkønurgamal í garði, gøtuni;gløggur á..., í...;royndur í leikum;stinnur í at...;tikin úr leiki;vandur upp við e-m, e-t;væl royndur;□hann hevur ikki altíð havt góðar dagar, ikki havt tað lætt;hann hevur mangan beiskan farið;hann seyp ikki søta mjólk, søta súpan, søtt hvønn dag;honum hevur ofta ligið vátt undir føti(vera fullkønur)duga væl at...;hava drúgvar royndir;hava havt, liðið, tolað, tolt manga ymisku;hava køvt mangt ælið, mangt ælið køvt;hava manga(n) bratta(n), salta(n) farið, klovið;hava mangan súran sopið, mangt vásið vappað;hava roynt, upplivað e-t áður;hava staðið, verið í hildarleiki, vási, víggi;hava verið í báti fyrr;hava verið í mongum lótum, royndum, vanda, vási;hava verið í víggi staddur;kenna e-t sum sína høgru hond;kenna, kunna væl listir og leikir;kunna væl snildir;vera alkunnur, bátsvandur, køstugur royndur o.fl.;vita av egnum royndum, frá sær sjálvum↔fáa mótstøðu,lærdur,raskur,skjótførur,staðkendur,vælvirkinAndheiti:leikmaður,óvanur
fulllastaður	sílaðin
fullliðugur	síendaður,tilbúgvin
fullljósur	sílitaður
fulllærdur	sílærdur
fullløddur	sílaðin
fullmanna	síútnevna
fullmannaður	Samheiti:fjallførir,fullfíggjaður,fullskipaður,mannaður,ovmannaðurvæl mannaður upp á konufólkahondina, mannfólkahondina;við allari, fullari manning;við fullum áseyðatali(fjølmentur)mannsterkur,vælmannaður,væl mannaður(undirmannaður)fámentur,hálvmannaður,veikmenturikki fjallførir;illa mannaður upp á konufólkahondina, mannfólkahondina;ov illa mannaður;við hálvari, lítlari manning(ómannaður)ikki fullmannaður↔fáur,manning,nógvur,skipan,tilnevning,útnevna
fullmataður	sígróðrarbúgvin
fullmentur	síarbeiðsførur,tilkomin
fullnýta	sígóðska
fullnøgdur	sínøgdur
fullprógvaður	sísannur
fullriggaður	sísjófar
fullriggari	sísjófar
fullríkur	síríkur
fullroyndur	sífullkønur
fullrygndur	sítilkomin
fullræði	sívald
fullsamdur	sísamdur
fullsettur	sílaðin
fullsigldur	sífullkønur
fullskegg	sískegg
fullskipaður	sífullmannaður,nøra
fullspottaður	síspottaður
fullstaðin	sígróðrarbúgvin
fullsterkur	síarbeiðsførur
fullstyrknaður	síarbeiðsførur,batnaður
fullsvøvntur	síalvakin,ómóður
fulltakin	síarbeiðsførur
fulltakka	sítakka
fulltikin	síarbeiðsførur
fulltíðarstarv	sístarv
fulltjúknaður	síhovin
fulltrú	síváttan
fulltrúgvi	sívaramaður
fulltrúi	sívaramaður
fullturrur	síturrur
fulltøkin	síarbeiðsførur
fulltøkur	sílíkur
full undir lúkurnar	síjavnstrokin
fullur	síaldutur,drukkin,javnstrokin,laðin,óskerdur,ríkiligur
fullur gamalseyðakjaftur	sítonn
fullvakin	síalvakin
fullvaksin	sítilkomin
fullvegis	síógvuliga
fullveldi	sívald
fullversnaður	síendaður
fullvirkaður	síendaður
fullvissa	sísannføring
fullvitaður	síklókur
fullvitugur	síklókur
fullvísur	sívissur
fullvæl	sísanniliga
fulnaður	sívælnøgd
fulpur	síklumpur
fulputur	síkvapsutur
fult	síógvuliga
fumma	síroykja,roykur,rúka,toka
fummisliga	síósmidliga
fummisligur	síbusutur
fummum	síarbeiða óvandaliga,busutur
fundarboð	síboðan
fundarbók	sífrásøgn,yvirlit
fundarevni	síumrøðuevni
fundarfrásøgn	sífrásøgn
fundarhald	sífundur
fundarhøli	síhøli
fundarsalur	síhøli
fundarsamtykt	sídómur
fundarskrá	sískrá,umrøðuevni
fundarslit	síendi
fundarviðgerð	síorðaskifti
fundast	sísiga
fundur	sífinningur,kríggj,viðrakingSamheiti:aðalfundur,aðalting,alfundur,altjóðafundur,ársaðalfundur,ársfundur,ársmøti,ástaðarfundur,bíbliufundur,borgarafundur,búnaðarstevna,bygdarstevna,bønafundur,bønamøti,byggifundur,býráðsfundur,eykaaðalfundur,eykafundur,fagnaðarfundur,fagnaður,felagsfundur,fimleikafagnaður,floksfundur,floksting,foreldrafundur,fólkafundur,fundarhald,gleðifundur,grannalag,grannaskikkur,grannastevna,hagafundur,hagastevna,hátíðarstevna,heimating,herráð,hugnakvøld,hústing,høvuðsfundur,høvuðsting,kirkjufundur,kirkjustevna,kirkjuting,kjakfundur,krákuting,kreppufundur,kunningarfundur,kvinnufundur,kvøldseta,landafundur,landbúnaðarstevna,landsfundur,landsstýrisfundur,limafundur,loyndarfundur,loynifundur,løgtingsfundur,mannafundur,meginting,mikkjalsmessufundur,mikkjalsmessumøti,millumlandastevna,millumtjóðastevna,mót,mótmælisfundur,møti,nevndarfundur,næmingafundur,oddafundur,ólavsøkuting,pallborðsfundur,prestastevna,ráðstevna,ríkisráð,rokfundur,rættarfundur,samankoming,samfelagsfundur,samfelagsmøti,samgongufundur,samkoma,samkoming,samkomulag,samráðingarfundur,samtala,savning,sáttarfundur,semingsfundur,skiftafundur,skundfundur,snarfundur,stovningarfundur,støðarmøti,summarstevna,telefonfundur,ting,tingfundur,tinghald,tjóðfundur,toppfundur,ungmannafelagsfundur,ungmannafundur,uppbyggingarfundur,uppstillingarfundur,umboðsmannafundur,útifundur,útimøti,valfundur,vekingarfundur,veljarafundur↔afturhitting
fundvísur	sísjónligur,staðkendur
funi	síroykur
funkuknappur	síknøttur
funs	síbarbrot,kloddakot,ótrivavætti,vavstur
funsa	síarbeiða óvandaliga
funsutur	síbusutur,frísutur
fura	síførka,skunda sær,viður
furða	síundurverk
furkutur	síóskapiligur,rukkutur
furustavur	sístavur
furuviður	síviður
fuss	símøsn,møsnari
fussa	síendurtaka,kóka,møsna,spræna
fusskóka	síkóka
fuva	síroykja,rúka,toka
fúgvi	sírot
fúgvin	sírotin
fúka	sífrættastSamheiti:fáma,físa,foysa,froysa,guva,jarðkava,kveistra,pístra,pústra,ríva,rúka,sjóleggja,strúka(støva)bosa,disma,dumba,dusma,dusta,dymba,rigna,ryðjafara á fok, í luftina, ríva, verða tikin av vindi;fara fúkandi, rúkandi, strúkandi;fletta upp um seg (um áir) t.e. fáma, fúka niðaneftir, uppeftir;fúka, rúka upp;fúka uppum (um foss) t.e. standa í andarisi;gera rok;standa upp í loft(gjósa)trekkja□tað físir, pústrar ígjøgnum (e-t)(foykja)físpa,foysafáa at fúka;oysa upp(eftir);seta í røring↔froysan,ríva,rokilsi,spræna
fúkandi	sílandvegin,vreiður
fúlna	sídraga á luftina
fúlsligur	símisháttur
fúlur	símisháttur,ósømiligur
fúna	sírotna
fúnaður	sírotin
fúsleiki	sídugnaskapur,megi
fúsur	síáhugaður,raskur,styggur,villigur
fútabann	síforboð
fútadeyði	sídeyði
fútaforboð	síforboð
fútagarður	síbústaður
fútakráka	sífínarimpa
fútaskifti	sítíðarskeið
fútaskrivstova	síbygningur
fygla	sífleyga
fygling	síbakkagonga
fyglingarfuglur	sífuglur
fyglingarlummur	sískefti
fyglingarmaður	síveiðimaður
fyl	síross
fylabýttur	sítápuligur
fylakæti	sígleði
fylbýttur	sítápuligur
fylgd	Samheiti:fylgdarmaður,fylgdarmoy,fylgdarsveinur,fylgi,fylgismaður,fylgisneyt,fylgisneyti,fylgisneytur,fylgisveinur,geingi,leiðarsveinur,leiðisveinur,samferðarmaður,samleið(brúðarfylgi)brúðarfólk,brúðargenta,brúðarkona,brúðarmaður,brúðarmoyggj,brúðarskari,brúðfólk,brúðkona,brúðmaður,offurfólk,offursfólk,offurpar,peikustoyla(líkfylgi)gravarfylgi,gravarskari,líkskari↔umgangast
fylgdarmaður	sífylgd
fylgdarmoy	sífylgd,hjálpari
fylgdarsjúka	síeftirfylgja
fylgdarsveinur	sífylgd
fylgi	sífylgd,hinna,nøgd,seyður
fylgiblað	síískoyti,skriv
fylgibræv	sískriv
fylgin	síáhugaður
fylgiseðil	sískriv
fylgisfastur	sístaðfastur
fylgiskjal	sískriv
fylgiskriv	sískriv
fylgismaður	sífylgd,partamaður
fylgismoyggj	síhjálpari
fylgisneyt	sífylgd
fylgisneyti	sífylgd
fylgisneytur	sífylgd
fylgispæl	sítónalag
fylgisveinur	sífylgd
fylgja	síárin,eftirfylgja,endaúrslit,jarða,ævintýrhugtak
fylgjakenning	sírættindi
fylgjast	síumgangast
fylgsni	sígoymsla,nøgd,vernd,ævintýrhugtak
fyljabásur	síseyðarætt
fyljaleggir	sígongulimur
fyljaryssa	síross
fyljaryssukníggjaður	síkálvakníggjaður
fyljatenn	sítonn
fylki	síluteind
fylking	sífelag,flokkan,herlið,nøgd,luteind
fylkingarmerki	síeyðkenni
fylkja	síflokka,hópa
fylkjast	síhópast
fylla	sífylla ár,gera aldu,ífylla,lossa,rúgva uppSamheiti:kjokka,ovfylla,ovlaða,pakka,proppa,roka,skeinkja,stappa,steinstappa,stúgva,stúva,uppfyllafylla afturáaftur, afturíaftur;fylla á kjaft, kjokk, tremur, í døbba, proppin o.fl.;gera uppí (indur, sperðil);grabba, kvísla, skeiða, skumpa, skupla, spaða, spaka (upp) í e-t;hella, hvølva, koyra, lata, oysa, renna, stoyta á, í, uppí, útí;stinga í, niður, upp↔javnstrokin,kroysta,laðin,lossaAndheiti:tøma
fylla ár	Samheiti:fyllafylla í árinum;fylla runt;hava (rundan) føðingardag↔hátíð
fyllast	síjavnstrokin
fylli	sínøgd,ogn
fyllibytta	sídrankari
fyllikíkur	sídrankari
fylling	sífullkoming,ífylla,sjóvarilska
fyllisandur	síífylla
fyllskapur	sídrykkjuskapur
fylskotin	símissa fostur
fyltung	síkviðin
fyltur	síjavnstrokin
fynd	síklókskapur,megi,standur
fyndargóður	síklókur
fyndarleysur	sídygdarleysur,kraftleysur
fyndarorð	símegnarorð,tos
fyndarríkur	síklókur
fyndigur	síklókur,orðkringur
fyndugur	síklókur,orðkringur
fyri	sífyrr,upplagdur
fyribeindur	síbrotin,deyður,fyrigingin
fyribeining	sídráp,skaði
fyribils	eina tíð;eitt sindur enn, nakað enn;enn ímeðan, meðan...;fyri bráðfeingi;fyri fyrst;í bráðfeingi, bráðskundi;í knappari vending, knøppum viðbragdi;í løtuni;meðan soleiðis er vorðið, stendur til;nakað framá, frameftir;nú, hetta meðan...;so ein hjálpist hagar til, inntil...;sum er, sum sakir standa;sum nú er;til bráðfeingis↔altíð,brádliga,fyrr,fyrst,higartil,leingi,liðin,lívstíð,løta,nú,ofta,síðani,skjótt,tíðarskeið,tíðliga,upprunaliga,útliðið,varandi,æviga
fyribilsformaður	sívaramaður
fyribilsgjald	síforskot
fyribilshjálp	síhjálp
fyribilsloyvi	sírættindi
fyribilsstjóri	sívaramaður
fyribilsstjórn	sívaramaður
fyribilsumvæling	síafturbøting
fyribirgin	síeftiransin,eftirsíggin
fyriboðan	síspádómur
fyribrigdi	síhending
fyriburður	síspádómur
fyribúgva	síbúgva út
fyribúgvin	sítilbúgvin
fyribúningur	sífyrireiking
fyribyrging	Samheiti:forsvar,gitnaðarverja,mótverja,neyðverja,sjálvverja,verja,verjutiltakfyribyrgjandi evni(skýgging)avbyrging,frábyrging,sóttarhald,sóttverja↔ansni,eftiransin,eftirlit,passa,skýggja,verja
fyribyrgja	síhindra,verja
fyribøn	síbønarhald,verja annan
fyribøting	sívernd
fyridøma	síbannseta,lasta
fyridømi	Samheiti:dømi,eftirdømi,fyrimynd,mynstur(leiðregla)leiðarstjørna,stavnhald(læriskeyti)mynstur,navnaklútur↔formur,ímynd
fyridømiligur	sífrálíkur
fyridøttur	síspádómur
fyrifarast	síhenda
fyrifarist	síhenda
fyrifjøl	síútlinja
fyrigera	síoyðsla burtur
fyrigerð	sífyrireiking
fyrigering	sífyrireiking
fyrigeringar	sífyrireiking
fyrigeva	Samheiti:avsaka,forláta,fyriláta,orsaka,tilgeva,umberabera yvir við e-m;geva e-m nakað eftir;halda e-m til góða(r);lata e-t verða gloymt;strika skuld;taka útyvir (e-t, við e-m)(tolnast)hava tol, umbæri o.fl;kunna bíða;sýna tol og umbæri;vera tolin, tolsamur o.fl.(rættvísgera)fjala lýti;breiða reint lak út yvir skitna song;káva, skava, taka útyvir (e-t)↔angra,fyrigeviligur,fyrigeving,tol,verja annanAndheiti:hevna,illminnast
fyrigevandi	sífyrigeviligur
fyrigeviligur	Samheiti:afturbøtandi,bótaligur,fyrigevandi○sum kann bøtast aftur, fyrigevast;sum stendur til bata, kann bjargast;□hatta var so óskyldugt (gjørt, sagt)↔angra,fyrigeva,fyrigeving
fyrigeving	Samheiti:avsakan,eftirgáva,eftirgeving,eirindi,forlátilsi,griður,lívd,miskunn,miskunnsemi,náð,náði,náðing,orsakan,pardón,umbering,umbersla,várkunn(viðkensla)eymkan (við e-m),samhugi,samhugur,samhugalýsing,samkensla↔angra,bírætta,bírætting,fyrigeva,fyrigeviligur,skálkaskjól,tolAndheiti:hevnd
fyrigingin	Samheiti:brotin,fyribeindur,oyðilagdur,uppsteðgaðurfarin í baklás;gingin fyri;í ólagi, óstandi;steðgaður upp;○sum ikki gongur, riggar, virkar↔brotin,brotna
fyrigongumaður	síoddamaður
fyrigrøði	sígrøði
fyrigykla	síímynda sær
fyrihyggin	síeftiransin
fyrihyggja	síansni
fyrijátta	sílova
fyrijáttan	sílyfti
fyrijátting	sílyfti
fyriklæði	síforhang
fyrikomandi	sígóðsintur
fyrikoming	síhending
fyrilagaður	sílagnubundin
fyrilagstur	síútmøddur
fyriláta	sífyrigeva
fyrilesari	síheimild
fyrilestrasalur	síhøli
fyrilestur	síbókalestur,tos
fyrilit	síafturhald,ansni
fyrilitsleyst	síóskilaliga
fyrilitsleysur	síbusutur,mannvándur,tápuligur
fyrilitsloysi	sívansketni
fyrimaður	sífyrrverandi
fyrimál	síáhugi
fyrimáli	síinngangsorð
fyrimuni	sígagn
fyrimunur	sígagn
fyrimynd	sífyridømi
fyrimyndarligur	sífrálíkur
fyri neyðini	fyri bestum;fyri neyðum;□tað er, var væl;tað treingist til;tað var í tøkum tíma;tað var nú ella aldri;tað var tíð upp á, upp á tíðina↔frálíkt,galda um,hóskiligur,neyðugur,tíbetur,týðandiAndheiti:óneyðugur
fyrireika	síbúgva út
fyrireikaður	sítilbúgvin
fyrireikan	sífyrireiking
fyrireiking	Samheiti:fyribúningur,fyrigerð,fyrigering,fyrigeringar,fyrireikan,grindarok,grindavás,hávasták,hávi,hóvasták,keinan,ómak,ómaki,ómakur,rok,rokan,roks,roksl,rus,rús,skundan,starv,sták,stákan,stríð,svarv,tilbúgving,tilbúningur,tilgerð,tilgering,tilgeringar,tilrigging,umbúnaður,umbúni,umbúningur,uttanumfjas,útgerð,vás,øsnstákan og kákan↔búgva út,byrja,byrjan,dubbing
fyrisetan	síásetan
fyriseting	síorð
fyrisetingarorð	síorð
fyrisetningur	síverkevni
fyrisettur	síásettur
fyrisitin	sístjórna
fyrisiting	sívald
fyriskipaður	síásettur,stjórna
fyriskipan	sílóg,skrá
fyriskipari	síoddamaður
fyrisnúður	sísnúður
fyrisprákari	síoddamaður
fyrispurningur	síspurningur
fyristaðið	sístjórna
fyristílaður	sístjórna
fyristøða	sívald
fyristøðukvinna	síoddamaður
fyristøðumaður	síoddamaður
fyrisæti	sívald
fyrisøguligur	síaldrandi
fyritaksandi	sídirvi
fyritakssemi	sídirvi
fyritonktur	síeftiransin
fyritráður	síband
fyritreyt	sílíkindi(r)
fyritøka	síbaksan
fyritøkumerki	síeyðkenni
fyrivarin	síeftiransin
fyrivarni	síansni
fyrivarningur	síspádómur
fyrivarur	síeftiransin
fyriætlan	síendamál,skrá
fyrnast	síeldast
fyrndarbrúk	sívani
fyrndarbygd	síbýur
fyrndargamal	síaldrandi
fyrndargøta	síkoyrivegur
fyrndarhús	síbústaður,bygningur
fyrndarkirkja	síkirkja
fyrndarsiður	sívani
fyrndarslag	sískyldfólk
fyrndarsteinur	sígrót
fyrndarvegur	síkoyrivegur
fyrndur	síavlagdur
fyrningarfreist	sífrest
fyrningartíð	sífrest
fyrnska	síluktur,rotna
fyrntur	síniðurdottin
fyrr	Samheiti:áður,einaferð,einusinni,frammanundan,fyri,herfyri,nýliga,onkrantíð,onkuntíð,undanafturi í bláastu miðøld;áðrenn, eftir, fyri Kristi føðing;áðrenn, fyri mína, okkara tíð, tíðarrokning;á sinni;eina ferð(ina);einaferð í tíðini;ein dagin (herfyri);eitt árið;fyri (eini) tíð, viku síðan(i);fyri kortum, stuttum;fyri langari tíð síðan;(fyri) langt, løtu síðan(i);fyri nøkrum árum, døgum, mánaðum, minuttum síðan(i);fyri skammari løtu, stund (síðan(i));fyrr á døgum;fyrr, tíðliga í tíðini;fyrst í fyrndini;henda dagin;í (av)gamlari tíð;í (av)gomlum døgum;í áðni;í farnu, fornu øld;í fjør, forðum, fornøld, fyrndini;í fyrndartíð;í gamlar dagar;í lidnum døgum;(í) seinasta, síðsta mánað;í seinastuni, síðstuni;(í) seinastu, síðstu viku;í teimum døgum;í teirri tíð(ini) (tá ið...);í teirri, tí seinastu tíðini;(langt) burt(ur) í tíðini;langt (í verðini) síðan(i);nakað (langt) síðan(i);(nú) eina náttina;(nú) ein dagin, morgunin;(nú) eitt árið, kvøldið;nøkur ár herfyri;onkuntíð fyrr;stutt herfyri, síðani;(ta) seinastu tíðina;tá í tíðini;tíðliga í...;um daginar, dagini, degini;□hevði eg ikki havt syndað síðan...;tað er bæði dagur og vika síðan(i);tað er mangur dagur á jørðini síðan...;tað er mong áin í havið runnin síðan(i)↔alsamt,altíð,brádliga,framvegis,fyribils,fyrst,higartil,leingi,liðin,lívstíð,løta,nakrantíð,nú,ofta,síðani,skjótt,ta ferð,tíðarskeið,tíðliga,upprunaliga,útliðið,varandi,æviga
fyrrapartsvakt	sívaktarhald,vaktari
fyrr enn ikki	síav illum
fyrrnevndur	síáðurnevndur
fyrrv.	sífyrrverandi
fyrrverandi	Samheiti:fyrrv.,fráfarni,gamli,táverandi,undanfarni(undanmaður)fyrimaður○sum áður, fyrr var;sum hevur verið, var;sum var undan hesum↔áðurnevndur
fyrst	sínúSamheiti:allarfyrst,alrafyrst,fyrstaat byrja við;á fyrsta sinni;fyrstu ferð;í byrjanini;í fyrsta bragdinum;í fyrsta eygnakasti, umfari;í fyrstani, fyrstuni;í fyrsta upphavi;í fyrstu syftu;í, við fyrstu atløgu;tað fyrsta;við fyrsta brest, eygnakast↔altíð,brádliga,fyribils,fyrr,higartil,leingi,liðin,lívstíð,løta,nú,ofta,síðani,skjótt,ta ferð,tíðarskeið,tíðliga,upprunaliga,útliðið,varandi,æviga
fyrsta	sífyrst,nú,skjótt
fyrstabók	sískriv
fyrstadrekka	símatur
fyrstahjálp	sígrøðing,hjálp,viðgerð
fyrstaútgáva	síútgáva
fyrstiføddur	sífrumborin
fyrstilærari	sílærarafólk
fyrstistavur	síbókstavur
fyrstrunnin	sífrumkendur
fýl	síklandursvætti
fýla	síklandursvætti
fýlagron	síklandursvætti
fýlast	sígremja seg,halla
fýligrani	síklandursvætti
fýlin	síónøgdur
fýlugrani	síklandursvætti
fýramannafar	sísjófar
fýrbeintur	síbeintur
fýrføttur	síbeintur
fýrhyrningur	sífýrkantur
fýrhyrntur	sífýrkantur
fýrin	sískjótførur
fýrisliga	sígjarna
fýrisligur	sískjótførur
fýrkantaður	sífýrkantur
fýrkantur	Samheiti:ferhyrningur,fjórhyrningur,fýrhyrningur,puntur,rútur(skákhyrningur)trapets(terningur)koppur,puntur,rift(fýrkantaður)ferhyrntur,fjórhyrntur,fýrhyrntur(fýrstrentur)fýrstrendur↔tríkantur
fýrstaður	síeldur
fýrstrendur	sífýrkantur
fýrstrentur	sífýrkantur
fýrur	síviti
fýrverk	Samheiti:eldverk,skreyteldur↔byrsuskot,skjóta
fýsi	sídugnaskapur,megi
fýsin	síhugspentur,vóngóður,øvundsjúkur
fýsn	sítrá
fýsni	sítrá
fæ	sídjór,ogn,peningur
fæfeingi	sípeningur
fæfeingisíløga	sífígging
fægoymsla	sígoymsla
fæhirðsla	sígoymsla
fækka	Samheiti:fækkast,minka,tynka,tynna,tynnastdetta frá;fækka, minka í tali;gerast fáir, færri;mókast burturímillum (um seyð);□so tynnist í valdra manna liði;tað doyr burturímillum↔minka,tømast
fækkan	síminking
fækkast	sífækka
fæleiga	síyvirskot
fæloysingur	sífátækafólk
fælutur	sídýrgripur
føða	síelva,mata,uppihaldaSamheiti:ala,alva,bera,eiga,gita,nøraala, eiga av sær, undan sær;bera í heim;eiga, fáa barn;fara, falla í gólv;fara í tvey;fara, vera komin á soppin;fáa avkom;fáa barn (við e-m);leggjast, liggja á song;leggjast niður;liggja í gólvi;nøra barn, børn;verða faðir, foreldur, mamma, móðir, pápi (at)(føðast)koma í heim;koma í verðina;koma undan móður faldi;koma úr móður lívi;síggja dagsins ljós;ver(ð)a barnborin, barnføddur↔fostur,føðing,kviðin,liva,livandi,livna,lív,makast,missa fostur,nørast,samlega,tvílívaðAndheiti:avlíva
føðast	síføða
føðga	símata,uppihalda
føði	símatur
føðievni	símatur
føðiland	síheimland
føðimelting	símelting
føðing	Samheiti:barnaferð,barnferð,barnsburður,barnsferð,barsilssong,burður,eiging,keisaraskurður,reis,tangarføðing↔føða,liva,livandi,livna,lív,nørast,nøringAndheiti:deyði,dráp
føðingardagsgáva	sígáva
føðingardagshald	síhátíð,veitsluhald
føðingardagur	síhátíð
føðingarhús	síbygningur
føðingarlamb	síseyður
føðingarstaður	síbústaður
føðingarverkir	sípína
føðistaður	síbústaður
føðistova	síhøli
føðsla	símatur
føðsluevni	símatur
føðsluríkur	sídygdargóður
føðsluvirði	sídygd
føðurland	síbústaður
føðursystir	sískyldfólk
føla	síleita,nema,uppliva
føli	Samheiti:ákenn,ákenning,kensl,kensla(kenslusemi)innileiki,sárlyndi,viðkvæmi↔sinnalag,sinnisrørsla,upplivaAndheiti:hjartaloysi
følin	síbleikur,kensluligur
følna	síavlitkast,doyggjaSamheiti:avblomstra,avblóma,doyggja,svidna(st)brenna, svidna(st), svíða, svíðast av;doyggja út;ikki koma fyri seg;missa blóma;missa bløðini, leyvið, nálirnar;sortna burtur↔avlíva,deyði,deyður,doyggjaAndheiti:grógva
følnaður	sídeyður
følv	síkavi,lag
følva	síkava,stroya
føra	sífarmur,flutningur,flyta,førka,rúma
førari	síoddamaður
føri	sílíkindi(r),strekki
føring	síflutningur
føringarbátur	sísjófar
føringarbyrði	síbyrði,hoyggj
føringarlamb	sígjald,seyður
føringarpartur	sígjald,partur
føringartorv	síbrenni
førka	Samheiti:aka,bera,draga,drafsa,dragsa,drassa,fíra,fláka,flyta,flytja,flytta,føra,hála,hveppa,hvøppa,javnflyta,koka,kokra,kotra,koyra,oka,ota,peiga,peiggja,reiggja,rena,renna,royva,røra,skaka,skjóta,skotra,skrika,skudda,skumpa,skúgva,sleipa,sópa,spyrna,steyta,stoyta,strúka,stumpa,stúpa,stúta,sveiggja,svinga,troka,tvørbera,veiggja,vikafíra, hava, koma, koyra, rena, renna undir e-t;fláka við fugli;flyta e-t úr stað;hála, toga e-t til síðis, til viks;skudda, skumpa, stumpa, stúta, stúpa undir e-t;sveiggja, svinga við ørmunum(førkast)aka,akast,alda,andvarpa,andvarpast,berast,bimba,blaka,blaktra,bleiktra,bragda,bragða,bresta,brugdast,dagga,dalda,dangla,darla,darra,darta,dartla,deiga,deingja,dingla,dirla,dirta,drifta,dritta,fara,ferðast,flagsa,flakra,flangra,flákra,flykra,flyta,flytast,fura,førka,glíða,hveppa,hveppast,hvøppa,kastast,kippast,kjálka,kjálkast,koma,kvakla,kvaklast,kvinka,larra,lava,láta,leiftra,lilla,lingra,liva,líða,rassast,reiðrast,reiggja,rembast,remsast,rilka,rilta,rista,ristast,róla,rósa,rumsa,rumsast,rúmskast,rúsast,rørast,skakast,skjótast,skreiða,skrensa,skrika,slavra,sláa,slena,sleikja,sleingja,sleingjast,sletta,slettast,stoytast,sveiggja,svinga,tvaglast,tvaska,tvørberast,veiggja,veiftra,veipa,veittra,vikast,vimsa,ønaaka, flyta, førka, hveppa, kritla, røra, vika seg;broyta støðu;fara á glið, á strok, til stroks;fara, (geva seg) frá, til viks, undan;fara úr stað;fláka, láta, sletta, veipa við e-m;gera eitt reiggj;glíða eftir t.e. skrensa, sleikja;hanga lavleysur í, hanga (leyst) við, hanga uppií;hanga og darla, larra, lilla, slena, slettast o.fl.;hava kviksilvur, kyksilvur í reyvini;hava seg, sleppa sær...;ikki støðast;kasta sær á (í svøvni);liggja ófriðarligur, í brotakøstum;marknast illa;ongan frið hava á sær;rassast, rutlast, rúsast við;rassa sær á;sita og brugdast, reiðrast;sita ófriðarliga;sita sum á glóðum, nálum;sita sum eitt kvørkviski, kvørkvisni;støðast ongastaðni;vera í rørslu;vera startin;□tað er ikki meir enn at lív blakar í honum;tað kvaklar í e-m;tað sæst tekin til lív↔avlagast,berja,brótast,danda,ganga,grulva,kastast,kollvelta,lyfta,nærkast,óstúttur,rembast,rista,risting,rugga,stanga,toga,troka,tveita
førkast	síførka
førleikafæ	sípeningur
førleikaviðbót	síískoyti
førleiki	síheilsustandur,klókskapur
førligur	Samheiti:akslabreiður,beinmikil,beinstórur,bósin,breiðherðaður,breiður,breiðvaksin,bringubreiður,bulamikil,bulfrekur,bulmikil,bulstórur,bulsverur,digur,ervamikil,frammikil,framprúður,framstórur,frekur,førur,gildugur,grefligur,grovlimaður,hammikil,herðabreiður,jarðgrógvin,javnbreiður,krappakslaður,kroppmikil,kroppstórur,køggutur,kýpin,kýplutur,lendabreiður,limafrekur,limamikil,limastórur,niðurbreiður,niðurtjúkkur,roysimikil,rundleittur,rúgvumikil,samanrikin,samanstappaður,samanstungin,samanstúvaður,síðubreiður,stappaður,stórbeinaður,stórleggjaður,stórligur,stórlimaður,stórskorin,stórur,sverur,tjúkkur,tættbygdur,tættligur,tættur,tættvaksin,tøpputur,uggabreiður,uppmikil,yvirborin(knotustórur)knotutur,knútutur(liðastórur)liðaljóturdúgligur (bátur), favntjúkkur (garður, veggur);knáliga, knóliga bygdur, vaksin;stórur og grefligur, sterkur;væl bulaður, herðaður, vaksin;sum tekur nógv upp á seg↔hovin,máldrúgvur,mikil,óskapiligur,prúður,rúmligurAndheiti:langvaksin,úrklænur
førna	síhovna
førningstorv	síbrenni
førningur	sífarmur
føroyakort	síatlas
Føroyaland	síheimland
føroyameistaraheiti	sínavn
føroyameistari	sívinnari
Føroyar	síheimland
føroyavinur	sívinur
føroyska	síumseta
føroysk lykt	sílampa
føroyskur	Samheiti:alføroyskur,fornføroyskur,nútíðarføroyskur,nýføroyskur,ramføroyskur,rótføroyskur,serføroyskurúr føroyum(innlendskur)heimakendur,heimligur,innlendur,ílendur(innanlands)innanlendis,innanríkis,innlendis(innføddur)innborinher á landi↔heima,heimland
førskapur	síheilsustandur,klókskapur
førur	síførligur,raskur,sterkur
føsil	sífløkja,vavstur
føsilmikil	sífløktur,óskapiligur
føsta	síhungur
føtil	síístig
føttur	síbeintur
føvning	Samheiti:fang,favnur,fevni,fevningur,føvningur,kneppi,móðurfang,skeytútbreiddir armar↔lógvi
føvningur	síføvning
