pa	sílortur
pabba	sípápi
pað	síhinna
paða	símissa skalið
pakk	sívánafólk
pakka	sídubba,fylla,kroysta
pakkaferð	sítúrur
pakkamjólk	símjólk
pakkapostur	Samheiti:ábyrgdarbræv,bílegging,bræv,brævapostur,brævpakki,flogpostur,fløskupostur,innskrivað bræv,jólakort,jólapakki,jólapostur,ordri,pakki,postpakki,postsending,postur,rekapostur,sendibræv,sending,snarpostur,teldupostur,uttanlandspostur,virðisbræv,virðispakki,virðispostur,vørusending↔boðan,boðberi,posta,postrúm
pakkhús	sígoymsla
pakki	sípakkapostur,posi
pakking	síbjálving
pakt	sísemja
pallalomvigi	sífuglur
pallast	Samheiti:heiða,hjallast,tjaldraleggjast í hjalla(r);mynda fláir, belti(r), lyndir, løg o.fl.↔lag
pallborð	síhækkað gólv
pallborðsfundur	sífundur,orðaskifti
pallborðsorðaskifti	síorðaskifti
palli	sífiskur
pallstokkur	síútlinja
pallur	síhækkað gólv,rók,sessur
pallut	síójavnur
palmin	sífitievni
pannuhvítur	sílitaður
pannumatur	símatur
pannuskøði	síhúð
pansari	síkloddakot,klæði(r)
pant	sítrygging
panta	síábyrgjast,ognartaka,skíta
pantalortur	sílortur
pantifúti	síinnkrevjari
pantseta	síábyrgjast
pantseting	síábyrgjast
pantsettur	síábyrgjast
pantur	sílortur,trygging
pappa	síleggja á
pappageykur	sífuglur
pappeskja	síkassi
pappír	Samheiti:ark,blað,brævapappír,brævark,brævpappír,glanspappír,gliturpappír,innpakkingarpappír,kardúspappír,kolpappír,lakmuspappír,litpappír,ljósmyndapappír,matpappír,pappírsblað,pappírslepi,pappírspetti,sigarettpappír,silkipappír,silvurpappír,skrivipappír,stensil(veggjapappír)tapet(pergament)kálvskinn,kálvsskinn(papýrus)sev at skriva á↔skriv,skriva
pappírsarbeiði	síarbeiði
pappírsbátur	sísjófar
pappírsblað	sípappír,skriv
pappírsdukka	sídukka
pappírsfjas	síítriv
pappírsflagg	síeyðkenni
pappírshandil	sísølubúð
pappírsklipp	símynd
pappírsknívur	síknívur
pappírskurv	síposi
pappírslepi	sílepi,pappír
pappírsleypur	síposi
pappírsligur	sídygdarleysur,úrklænur
pappírslím	síklistur
pappírspeningur	sípeningur
pappírspetti	sípappír
pappírsposi	síposi
pappírsskeyti	síumvav
pappírstunnur	síúrklænur
pappseymur	sínagli
papýrus	sípappír
par	síunnustarSamheiti:bóndahjún,brúðarpar,feðgar,fríggjarafólk,fríggjarapar,greipa,hjún,hjúnafelagar,kongshjún,møðgur,offurpar,prestafólk,prestahjún,prestfólk,unnustarbáðar, báðir, bæði;bara, bert, einans tveir;drongur og genta;einar, eini, einir;hann og hon;kallur og kelling;maður og kona;... og eg, hann, hon, tað;par um par t.e. tveir og tveir;teir, vit  báðir, bæði, báðar;tveireinir, tveyeini, tværeinar;tveir einir, einsamallir;tveir, tvey, tvær;tvey pør;tvinnar, tvinni, tvinnir, tvint;vit báðir...(navn)(antarpar)dunnupar,gásapar(køking)køkja,lambskøkja(fiskagreipa)greipa,hýsugreipa,luftna,seiðagreipa,smáfiskagreipa(kneppa)kneppi,lomvigakneppa,lomvigakneppi,skarvakneppa(handilspar)hosnapar,hosupar,koppaparblikur, æðubliki, æðublikur og æða;brimil og opna, úldrynja;bukkur, geitarbukkur, geithavur og geit;frensur, fressur og løða;graðingur og ryssa;gøltur, runi og purka, súgv;hani og høna;harufressur og hara;hundur og tík;mjálkafiskur, silfiskur og gýtingarfiskur, rognfiskur;steggi og bøga;tarvur og kúgv;veðrur og ær↔fleirfaldur,fríggja,granni,hjúnalag,para,partamaður,samansjóðaðir,semjast,tyssi,umgangast,vinur
para	sígiftastSamheiti:greipa,kneppa,køkjafáa (gás) at takast;greipa fisk, seið;kneppa lomvigar;køkja seyð;draga, para, ranga, snúgva, stinga hosur saman, saman hosur;skipa í pør(teyggja)flótta,tagla,tyssa,varða,vørðabinda saman í teyggju, tyssi, vørðu;draga upp á (tráð);heingja, teggja, tagla upp á e-t, seg;heingja upp eitt og eitt;tagla eftir tráði;teyggja saman í flóttu(r);teyggja, tyssa saman;varða, vørða lundar saman(greiping)køking(makaður)giftur,óstakur,paraður(maki)annar av parinum;annar makin, parturin(samangreipaðir)greipaðir saman↔par,samansjóðaðir,umgangast
paradis	síhimnaríki
paradís	síhimnaríki
paraður	sígiftast,para
paranoða	sínoða
pardansur	sídansur
pardón	sífyrigeving
park	síurtagarður
parka	sísessa
parkera	sísessa
parkering	síbíðan
parking	síbíðan
parrag	síólagna,rakdirðil
parrak	síólagna,rakfallin
parrakur	síólagna
parta	síbýta
partabræv	sípeningur,váttan
partabrævasøla	síhandilsskapur
partaeigari	síeigari
partafelag	sífelag
partagjald	síavgjald,gjald
partagrind	sípartur
partahvalur	síhvalur,partur
partalag	sífelag
partamaður	síeigariSamheiti:blindi,borðmaður,duli,fylgismaður,makkari,samstarvsfólk,samstarvsmaður,samverkamaður,viðhaldsfólk,viðhaldsmaður,viðspælari,skák t.e. tveir partamenn(viðhaldsfólk)samstarvsnevnd,stuðul,stuðulsfelag↔eigari,felagslimur,felagsskapur,granni,par,vinurAndheiti:mótstøðumaður
partaní	sívánafólk
partaníggj	sívánafólk
partapeningur	sípeningur
partaskjal	sípeningur,váttan
partasvíkur	sísvikari
parteigari	síeigari
parthallur	sísvikafullur
parthavari	síeigari
partískur	sísvikafullur
partleysur	síuttanveltaður
partloysi	síuttanveltaður
partrola	sífiska
partrolari	sísjófar
partroling	sífiskiskapur
partsreiðari	síreiðarí
partsreiðarí	síreiðarí
partur	síluteind,sindurSamheiti:bátslutur,bátspartur,beltilundi,beltislundi,búlutur,búpartur,drápshvalur,drápspartur,fiskapartur,fiskatíggjund,fiskipartur,formanspartur,føringarpartur,grindapartur,grindatíggjund,heimapartur,hvalatíggjund,jarðarhvalur,jarðarlundi,jarðarpartur,kastingarpartur,kenningarfiskur,kongshvalur,kongskeyp,kongstíggjund,kópatíggjund,landpartur,lunnatoskur,lutur,manningarpartur,mannpartur,mannskapspartur,manspartur,miðlingapartur,nótarpartur,partagrind,partahvalur,samstøðupartur,sígging,síggingarpartur,síggingarstykki,síging,sígingarpartur,sjálvdrátt(r)arfiskur,stakipartur,tálgartíggjund,tilfarsliður,tíggjund,tíggjundarfiskur,tíggjundarfjós,tíggjundarflak,tíggjundarkorn,tíggjundarlundi,tíggjundarull,tíggjundull,umloysur,útróðrarpartur(skamtur)fiskikvota,handilskvota,inngáva,kvota,ransón,sølukvota↔avgjald,býta,býti,frároknaður,helmingur,luteind,sundurbýttur,umbýttur
partú	sísanniliga
partvíst	sínæstan
partvísur	síófullfíggjaður
parykkur	síhár
pass	sífiskileið,strekki,tíðarskeið,váttan
passa	síhóska væl,roynaSamheiti:akta,ambæta,ansa,daddast,fjálga,fjálva,gæta,hagreiða,hagrøkja,halda,hava,røkja,røkta,sæta,týggja,umsita,uppihalda,vaka,vakta,varða,varðveita,verndaansa eftir e-m;ansa børnum;bera e-n á hondum, lógvum;fara um, við;fáa litið til;fáa undir hendur;fjálga, fjálva um e-n;ganga (illa, væl) um;ganga, halda, standa vakt;goyma at;halda hondina, sína hond yvir e-m;handfara (illa, væl);hava ans, eftirlit, umsjón við e-m;hava ábyrgdina av e-m;hava barnaansing, dagrøkt;hava í ábyrgslu, forsvar, varveitslu, verju;hava í hondum, um hendi, hendur;hava tilsjón um e-t;hava umsorgan fyri, við e-m;hava undir hond;hjúka, hjúkla, hjúkra fyri, um e-n, uppi yvir e-m;hugla, hugna, húgla, høla um e-n;hyggja eftir e-m, til e-n;sita dadda, vakt;sita hjá, uppi yvir;sita inni hjá børnum;sita, standa, vera á varðhaldi;síggja e-m til góða(r);síggja, syrgja fyri e-m;sæta e-m, sæta fyri e-m;taka hond um e-n;taka sær av;vaka, vakja (uppi) yvir e-m;varta (e-n) upp;vera um e-n;vera verja, verji hjá↔ansni,eftiransin,eftirlit,fyribyrging,hjálpa,krógva,røkiskapur,røkt,styrkja,uppihalda,vaktarhald,vanda sær,varðveitsla,verja,verja annan,verja seg
passaliga	Samheiti:á leið,hampiliga,mátaliga,nokk so,nøkulunda,passiliga,passuliga,rímiliga,rættiliga,sámiliga,toliliga,toluliga,veldiliga,væl↔hóska væl,hóskiligur,ógvuliga,tíðarhóskandi
passaligur	síhóskiligur
passiliga	sípassaliga
passiligur	síhóskiligur
passmynd	símynd
passuliga	sípassaliga
passuligur	síhóskiligur
patent	sírættindi
patentur	sísnotiligur
patrón	síbumba
patt	síjavnvág,javnviga
pá	sílortur
pábót	síafturbøting,ískoyti
páfinning	síframleiðsla
páfuglur	sífuglur
pálmaolja	sífitievni
pálmari	síferðafólk
pálur	sífiskur
pápabeiggi	sískyldfólk
pápabeiggjakona	sískyldfólk
pápaleysur	síeinsamallur
pápasonur	síyndisbarn
pápasystir	sískyldfólk
pápi	sískyldfólkSamheiti:babba,barnfaðir,faðir,pabba↔avvarðandi,móðir
páradís	síhimnaríki
pásetligur	síófúsur
pásíggin	sínatin
páskaaftan	síaftan
páskaboðskapur	síboðan
páskafríggjari	síunnustar
páskafrítíð	sífrítíð
páskahald	síhátíð,veitsluhald
páskalamb	síJesus,seyður
páskaregg	síegg
páskaskekil	síkastibløka
páskasnøkil	síkastibløka
páskavetur	síillveður
páskot	sískálkaskjól
pástandur	síáskoðan
pátra	síletast
pátrúgv	síátrúni
pávabræv	síboðan
pávakirkja	síkirkja
pávasetur	síbústaður
pedalur	síístig
peglafløska	sífløska
peglaglas	sífløska
peia	sígjalda
peiga	síførka,peika
peiggja	síførka,peika,síggjast
peika	síhorva,vísa áSamheiti:halda,hálda,medda,miða,munda,odda,peiga,peiggja,peyra,siktanetta sær á↔horva,ýta
peikustoyla	síbarn,fylgd,kvinna
peila	síavýtað,ýta
peiling	síýta
peis	síeldur,gerandislív
peka	sísjófar
peki	síkloddakot,sjófar
peli	Samheiti:grindarstólpi,lekt,lyktarpeli,lyktarsteyri,lyktarsteyrur,neip,neipa,pelur,pílari,skorða,snórapelur,steinsúla,súla,spír,spølur,stavur,steyri,steyrur,stik,stika,stikusteyri,stikusteyrur,stólpi,stytta,telefonsteyri(pinnur)leittur,sneis,sprit,sprita,sproti,staki,stong,teinur
pelikánur	sífuglur
pell	sílygnari,ósannindi
pella	sílúgva
pelur	sípeli
pempa	síganga,kradda
penalarhús	síslíðrar
pengagáva	sígáva
pengagrammur	sínatin
pengakassi	sígoymsla,kassi
pengaleysur	sífátækur
pengamaður	síríkmaður
pengamongd	sípeningur
pengaoyra	sípeningur
pengar	sípeningur
pengarúgva	sípeningur
pengaseðil	sípeningur
pengaskáp	sígoymsla
pengi	sípeningur
peningabót	síendurgjald
peningafalsan	sísvik
peningafalsari	sísvikari
peningaflutningur	síflyting
peningaflyting	síflyting
peningagáva	sígáva
peningagirnd	sítrá
peningagrammur	sínatin
peningagrískur	sínatin
peningahall	síhall
peningahjálp	síhjálp
peningahædd	sípeningur
peningaílegging	sífígging
peningaíløga	sífígging
peningajáttan	sífígging,gáva,hjálp
peningakassi	sígoymsla
peningakistil	sígoymsla
peningakærur	sínatin
peningaleysur	sífátækur
peningaliga	sífíggjarviðurskifti
peningaligur	sífíggjarviðurskifti
peningaloysi	sífátækt
peningamál	sífíggjarviðurskifti
peningamongd	sípeningur
peninganeyð	sítørvur
peninganøgd	sípeningur
peningaogn	síogn
peningarúgva	sípeningur
peningaskrín	sígoymsla
peningaskuffa	sígoymsla
peningaskuld	sískuld
peningaspell	síoyðslusemi
peningastovnur	sílánistovnur
peningastudningur	síhjálp
peningastuðul	síhjálp
peningastuldur	sístuldur
peningastyrkur	síhjálp
peningasvik	sísvik
peningatrongd	sífátækt
peningatrot	sífátækt,hall
peningatrupulleiki	sífátækt,hall
peningaupphædd	sípeningur
peningaveiting	sígáva
peningavinningur	síyvirskot
peningavirði	sídygd
peningseind	sípeningur
peningsveitan	sífígging
peningsverk	síarbeiði
peningsvirði	sídygd
peningur	Samheiti:avlopspeningur,áogn,bankaseðil,blóðpengar,blóðpeningur,borðfæ,dáli,eginpeningur,einkróna,eittoyra,fimmkróna,fimmogtjúguoyra,fimmoyra,fæ,fæfeingi,førleikafæ,gjaldkort,gjaldoyra,grundpeningur,gullpeningur,gullstykki,gyllin,hundraðkrónuseðil,húshaldspeningur,hædd,høvuðsstólur,kassakredittur,kassapeningur,kekkur,keypslupeningur,keypspeningur,króna,krónupengi,krónutal,landskassi,lánbræv,lánsbræv,lánsfæ,lánspeningur,lummapengar,lummapeningur,lutapeningur,markur,monningur,mynt,mynteind,myntur,mørk,ogn,oyra,pappírspeningur,partabræv,partapeningur,partaskjal,pengamongd,pengaoyra,pengar,pengarúgva,pengaseðil,pengi,peningahædd,peningamongd,peninganøgd,peningarúgva,peningaupphædd,peningseind,pund,rakstrarpeningur,reiðupeningur,ríkiskassi,seðil,silvurdáli,silvurmyntur,silvurpeningur,skattapeningur,skillingur,smápengi,smápeningur,spesia,spesiudáli,stovnfæ,stovnpeningur,stovnsfæ,sølupeningur,tiltakspeningur,tiltøkupeningur,tíggjukróna,tíggjukrónuseðil,tíggjuoyra,tjúgukróna,trímarkur,trygdarpeningur,tryggingarhædd,tumark,túmarkur,túsundkrónuseðil,tveykróna,tveyoyra,tvíkróna,tvískillingur,upphædd,valuti,virðisbrævføst ogn;gull og grønir skógir;krossaður kekkur;peningur í hondina;reiður peningur;tøkur peningur↔eiga,eigari,fígging,fíggjarviðurskifti,ogn,ríkmaður,ríkur
penliga	síyndisliga
penligur	sífólkaligur,vakur
pennahúsi	síslíðrar
pennaskaft	sískefti
pennasleikjari	sílandkrabbi
pennatekning	símynd
pensjón	sígjald
pensla	sísmyrjaSamheiti:beisa,bika,bletta,bronsa,bræða,eikimála,fernisa,fernisera,hvítta,kálka,lakka,mála,múnja,smyrja,sproytimála,tjarga,tjøra,tjørgasmyrja uppá(bletta)deplagera prikkut↔farging,lita,litaður,litevni,littóni,málaður
pensling	sífarging
penta	síband,lúgva,seyma
penur	sífólkaligur,vakur
pera	sílampa
pergament	sípappír
peringarstreymur	sístreymur
perkin	sítrongur
perkutórað	síoyðin,snøggur,uppfiskaður
perla	síbumba,epli,leka,valaverk
perlulív	sígerandislív
perlumóðir	síhinna
permumynd	símynd
pers	sítrýst,tyngd
persa	síkroysta,trýst,tyngd,tyngja
persóngerð	sííholdan
persóngering	sííholdan
persónleiki	sísinnalag
persónleysur	síópersónligur
persónliga	sísjálvur
persónligur	sísjálvur
persónlýsing	síallýsing,frásøgn
persónmenska	sísinnalag
persónsfornavn	síorð
persónssamband	sísamband
persónstal	síeyðkenni,nummar
persónur	Samheiti:almenningur,almúga,almúgi,almúgumaður,borgari,bóndafólk,einstaklingur,fólk,fólkaskapilsi,heiðursborgari,heimafólk,heimamaður,heimsborgari,hendingamaður,kyka,maður,mannabarn,mannkykt,mannkyn,mannvera,mansbarn,manskykt,manskyn,medmenniskja,menniskja,næsti,privatfólk,privatmaður,sammenniskja,samskapningur,samtíðarfólk,samtíðarmaður,sál,skapningur,skeggi,skepilsi,skikki,staklingur,stakmaður,tegnur,veramannaheimur (t.e.) mannaætt;vanligt fólk↔avvarðandi,barn,einbúgvi,húsbóndi,hvør einasti,íbúgvi,kvinna,niðursetufólk,skyldfólk
pertin	sítrongur
pes	síhár,ull
pesja	síhár,ull
pesjuskeki	síull
pesjutur	síloðin
pesjær	síseyður
pestaður	síillramur
petrolium	síbrenni
petroliumslampa	sílampa
petroliumsovnur	síeldur
petta	síknúsa,skræða
petti	síkvennskøp,luteind,óflýggjakroppur,sindur,smildur,strekki
peyra	sípeika
pi	síkenning,skríggj
piða	síeta,gnaga
piðaður	síavgnagaður,rakfallin
pikk	símótvilji
pikka	síberja,eta,ljóða,stinga
pikkfall	síband
pikkubarn	síbarn
pikkulítil	sísmáur
pikkumæ	síseyður
piksur	síkrøkjari
pil	síkallskøp
pilk	síhanddragin,ítriv
pilka	sífiska,klóra,pynta
pilkaður	sítilgjørdur
pilkaformur	síformur
pilkandi rotin	sírotin
pilkur	síhúkur
pilkutur	síhanddragin,leingi,seinpjakutur
pill	síkallskøp,kvennskøp
pillbýttur	sítápuligur
pilli	síkallskøp
pillsvakur	sísvakur
pillur	síkallskøp
pillørur	sísvakur
piltalið	símanning
piltateinur	síband
piltur	síband,barn
pimpa	sídrekka brennivín
pimpsteinur	sígrót
pingvin	sífuglur
pink	sípinkulingur
pinka	síbarn,pinkulingur
pinkalítil	sísmáur
pinkubarn	síbarn
pinkulingur	Samheiti:armóðarlamb,avmegingur,avnor,avnór,bøkkur,drymbingur,dvørgur,finna,frensageldari,frittur,gimbrarlambsneisti,gimburlambskøttur,gimburlambsneisti,grell,grellungi,grísamenni,gøltur,gørtur,hinsi,hinsur,hoynol,hólgi,hvølpur,karðalok,knip,knipil,knipr,knipur,krylv,krylvingur,kryvlingur,kvígumellingur,køgga,køttur,lívkneppingur,lívneppingur,manstandur,máhamur,máhav,meril,merlingur,minkur,mirlingur,mismenni,mistrivningur,mýripinnur,mørknetti,nalvungi,nartlingur,neisti,nell,neyðardýr,neyðarfostur,nilk,nuggur,nyðruvongur,nørtur,óvætti,pink,pinka,pinkur,píningur,pýggi,pýggj,rognabrók,rulkur,sannsaki,sjálvvætti,skjølkur,smámaður,smátandur,snell,sniffil,spjálk,tandur,teppur,tertlingur,trænuvaldur,tøppur,undanstøkkingur,vammagripur,vantrivningur,várhólgi,velikur,vongureitt einki;eitt eiti;eitt lítið frell;lítið, dvørgvaksið fólk;smávaksin maður;□hatta er ikki frægari enn eitt lokkanoða;hatta er ikki størri enn ein frittur;hatta er ikki øðrvísi enn ein jarkafinna;hatta er sum eitt spjaldur (millum hinar);hatta røkkur, stígur ikki upp fyri bukkutrom;hatta stendur ikki (upp) fyri bukkustav;hatta stígur ikki (upp) úr rossaspori;hatta sær út sum ein gloypingur↔brek,brekaður,kryplingur,rakdirðil,sindur,sjúkur,smáur,smildur,vantrívastAndheiti:kraftamaður,tríalingur
pinkulítil	sísmáur
pinkur	sípinkulingur
pinkutur	sísmáur
pinnabrenni	síbrenni
pinnapakkaður	síjavnstrokin
pinnasegl	sísegl
pinnaskøta	sífiskur
pinnastillur	síkvirrur
pinnastívur	síharður
pinnaverk	síkloddakot
pinnpakkaður	síjavnstrokin
pinnstillur	síkvirrur
pinnstívur	síharður
pinnur	síoddur,peli
pintera	síangra
piparargur	sívreiður
piparmoy	síeinsamallur,kvinna
piparmoyggj	síeinsamallur,kvinna
piparsligur	síkeðiligur
piparsveinur	síeinsamallur
pipp	sískríggj
pippa	sífuglur,skríggja
pippur	sífuglur
pippus	sífuglur
pipra	síkrydda,rista
pipran	síristing
piprast	sírista
piprilsi	síristing
piprutur	síóstúttur
pirk	síkenning,sár
pirka	sígrópa
pirkja	síblunka
pirkla	síklóra
pirr	síkenning
pirra	sífiskur,koyna,skíta
pirrifressur	síketta
pirrikurri	sífiskur
pirruskotin	síójavnur
pirrutur	síójavnur
pirtl	síkenning
pirur	sígarður
pis	sífongur
pisa	síbarn,fløska,fuglur,ungi
pisasligur	síúrklænur
piska	síkvennskøp
piss	sívatn
pissa	Samheiti:klinga,lagra,linga,mígafara eini ørindi;floyta seingina;gera sínar ódygdir (t.e.) míga og skíta;hjálpa sær sjálvum;kasta sær av vatni(num);koyra, lata lúkuna niðurfrá;lagra av;lata, stoyta løgin av (eplunum);míga, pissa í buks(ur)(nar);míga, pissa í song, undir seg;tøma bløðruna;vatna sær;vinda landið úr sær(vilja pissa)ikki fáa av sær, migið, pissa, ikki fáa vatnið av sær;vera bløðrusprongdur, trongdur;vera komin á trongd, (næstan) sprongdur í landi;vilja míga(vatning)gera, hava, verða fyri vatning↔skíta,undirpissur
pissa ímóti lotinum	síspilla fyri sær
pissari	síkallskøp
pisshús	síbygningur
pissiboppa	síkallskøp
pissigøltur	síkallskøp,undirpissur
pissilingur	síkallskøp
pisubúr	síbúr
pisuhús	síbúr
pisuhylur	síhylur
pisukassi	síbúr
pisuknívur	síknívur
pisuligur	síúrklænur
pisulundi	sífuglur
pisumurtur	sífiskur
pisurøða	sítos
pisutur	sílitaður
pisuveitsla	síveitsluhald
pitil	sílás
pitla	síeftirbátur
pittur	síkallskøp
pí	sískríggj
pík	síoddur
píka	síbarn,kvinna
píkarstavur	sístavur
píkstavur	sístavur
píkur	síoddur
píla	sískunda sær
pílagrímsferð	sítúrur
pílagrímur	síferðafólk
pílahúsi	síslíðrar
pílari	sípeli
pílgrímur	síferðafólk
pílika	síboðberi
pílikur	síboðberi
pílltak	sítekja
píllur	síoddur
pína	síbanna,sorg,tari,verkjaSamheiti:afturkembing,agg,agnaplága,andsperr,andsperra,andsperri,ágangur,álvaskot,berjakreppingur,berjakrymp,brandsótt,bringutak,bróstsviði,bróstverkur,búkilska,búkpína,búkrið,búksjúka,flog,flogstingur,fretstingir,garnapína,gikt,giktarflog,hagg,hagl,hald,hálsverkur,hungurspína,høvuðpína,høvuðverkur,ilska,ilskuferil,kikn,kikni,kinkur,kroystiverkir,kúgvan,kúgvilsi,kúgving,kveisa,kvøl,kýli,lendahald,lendapína,lendaverkur,leysastingur,liðapína,liðaverkur,livurhøgg,líðing,magailska,magakrymp,magapína,magasnertir,marleggur,mein,meinstingur,nagg,nekk,níting,pínsl,pínsla,pínuherðindi,plága,sárki,sársaki,sárseyki,slótturak,slysni,snerringar,snurringar,stingur,sviði,ryggverkur,tannapína,tannverkur,tjørugangur,tregi,treki,verkingar,verkir,verkur,vindgikt,virkingar,vøddapínaferðandi pína;herðindi, hørðildi, hørðindi av...;innibyrgdur vindur(beinverkur)menningarbrek,mergjarlop,merglop(barnsverkir)barnsneyð,barnsótt,barnverkir,barsilsneyð,eftirverkir,føðingarverkir,kreymaverkir,kreymaverkur,kreymi,pínuverkir,smáverkirfalskir verkir;ring barnferð(kettlingasótt)pína hjá kettu (tá ið hon leggur)↔pínast,píning,sjúka,sorg,svárur,verkja
pínandi	sísvárur
pínari	síkargakoka,óflýggjakroppur
pínast	Samheiti:líða,nívast,plágast,sárkast,seigpínast,útstandafáa av at vita, fáa tað, fáa tað dygt;fáa, kenna sviðan;gerast sárur, særdur;hava ilt;hava, líða kvalir, neyð, pínu o.fl.;hava marruna, samvitskubit o.fl.;hava tveir fríggjadagar í einari viku (t.e.) hava tað ringt;kenna á egnum kroppi (hvat tað vil siga at...);kenna ilsku;vera ringur av gikt, høvuðpínu, livurhøgg, vindi o.fl.;□e-t brýtst, bylgist, gongur, rembist, rørist innan í e-m(píndur)neyðpíndur,pínslaður,seigpíndurilla kroystur;illa viðfarin;nívdur av...;píndur og plágaður↔pína,píning,sorg,sorgarbundin,svárur,verkja
píndur	sípínast
pínegg	síegg
píning	Samheiti:djórapínsla,dýrapínsla,mannapíning,mannapínsla,pínsl,pínsla,pínsling↔pína,pínast,sorg,svárur,verkja
píningarveður	síillveður
píningsveður	síillveður
píningur	síegg,pinkulingur,seyður,vindur
pínsl	sípína,píning,sorg
pínsla	sípína,píning,sorg
pínslaður	sípínast
pínslarváttur	Samheiti:blóðvitni,blóðvitnismaður↔átrúni,halgimenni
pínsling	sípíning
pínslustaður	síhelviti
pínslusøga	sífrásøgn,skriv
pínufullur	sísvárur
pínugingin	sísárur
pínuherðindi	sípína
pínuleysur	síarbeiðsførur
pínumikil	sísvárur
pínusamur	sísvárur
pínustaður	síhelviti
pínuverkir	sípína
pípa	síbríksla,ljóða,sigarett,skríggja
pípan	síbríksl,skríggj
pípuglóð	síeldur
pípuhólkur	síringur
pípur	sírukka
pípuroykur	síroykur
pípustúgvur	sísigarett
píputubbak	sísigarett
píra	sídrýggja,kargakoka
pírin	sínatin
pírni	sínatinskapur
pírutur	sínatin
písk	síkenning
píska	síarga,elta,pynta,spíska,stjala
pískaður	sínoyddur
pískari	sírøritól
pískur	síkílaskapaður
pískutur	sítjóvskur
pístr	sívindur
pístra	síanda,fúka,hvíla
pístran	sívindur
pístur	sívindur
písturtonn	sítonn
pjaga	síletast
pjak	sídrál,eftirbátur,ljóð
pjaka	síletast,putla
pjakan	sídrál,ljóð
pjakast	síletast,putla,verkfall
pjakutur	síseinpjakutur
pjakuvætti	síeftirbátur
pjakverkfall	síverkfall
pjank	sídrál
pjankast	síletast,putla
pjankus	síeftirbátur
pjankutur	síseinpjakutur
pjask	síljóð
pjaska	síputla
pjága	síletast
pják	sídrál,eftirbátur
pjákutur	síseinpjakutur
pjána	síletast
pjátra	símøsna,teska
pjátran	símøsn
pjátur	símøsn
pjonkur	sífjall,posi
pjøg	síeftirbátur
pjøga	síletast,putla
pjøgast	síletast,putla
pjøgga	síumvæla
pjøggutur	síilla ílatin
pjøki	síposi
pjøkin	síeftirsíggin
pjøkni	sírøkiskapur
pjøkur	síposi
pjøltrutur	síilla ílatin
pjøltur	síkloddakot
pjøpp	símøsn,møsnari
pjøppa	símøsna
pjøskutur	síilla ílatin
pjøssa	síumvæla
pjøssur	síótrivavætti
pjøssutur	síilla ílatin
plaga	síórógva;gera e-t av gomlum vana;halla til, vera hallur til at...;hava hug, lyndi, lyndski, lyndsku til...;hava sær fyri;hava tað fyri;hava til lyndi, máta, sið, siðvenju, skikk, vana, venju;vera at at gera e-t;vera vanur at...↔medferð,uppaling,vanabundin,vani
plagg	síklæði(r)
plakát	símynd
planki	síviður
planta	sídyrka,urt
planting	sídyrking
plantufiti	sífitievni
plantuføði	símatur
plantumargarin	sífitievni
plantuolja	sífitievni
planturíki	síurt
plasta	síleggja á
plastbátur	sísjófar
plasthylki	síslíðrar
plastposi	síposi
platt	síógvuliga
plága	síargapetti,órógva,pína,sorg,verkja
plágari	síargapetti
plágast	sípínast
plágumikil	sítorførur
plánur	síverkevni
pláss	síbýur,sessur,stað,starvSamheiti:andarúm,arbeiðspláss,arbeiðsrúmd,árarúm,árarúmd,blaðrúmd,boð,breidd,dýpd,hurðarrás,húsarúm,húsarúmd,húsrúmd,hvarv,hædd,leið,longd,rásarúm,royvi,royvildi,róðrarrúmd,rúm,rúmd,skoparúm,skotbragd,skotbragð,skotbrá,umráði,umveldi,vídd,víðilsi,øki↔stað,strekki
plásslítil	sítrongur
plásstrot	Samheiti:húsatrongd,rúmloysi,trongd,trongi↔troka,trokan,trongur
plássur	sístað,starv
plástur	síumvav
pláta	sílag
plátuhúkur	síhúkur
plátuhúsi	síslíðrar
plátusavn	sígoymsla
pleira	sídálka,ganga
pleirur	sífótur
plettur	síblettur,stað
pleyra	sídálka,ganga
pleyrur	sífótur
pli	sískríggj,ungi
plia	sískríggja,teska
pligga	sífiskileið
plikt	sísessur,skylda
plikta	sílova
pliktarbeiði	sískylda
pliktarbekkur	sísessur
pliktigur	sísekur
plinka	sífiskileið
plinki	sífiskileið
plinkur	sífiskileið
plógfoyra	sískarð
plógross	síross
plógryssa	síross
plógtorva	síflag
plógv	sískarð
plukka	síroyta
plukkufuglur	síbýttlingur,kastibløka
plumba	síífylla
pluss	síafturat,gagn
plúsin	síhovin
pløga	sídyrka
pløging	sídyrking,skarð
poð	sísindur
poða	sílosa
poðutur	síloðin
poesiur	sísangur
poki	síposi
pokna	síhol,koyna
poknueyga	sírók
poknutinna	sígrót
poknutur	síinnanopin,ójavnur
pokuskotin	síójavnur
pokutur	síójavnur
politikkur	síendamál
politistøð	síbygningur
polka	sídansur
polkahár	síhár
polladunna	sífuglur
pollamjørki	sítoka
pollhús	síbygningur
pollur	sífjørður
polstra	síleggja á
poppbólkur	sísangari
popporkestur	síorkestur
poppsangari	sísangari
popptónleikur	sítónalag
poppur	sítónalag
portari	sívaktari
portur	síinngongd
portursdyr	síinngongd
porturshol	síhol
porturshválv	síbergloft
posabak	síbera
posaband	síband
posabjølgur	sílepi
posadýr	sídjór
posafuglur	sífuglur
posakelkur	síbotnur
posakloddi	sílepi
posaknútur	síknútur
posamatur	símatur
posapjøki	síposi
posaprinsur	síposi
posaregn	síregn
posarenning	síkapping,renning
posaspjaldur	sískelti
posaspjørr	sílepi
posataska	síposi
posi	Samheiti:barkhít,beriposi,biddaraposi,eggjaprilla,eggjaroð,eplaposi,eplasekkur,frystiposi,gorsekkur,haglposi,hálvtunnusekkur,hít,hoyposi,klædnasekkur,klæðsekkur,kolposi,kolsekkur,kornposi,koyggjusekkur,koyriposi,kókiposi,krossmessuposi,krotuposi,leðursekkur,lippuposi,lippuskjátta,livrarskjátta,lóðurposi,lýsiposi,matposi,matskjátta,mjølsekkur,pappírsposi,plastposi,poki,posaprinsur,postsekkur,prilla,ruskposi,sandsekkur,sekkur,skjátta,skreppa,slógsekkur,slógskjátta,steikiposi,torvposi,tunnuposi,ullarhít,ullarposi,vatnhít(pjøki)balli,ballingur,drøltur,døttur,knurvali,knýti,krossmessupjøki,krossmessuposi,pakki,pjonkur,pjøkur,posapjøki,skreppa(kurv)pappírskurv,pappírsleypur,seymikurv,tæga(taska)beltistaska,ferðataska,handtaska,kobbataska,kópaskinstaska,kópataska,posataska,segldúkstaska,skúlataska↔byrði
positivur	síjáttandi
posta	Samheiti:poststemplagjalda postgjald fyri;seta frímerki á↔pakkapostur,postrúm
postalakirkja	síkirkja
postalínsmálningur	símynd
postalínsmynd	símynd
postavgreiðsla	sítænastuveiting
postbátur	sísjófar
postberi	síboðberi
postboð	síboðberi
postboks	sípostrúm
postfar	sísjófar
postferð	sítúrur
postflutningur	síflutningur
postførningur	sífarmur
postgjald	sígjald
posthús	síbygningur
postkassi	síkassi,postrúm
postkort	sískriv
postkrav	síkrav
postlúka	sípostrúm
postmaður	síboðberi
postmerki	síváttan
postnummar	sínummar
postordri	síkrav
postpakki	sípakkapostur
postriva	sípostrúm
postrúm	Samheiti:boks,postboks,postsmoga(postlúka)postriva(postkassi)kassi til brøv o.fl.↔pakkapostur,posta
postsekkur	síposi
postsending	sípakkapostur
postskip	sísjófar
postsmoga	sípostrúm
poststempla	síposta
postsøla	síhandilsskapur
postur	síboðberi,pakkapostur
posutur	síhovin,rúmligur
pot	síkanning,torveyga
pota	sístinga
pottabrot	síglas
pottadeyvur	sídulur
pottadulur	sídulur
pottaður	sínáttlagdur
pottafløska	sífløska
pottakaggi	síkassi
pottalok	sílok
pottaløgur	sívatn
pottamál	síkassi
pottaplanta	síurt
pottatrom	síútlinja
pottaørindi	sísangur
pottbúgvin	sítilgjørdur
potttættur	sítættur
pottur	Samheiti:blóðpottur,døgurðapottur,eplapottur,fargipottur,fløtpottur,greytarpottur,grindapottur,grunningshøvdapottur,grýta,haldapottur,hálvpottur,hálvtunnupottur,ímpottur,kannupottur,kastirolla,kastrolla,kjøtpottur,krússapottur,leirpottur,litingarpottur,litpottur,lýsipottur,løgpottur,matarpottur,matgerðarpottur,mjólkarpottur,mjólkgreytarpottur,náttpottur,nátturðapottur,skaftagrýta,snykpottur,soðgrýta,soðpottur,sortupottur,steikigrýta,steikipottur,stóripottur,súpanarpottur,sveitapottur,svertupottur,tintarpottur,tjørupottur,tólvkannupottur,tóvarapottur,tunnupottur,tvagpottur,tvíkannupottur,urtapottur,vaskigrýta↔fløska,kassi,spann,trog
potuveður	síkavi,veðurlag
potuvindur	sívindur
pólalýsi	síljósglæma
pólferð	sítúrur
pólhav	síhav
pólísur	síkavi
pólkringur	síringur
pranga	síkeypa
prál	síreyp
prála	síreypa
prálari	síreypari
prámur	sífótur,sjófar
prásapinnur	sílampa
prási	sílampa
prát	sítos
práta	síendurtaka,siga
prátan	sítos
prátari	símøsnari
prátingarhugur	síprátsemi
prátingarsamur	símunnkátur,tíðindafróður
prátmikil	símunnkátur
prátríkur	símunnkátur
prátsemi	Samheiti:frásøgugleði,prátingarhugur↔munnkátur,orðkringur,tíðindafróður
prátutur	símunnkátur
prei	sínærkast
preia	síkalla á ein
prektigur	sípyntaður
prektugur	sípyntaður
premia	síheiðursløn
prent	síárit,skrift
prenta	sískrivaSamheiti:endurprenta,litprenta,litprika,ljósprenta,reinprenta,samprenta,steinprenta,yvirprentaprenta uppaftur;prenta út;seta (upp) á prent(seta handrit)setagreiða til prentingar(geva út)lata bók, bókaverk, prent o.fl. úr hondum(tættprentaður)tættskrivaður↔árit,áskrift,boðberi,bókaheimur,bókstavur,lesa,rithøvundur,skrift,skriv,skriva,útgáva
prentbúni	sískrift
prentfrælsi	sífrídómur
prentis	síbyrjari,sjómaður
prentlist	sílist
prentlutur	síárit
prentlýti	sískeivleiki
prentmiðil	síboðberi
prentmót	símynd
prentmynd	símynd
prentsmiðja	síverkstaður
prentsnið	sískrift,útsjónd
prentstavur	síbókstavur
prentsverta	sílitevni
prentus	síbyrjari,sjómaður
prentvilla	sískeivleiki
prep	síkenning
press	síkroyst
pressa	síkroysta,tyngja
pressari	síavtakafólk
prestadyr	síinngongd
prestafólk	sípar
prestagarður	síbústaður
prestagjald	sístað
prestahald	sígjald
prestahjún	sípar
prestajørð	síjarðarstykki
prestakamar	síhøli
prestakjóli	síklæði(r)
prestakyrra	sígóðveður
prestaloysi	sítørvur
prestasetur	síbústaður
prestaskúli	sískúli
prestastev	sídansingarháttur
prestastevna	sífundur
prestastig	sídansingarháttur
prestbátur	sísjófar
prestbygd	síbýur
prestbøur	síjarðarstykki
prestferð	síflutningur,túrur
prestflutningur	síflutningur
prestfólk	sípar
presthagi	síjarðarstykki
presthald	sígjald
prestjørð	síjarðarstykki
prestklæddur	sípyntaður
prestleypur	síkassi
prestloysi	sítørvur
prestsetur	síbústaður
presttal	síoffurgáva
prestveður	sígóðveður
prestvíga	síútnevna
prestvígsla	sívígsla
presur	sídálk
pret	sísnildarbragd
pretin	sípyntaður,stoltur,trongur
pretna	síernast
pretta	síarga,brigsla
prettin	sígeva øðrum skyldina,listumlærdur
prev	síkenning
priðari	sínagli
priði	síoddur
prik	síillsinnisgleps,kenning,stunga
prika	síarga,stinga
prikka	sílampa
prikkabeinur	síbeinur,nákvæmur
prikkafiskur	sífiskur
prikkastrika	sístrika
prikkur	síblettur
prikkutur	Samheiti:blettutur,blikutur,blondutur,deplutur,diglutur,dílutur,eplutur,fjøllittur,flekkutur,fruknutur,frænutur,frøknutur,marglittur,ritutur,skjórutur,smádiglutur,sorutur,sprøklutur,trílittur,tvílittur(blomstrutur)blómutur,rósuturvið blettum, deplum, frøknum, prikkum o.fl.↔blettur,litaður,mynstrutur,puntutur,stríputur
prilla	síarga,koyna,posi,sibbi,skriv
primsigna	sísigna
primuslykt	sílampa
prinsa	síletast
prinsessa	síríkisarvingi
prinsur	síríkisarvingi
pripni	símótvilji
pripp	símótvilji
prippin	sísmásárur
pripputur	sísmásárur
pritla	síarga
privatfólk	sípersónur
privatkoyring	síflutningur
privatlív	sígerandislív
privatmaður	sípersónur
privatskúli	sískúli
príla	síkuta
príling	síillveður
prís	sílovorð
prísa	sílovprísa
prísan	sígleðirómur
prísansing	síeftirlit
prísáseting	símeting
príseftiransing	síeftirlit
príseftirlit	síeftirlit
príshækkan	Samheiti:dýrkan,vørudýrkan↔dýrka,ískoyti,okra,okur,prísur
prísískoyti	síískoyti
príslag	síprísur
príslega	síprísur
príslisti	síyvirlit
príslækkan	síminking
príslækking	síminking
prísmunur	símunur
prísráð	sívald
príssteðgur	síendi
prístalsviðbót	síískoyti
prísur	sílovorðSamheiti:avreiðingarprísur,boð,byggikostnaður,dagsprísur,ferðakostnaður,fiskaprísur,handilsvirði,hámarksprísur,helvtarprísur,helvtarvirði,keypsprísur,keypsvirði,kornprísur,kostnaðarprísur,kostnaður,lágmarksprísur,lágprísur,marknaðarprísur,meirkostnaður,miðalkostnaður,miðalprísur,miðalvirði,mjólkarprísur,okur,okurprísur,ovurprísur,príslag,príslega,søluprísur,søluvirði,takstur,ullarprísur,undirprísur,útflutningsprísur,virði,vøruprísurhálvt virði, hálvur prísur;niðursettur prísur(kursur)gangvirði,navnvirðiáljóðandi virði↔avgjald,dygd,dýrka,ískoyti,okra,príshækkan,útreiðsla
prísviðbót	síískoyti
profetera	síspáa
profetur	síspámaður
promilla	síluteind
proppa	sífylla,steingja
proppaður	símettur
proppmettur	símettur
proppur	Samheiti:døbbi,kíkatøppur,lús,nøgla,oyraproppur,skeinkiproppur,skrúviproppur,spuns,spunsl,teppur,tundurproppur,tundurtøppur,tøppur,ølproppur↔afturlatin,botnur,lok,steingja,ventilur
props	sístívari
prosa	sísangur
prosayrking	sísangur
prosent	síluteind
proviantur	símatur
proysur	síbyrjari,sjómaður
prógv	sípróvroynd,váttan
prógva	Samheiti:mótprógva,próvføra,sannprógva,sannroyna,skjalfesta,skjalprógva,vitnisførabera prógv um (e-t);føra prógv fyri (e-m)(vátta)eiðfesta,vitna,vitnisførabera fram váttan (fyri, um);fáa e-n at trúgva at...;geva trygd, vissu fyri;sannføra, vissa e-n um e-t;vísa at so er(undirskriva)kvitta,undirrita,váttageva skrivliga váttan (fyri, um e-t);kvitta fyri e-t;seta navn(ið) undir;seta, skriva hond sína, navn sítt undir;seta undirskrift(ina) undir;skriva undir;staðfesta við undirskrift;vátta skrivliga↔eftirlíka,játtan,seta í gildi,váttan
prógvaður	sísannur
prónshøvd	síhøvur
próstagarður	síbústaður
próvbræv	síváttan
próvdómari	sígagnmetari
próvdøma	sídøma
próvdøming	sídómur
próvfastur	sísannur
próvføra	síprógva
próvførsla	síorsøk,próvroynd
próvgrund	síváttan
próvlestur	síbókalestur
próvmegi	síváttan
próvmerki	síummæli
próvnám	sískúlagongd
próvroynd	Samheiti:aðalroynd,ársroynd,eksamia,eldroynd,endurpróvtøka,fráfaringarroynd,heystroynd,hugaroynd,koyriroynd,prógv,próvtøka,prøvi,roynd,støðuroynd,sveinaroynd,sýnisroynd,upptøkuroynd,várroyndástøðilig roynd(próvførsla)eldroynd,gudsdómur,jarnburður(royndartíð)royndarár,royndarløta,royndarstund,roynslustund(tilroynd)hissinisroynd,prøvi,roynd(taka prógv)fara upp, vera uppi til próvtøku, roynd;fáa, lúka prógv;klára, standa roynd(ina), prøva(n);vera uppi í e-m↔frálæring,lærdómur,roysnisgerð,skúlagongd
próvskeið	sískúlagongd
próvskjal	síváttan
próvskúli	sískúli
próvtakari	síbyrjari
próvtal	síummæli
próvtøka	sípróvroynd
próvtøkuskúli	sískúli
prukka	sístavur
prumpa	sífrata
prumpur	sífretur
prumsintur	síófúsur
prunk	síprýðislutur
prunka	sípynta
prus	sísár
prusal	sísár
prusali	sísár
prusur	sísár
pruta	sífrata,koyna
prutl	síanding,ljóð
prutla	síanda,gera aldu,kóka,ljóða
prutta	síkeypa
prúdd	síyndi
prúdleiki	síyndi
prúdligur	síhovin,prúður
prúðka	sífríðkast,hovna
prúðkaður	síhovin
prúðleiki	síyndi
prúður	síhábærsligur,hovinSamheiti:evnagóður,evnaligur,evnisligur,gildugur,háttligur,kimpurligur,kippuligur,mandigur,mannførur,mansligur,mennigur,menniligur,menskur,prúdligur,seydligur,stimaligur,stórligur,trivaligur,vælvaksin,vøkstriligur,vøksturligurbæði prúður og vakur, stórur og prúður, stórur og sterkur;bæði væl og sterkliga skaptur;prúður upp á kropp;sum eitt garðross;væl bulaður, bygdur, vaksin(býtisførur)býtisbærur,ískerandi,sundurtakandi,tíggjundarførur(kallmansligur)mannfólkaligursum ein kallmaður↔førligur,høgur,mikil,vakurAndheiti:úrklænur
prýddur	sípyntaður
prýða	sípynta
prýði	síheiður,prýðislutur,yndi
prýðiligur	sípyntaður
prýðisgripur	síprýðislutur
prýðislutur	síluturSamheiti:borðprýði,bringuprýði,brúðarstás,hálsmen,hálsprýði,høvuðgull,jólaprýði,jólapynt,jólastás,oyrnagull,prunk,prýði,prýðisgripur,pynt,skart,skartgripur,skreyt,skreytgripur,skreytlutur,skrúð,skrúðir,skrúðsnórar,skrúður,stakkastás,stásskart og skreyt↔dýrgripur,pynta,pyntaður,pyntidukka,stakkalastás,yndiAndheiti:ræðumynd
prýðisplanta	síurt
prýðka	sípynta
prædika	sítosSamheiti:boða,prætika,siðboðaboða kristna trú, trúgv;halda gudstænastu, prædiku;lesa aftanbøn, inngangsorð, lestur o.fl.;prædika Guds orð↔andligur,átrúni,bíbilskur,heilagleiki,kirkja,kirkjugangur,kristning,siga,tos,umvenda,umvendur
prætika	síprædika,tos
prøva	síkanna,royna,uppliva
prøvi	síkanning,próvroynd
prøviti	síkelda
p-tal	síeyðkenni
pu	sísindur,ull
pua	síhár,klumpur,losa
puff	síanding
puffa	síanda
pulka	síklóra
pullur	sífuglur
pulsslag	síljóð
pulsur	síljóð
pulsæðr	síæðr
pulvur	sísmildur
pumma	síkavstoytast,klæða
pumpuringur	sífuglur
pumpuroykur	síluktur
pumpuvatn	sívatn
pums	sífall,ljóð
pumsa	sífalla
pund	sípeningur
pundskardús	sísigarett
pundsseyður	síseyður
pundsær	síseyður
pungur	síbyrjari,eista,sjómaður
punkt	síblettur,luteind
punsur	sírúsdrekka
puntur	sífýrkantur,sjófar
puntutur	Samheiti:blápuntutur,reyðpuntutur,rútutur,smápuntutur,talvutur↔litaður,mynstrutur,prikkutur,stríputur
puppuringur	sífuglur
purka	síbarn,grísur,ótrivavætti,seyður
purkutur	sískitin
purla	síhár,kemba
purluknokkur	sípurlutur
purlutur	Samheiti:krúllutur,kurlutur,ullhærdur(purlut fólk)kurla,kurlukollur,purluknokkur↔frísutur,hár,hárvøkstur,snák
purpur	sílitevni
purpurhinna	sítari
purpurlitaður	sílitaður
purpurlittur	sílitaður
purpurlitur	sílittóni
purpurreyður	sílitaður
purpurtari	sítari
purra	síarga,eista
purrifinna	síkvennskøp
purrukuldi	síkuldi
pusa	síreka seyð
pusalaknektur	sífiskur
puss	síklæði(r),sár
pussa	sígníggja,rudda
pussfiskur	síbýttlingur,undirhaldari
pussur	síkallskøp
puthonk	síhonk
putl	síítriv
putla	síeftirbátur,letast,tjóvurSamheiti:bollast,diggast,dikkast,dintlast,fanglast,fangslast,finglast,fjasa,fjasast,fjatla,fjatlast,fonglast,fongslast,frensast,fressast,fretla,fretlast,fritlast,heksast,høsnast,koksast,kveistrast,mekast,pjaka,pjakast,pjankast,pjaska,pjøga,pjøgast,putlast,putrast,reyvast,roksa,roksast,skava,skavast,skitlast,skøvast,smáputla,smáputlast,stáka,stákast,sýsa,sýsast,sýslast,øsna,øsnastarbeiða seint;fanglast og fjasast við e-t;fáast, finglast, krutlast, pilka, pilkast, skítast, skølmast, takast við e-t;fretla uppií;ganga og smáfretla;roksa(st) fyri, við e-m;skjaldrast við e-t;standa og krovast;vera í andvirki;øsnast uppi yvir e-m↔arbeiða,bíða,ítriv,letastAndheiti:arbeiða
putlarbeiði	síítriv
putlast	síletast,putla
putlisamur	síleingi,seinpjakutur
putlutur	síleingi,seinpjakutur
putra	sístroya
putrast	síputla
putt	sístavur
puttur	sístavur
putur	sílitevni,smildur
puutur	síloðin
púkin	síSátan
púl	síbaksan
púla	síhindra
púlsamur	sítorførur
púra	síógvuliga
púrasta	síógvuliga
púrga	sísøra
púrgera	síberja,søra
púrgerð	síbúkilska
púrgjørdur	símannvándur,ófriðarligur
púrsørur	sífátækur,sørur,tápuligur
púrt	síógvuliga
púrur	síeinskærur,sørur,tápuligur
púsin	sívreiður
pústr	sívindur
pústra	síanda,fúka
pústran	sívindur
pústrari	sívindur
pústur	síduk
pústurgráur	sílitaður
pústurhvítur	sílitaður
pústursvartur	sílitaður
púta	síleyslyntur persónur
pútuhús	síbygningur
pútusonur	síleysingabarn
pútusveinur	síleysingabarn,leyslyntur persónur
pyks	sísár
pyksi	sísár
pylsubræur	sífitievni,smelt
pylsueitran	síeitran
pylsufløt	sífitievni
pylsusoð	sívatn
pylsuvognur	síbygningur
pynt	síprýðislutur
pynta	Samheiti:blómuprýða,fitta,fríðka,hampa,keina,myndprýða,myndskrýða,nosla,orðna,pilka,píska,prunka,prýða,prýðka,skikka,skreytbúgva,skrúða,skrýða,snolla,snøgga,stása,stásklæða,trivafanta, hampa seg eitt sindur;fara í annað (betri), í pussið;fjaðra seg í, um;fríðka, hampa um e-t;gera e-n vakran;gera í ordan, stand;hampa seg afturum;hampa seg (í);lata seg betri, væl í;lata seg í annað (betri), í pussið;keina, nosla, pilka, píska, snáka sær;prýða, prýðka um e-t;seta hárið;seta við perlum, gulli o.fl.;skifta í betri klæði(r);skifta klæði(r);snolla e-n, seg upp;stása upp;triva (um) (e-t);vera til prýðis(skarta)pranga t.e. klæða seg (ov) stásiliga(telgja til t.e. snøgga til)fínka,hampa,snidra,snikka,snota,snotra,snøgga↔forma,pyntaður,pyntidukka,prýðislutur
pyntaður	Samheiti:altarsklæddur,avblástur,blómuprýddur,búgvin,faktaligur,fínklæddur,fínur,flaggskrýddur,fríðføttur,glæsiligur,gyrdur,hamfríður,hampaður,hátíðisprúður,íhampaður,jakkaklæddur,jólaklæddur,kirkjuførur,kirkjuklæddur,kjarmur,kragaklæddur,kurtaligur,listafínur,løpputur,nossligur,nýgreiddur,nøggur,prektigur,prektugur,prestklæddur,pretin,prýddur,prýðiligur,silkiklæddur,skapligur,skartligur,skreytiligur,skreytmikil,skrúðklæddur,skrýddur,smartur,snotiligur,snøggligur,snøggur,stásiligur,stásisligur,stásklæddur,sunnudagsklæddur,tíguligur,uppskrýddur,uppsnákaður,uppsnollaður,uppstásaður,uppstrokin,útprýddur,útskrýddur,vátakembdur,vegligur,veitsluklæddur,veitsluprýddur,veitsluskrýddurfittur um løppurnar;í fínum, nossligum klæðum;í pussinum, stásinum, stásklæðum;fínt, nossliga, snøgt, vakurt, væl ílatin, klæddur;reinur og nossligur;reinur og ruddiligur;settur við...;stoltur í klæðum;□hann er altíð væl klæddur;hann er ikki roykrotin;hesin sigur sjey↔fríðdæmdur,fríðkast,klæða,klæði(r),prýðislutur,pynta,pyntidukka,snotiligur,til stásbrúk,vakur,yndi,yndisligaAndheiti:illa ílatin
pyntidukka	Samheiti:mótadukka,mótaprinsur,pyntireyv,snáka,stásdukka↔prýðislutur,pynta,pyntaður,stakkalastás
pyntireyv	sípyntidukka
pýggi	síbarn,lortur,pinkulingur
pýggj	síbarn,lortur,pinkulingur
pýggjaligur	síósømiligur,skitin
pýggjapá	sílortur
pøða	síbrenni
pøðutur	sívátur
pøs	síspann
pøsa	símáttsúgva
pøsast	sítroyttast
pøsing	síoverving
pøstur	síútmøddur
