ydda	síspíska
yðja	síkrykja
yðjan	sínøgd
yðjandi	síógvuliga
ylast	síhitna
ylblot	sívatn
ylbloti	sívatn
ylheitur	síheitur
ylja	síhita
ylmikil	síheitur
ylna	síhitna
ylnaður	síheitur
ylsvarmi	síhiti
ylur	síhiti,kærleiki
ymis	síannarleiðis,fjølbroyttur,umskiftiligur
ymisháttaður	sífjølbroyttur,mislyntur
ymiska	síhindur
ymiskt	Samheiti:ymistalskyns...;alt handa slag;alt millum himmal og jørð;alt møguligt;alt sum kann nevnast við navni;alt sum nevnast kann;alt sum upp kan roknast;alt uttan livandi grind;av øllum sløgum;bæði eitt og anna;bæði líkt og ólíkt;hetta og hatta;hvørt av sínum;mangt og hvat;mangt og mangt;nógv sløg av...;stórt úrval, útval av...↔úrval,val,valdur,valmøguleiki,velja
ymiskur	síannarleiðis,fjølbroyttur,umskiftiligur
ymisligur	sífjølbroyttur,umskiftiligur
ymislitaður	sílitaður
ymislittur	sílitaður
ymissur	síannarleiðis,fjølbroyttur,umskiftiligur
ymist	síymiskt
ymisvorðin	sífjølbroyttur,mislyntur
ymja	síljóða
ymsastaðna	síymsastaðni
ymsastaðni	Samheiti:summastaðni,summstaðni,ymsastaðnaallastaðni og ongastaðni;á, í summum, ymiskum støðum;her og har;í støðum(onkustaðni)einastaðni,nakrastaðni,nakrastaðnis,onkrastaðni,onkustaðnaá, í onkrum stað;her, har einastaðni, onkustaðni↔allar vegir,allastaðni,báðumegin,higar og hagarAndheiti:ongastaðni
ymsumegin	síbáðumegin
ynda	síásttikin,dáma
yndast	síásttikin,fríggja
yndi	síkærleikiSamheiti:einglabrá,fagurleiki,glæstriskapur,náttúruvakurleiki,prúdd,prúdleiki,prúðleiki,prýði,snøggleiki,vakurleiki,vænleiki,yndisleiki,yndistokki↔fríðdæmdur,fríðkast,prýðislutur,pyntaður,snotiligur,vakur,yndisliga
yndigur	sívakur
yndiligur	sívakur
yndisbarn	Samheiti:alsklingur,einkabarn,einkadóttir,einkar-,einkasonur,elskulingur,eygnasteinur,hjartabarn,onkabarn,onkadóttir,onkar-,onkasonur,pápasonur,skattur,trúnaðartáta(yndisblóma)best dámda blóma(yndisdjór)yndisdýryndislag, yndisbók o.fl.↔dýrgripur,kelivætti,kjørAndheiti:kastibløka
yndisblóma	síyndisbarn
yndisbros	sískellilátur
yndisbrúður	síkvinna
yndisdjór	síyndisbarn
yndisdýr	síyndisbarn
yndisfagur	sívakur
yndisfljóð	síkvinna
yndisfullur	sívakur
yndislag	síblídni,tónalag
yndisleiki	síyndi
yndisliga	Samheiti:alskiliga,blídliga,blíðan,blíðum,blítt,bróðurliga,deiliga,eiriliga,elskuliga,eymliga,faðirliga,fagurliga,fryntliga,frýntliga,góðsliga,hjartaliga,í blíðum,kærliga,mildan,mildiliga,mildliga,milt,móðurliga,penliga,smørliga,systurliga,søtliga,vakurliga,vakurligani,vakurt,við góðum,vinaliga,vinarligaí góðsemi, góðsemju;í góðum anda;í sátt og semju;við blíðum, føgrum læti, orðum(stásiliga)glæsiliga,stásisliga↔fríðdæmdur,fríðkast,pyntaður,snotiligur,vakur,vegna vinskap,yndiAndheiti:óvinarliga
yndisligur	sívakur
yndisorð	sífótatraðk,lovorð
yndistokki	síyndi
yndisvænur	sívakur
yndugur	sívakur
yngd	síbarnaár
yngdur	síungligur
ynging	síviðseting
yngjast	sífríðkast
yngla	sínørast
yngul	Samheiti:kelv,kelvi,kelvingur,krabbakelv,kræklingskelv,kræklingskelvi,smákelv,svartgjar,øðukelv(grunnslóð)áta,fuglaæti,grunnát,grunnæti,murtl,murtn,reyðæti,seiðaæti,sildaæti,smáæti,sviv,æti↔seinføðingur,ungi
ynna	síásttikin,dáma
ynnast	síásttikin,fríggja
ynniligur	sígóðsintur,vakur
ynnisligur	sígóðsintur,vakur
ynski	sítrá,vón
ynskisdreymur	síveruleikaflótti,vón
ynskisseðil	síyvirlit
ynskja	sítráa,vóna
ynskjandi	síeftirynskjandi
ynskur	sítrá,vón
ynta	sísvara
yppa	síavlíva,elva
yppa klandur	altíð vera á øðrum tráð, tráði, træði, træðri;birta, elva (til) hatur, klandur, ófrið, ósemju o.fl.;birta uppundir (ófrið);gera, íbirta, valda, volda illstøðu, ófrið, ósemju o.fl.;gera spruttispæl, sprutt í spælið;loypa klandur, ólag, split, splitt o.fl. í;loypa krutl, mislag, ófrið, óskil, splittiskeið í;oyðileggja alt;seta fólk upp móti hvørjum øðrum;seta ilt ímillum (tveir);seta tveir saman;spilla spælið;øsa tveir upp hvønn móti øðrum;□Gyða loypti splitt í dansin;nú er friðurin úti;nú kemur smyril í staraflokk;tað kemur hundur í e-t↔berjast,fíggindi,harðhjartaður,hata,hatur,hjartaloysi,illsemjast,klandursvætti,kríggj,kríggjast,mannvándur,mótstøðumaður,óflýggjakroppur,óvinarliga,skelda,skeldastAndheiti:mekla
yppast	síhenda
yppingartak	sítak
yrkadagur	Samheiti:arbeiðsdagur,gerandidagur,gerandisdagur,gerandiskvøld,yrkakvøld,yrkudagurgerandi (og heilagt);vanligur arbeiðsdagur;yrkar nætur;yrkur (t.e.) gerandis-
yrkakvøld	síyrkadagur
yrki	Samheiti:garðyrki,grótarbeiði,handaverk,handverk,heimayrki,húsvirki,hvønndagsyrki,høvuðsyrki,lívsbreyð,tvíyrki,urtagarðsarbeiði,urtagarðsyrki,vinnuvegurdagligt yrki↔arbeiða,arbeiði,ítriv,starv,starvsgrein,verkevni,vinnulív
yrking	sísangur
yrkingabók	sískriv
yrkingargávur	síklókskapur
yrkingarháttur	síarbeiðslag
yrkingarlag	síarbeiðslag
yrkingarlist	sílist
yrkingasavn	sískriv
yrkisbókmentir	síbókaheimur
yrkisbróðir	sífelagslimur
yrkisevni	síamboð
yrkisfelag	sífelag
yrkisfelagi	sífelagslimur
yrkisfótbóltur	síkapping
yrkisgrein	sístarvsgrein
yrkishermaður	síhermaður
yrkisítrótt	síkapping
yrkiskunnleiki	síklókskapur
yrkislag	síarbeiðslag
yrkisleið	sístarvsgrein
yrkisleysur	síarbeiðsleysur
yrkisloysi	síarbeiðsloysi
yrkislærdómur	sílærdómur
yrkislærdur	sílærdur
yrkismentan	símentan
yrkisnavn	sínavn
yrkisorð	sínavn
yrkissjúka	sísjúka
yrkisskúli	sískúli
yrkisútbúgving	sískúlagongd
yrkja	sílúgvaSamheiti:enduryrkja,kappyrkja,rímabotna ørindi;gera, seta saman (eina) yrking;skriva á bundnum máli;skriva poesi;skriva, yrkja kvæði(r), sangir, sálmar, yrkingar, o.fl.;gera, smíða stev, ørindi o.fl;yrkja afturat;yrkja afturímóti;vera rímari, skald, yrkjari, ørindasmiður o.fl.↔rithøvundur,sangur,skald,skriva,tungumál
yrkjari	sískald
yrkorð	sínavn
yrkudagur	síyrkadagur
ysta	síharðna
ystast	síharðna
ytri	sífjarskotin,uttaná
ytst	sífjarskotin,uttarlaga
ytstifingur	sífingur
ytstur	sífjarskotin,uttaná
yvir	síovarlaga,ríkiliga
yviralsklæði	síklæði(r)
yvirarbeiði	síarbeiði
yvirav	síáraka
yvirbekkur	sísessur
yvirborð	síyvirflati
yvirborin	síførligur,hovin
yvirbragd	síeyðkenni,útsjónd
yvirbragð	síeyðkenni,útsjónd
yvirbrá	síeyðkenni,útsjónd
yvirbregði	síútsjónd,vinnari
yvirbregðin	sístoltur
yvirbrigdi	sívinnari
yvirbrigði	sívald
yvirburður	sívald
yvirbyrjaður	síavtakin
yvirdráttur	sílán
yvireingil	síævintýrhugtak
yvirerving	síoverving
yvirferð	síaldrandi,túrur
yvirflati	Samheiti:innsíða,jarðarskorpa,jarðaryvirflati,jarðflati,jørð,skorpa,steinhválv,úthamur,útsíða,yvirborð,yvirsjónd,ýta(skal)eggjakoppur,eggjaskal,eplaflus,eplaskal,flus,hylki,klíggj,kornsáða,rótaskal,sáð,sáða,súreplaflus,útskinn(vatnsmáli)vatnskorpa,vatnstøða↔hinna,húð
yvirflóð	sínøgd
yvirfólk	síoddamaður
yvirgangskroppur	síóflýggjakroppur,tjóvur
yvirgangsmaður	síatsóknarmaður,óflýggjakroppur,tjóvur
yvirgangsverk	síbrotsverk
yvirgangsvirksemi	síbrotsverk
yvirgangur	síbrotsverk,hóttan
yvirgerðarmaður	síóflýggjakroppur
yvirgeva	sítapa
yvirgivin	símannvándur
yvirgonga	sífrest,seyðarakstur
yvirgongd	sífrest
yvirhagi	síjarðarstykki
yvirhallur	sísjóringur
yvirhiti	síhiti
yvirhonds	síógvuliga
yvirhoyra	sítráspyrja
yvirhoyring	síspurningur
yvirhugaður	síáhugaður
yvirhugi	sívreiði
yvirhøvd	síhøvuðskál
yvirhøvur	síofta
yvirjarðligur	Samheiti:gudaborin,gudborin,guddómligur,guddómsligur,gudvígdur,himinligur,himmalskur,himniskurikki av hesari jørð;ikki av hesi verð;ikki av hesum heimi↔andligur,átrúni,bíbilskur,Gud,himnaríki,JesusAndheiti:forgeingiligur
yvirkarði	síkarði
yvirklæði(r)	síklæði(r)
yvirkoyggja	síseingjarstaður
yvirkoyrdur	sísamanbrestur
yvirkroppur	sílikam
yvir land	sílandvegin
yvirlendi	síberg
yvirlit	síklókskapurSamheiti:altjóðaskráseting,álmanakki,álmunakki,bíðilisti,bókalisti,bókaskrá,dagatal,dráttarlisti,evnisyvirlit,ferðafólkatal,grindalisti,haldaratal,húsatal,hvítbók,innihaldsyvirlit,jarðarbók,jarðbók,jólakalendari,kalendari,kalsbók,kongsbók,kortaskrá,kútal,kvøðulisti,landsbók,listi,lógasavn,lógbók,løgbók,manningarlisti,manntalslisti,markabræv,matarskrá,matkort,matrikul,matseðil,matskrá,minnisblað,minnisbók,minnislepi,príslisti,roknitalva,seðlasavn,seðlaskrá,skattalisti,skinnatal,skipan,skipaskrá,skipaskráseting,skrá,skráseting,stigatal,stigatalva,streymtalva,stykkjatal,svarlisti,sølulisti,tabell,tal,talva,telefonbók,tilfarslisti,tingbók,tímaseðil,tímatal,tímatalva,tímaætlan,tollskrá,uppritsbók,uppskriftabók,uppskriving,úthendi,vínkort,vørulisti,vøruskrá,yvirskoðan(roknskaparbók)bankabók,handilsbók,kassabók,kontrabók,sjúkrakassabók,sparikassabók(dagbók)árbók,ársbók,ársrit,fundarbók,gerðabók,loggbók,rættarbók,siglingarbók,sjúkradagbók,skipsbók,skipsdagbók,vártingsbók,ynskisseðil(fólkayvirlit)adressubók,barnatal,burðatal,fólkatal,gestabók,kirkjubók,limalisti,limatal,listi,manntal,navnalisti,navnaskrá,næmingatal,svartilisti,telefonbók,valevnalisti,vallisti(hagtal)atkvøðutal,deyðatal,farmynd,farstrika,lambatal,mannadeyði,stabbamynd,stigatalva,strikumynd,valmynd(orðaskrá)bakleiðisorðabók,einmálsorðabók,móðurmálsorðabók,orðabók,orðalisti,orðasavn,rættskrivingarorðabók,samheitabók,samheitaorðabók,samtalsbók,skyldorðabókgulu síðurnar;hagfrøðilig tøl;hagtøl;tøl á, yvir...↔nummar,skráseta,skriv
yvirlitsgóður	sígreiður
yvirlitslestur	síbókalestur
yvirlitur	sílittóni
yvirlíki	sívinnari
yvirluti	sívald
yvirlýsa	síljósglæma
yvirlýsing	síboðan,játtan,skrá,ummæli
yvirlærari	sílærarafólk
yvirlæti	sískálkaskjól
yvirmaður	síoddamaður,vinnari
yvirmaki	sívinnari
yvirmakt	sívald
yvirmáttugur	sísterkur
yvirmenni	síavtakafólk,kraftamaður
yvirmenska	símegi
yvirmenskur	sísterkur
yvirment	símegi
yvirmentur	sísterkur
yvirmeta	sítilbiðja
yvirmeting	símeting
yvirmógvur	símógvur
yvirmuður	símunnur
yvirmunnur	símunnur,tonn
yvirnatúrligur	síóveruligur
yvirnøgd	sínøgd
yvirplagg	síklæði(r)
yvirprenta	síprenta
yvirprenting	síárit
yvirráð	sívald
yvirrið	sívinglan
yvirræði	sívald
yvirsinni	sívreiði
yvirsintur	sívreiður
yvirsjón	síveruleikaflótti
yvirsjónd	síyvirflati
yvirskegg	sískegg
yvirskipaður	sínøra
yvirskipan	sískipan
yvirskoðan	síklókskapur,samandráttur,yvirlit
yvirskot	Samheiti:avlop,avlopspeningur,avtøka,ábati,ágóði,ársavlop,ársvinningur,ávinningur,ávøkstur,býtispeningur,eftirtøka,eykaágóði,fæleiga,løtuvinningur,nettoavlop,peningavinningur,rakstraravlop,samansparing,skiftisavlop,skiftisíkast,sparipeningur,tiltakspeningur,umloysur,úrslit,úrtøka,vinningsbýti,vinningur(renta)dragurenta,innlánsrenta,okurrenta,ovurrenta,renturenta,útlánsrenta↔avlop,búnast,endaúrslit,foruttan,grøði,úrtøkugóðurAndheiti:hall,skuld
yvirskrift	sínavn
yvirskørr	síbergloft
yvirstaðin	síendaður
yvirsteinur	sígrót
yvirstempla	sískriva
yvirstjórn	sívald
yvirstætt	síaðalsfólk,samfelagsstætt
yvirsvinnur	síálvarsamur,stoltur
yvirtak	sítak
yvirtala	sínoyða
yvirtaling	sífreisting
yvirtikin	síavstoktur í...,smittaður
yvirtíðarløn	sígjald
yvirtorva	síbrenni
yvirtóni	sítónalag
yvirtráður	síband
yvirtrom	síútlinja
yvirtryggja	sítryggja
yvirtrýst	sítrýst
yvirtænari	síhjálpari
yvirum	Samheiti:tvørturumtvørtur um;yvir á hin bógvin, hina síðuna, í hitt borðið;yvir hinumegin;yvir um↔áraka,báðumegin,hinumegin,javnsíðis
yvirumsjón	síeftirlit
yvirvaksin	síhøgur,mikil
yvirvald	sívald
yvirvánir	sívald
yvirvekraður	sísvøvntungur
yvirveldi	sívald
yvirvinna	sísigra
yvirvunnin	sísigra
yvirvøld	sívald
yvri	sívreiði
yvrigur	síáhugaður
