ó	sító
óampaður	síóttaleysur
óansin	síbusutur
óansni	sívansketni
óarbeiðsførur	síbrekaður
óarbeiðsligt	sítorførur
óarbeiðsligur	síóskapiligur
óargadjór	síóflýggjakroppur,ótangi
óargadýr	síóflýggjakroppur,ótangi
óargagerð	sískálkagerð
óargakroppur	síóflýggjakroppur,ótangi
óargaligur	símannvándur
óargaskapur	síóndskapur
óargaungi	síótangi
óast	sító
óatfinnandi	síósekur
óatkomandi	síófarandi
óatkomiligur	síófarandi
óavgjørdur	síivasamur,javnviga
óavgjørt	síjavnviga
óavhøvdaður	síókruvdur
óavmarkaður	síóskerdur
óavvitandi	Samheiti:ómedvitin,ótilvitaður,ótilvitandi,óvitandi,óvitvísurikki avvitandi;uttan at vita av;○sum er ókunnigur um e-t↔óvit,tilviljandi
óálítandi	sídygdarleysur,ósannur,svikafullur
óár	sívánatíð
óárligur	síósannlíkur
óártímiligur	síósannlíkur
óásettur	síóskerdur
óát	Samheiti:óáta,ógvæta,ógvæti,óæta,óæti↔eta,gagnast illa,óetandiAndheiti:matur
óáta	síóát
óátalaður	síóskalaður
óátuligur	sísmakkringur
óávinniligur	síóvinniligur
óbati	síhindur
óbeinamaður	síklandursvætti
óbeinasamur	síófúsur
óbeinleiðis	Samheiti:aftanífrá,bakleiðis,bakvegisá bakið;gjøgnum bakdyrnar(krókvegis)skákleiðis,skákvegis(umleiðis)umvegis↔framundirróður,vísa áAndheiti:beinleiðis
óbeinur	síhallur,óneyvur,ósannur,rundur
óbekvemmur	síbusutur
óbendandi	síharður
óbendiligur	síharður
óbiðin	sísjálvbiðin
óbindandi	Samheiti:leysligur,óformligurikki bindandi;ikki eftir strongum reglum;ikki formligur↔fríur
óblandaður	síeinskærur
óblankur	sífløktur
óblíður	síharðhjartaður,vreiður
óblýggjaður	síblýfríur
óboðin	sísjálvbiðin
óborin	síóbúgvin,tungur
óboyggiligur	síharður,óvinniligur
óbótaður	sísmakkleysur
óbótagerð	síbrotsverk
óbótaligur	sídýrur,óbøtiligur
óbótamaður	síbrotsmaður
óbótaverk	síbrotsverk
óbrákaður	síheilur
óbrigdiligur	síeinsljóðandi,sannur
óbrotin	síheilur,óskalaður,samanhangandi
óbroytandi	síeinsljóðandi,sannur
óbroytiligur	síeinsljóðandi,sannur
óbroyttur	Samheiti:samureins og altíð, sum altíð, áður, fyrr;enn sum áður;samlíkur áður;sum hann er vanur, plagar;□hann er sær sjálvum líkur;har er eingin broyting, munur;hatta ger, munar hvørki frá ella til, til ella frá;hatta ger ongan mun, munar einki;tað kemur niður í sama stað, verður verandi óbroytt↔einsljóðandi,sannur
óbrúkiligur	sídygdarleysur
óbrúktur	sínýggjur
óbrýndur	síóhvassur
óbræddur	sílitfarin
óbundin	sífríur
óburður	síkryplingur
óburin	sígeldur
óbúgvin	síófyrireikaður,óvanur,ungurSamheiti:grønur,ófjaðraður,ófloygdur,ómataður,óstaðinikki búgvin;ikki flogbúgvin;ikki floygdur;ikki fullbúnaður;ikki fullvaksin;ikki staðin;ikki takandi(óborin)óføddurí móður lívi↔nakin,ófullfíggjaður
óbygd	síoyðistaður
óbygdur	sífólkaoyðin
óbýli	síoyðistaður
óbýttur	síóskerdur
óbøtandi	sídýrur,óbøtiligur
óbøtiligur	sídýrurSamheiti:óbótaligur,óbøtandi,ófyrigevandi,ógrøðandi,ógrøðiligur,ólekjandi□har, her er, hjálpir eingin bøn;her, nú hjálpir eingin kæra mamma;e-m stendur ikki til bata;e-t bøtist ikki aftur↔brotna,glataður,miseydnast,oyðileggjast,óheppin,ólagna,skaði
ódagi	síósemja
ódagur	síósemja
ódáð	síbrotsverk
ódálkaður	sígóðsintur,ósekur,reinur
ódámaður	sílitfarin,skitin
ódámligur	síræðandi
ódámur	sílittóni
ódeyðaveður	síillveður
ódeyði	sídeyði
ódeyðileiki	síendaloysi,lív
ódeyðiligleiki	síendaloysi,lív
ódeyðiligur	sívarandi
ódirvi	símótloysi
ódjarvur	síbangin,mótfallin
ódjór	síóflýggjakroppur,ævintýrhugtak
ódlátaður	síófriðarligur
ódligur	síbusutur,ófriðarligur
ódlingur	síóflýggjakroppur
ódn	síbruni,illveður,jarðarstykki,sjóvarilska,stað,sveipur,vindur,vreiði
ódna	sísláa gras,storma
ódnarálop	síálop
ódnarbardagi	síkríggj
ódnarbit	síhampafólk
ódnarbrestur	síillveður
ódnarbrim	sísjóvarilska
ódnarbrot	sísjóvarilska
ódnardagur	Samheiti:bakkdagur,brimdagur,brimnátt,brimsummar,brimvetur,burturgangingardagur,harðveðursdagur,harðvetur,illveðursdagur,illveðurskvøld,illveðursnátt,illveðurssummar,innidagur,inniveðursdagur,ódnarnátt,ódnarvetur,ógerðardagur,óveðursdagur,óveðursnátt,óveðursvetur,ruskdagur,stormdagur,stormnátt,vetrarmagn,vindár,vinddagur,vindnátt↔aldutur,draga á luftina,illveður,sjóvarilska,storma,vánatíð,veðurringurAndheiti:góðveður
ódnardun	síljóð
ódnarferð	sítúrur
ódnarhugi	sííblástur
ódnarhugur	sííblástur
ódnarhvirla	sívindur
ódnarlátur	sískellilátur
ódnarljóð	síljóð
ódnarlop	sílop
ódnarnátt	síódnardagur
ódnarregn	síregn
ódnarrið	sívindur
ódnarróður	síróður
ódnarróp	sískríggj
ódnarsjógvur	sísjóvarilska
ódnarstormur	sívindur
ódnarstykki	síóflýggjakroppur,ótangi
ódnartak	síátak
ódnaruppgangur	sísjóvarilska
ódnarveður	síillveður
ódnarvetur	síódnardagur
ódnarvindur	sívindur
ódning	sísveipur
ódn í vindi	sívindur
ódnur	sísveipur
ódoyggjandi	sívarandi
ódrekkandi	síóetandi
ódrukkin	Samheiti:edrúurblanka, púra, turra edrúur;edrúur sum ein fótalunnur;ikki drukkin;púra blankur;turrur sum eitt øksarskaft;○sum ikki hevur leska, smakka tað, ikki kennir til(ganga edrúur)gera lítið við tað váta slagið;halda seg frá brennivíni, tí váta slagnum;ikki leska, nýta, røra, smakka brennivín, tað, tað váta slagið;ikki gera nógv av (at drekka);leggja av (at drekka);seta fløskuna á hillina;turrleggja e-n, seg;venda tí váta slagnum bakið;venja e-n, seg av við at drekka;vera fráhaldandi(avrenning)minking av rúsevni í blóðinum(renna av)gerast edrúur;ølið rennur av aftur(avafturrunnið)avrunnið(turrlagdur)vorðin edrúur↔avhald,detta av,drankari,drekka brennivín,drukkin,drykkjuskapur,hava timburmenn,kenning,timburmennAndheiti:drukkin
ódrúgvur	sílatur,upplopSamheiti:bráðdrigið,bráðfarin,eyðnýttur,eyðtøkin,eyðtøkur○sum er skjótur eftir seg, skjótt verður uppi;sum ikki steðgar á, steðgast;□hatta er bæði komandi og farandi;hatta fær (skjótt) fótalætir;hatta gongur skjótt undan, kemur og fer, varir stutt;hatta liggur ikki leingi á;tað er burtur sum ósmurdur skeyti;tað er sum at sleikja døgg;tað hvørvur, minkar sum matur á borði;tað sum kemur lætt fer lætt↔hilnast illa,oyðsla burtur,oyðsluturAndheiti:varandi
ódrýggiligur	síoyðslutur
ódrýggjaligur	síoyðslutur
ódugnabjølgur	sívánamaður
ódugnabóndi	sívánamaður
ódugnadjór	sívánamaður
ódugnadýr	sívánamaður
ódugnakroppur	sívánamaður
ódugnaligur	síkraftleysur
ódugnamaður	sívánamaður
ódugnaskapur	sívansketni
ódugnavætti	sívánamaður
óduguligur	síkraftleysur
óduldur	síopinberur
ódult	síopinberur
ódygd	sílótir,óflýggjakroppur
ódyggur	sísvikafullur
ódyrkaður	síniðurdottin
ódýr	síóflýggjakroppur
ódýrur	síbíligur
ódællur	símannvándur,ófúsur
ódælur	símannvándur,ófúsur
ódæmsligur	sískitin
ódømi	síóreglulív
óðadøla	síleyslyntur persónur
óðal	síogn
óðalborin	síarvaborin
óðalsborin	síarvaborin
óðalsbóndi	síjarðyrkismaður
óðalsbygd	síbýur
óðalsbýta	síbýta
óðalsbýti	síbýti
óðalsbøur	síogn
óðalsjørð	síogn
óðalsmaður	síjarðyrkismaður
óðalsrættur	sírættindi
óðalsting	sívald
óðamannahús	síbygningur
óðamannatos	símøsn
óðamannaverk	sídáragerð
óðamýli	síóflýggjakroppur,ótangi
óðast	síbeistast
óðinshani	sífuglur
óður	sísvakur,vreiður,øvutur
óeginligur	síóveruligur
óegndur	síavegndur
óektaður	síblandaður,dygdarleysur,ósannur,uppgjørdur
óeldaður	síbrunnin
óella	sífuglur
óendaliga	síógvuliga
óendaligur	sívarandi
óerla	sífuglur
óetandi	Samheiti:ódrekkandi,ógagnsligur,vamlisligur,vamluturikki berandi at munni, í munn, etandi, drekkandi, munnbært;ikki borðberandi, borðbærur, borðførur, munnberandi, munnbærur;ónýtiligt til fólkaføði, mannaføði, matna;○sum gagnast illa, ikki gagnast;□hatta er ikki fólkaføði, fólkamatur;hatta kemur ikki í menniskjans munn;hatta verður ikki etið, verður óetið↔eta,gagnast illa,matur,óátAndheiti:etandi
óeydna	síólagna
óeydnismaður	síavynnumaður,vánamaður
óeydnudagur	sívánatíð
óeydnuferð	sívandi
óeydnufuglur	síspámaður
óeydnugerð	síólagna
óeydnuligur	síóheppin
óeydnumaður	síavynnumaður,vánamaður
óeydnupláss	síillveðurshol
óeydnusamur	síóheppin
ófalsaður	síeinskærur,sannur
ófalur	síótøkur
ófant	síbarbrot
ófantaliga	síilla ílatin,ósmidliga
ófantaligur	síaldutur,busutur,illa ílatin,óskapiligur,ósømiligur,veðurringur
ófantaveður	síillveður
ófarandi	Samheiti:illgongdur,klintrutur,kløtrutur,knortlutur,óatkomandi,óatkomiligur,óførur,ógongdur,óhøgligur,óklívandi,ókvensligur,ólagaligur,ótøkiligur,ótøkin,ótøkur,óvegligur,skjørslutur,skjørur,sniðgongt,torfarin,torgingin,torgongdur,ørguturikki, illa, neyvan, valla atkomandi, framkomandi, gangandi, gongdur, gongt, klúgvandi;ikki, illa rendur, rent;ikki mannførur;ringt føri, geingi;ringur at fara, ganga, koma, sleppa at, av, á, í, til, um, úr;□har er ikki farandi, framkomandi, gongubært;har er ókvensligt geingi, ókvensligt, óvegligt at ganga;har er so ringt um;hatta er ikki heimatiltikið, heimatiltøkt;hatta eru eingi, ikki kirkjuspor;tað var ikki brúðargongd(torrógvin)kyrruvandur,kyrruvándur,ófarandi,torsigldurikki bátsrøtt, fjarðført, fjarðrøtt, fjørðfart;ikki farandi um fjørðin;ikki klúgvandi, rógvandi, siglandi, útrógvandi;□fjørðurin er ikki bátaførur↔busutur,hálur,ógjørligur,ójavnur,óskapiligur,torførurAndheiti:atkomandi,ómakaleysur
ófaratøkin	síbusutur
ófastur	síóveruligur
ófatandi	sífløktur,ólýsandi
ófatiligur	sífløktur,ólýsandi
ófegin	sísorgarbundin
ófeigur	ikki feigur;○sum ikki er búgvin at doyggja;sum ikki skal doyggja enn;□mínir dagar vóru ikki taldir;mín tíð var ikki komin, ikki uppi;mær var ikki lagað at doyggja tá↔forgeingiligur,lív,liva,livandi,livnaAndheiti:hálvdeyður
ófeingi	síórin
ófeingin	síórin
ófellandi	sísannur
óferð	síólagna
óferi	sísvullur
ófestur	sístøðuveikur
ófimsligur	síbusutur,óskapiligur
ófimur	síbusutur,harður,óstúttur,seinpjakutur
ófiskiligur	síaldutur,dygdarleysur
ófittligur	síbusutur,óskapiligur
ófittur	síóskapiligur,ræðandi
ófínur	síóskapiligur,ósømiligur
ófjaðraður	sínakin,óbúgvin
ófjálgur	síræðandi
ófjáltraður	síóttaleysur
ófjølbroyttur	síeinsljóðandi
ófjøsaligur	sífrísutur,illa ílatin
ófjøsasligur	sífrísutur,illa ílatin
óflaktur	síókruvdur
óflongdur	sínasadjarvur,reyputur
ófloygdur	sífjaðrast,loðin,óbúgvin
óflýggjadýr	síóflýggjakroppur
óflýggjaður	símannvándur
óflýggjakroppur	Samheiti:aputýggi,avryski,bakbeist,barbárur,bardagakattur,bardagamaður,bartrog,beist,belsmaður,berserkur,bithorn,bituvargur,bitvargur,bløðra,búrbeist,búrhundur,búrkattur,búrkroppur,búrlív,búrmenni,búrskálkur,búrskinn,búrskræðari,búrtjóvur,bøðil,bølmenni,djevul,hólkur,einaharri,einræðisharri,einvaldsharri,fani,findarskálkur,findarskelmur,hapartýggi,hapurtýggi,harðstjóri,hárloypingur,helvitishundur,herjanssonur,herskireyv,hjartaloysingur,hornabítur,hundabeist,hundakroppur,hundatýggi,hundskinn,hundsskinn,hundsvottur,høvuðkambur,illbit,illdýr,illkrút,illmenni,illnati,illnit,illryski,illsinnabløðra,illsinnapirra,illsinnavætti,illsinnislúnur,illtýggi,illvætti,kjálki,kroppur,krúthorn,kúgari,leviátur,lúsahólkur,lúsahundur,lúsakjálki,lúsakroppur,lúsaleingja,lúsaskarvur,lúsavætti,lúshundur,lúsungi,lættlámur,mannfíggindi,mannvargur,margbøðil,margskálkur,morðbrandur,murgur,níðingur,orgallur,ormasekkur,óargadjór,óargadýr,óargakroppur,ódjór,ódlingur,ódnarstykki,ódýr,óðamýli,óflýggjadýr,óflýggjamaður,ófriðardýr,ófriðargestur,ófriðarkroppur,ófriðarmaður,ófriðarvætti,ófriski,óhógvamaður,ólátakleppur,ómenni,ómenska,ónærafólk,óspektarmaður,ótangi,ótoyggi,ótvætti,ótýggi,óvandaslag,óviljamaður,óvætti,petti,pínari,reyvarhol,reyvarringur,sádómur,sjóránari,sjóránsmaður,sjórænari,sjóræningi,skaðafuglur,skaðavætti,skarn,skarndjór,skarndýr,skarnskroppur,skarnskrút,skarnsmuður,skarnstjóvur,skarnsungi,skarnsvætti,skarnvargur,skarvur,skálkur,skelmur,skemdarkjaftur,sóthestur,spektakkul,spók,spýggj,svínakjálki,svínarennil,svínhundur,tjóvabeist,tjóvsungi,tríggi,trog,trællur,trælmenni,turkur,tyktari,týggidýr,úlvarungi,valdræningi,valdsharri,vanegli,vanigla,vanigli,váðagestur,veitsluspillari,viðkrút,villmaður,villmenni,vittuggi,yvirgangskroppur,yvirgangsmaður,yvirgerðarmaður,øðukongur,øsingarmaður(illkvendi)bikkja,brita,galdrakvendi,gívur,groyggj,groyggja,gúr,gæsa,heks,illbikkja,illkvendi,illmoldartorva,illneita,keipa,klandra,kvendi,meka,mer,murga,møka,neita,ódygd,ókvendi,ónæra,skarnskvendi,skarnsteys,snót,snóta,teys,tytta,ørnav óvandaslag;bannsett fólk;beista ungi;devuls kvistur;dummur hundur;ein devuls, fanans, helvitis...;ein fortinaður stavnur;ein harður hundur;ein sovorðin smyril;ein øgil og ein bøðil;eitt grúiligt krút;eitt reint, satt helviti;eitt ross;hundasáð t.e. óargaungar;hvast fólk;óreint fólk;sátans ungi;úlvur í mannalíki;□hann er sum smyril í staraflokki;hatta ber seg ikki at sum fólk;hatta líkist ikki fólki↔argapetti,baktalari,harðhjartaður,hjartaloysi,ilskast,klandursvætti,lúnuskøltur,mannvándur,ófriðarligur,ófúsur,óndskapur,ósemja,ótangi,tvørlyndi,vánafólk,vánamaður,vreiði,yppa klandur,ætla ilt,ørskapurAndheiti:hampafólk
óflýggjaligur	símannvándur
óflýggjamaður	síóflýggjakroppur
óflýggjaorð	síspottorð
óflýggjaskapur	síørskapur
óflýggjatala	síspottorð
óflættiligur	síófúsur
óforgeingiligleiki	sílív
óforgeingiligur	sívarandi
óformligur	síóbindandi
óforsíggin	síbusutur
óforsíggja	sívansketni
óforsynja	sívansketni
ófólkaligur	sínasadjarvur,ósømiligur
ófrásigandi	síólýsandi
ófrásigiligur	síólýsandi
ófrelstur	síheiðin
ófridligur	síaldutur,ófriðarligur,ófúsur
ófriðardýr	síóflýggjakroppur
ófriðargestur	sígestur,óflýggjakroppur
ófriðarkroppur	síóflýggjakroppur
ófriðarland	sístatur
ófriðarligur	Samheiti:balstýrigur,balstýrin,brasin,brestandi,buldrandi,buldrutur,fjasamikil,galdrutur,garvillur,gæsutur,hámikil,hávamikil,herskandi,larmandi,larmutur,leiðindur,livandi,ovurvirkin,ódlátaður,ódligur,ófridligur,ófriðarmikil,ógvisligur,ógvusligur,ólagaligur,ólátaður,ólátaligur,ólátin,óljóðamikil,óró,óróligur,óstýrandi,óstýriligur,púrgjørdur,ribbaldakendur,rokaligur,rokasligur,rokkendur,rokmikil,rokutur,ruskusligur,rusutur,skramblutur,sprækin,sprækligur,umripiligur,umripingarsamur,vasutur,villur,vøsuturringur at hava við at gera;sum ein loppusekkur, tarvur, vargur, varúlvur;sum eitt eg veit ikki hvat;sum eitt omanlop, óløgi;við buldur og brak, buldur og reyp, gang og levind, rok og fok;□hann leikar í sum úlvur á hungursferð;(seyða)fylgið er harðrent;seyðurin er útrendur(órógvasamur)órógvin,órógvur,óróligur,óstillur,óstiltur,óstøðugur,óstøðuligur,skrúgvuleysur,skrúvuleysur,startin,støðuleysur□eldur er í halanum á honum;hann er aldri, ongantíð í frið(i);hann er eitt flog;hann hevur ikki bindindi ella tol (at bíðða), ikki frið ella ró á sær;hann hevur kyksilvur í reyvini;hann situr og andvarpast, rassast;hann situr, stendur sum á brondum, glóðum;hann vappar sum æða í eggrás↔beistast,berjast,brótast,busutur,hugspentur,kastast,levind,ljóðmikil,málmikil,óflýggjakroppur,ófúsur,órógva,ótangi,snarsintur,vreiðurAndheiti:kvirrur
ófriðarlæti(r)	sílevind,ørskapur
ófriðarmaður	síóflýggjakroppur
ófriðarmikil	síófriðarligur
ófriðarskip	sísjófar
ófriðartíð	sívánatíð
ófriðarvætti	síóflýggjakroppur
ófriður	síkríggj,levind,ljóð
ófriski	síóflýggjakroppur,ævintýrhugtak
ófríður	sílitfarin,misháttur,ójavnur
ófrímerktur	Samheiti:ópostaðurvið ongum frímerki, postmerki↔kostnaðarleysur
ófríur	síkúgaður
ófrosin	síísfríur
ófrukt	sígeldingur
ófryntliga	síóvinarliga
ófryntligur	sívreiður
ófrystur	síísfríur
ófrýntligur	sívreiður
ófrælsi	sítvingsil
ófrælsur	síkúgaður
ófrætta	síboðan
ófrættaboð	síboðan
ófrættafuglur	síspámaður
ófrættakendur	síræðandi
ófrættarámi	síóhugnaður
ófrættatíðindi(r)	síboðan
ófrætti	síboðan
ófrættindi(r)	síboðan
ófrættir	síboðan,ólagna
ófrættisfuglur	síspámaður
ófrættistíðindi(r)	síboðan
ófullborin	símissa fostur
ófullfíggjaður	Samheiti:avmarkaður,hálvfíggjaður,hálvgingin,hálvgjørdur,hálvhoyggjað,hálvliðin,hálvliðugur,hálvrógvin,hálvrunnin,hálvsiglt,hálvur,hálvvirkaður,lutvísur,ófullførdur,ófullgjørdur,ófullkomin,ófullnøgandi,óheilur,óliðugur,ólokin,partvísurikki fingin frá hondini;ikki fullkomin;ikki (heilt, reiðiliga) liðugur;ikki komin í helvt;ikki nóg góður, mikil, nógvur o.fl.;ikki nøktandi;í hálvum gekki;komin eitt sindur, nakað, væl áleiðis, ávegis;komin hálva leið, hálvan veg;komin í hálvan gekk, í hálvgekk, í helvt;○sum ikki røkkur til, ikki stendur mát (enn);□enn er langt, nakað á mál;hatta er heldur nomisligt, kollut;(húsini) standa í gerð;ikki er hundur hálvbardur;klokkan er hálvgum (...);nú er komið í helvt;nú stendur í hálvakorti, miðgekki;tað er enn á byrjanarstigi, royndarstigi;tað er lítil sjógvur rógvin enn;tað liggur í hálvum gekki(hálvur (av...))hálvdrukkin (um fløsku, ílat),hálvfermdur,hálvfullur (av...),hálvsetturum hálvan;um miðju(na);upp undir mið, miðju, miðjuna, mittu↔helmingur,javnstrokin,náttlagdur,nærkast endanum,næstan,óbúgvin
ófullførdur	síófullfíggjaður
ófullføri	síbýttisskapur,ørvitisskapur
ófullførur	síbrekaður,svakur,tápuligur
ófullgjørdur	síófullfíggjaður
ófullkomin	síófullfíggjaður
ófullnøgandi	síófullfíggjaður
ófúsur	Samheiti:andrísin,fasthentur,harður,hálvhugaður,hjarnaður,hopileysur,hopleysur,illfýsin,kontrárigur,løgin,malisjønskur,malisjøskur,malsjønskur,malsjøskur,mansjønskur,meingøvgaður,meingøvgutur,meinskur,mótrisin,nakkafattur,negativur,neiligur,neisagdur,neisøgin,neyðugur,noktandi,óbeinasamur,ódællur,ódælur,óflættiligur,ófridligur,óhoyriligur,óhoyrin,ólagaligur,ólýðin,ómøguligur,órímiligur,ósmidligur,ótemiligur,ótemjandi,óviðeiriligur,óviljaður,óviljugur,óvilligur,pásetligur,prumsintur,rangsinnaður,rangsintur,rangvørgur,ríggin,ríggjutur,serlyndur,sersinnaður,sersintur,serur,siggutur,stáliskur,stívrendur,stívsinnaður,stívur,stokksettur,stórmøraður,strangur,stríðigur,stríðugur,stríður,stríggjur,trályndur,treiskin,treiskligur,treisklyndur,treiskur,trekin,treklyndur,trekur,treyður,trongskygdur,trúgutur,trylskur,trælskur,tvitin,tvørballaður,tvørballutur,tvørlyndur,tvørlyntur,tvørsintur,tvørur,tvørviðaður,vandin,vandlátur,ølóðurfasthildin á sínum;lítið hugaður;ómøguligur at tosa við;ringur at fáast við, hava við at gera;treiskur í huga;uttan áhuga;sum heldur fast við sítt, heldur upp á sítt, stendur við sítt;□eingin kann flætta við hann;hann aktar illa, ger bara sum hann sjálvur vil;hann er harður í horn at taka;hann er hvørki at høgga ella stinga í, ikki til at flætta við, ikki til at vika;hann er ikki til at fáa frá sínum, gongur ikki frá sínum;hann gongur sínar egnu gøtur, leiðir, vegir;hann, hatta heldur seg vera, lærist ikki, tekur ikki við lærdómi;hann hevur hart sinni, letur seg ikki vika;hann hevur stáloyra, steinoyra;hann hevur tíggju orð aftur ímóti (einum) (orði);hann vikast, víkir, víkur ikki ein tumma (frá sínum);tað er sum at sletta vatn á gás;tað flættast ikki við hann;tað rínur einki við hann(framasøkin)ærusjúkur(ráðaríkur)eginsinnaður,einráðin,einvísur,harðligur,harðmøraður,heimaríkur,herskandi,herskutur,hopleysur,høvuðkambaligur,maktsjúkur,ráðasjúkur,sjálvklókur,sjálvráðin,sjálvrættvísur,sjálvstórur,trábeitin,valdfúsur,valdkærurheimaríkur sum hundur;sum smyril í staraflokki;ringur at hava við at gera;stórur í ondini;□hann er ein tóvi at fáast við;hann vil altíð hava rætt, hava sítt segl á loft;tað flættast ikki við hann;tað rínur einki á hann alt ið prædikað verður;tað rínur einki við hann(klandringarsamur)bardagafúsur,bardagamikil,bardagasamur,blóðtystur,drápshugaður,illbirtin,kjakutur,klandrutur,klandursamur,krígshugaður,meklutur,stríðsfúsur,stríðshugaður,trætin,vígfrekurargur at berjast;kvikur at sláa;leysur, lættur á hondini;○sum hevur til lyndi at sláa;□fyrsta er orðið, annað er høggið, slagið↔aftra seg,beistast,berjast,brótast,harðhjartaður,hjartaloysi,illa dámdur,ilskast,kastast,klandursvætti,leti,levind,lúnuskøltur,mannvándur,nasadjarvur,óflýggjakroppur,ófriðarligur,ógjarna,ótangi,snarsintur,tvørlyndi,týningarhugur,vreiði,vreiður,ætla iltAndheiti:hjálpsamur,játtandi,villigur
ófyltur	sítómur
ófyrigevandi	síóbøtiligur
ófyrikomandi	síharðhjartaður
ófyrireikaður	síóvanurSamheiti:óbúgvin,óráddur,óráðtøkin,ótilbúgvin,óútbúgvin,óútgjørdurikki klárur, ikki til reiðar o.fl.;ikki útreiðraður, útskavaður;illa búgvin, fyrireikaður, tilbúgvin, útgjørdur(ótilgjørdur)óuppgjørdur,óuppreiddur↔óvanurAndheiti:tilbúgvin
ófýsi	símótvilji
ófýsiligur	síaldutur,óruddiligur,ræðandi,skitin,veðurringur
ófýsin	síaldutur,óruddiligur,ræðandi,veðurringur
ófýsisligur	síaldutur,ræðandi,veðurringur
óføddur	síóbúgvin
ófødningur	sífostur
ófølnandi	sívarandi
óføra	síógvuliga
óføraveður	síillveður
óføri	síforræði,illveður,svullur
óførisseyður	síseyður
óføristorva	síforræði,grasvaksin blettur
óførliga	síósmidliga
óførligur	síbusutur
óføroyskur	sífremmandur
óført	sífrálíkt
óførur	síaldutur,brekaður,frálíkur,hovin,mikil,nógvur,ófarandi,ógjørligur,smittaður
ógagn	sídáragerð,hindur,spell
ógagnsamligur	sísmakkringur
ógagnsamsligur	sísmakkringur
ógagnsligur	síóetandi,ræðandi,smakkringur
ógagnsorð	síspottorð
ógagnsverk	síbrotsverk,dáragerð
ógáin	síbusutur
ógegnigur	sídygdarleysur
ógegniligur	sídygdarleysur
ógegnisligur	sídygdarleysur
ógegnugur	sídygdarleysur
ógemeina	síógvuliga
ógemeinur	símikil,nógvur,ólýsandi
ógerandi	síógjørligur
ógerð	síbrotsverk
ógerðardagur	síódnardagur
ógerðarveður	síillveður
ógerningur	síbrotsverk
ógiftur	síeinsamallur
ógigni	síkloddakot
ógilda	sídøma
ógildan	síavtøka
ógildigur	síólógligur
ógilding	síavboð,avtøka
ógildingarstevning	síboðan
ógildur	síólógligur
ógingin	síóskerdur
ógitandi	sífløktur
ógitin	sífløktur
ógittur	sífløktur
ógjarna	Samheiti:neyðugt,trekan,treyðan,treyðugt,trekligaav lítlum, ringum huga;ikki av egnum vilja, góðum, stórum huga;ikki av lyst, lysti;ikki fyri alt í verðini;ikki við gleði;ikki við góðum;móti eins vilja;við ilt, ringt tannabit;við mishugi, ógleði;við ringum tannabiti(striltið)illa,líðandi,møðsamliga,ringt,seigliga,seint,smátt,spakuliga,strevisliga,stríggið,stríggisliga,trekliga,trekt,trevið,treytiliga,tungan,tungligaikki væl;við bit og slit, neyð og deyð, strev og stríð, stríð og strev, treyð og neyð↔aftra seg,líðandi,lítið,noktan,næstan,ófúsur,ósmidliga,so dánt,umleiðAndheiti:gjarna
ógjølla	síóskilliga
ógjølliga	síóskilliga
ógjørligur	Samheiti:hopleysur,óførur,ógerandi,óhugsandi,ómøguligur,vónleysur□har er eingin bøn, møguleiki, vón o.fl.;hatta kann ikki vera tal um, kemur ikki upp á tal;tað ber ikki til;tað er ikki at bjóða til;tað er ikki hugsingur, talingur um;tað er ógjørligt, ómøguligt;tað er sum at oysa havið turt↔ófarandi,ósannlíkur,torførur
óglaður	sísorgarbundin
ógleði	sísorg,tunglyndi
ógloymandi	síáhugaverdur
ógongdur	síófarandi
ógoymsla	síórøkiskapur
ógóðsligur	síaldutur,misháttur,ræðandi,skitin,veðurringur
ógreiddur	sífløktur,frísutur
ógreiða	sívavstur
ógreiðandi	sífløktur
ógreiði	sívavstur
ógreiðiligur	sífløktur
ógreiðsamliga	síóskilliga
ógreiðsamligur	sífløktur
ógreiðsamsligur	sífløktur
ógreiðsla	sívavstur
ógreiður	sífløktur
ógreiniliga	síóskilliga
ógreiniligt	síivasamt
ógreiniligur	sífløktur
ógreitt	síóskilliga
ógróðrarligur	sígróðrarlítil
ógrundaður	Samheiti:grundarleysur,grundleysur,óprógvaður,óváttaðurikki eftirfarandi;ikki staðfestur;uttan hald í veruleikanum↔ósannlíkur,ósannur
ógrøðandi	síóbøtiligur
ógrøðiligur	sígróðrarlítil,óbøtiligur
ógudiligur	síheiðin
ógva	síræða
ógvast	Samheiti:øgast,øtastgerast forfardur;ógvast, øgast, øtast við (e-n);ønskrast við;□eyguni vuksu í honum↔bangin,mótfallin,mótloysi,ræðast,ræðsla,ønskrast
ógvár	sívánatíð
ógvella	sífuglur
ógviliga	síógvuliga
ógviligur	sínógvur,ólýsandi,ræðandi
ógvisliga	síósmidliga
ógvisligur	síbusutur,ófriðarligur,óskapiligur,veðurringur
ógvorðaður	síreyputur
ógvuliga	Samheiti:aldeilis,almikið,alvegis,andskræmiliga,andstyggiliga,avbera,avbæra,avgapiliga,avlagi,avlagna,avskapiliga,avskila,avskræmiliga,bankað,beista,blanka,burturav,burturúr,deiliga,devulsliga,drabbandi,dýrandi,eiggiliga,einskila,einstaka,einsýna,eitrandi,endaleysa,evars,evarska,eyka,fanansliga,fjølmikið,forbankað,forbiðið,framífrá,framúr,framúrskarandi,frágerða,frálíka,fráskila,fullkomiliga,fult,fullvegis,gresiliga,gressiliga,grúiliga,grøtiliga,grøtuliga,heilt,hendinga,herviliga,hjartans,høpisleysa,ítarliga,kolandi,lallandi,makaleysa,margpikkiliga,merkiliga,mikið,mikilsti,morandi,nógv,ordiliga,ovurhonds,óendaliga,óføra,ógemeina,ógviliga,óhugnaliga,ókristiliga,óloyviliga,ólukksáliga,ómáta,ómátaliga,ómetaliga,ómyrðiliga,ómøguliga,ónatúrliga,órímiliga,óryggiliga,ósambæriliga,ósambærliga,ósigiliga,ósjónliga,óskapiliga,ótespiliga,ótrúliga,óvanliga,platt,púra,púrasta,púrt,reiðiliga,reiðuliga,reint,ræðuliga,rættiliga,rættuliga,sára,sera,serdeilis,serliga,serligani,serskila,serskilt,serstaka,serstakliga,sjaldan,sjaldsama,sjaldsamliga,sjáldan,sjáldsama,spinnandi,stak,stein,stóran,stórliga,stórum,stúgvandi,svarta,syndarliga,turra,undarliga,úrlagi,úrlíka,úrsýna,ússaliga,útav,vanlukku,vanlukkuliga,vekk,veldiga,veldiliga,veruliga,vindandi,virkuliga,vitleysa,vælsignað,yðjandi,yvirhonds,ævintýrliga,øgiliga,ørandi,øtiligaal-;allar-;alra-;als;av allari leið;á allan hátt;í stóran mun;nakað so...;dygdar-;einskila-;frágerðar-;fráskila-;heilt og aldeilis;hendinga-;hendings-;ikki eiti;ikki eiti av, á;ikki hissini;ikki smávegis;í alstóran, stóran mun;med alla;megnar-;nokk so;ovur-;rimmar-;risa-;steina-;stein etandi...;uttan líka;úrgerðar-;úrmælings-;út av bókini, lagi, øllum lagi;út í eitt og alt;(út) í odd og egg;vala-;viðgita-;vorðið sum;□tað er ikki eiti á;tað er ikki orð á;tað sigst ikki frá↔eindømi,frálíkur,nógvur,nøgd,ólýsandi,passaliga,ríkiliga,ræðandi,sára,sjáldsamur
ógvuligur	sínógvur,ólýsandi,ræðandi,veðurringur,vreiður
ógvusliga	síósmidliga
ógvusligur	síbusutur,ófriðarligur
ógværa	síeyðmýking
ógvæta	síóát,vánamaður
ógvæti	síóát
ógvølla	sífuglur
ógyrðin	síharður
ógætuliga	síósmidliga
ógæva	síólagna
ógævutíð	sívánatíð
óhagur	síbusutur
óhampaður	sífrísutur,illa ílatin
óhampiliga	síilla ílatin,ósmidliga
óhampiligur	síbusutur,illa ílatin,ósømiligur
óhandaliga	síósmidliga
óhandaligur	síbusutur
óhandigur	síóskapiligur
óhandiliga	síósmidliga
óhandiligur	síbusutur,óskapiligur
óhapp	síólagna
óheftur	sífríur,uttanveltaður
óhegnigur	síbusutur
óheiðurliga	síóreiðiliga
óheiðurligur	sísvikafullur
óheilur	síófullfíggjaður
óheimil	síólógligur
óheimligur	sífremmandur
óhent	síuttanhanda
óhentur	sídygdarleysur
óhepni	síólagna
óheppið	síspell
óheppiligur	síóheppin
óheppin	Samheiti:eydnuleysur,óeydnuligur,óeydnusamur,óheppiligur,ólukksáligur,ólukku,ólukkuligur,óskepnuligur,óveiðiligt,vanlukku,vansælur,vána,vánaliguróveiðiligt tann dagin(ver(ð)a óheppin)vera fyri ólagnu,vera óheppinfáa høgg í borðsenda;fáa slag á veingin;gera gyski burtur úr e-m;gerast vónbrotin;hava ringar royndir av e-m;koma fyri parrakin;koma illa, skeivt fyri;slíta ilt;vera fyri happi, óhappi, vanlagnu o.fl.;vera fyri parraginum;vera fyri vónbroti;vera hart, illa royndur av e-m;vera (illa) skølsettur av e-m↔avynnumaður,brotna,miseydnast,neyðkomin,oyðileggjast,óbøtiligur,ólagna,ólukkutíð,skaði,spell,spilla fyri sær,vandi,vansketniAndheiti:eydnuberandi
óherdur	síóhvassur
óhevndur	síóskalaður
óhildin	sídygdarleysur
óhindraður	síóttaleysur
óhirðiligur	síórøkjutur
óhirja	síótrivavætti
óhjálpin	síbrekaður,uppikastaður
óhjálptur	síbrekaður
óhoyggjaður	síniðurdottin
óhoyriligur	síófúsur
óhoyrin	síófúsur
óhógv	síhóttan,illveður,oyðslusemi
óhógvamaður	síóflýggjakroppur
óhógvaveður	síillveður
óhógvin	síbusutur
óhóskandi	síannarleiðis,dygdarleysur,ósømiligur
óhóvliga	síósmidliga
óhóvligur	síbusutur
óhóvsamur	sínasadjarvur
óhugaligur	síkeðiligur,ræðandi,svárur
óhugi	símótvilji
óhugnaður	Samheiti:illunnilsi,ófrættarámi,óhugni,óunnileiki↔bangin,ræða,ræðandi,ræðast,ræðsla,skelkandiAndheiti:hugni
óhugnakendur	síræðandi,svárur
óhugnaliga	síógvuliga
óhugnaligur	síræðandi,svárur
óhugnasamur	síræðandi,svárur
óhugni	síóhugnaður
óhugsandi	síógjørligur,ólýsandi,ósannlíkur
óhugur	símótvilji
óhulin	síopinberur
óhumska	sídálk
óhundska	sídálk
óhvassur	Samheiti:bitleysur,eggleysur,eggslitin,mýldur,óbrýndur,raggaður,rábeittur,sáreggjaður,sárur,skarðaður,skarðutur,skørðuturfullur av skørðum;hvítur í, rundur í, tjúkkur fyri eggini;ikki bitgóður, hvassur, útberandi o.fl.;illa beittur, brýndur;við ongum biti, við rá;○sum einki bit er í, hevur ringa egg, ringt bit;□eggin er fløt;hann hevur mist bitið, skalar ikki, stendur ikki á;hetta bítur einki, ikki, ikki nakað, illa;hetta bítur ikki fólk í fingur, merkir ikki á;hetta er (óhvast) sum ein gásarkjaftur, sagarkjaftur, eitt fliðujarn;hetta er tað jarnið ið er;líggin stráar so illa(bleyteggjaður)bleytur,deigbleytur,deigur,karbleytur,mjúkeggjaður,mjúkur,óherdurbleytur í eggini;við bleytari egg(óhvessa)doyva,mýla,raggagera óhvassan;leggja eggina flata;mýla eggina(óhvessast)raggast,rapa,ryðja,ræastfalla av bloytu;gerast bitleysur, óhvassur, skarðutur o.fl.;leggjast fyri;missa bitið;□eggin rapar, ryður↔bíta,brýnaAndheiti:hvassur
óhvessa	síóhvassur
óhvessast	síóhvassur
óhvørvandi	síáhugaverdur
óhvørviligur	síáhugaverdur
óhyggin	síbusutur,tápuligur
óhyggi(r)	sídáragerð
óhyggja	sívansketni
óhærdur	sínakin
óhøgi	síbarbrot
óhøgindi	síbarbrot
óhøgligleiki	síhindur
óhøgligt	síuttanhanda
óhøgligur	síófarandi,torførur,uttanhanda
óhøviligur	síósømiligur
óhøviskleiki	sífrekleiki
óhøviskur	síósømiligur
óin	sító
óisligur	síbusutur
óivað	síeyðvitað,kanska
óíbundin	síleyshentur
óílatin	sínakin
óítøkiligur	síímyndarligur,óveruligur
ójavni	síbugur,munur,ósemjaSamheiti:bláliður,geiri,hóllur,hólpur,høllur,klíggjabrot,klunkur,knortil,knópur,óslætti↔krympast,ójavnur,rukka,rukka saman,rukkutur
ójavnsintur	símislyntur
ójavnur	síannarleiðis,rukkutur,rundur,umskiftiligurSamheiti:bólkutur,buklutur,bullutur,bunglutur,bylgjandi,glipsutur,hálvrísin,hvassur,klumbrutur,knokkutur,knortlutur,knubbutur,knøggutur,knørtutur,ólent,óslættur,rísin,rúðrutur,skeljutur,skrubbutur,stirvin,stirvisligur,stólputur,ývin(bylgjutur)aldutur,bylgjandi(giljutur)gryvjutur,kassutur,kullutur,lægdutur(gloprutur)glosutur(heyggjutur)bringutur,bríkutur,bullutur,bøkkutur,fjallbygdur,fjallmikil,hamramikil,pallut,smátorvutur,stellutur,tindamikil,tindutur,trøpputur,túvutur,túvuvaksin(klumputur)bitlutur,titlutur(knallutur)filputur,grýtutur,hvassur,klettutur,knaggutur,knortlutur,knubbutur,knørtutur,skjørslutur,skriðutur,skrumlutur,skurslutur,skurvin,skurvutur,smágrýtutur,stallutur,stórgrýtutur,túgvutur,ørgutur(niplutur)bitlutur,hólputur(pirrutur)arrutur,finnutur,knútutur,knyklutur,koynutur,ófríður,pirruskotin,poknutur,pokuskotin,pokutur,rúðraskotin,rúðrutur(rondutur)garðutur(ruflutur)flísutur,flyksutur,foyrutur,hvassur,ríflutur,ríslutur,rubbutur,óslættur,skøvutur(travsutur)slindrutur,slintrutur,soymutur,tágutur,trevjumikil,trevsutur,træðrutur,tægrutur(skarðutur)lipputur,røðutur,skarðaður,skørðuturhvassur sum skøtuskinn;rísið sum skøtubak;við bylgjum;□tað er sum at ganga á glopragróti, kluftagróti, kollgróti, urðargróti↔flosna,frísutur,innskorin,kornutur,krympast,ófarandi,ójavni,rukka,rukka saman,rukkutur,ývnaAndheiti:beinur,flatur
ójavnvág	símunur
ójólaligur	síósannlíkur
ókanniligur	sífløktur,ólýsandi
ókátur	sísorgarbundin
ókembdur	sífrísutur
ókendur	sífløktur,fremmandur
ókenniligur	sífløktur
ókeypis	síkostnaðarleysur
ókka	sífremmandamaður
óklárur	sífløktur
óklívandi	síófarandi
óklókur	sítápuligur
óklæðiligur	síannarleiðis
ókneptur	síupplatin
ókókaður	Samheiti:hálvráur,karráur,kavráur,ósoðin,ráurikki kókaður, loyptur enn(óstoktur)ikki bakaður, brúnkaður, káraður, skorpaður, stoktur enn↔kóka,matgera,matgerð,matur,steikja
ókravdur	sísjálvbiðin
ókristiliga	síógvuliga
ókristiligur	síheiðin
ókristin	síheiðin
ókruvdur	Samheiti:bøllutur,ósløgdurrundur fiskur;bæði bøllut og flatt;bæði rundur og flatur fiskur(óavhøvdaður)við høvdi(óflaktur)
ókrút	síillgras,letingi
ókunnigur	sífremmandur
ókunnleiki	síbýttisskapur
ókunnufólk	sífremmandamaður,gestur
ókunnugleiki	síbýttisskapur
ókunnugur	sífremmandur
ókunnukona	sífremmandamaður
ókunnuland	sístatur
ókunnumaður	sífremmandamaður
ókunnumál	sítungumál
ókunnuorð	síorð
ókunnur	sífremmandur
ókúgaður	sífríur
ókúgandi	sívarandi
ókvendi	síóflýggjakroppur
ókvensligur	síharðhjartaður,harður,ófarandi,vátur
ókviðin	sígeldur
ókvæmisorð	síspottorð
ókynni	síbýttisskapur
ókyrra	sígera aldu,sjóvarilska
ókyrrupláss	síillveðurshol
ókyrrur	síaldutur
ókønur	síóvanur
ólafótur	síøvutur
ólag	síavlaging,lótir,ólagna,skipanarloysi,vavstur
ólagabarn	síavynnumaður
ólagafólk	síavynnumaður
ólagaliga	síósmidliga
ólagaligt	síuttanhanda
ólagaligur	síbusutur,ófarandi,ófriðarligur,ófúsur,torførur,uttanhanda
ólagamaður	síavynnumaður
ólagna	Samheiti:avinna,avynna,beigur,bilóhapp,bilvanlukka,eydnuloysi,ferðsluóhapp,ferðsluvanlukka,forbannilsi,forfall,glappakast,gleppakast,grindaskaði,happ,harmasøga,harmleikur,hóttafall,hundalív,illgongd,kneyk,kneykur,miseydna,náttúruvanlukka,óeydna,óeydnugerð,óferð,ófrættir,ógæva,óhapp,óhepni,ólag,ólíkindalív,ólukka,óskepna,óstund,parrag,parrak,parrakur,rossalív,rukkulív,skaðabólt,skaðahending,skaðatilburður,skaði,skrædl,snertur,smeit,smeitur,sorgarhending,sorgarleikur,sorgarstandur,sorgarsøga,sorgartilburður,spell,vanlagna,vanlukka,vanlukkustandur,vanlukkutilburður,vanskepna,váhøgg í borðsenda, dyrnar;lúsa, vána, vánaligt lív;ræðulig vanlukka;syrgiligur tilburður;tung lagna;vánalig tilvera(vera fyri ólagnu)vera fyri e-m, sama býti;vera fyri somu (ó)lagnu;vera fyri vanbýti í lívinum;□har er skil og fantur↔avynnumaður,brek,brekaður,brotin,brotna,deyði,lagna,meinslast,miseydnast,neyðkomin,oyðileggjast,óbøtiligur,óheppin,ólukkutíð,sár,skaða,skaði,spell,spilla fyri sær,vandi,vansketni,vánatíðAndheiti:eydna
ólastandi	síósekur
ólavsøka	síhátíð
ólavsøkuaftan	síaftan
ólavsøkuferð	sítúrur
ólavsøkufríggj	síástarlív
ólavsøkufríggjari	síunnustar
ólavsøkugestur	sígestur
ólavsøkuhald	síveitsluhald
ólavsøkumjørki	sítoka
ólavsøkumysing	sístreymur
ólavsøkurota	síregn
ólavsøkuting	sífundur
ólátaður	sínasadjarvur,ófriðarligur
ólátakleppur	síóflýggjakroppur
ólátaligur	síófriðarligur
ólátalív	síørskapur
ólátaskapur	síørskapur
ólátin	síófriðarligur
ólekjandi	síóbøtiligur
ólent	síójavnur
ólesandi	sífløktur
ólesiligur	sífløktur
ólesingur	sísibbi
óleskaður	sísvangur,tystur
ólevnað	síóreglulív
ólevnaður	síóreglulív
óliðiligur	síharður
óliðugur	sínáttlagdur,ófullfíggjaður
óliðuligur	síharður
ólitaður	sílitfarin
ólittur	sílitfarin
óliviligur	sísvárur
ólíðiligur	sísvárur
ólíka	síhvaðna
ólíkindaferð	sítúrur
ólíkindalív	síólagna
ólíkindaveður	síillveður
ólíkindi(r)	síillveður,ørskapur
ólíkligskapur	síeyðmýking
ólíkligur	síbusutur,ósømiligur
ólíkur	síannarleiðis
ólívin	síraskur
ólívis	síavlíva
ólívs	síavlíva
ólívsgerð	síbrotsverk
ólívssár	sídeyðamein,sár
ólívssótt	sísjúka
óljóð	síljóð
óljóðamikil	síófriðarligur
ólokin	sínáttlagdur,ófullfíggjaður
óloysandi	sífløktur
óloystur	sífløktur
óloyviliga	síógvuliga
óloyviligur	síólógligur
ólógligur	Samheiti:brotskendur,brotsligur,brotsmansligur,heimildarleysur,loyvisleysur,lógleysur,løgleysur,ógildigur,ógildur,óheimil,óloyviligur,óreiðiligur,óregluligur,óreglurættur,óreglusamur,regluleysur,revsiverdur(bannaður)fimtaður,forboðin,noktaðurikki galdandi, gildur, heimilaður, loyvdur, loyviligur, lógligur, løgligur;ikki í samsvari við lógina;uttan heimild, loyvi;við ongari heimild;við ongum loyvi;○sum er framdur í heimildarloysi;□tað er ikki (fyri) mark, ikki í gildi;tað er ikki lov, loyvt (at);tað geldur ikki;tað hevur ikki gildi↔brotsmaður,brotsverk,forbjóða,forboð,friða,lóg,lúgva,lygnari,óreiðiliga,ósannindi,ósannur,seta í gildi,skipanarloysi,snildarbragd,svik,svika,svikafullur,svikariAndheiti:galdandi
ólótir	síørskapur
ólukka	síólagna
ólukksáliga	síógvuliga
ólukksáligur	símannvándur,óheppin
ólukku	síóheppin
ólukkudýr	sívánamaður
ólukkulag	sívandi
ólukkuligur	síóheppin
ólukkuráð	síleiðbeining
ólukkusettur	símannvándur
ólukkuskil	sívandi
ólukkutíð	Samheiti:óreinskutíð,tíanverri,tíverri,vanlukkutíð□men gakk;men tak við;so illa vildi til at...;tað var harmiligt, illa, lort, ólukksáligt, skitt at...;tað var ikki so gott;tað var so óheppið at...;til alla ólukku, vanlukku;til alt óhapp;vanlukkan vildi at...↔brotna,miseydnast,oyðileggjast,óheppin,ólagna,skaði,spellAndheiti:tíbetur
ólúgvaður	síómóður
ólúgvandi	síraskur,sterkur,varandi
ólúgvin	síraskur
ólýdni	sítvørlyndi
ólýðin	síófúsur
ólýsandi	Samheiti:ófatandi,ófatiligur,ófrásigandi,ófrásigiligur,ógemeinur,ógviligur,ógvuligur,óhugsandi,ókanniligur,ómátaligur,ómetaligur,ómetiligur,ónatúrligur,ónáttúrligur,ónevnandi,órannsakandi,órannsakiligur,ósigandi,ósigiligur,ótaldur,ótalligur,óteljandi,ótrúligur,ørandi↔frálíkur,mikil,nógvur,ógvuliga,ósannlíkur,ræðandi,skelkandi,varandi
ólýttur	síósekur
ólærdur	síleikmaður,óvanur
ólæstur	síupplatin
ólæti(r)	sílevind,ørskapur
óløg	sísjóvarilska
óløgi	sísjóvarilska
óløntur	sílønarleysur
ómagahýra	sígjald
ómagalamb	síseyður
ómagaligur	síkraftleysur,óskapiligur
ómagaskapur	sífátækt,vansketni
ómagasligur	síkraftleysur,óskapiligur
ómagasveitti	sísveitti
ómagi	sífátækafólk,ómyndingur,vánamaður
ómak	síansni,baksan,fyrireiking
ómaka	síhindra
ómakaður	síannarleiðis,einsamallur
ómakaleysur	Samheiti:arbeiðsligur,beriligur,bráðnýttur,eyðførur,hentligur,hentur,høgligur,lagaligur,liðiligur,lættførur,lættligur,lættur,ómaksleysur,smíðiligur,soymin,tøkin,tøkur,vegligur,veviligur,viðførligur,viðførur,vinnuligur,virkiligurgóður at fáast við;lættur at fara undir, fremja, gera(handigur)fimsligur,smidligur,viðførligurlættur at handfara;○sum liggur væl í hondini↔atkomandi,eyðfingin,hóskiligur,lættliga,lættur,tøkurAndheiti:ófarandi,torførur,uttanhanda
ómakaløn	sígjald
ómakamikil	sítorførur
ómakasamur	sítorførur
ómaki	síansni,baksan,fyrireiking
ómaksleysur	síómakaleysur
ómaksløn	sígjald
ómaktaður	síómóður
ómakur	síansni,baksan,fyrireiking
ómannaður	sífullmannaður
ómanshýra	sígjald
ómansligur	síbangin,kraftleysur,kventlutur
ómansskapur	símótloysi,vansketni
ómarkaður	sínavnleysur
ómataður	síóbúgvin
ómálaður	sílitfarin
ómáli	síbarn
ómálingur	síbarn
ómáta	síógvuliga
ómátaliga	síógvuliga
ómátaligur	símikil,nógvur,ólýsandi
ómedvitin	síóavvitandi
ómegd	símáttloysi
ómegi	símáttloysi
ómegn	símáttloysi
ómenni	síeftirbátur,óflýggjakroppur,vánamaður
ómenniskjansligur	símannvándur
ómenska	síeftirbátur,óflýggjakroppur,vánamaður
ómentaður	síósømiligur
ómentaligur	síkraftleysur
ómentan	síóreglulív
ómerktur	sínavnleysur,ósekur
ómetaliga	síógvuliga
ómetaligur	símikil,nógvur,ólýsandi
ómetiligur	símikil,nógvur,ólýsandi
ómettandi	símatfegin
ómettiligur	símatfegin
ómildi	síóndskapur
ómildur	símannvándur,veðurringur
óminni	sígloymska
óminnisdrykkur	síeitur,ævintýrhugtak
ómintaligur	síbusutur
ómintur	sígloymskur
ómissandi	sídýrur
ómissiligur	sídýrur
ómóður	Samheiti:avmóður,avmøddur,hvíldur,ólúgvaður,ómaktaður,ómøddur,ósjóðaður,ótroyttur,úthvíldur(fullsvøvntur)útsvøvnturvæl svøvntur↔hvíla,hvíld,liggjaAndheiti:útmøddur
ómótmælandi	sísannur
ómótstøðuligur	síóvinniligur
ómúgvandi	sífátækur
ómyndigur	síungurSamheiti:ómyndugurov ungur til...;○sum ikki fær rátt, kann ráða yvir sínum, ikki kann giftast, velja o.fl.;sum ikki hevur valrætt;sum ikki sjálvur ræður yvir sær↔ómyndingur
ómyndingi	síómyndingur
ómyndingur	Samheiti:ómagi,ómyndingi↔ómyndigur
ómyndugur	síómyndigur,ungur
ómyrðiliga	síógvuliga
ómyrðiligur	sínógvur
ómælandi	sídjór,fámæltur
ómæltur	símálleysur
ómøddur	síómóður
ómøðiligur	síónøgdur,raskur
ómøguliga	síógvuliga
ómøguligur	síófúsur,ógjørligur,ónøgdur
ónaseyður	síseyður
ónatúrliga	síógvuliga
ónatúrligur	síólýsandi,ósannlíkur,óveruligur,uppgjørdur
ónáð	síbaksan,hindur,levind
ónáða	síbeistast,hindra,órógva
ónákvæmur	síóneyvur
ónáttúrligur	síólýsandi,ósannlíkur,óveruligur,uppgjørdur
óndimaður	síSátan
óndska	síóndskapur
óndskapsligur	símannvándur
óndskapur	sívreiðiSamheiti:dekansskapur,devulsskapur,djevlarí,eirindaloysi,fanansskapur,fjandansskapur,fortrot,grimd,harðlyndi,harðsinni,illbirtni,illfýsi,illgign,illmegn,illmura,illnati,illneitan,illneiti,illneitilsi,illskapur,illvild,ilska,meinfýsni,meingleði,meinska,miskunnarloysi,níðingsskapur,óargaskapur,ómildi,óndska,ónæraskapur,óreinheit,óreinskapur,samvitskuloysi,skaðafrøi,skarnsmálmur,tramanskapur,veikansskapurillir andar;illur máttur;ring mura;ringur málmur;siga, gera eitt av illgign, óreinskapi↔harðhjartaður,hjartaloysi,mannvándur,óflýggjakroppur,skálkagerð
óndur	símannvándur,vreiður
ónertur	síóskerdur
ónervaður	síóttaleysur
ónettur	síóneyvur
ónevnandi	síólýsandi
ónevndur	sífløktur,navnleysur
ónevni	sínavn
óneyðugur	Samheiti:ótarvur,tarvleysurikki fyri neyðini;ikki neyðugur;□hví fari eg tvætlandi (sum eitt...)↔avlop,dygdarleysur,gróðrarlítil,spell,til fánýtis,vónleystAndheiti:fyri neyðini,neyðugur
óneyvt	síóskilliga
óneyvur	Samheiti:blóðskeivur,galin,óbeinur,ónákvæmur,ónettur,skeivrakin,skeivurov aftarlaga, frammarlaga, niðarlaga, ovarlaga o.fl.;við síðuna av;øðru megin við;○sum er skeivrakin, missir, rakar skeivt, rakar við síðuna av;sum ikki er beinur á, ikki fær siktið á, ikki rakar(skeivumegin)øvutumegin↔báðumegin,hinumegin,raka skeivt,skeivleikiAndheiti:nákvæmur
ónira	síseyður
óniri	síseyður
óniringur	sívánamaður
ónirisligur	sídygdarleysur,kraftleysur,úrklænur
ónjóta	síótangi
ónjótadýr	síótangi
ónoktandi	sínevniliga,sannur
ónolla	sígeldingur,lótir
ónomin	síóskerdur
ónortin	síóskerdur
ónossligur	síaldutur,illa ílatin,misháttur,óruddiligur,skitin,veðurringur
ónytta	síavlop,dáragerð,kloddakot,letingi,vánamaður
ónyttigur	sídygdarleysur
ónyttufjas	síavlop,ítriv,stakkalastás
ónyttugur	sídygdarleysur
ónyttuligur	sídygdarleysur
ónýta	síknúsa
ónýtandi	sídygdarleysur
ónýtiligur	sídygdarleysur
ónýtisdagur	sívánatíð
ónýttur	sínýggjur
ónýtur	sídygdarleysur
ónæra	sílótir,óflýggjakroppur,seyður
ónærafólk	síóflýggjakroppur,ótrivavætti
ónærarit	sískriv
ónæraskapur	síóndskapur
ónæriligur	síósømiligur
ónærisliga	síósmidliga
ónærisligur	síósømiligur
ónøgd	símótvilji
ónøgdur	Samheiti:misnøgdur(grenjutur)fýlin,knarkutur,knarrutur,knerkutur,kveinutur,ómøðiligur,ómøguligur,sjarrutur↔gremja seg,mótvilji,vreiðurAndheiti:nøgdur
ónøktiligur	síkraddutur,kravmikil,matfegin
óorð	síspottorð
óorðaður	síreyputur
óparaður	síeinsamallur
óparalig	síannarleiðis
ópersónligur	Samheiti:persónleysur
óplikt	símáttloysi
ópostaður	síófrímerktur
óprentaður	síóskrivaður
óprógvaður	síógrundaður
óra	sígruna,liva,loga
órakaður	síloðin
órannsakandi	sífløktur,ólýsandi
órannsakiligur	sífløktur,ólýsandi
óráddur	síófyrireikaður
óráð	sídáragerð
óráðaligur	síósømiligur
óráðamaður	síbýttlingur
óráðatøkin	síbusutur,dølskur
óráðiligur	sífløktur,misháttur
óráðtøkin	síbusutur,dølskur,ófyrireikaður
óráðtøkni	sídirvi,vansketni
óráðuligur	síósømiligur
óregla	sískipanarloysi,vavstur
óregluligur	síólógligur,umskiftiligur
óreglulív	Samheiti:blóðskemd,frillulív,hor,hordómur,leysalevnað,leysalív,leysingalív,leyslyndi,leyslæti,náttarlevnað,náttarlív,ódømi,ólevnað,ólevnaður,ómentan,óreinleiki,óreinska,óryggjuskapur,ósiðalag,ósiðalív,ósiðaskapur,ósiðsemi,ósiður,ótrúskapur,rotinskapur,rukkulív,siðaloysi,siðaspilla,siðloysi,siðspilla,skøkjulevnað,spilla,spilling,trúloysieitt syndafult lív;kynsligt ólevnað;óryggiligt, ósiðaligt, siðaleyst kynslív, levnað, lív;óryggiligur levnaður;ringt siðalag, ringur siður↔flogsa,flogsutur,horast,leyslyntur persónur
óreglurættur	síólógligur,umskiftiligur
óreglusamur	síólógligur,umskiftiligur
óreglusemi	sískipanarloysi,vavstur
óreiðiliga	Samheiti:av órættum,óheiðurliga,óruddiliga,órættiliga,óærliga,rangliga,rangt,skeivtikki av røttum↔lokka,lúgva,lygnari,ólógligur,ósannindi,ósannur,snildarbragd,svik,svika,svikafullur,svikariAndheiti:heiðurligur
óreiðiligur	síólógligur,svikafullur
óreinføri	sískitføri
óreingiliga	sínevniliga
óreingiligur	sísannur
óreinheit	síóndskapur
óreinleiki	síóreglulív
óreinligur	sískitin
óreinsettur	símannvándur
óreinska	sídálk,dálka,óreglulív,skitføri,øska
óreinskan	sídálk
óreinskapur	sídálk,óndskapur
óreinsking	sídálk
óreinskusettur	símannvándur
óreinskutíð	síólukkutíð
óreinur	síatgrunnur,listumlærdur,mannvándur
órevsaður	síósekur,óskalaður
órin	Samheiti:mótstøðuføri,mótstøðumegi,ófeingi(órinin)mótstøðufastur,mótstøðuførur,ófeingin,viðtøkusørur(órína)gera mótstøðuføran, órinan, viðtøkusøran o.fl.↔feingin,feingja,fongd,sjúka,sjúkur,smittaður
órinin	síórin
órímiliga	síógvuliga
órímiligur	símannvándur,ófúsur,ósannlíkur,svikafullur
órína	síórin
óroyndur	sínýggjur,óskerdur,óvanur
óró	sílevind,ófriðarligur,ræðsla,rørsla
óróðrarligur	sísjóringur
órógv	sílevind,ræðsla,rørsla
órógva	síhindraSamheiti:ampa,ampast,erkymla,darva,forða,forstýra,ónáða,tarna,ørkelma,ørkymbla,ørkymla,ørkymraampast fyri e-m;bróta av;gera brøk, spruttispæl o.fl. í;gera, elva til, valda, volda mislag, ólag o.fl.;gera hugspjaddan, ørkymlaðan o.fl.;gera ónáðir;gera sprutt í spælið;halda vøku fyri e-m;loypa brøk, krutl, ólag, órógv, óskil, split, splitt, surr o.fl. í;□tað kemur fløkja, frensur, hundur o.fl. í e-t(nerva)baga,bagga,bila,breka,feila,kula,meina,meinka,neyva,neyvra,órógva,plaga,plága,saka,sæta,vónahava við sær;henda e-m;koma oman yvir e-n;kula at;rína á, við;standa á;vera at, áfatt, ámannafatt, fatt, galið, skeivt;vera at baggi, meini, á vási, í vegin;vera galið, skeivt;vera spinnandi galið;□her býr (okkurt) annað undir;her er brøkur, frensur, sperðil o.fl. í;her er ikki alt sum tað eigur at, skal vera;har er okkurt illgrunavert;her hongur annað uppivið;her loðar okkurt upp við;hetta er ikki rætt, rætt fatt, vorðið, rættskaffið, rættvorðið;hvat bagir, brekar, er, sakar o.fl.;nú er ikki beint á miðskafti;nú er okkurt áfatt, galið;tað ruggar ikki rætt↔darvaður,hindra,hindur,levind,ófriðarligur
órógvan	sílevind
órógvasamur	síbangin,ófriðarligur,skundmikil
órógvast	síbilsnast
órógvin	síbangin,ófriðarligur,skundmikil
órógvur	síbangin,ófriðarligur,skundmikil
óróligur	síaldutur,bangin,ófriðarligur,sjóringur,skundmikil
órudd	síavlop,ótrivavætti
órudda	síótrivavættiSamheiti:hoyggja,hundvaða,hundvevja,rannvála,rannvælablaka higar og hagar;blanda, kleksa, vevja alt saman;gera óruddiligan;hoyggja, rassa e-t (til);hoyggja við e-m;hurla alt saman;ikki taka upp (aftur) (eftir seg);kasta í krógv;koyra, tveita alt hurl um burl;leggja, tveita frá sær sum best ber til, sum til ber;róta alt á gos;venda (øllum) upp og niður(liggja til órudd)liggja fyri fótunum á fólki;liggja í vegin;liggja og flóta, rekast, sældast;liggja og sleingjast í hvørjum horni;liggja, standa, vera til fortreð, órúms, trongrúm;rúgva upp;□fólk fær ikki gingið, verið fyri hasum↔avlop,óruddiligt høli,óruddiligur,órøkiskapur,órøkjutur,ótrivavættiAndheiti:rudda
óruddiliga	síóreiðiliga
óruddiligt høli	Samheiti:hundabøli,krubbali,krumpali,kuffalahol,kufluhús,kurpalahol,kurpali,ravnabøli,ravnsreiður,ránsmannabøli,skarvabøli,sótharpa,sóthola,sugga,svínabøli,trøllabøli,útskotshús↔avlop,bústaður,bygningur,høli,órudda,óruddiligur,órøkiskapur,órøkjutur,ótrivavætti
óruddiligur	síórøkjuturSamheiti:kurpasligur,ófýsiligur,ófýsin,ónossligur,óryggiliguróruddiligur og trongligur;sum eitt hundabøli, svínabøli, trøllabøli;sum eitt ravnabøli, ravnsreiður, skarvabøli;sum eitt kuffalahol, kufluhús, kurpalahol, kurpali;□alt, húsið, rúmið, túnið flýtur;fólk fær ikki gingið fyri óruddi;har er, liggur fult av óruddi, hatta liggur (bara) til órudd;har er verri enn hjá markøttum;har, hatta er sum í einum urðarkova, urðarkumla, sær út sum tað er bumbað;har liggur alt og flýtur, rekst, sleingist, sløðist, sældast, søplast;har var hús for rús;hetta er ein verri sugga, verri enn ein sugga;hatta er sum ein hyrnirúgva, sum urðin;hatta líkist einum ránsmannabøli;tað er eitt hússetur ið har er;tað flýtur frá galvi til gátt(ar);tað liggur og rekst sum rossahaft↔avlop,órudda,óruddiligt høli,órøkiskapur,órøkjutur,ótrivavættiAndheiti:reinur,ruddiligur
órusl	síavlop
órusla	síavlop,sjóvarilska
óruslurúm	síhøli
órussavætti	síótrivavætti
órussur	síkloddakot
órusta	síkríggj,ósemja
órúm	síavlop
óryggiliga	síógvuliga
óryggiligur	síóruddiligur,ósømiligur,sannur,skitin
óryggja	sískipanarloysi
óryggjuskapur	síóreglulív
óræddur	síóttaleysur
órætta	síeyðmýkja
órættan	sísvik
órættargerð	sísvik
órættarløn	símutur
órættferð	sísvik
órættiliga	síóreiðiliga
órættiligur	sísvikafullur
órættur	sírundur,svik,øvutur
órættvísi	sísvik
órættvísur	síósannur,svikafullur
órættvorðin	síósannur,óvanligur
órøðiligur	sísjóringur
órøðuligur	sísjóringur
órøkin	síórøkjutur
órøkiskapur	síoyðslusemiSamheiti:deyðadums,drák,ógoymsla,ótrivaskapur,vanbrúk,vanstýri(vanrøkt)misrøkt,órøkja,órøkjuskapur,órøkt(sýna órøkiskap, vanrøkt)fáa fornan;gera til haga (aftur);lata fara í forna;fyrna veltan bø(ver(ð)a fyri vanrøkt)falla, fara í forna, fyrni;liggja í forna, fyrni, haga, mosa↔líkasæla,niðurdottin,órudda,óruddiligt høli,óruddiligur,órøkjutur,ótrivavætti,vanrøkjaAndheiti:røkiskapur
órøkja	síórøkiskapur,ótrivavætti,vanrøkja
órøkjukleppur	síótrivavætti
órøkjukroppur	síótrivavætti
órøkjureyv	síótrivavætti
órøkjuskapur	síórøkiskapur
órøkjutur	Samheiti:óhirðiligur,óruddiligur,órøkin,ótrivaligur,sløðin,vanrøkin,vanskettin,vónarleysurlítið húsligur↔busutur,latur,niðurdottin,órudda,óruddiligt høli,óruddiligur,órøkiskapur,ósmidliga,ótrivavætti,vanrøkja,vansketni,vánafólk,vánamaðurAndheiti:eftirsíggin,húsligur
órøkjuvætti	síótrivavætti
órøkt	síórøkiskapur
órøktaður	síniðurdottin
órøktur	síilla ílatin,niðurdottin
órørdur	síóskerdur
órørligur	sífastur,óvinniligur,sannur
ósaltaður	sísmakkleysur
ósaltur	sísmakkleysur
ósamanhangandi	Samheiti:brákaður,brotkendur,leysurí brotum;í smáum(eftir løtum)í bylgjum, rendum, stoytum, støkkum, tørnum↔brákaligur,brotin
ósamansettur	síeinsamallur,einsljóðandi,greiður,tápuligur
ósambæri	símunur
ósambæriliga	síógvuliga
ósambæriligur	síannarleiðis,ósannlíkur,ósømiligur
ósambærliga	síógvuliga
ósambærligur	síannarleiðis,ósannlíkur,ósømiligur
ósamdir	síósamdur
ósamdur	Samheiti:ósátturikki samdur, samhugaður, sammæltur, samsintur(ósamdir)ósamsikki á einum máli;ójavnir á máli;□teir draga ikki eina (somu) línu;teir eru ikki sameintir, sammæltir↔berjast,fíggindi,hata,hatur,klandursvætti,kríggjast,mótstøðumaður,óvinarliga,skelda,skeldast,spjaðing,tvørlyndiAndheiti:samdur
ósami	síósemja
ósammiðjaður	símiðfjarur
ósams	síósamdur
ósamsvar	símunur
ósamsvarandi	síósannlíkur,tvørsagdur
ósamunni	síáarmunni
ósannindi	Samheiti:falsmæli,hvít lygn,ilsmansboð,íspuni,jútalygn,krønika,lívslygn,lygi,lygiorð,lygisøga,lygitala,lygitíðindi,lygn,lygnarorð,lygnsmansboð,neyðlygn,ósannleiki,pell,ranglýsing,ranglæra,reinging,skrøgg,skrøggsøga,uppspuni(gøla)gølusøga,gølutíðindi,hersøgafalskur, rangur vitnisburður;kolsvørt lygn;ósonn boð, læra, orð, søga, tala, tíðindi o.fl.;reinging av sannleikanum;tann bera, blanka, bláa, ráma, svarta(sta) lygn;□hatta er ikki, illa, neyvan, valla eftirfarandi↔lúgva,lygnari,mistaka seg,ólógligur,óreiðiliga,ósannlíkur,ósannur,skálkagerð,skálkaskjól,skeivleiki,snildarbragd,svik,svika,svikafullur,svikari,tvørsagdur,veruleikaflóttiAndheiti:sannindi
ósannleiki	síósannindi
ósannlíkur	Samheiti:dømileysur,misljóðandi,óhugsandi,ónatúrligur,ónáttúrligur,órímiligur,ósambæriligur,ósambærligur,ósamsvarandi,ótrúligurikki eftirfarandi, sannlíkur, trúligur o.fl;□hatta hevði, vildi eg forsvorið;tað ljóðar ótrúligt, sum ein lygn(óárligur)óártímiligur,ójólaligur,óvanligursum ikki hóskar til árstíðina, hesa ársins tíð, hesa tíð á ári(num)↔avlagdur,ógjørligur,ógrundaður,ólýsandi,ósannindi,ósannur,óvanligur,sjáldsamur,tvørsagdurAndheiti:sannur
ósannur	Samheiti:bjóraður,blóðskeivur,falskur,galin,íspunnin,óálítandi,óbeinur,óektaður,órættvísur,órættvorðin,ósøguligur,ranglisin,rangur,samanpentaður,skeivur,uppspunnin,vitleysurav allari leið;burtur úr vón og viti;heilt út av lagi;ikki á leið;ikki beinleiðis, heilt beinur, rættur, sannur;ikki beint, rætt, satt o.fl.;ikki, illa, neyvan, valla eftirfarandi;ranglisin t.e. mislisin;rúkandi skeivur;tann bera, blanka, ráma, svarta(sta) lygn;tann bláa, kolsvarta lygn;uttan meining;uttan (nakað) hald í veruleikanum;□hatta er burtur, út av allari leið, øllum lagi;hatta er (heilt) burtur úr vón og viti;hatta er heilt burturvið, galið, høpisleyst, rangt, skeivt, skilaleyst o.fl.;hatta er komið, spunnið av lygnum, ósannindum o.fl.;hatta er uttan fyri, gongur út um alt mark;hatta hevur einki við sannleikan, veruleikan at gera;hatta hevur ikki stað;tað er einki hald, hósk, høpi, skil í tí;tað er einki í hasum, um hatta;tað er ikki takandi í orðs stað;tað er, liggur einki til grundar fyri hasum;tað er ongum líkt, líkist ongum;tað er so langt frá;tað nertir, nertur ikki við↔lúgva,lygnari,mistaka seg,ógrundaður,ólógligur,óreiðiliga,ósannindi,ósannlíkur,svik,svika,svikafullur,svikari,snildarbragd,tvørsagdurAndheiti:sannur
ósaskrubba	sífiskur
ósavatn	sívatn
ósámiligur	síósømiligur
ósáttur	síósamdur
ósekaður	síósekur
ósekur	Samheiti:ákæruleysur,hvítur,óatfinnandi,ódálkaður,ólastandi,ólýttur,ómerktur,ósekaður,óskaddur,óskammaður,óskyldigur,óskyldugur,reinur,sakleysur,skuldleysurfríur, reinur fyri...;ikki sekur;ódálkaður, óskaddur av...;ósekur sum barnið í vøgguni;uttan skuld, skyld, søk o.fl.;○sum hevur gott orð á sær;sum ikki eigur part í...(bótaleysur)órevsaður,revsingarleysursum ongar bøtur fær(vera ósekur)hava fingið uppreisn;hava gott orð á sær;ikki eiga lut, part í...;ikki vera sekur í...;vera fríur fyri...;vera ólastandi, óskyldigur, sakleysur o.fl.(fríkendur)frídømdur,reinsaðursum hevur fingið uppreisn↔døma,fríurAndheiti:sekur
ósemi	síósemja
ósemja	Samheiti:andvíki,arbeiðsósemja,arvaklandur,arvastríð,blaðgøla,blaðkjak,blaðklandur,blaðstríð,blaðtræta,brestur,burdansur,búrdansur,bygdaklandur,bygdarklandur,deila,deilan,deiling,dráttur,eljustríð,flokkadráttur,glymmardansur,glymurdansur,grannaklandur,grannastríð,grasningur,illnati,illneiti,illsemja,illstøða,ilska,innanhýsisklandur,jarðarklandur,kegl,kjak,klammarí,klandur,klandursemi,klovningur,kløtur,krakel,kuril,kurtan,kutan,lønarstríð,lønartræta,marknastríð,marknatræta,meldur,misljóð,munnsleip,orðadráttur,orðareiggj,orðastríð,orðgonga,orrusta,ódagi,ódagur,ójavni,órusta,ósami,ósemi,reipatveitan,reipstveitan,rok,run,rættartræta,samanbrestur,skarpskering,skjarr,smáklandur,snákasveig(gj),spjaðing,split,splitt,splittiskeið,stríð,stættastríð,sundurlyndi,togan,trupulleikar,træta,træting,trætnaður,trætni,trætumál,tvídráttur,tvískinningur,tvørdráttur,tvørran,uppgerð,valstríðmorð og brandur↔berjast,fíggindi,harðhjartaður,hata,hatur,hjartaloysi,illa dámdur,klandursvætti,kríggj,kríggjast,levind,mannvándur,mótstøðumaður,orðaskifti,óflýggjakroppur,óvinarliga,skelda,skeldast,spjaðing,tvørlyndiAndheiti:semja
ósemjast	síillsemjast
ósi	síáarmunni
ósiðaður	síósømiligur
ósiðagerð	síbrotsverk
ósiðalag	síóreglulív
ósiðaligur	síósømiligur
ósiðalív	síóreglulív
ósiðaskapur	síóreglulív
ósiðiligur	síósømiligur
ósiðsemi	síóreglulív
ósiður	sílótir,óreglulív
ósigandi	síólýsandi
ósigiliga	síógvuliga
ósigiligur	síólýsandi
ósigraður	sífrálíkur
ósigrandi	síóvinniligur
ósigur	Samheiti:niðurløga,stórtap,tap,undirluti,undirlutur,vansigur↔her gerst einki,missur,tapa,tapariAndheiti:sigur
ósjálvbjargin	síkraftleysur
ósjálvrátt	sítilviljandi
ósjálvstøðugur	sístøðuveikur
ósjálvsøkin	sígóðsintur
ósjálvsøkni	Samheiti:sjálvgloymska,sjálvnoktan,hjálpsemi
ósjóðaður	síómóður
ósjón	síræðumynd
ósjónliga	síógvuliga
ósjónligur	síkrógvaður,misháttur
óskaddur	síheilur,ósekur,óskalaður
óskaðiligur	sígóðsintur
óskaffiligur	síóskapiligur
óskakandi	sífastur
óskalaður	Samheiti:beinheilur,heilbeinaður,heilbjargin,heildligur,heilligur,heilskapaður,heilur,hevndarleysur,høggaleysur,meinleysur,óátalaður,óbrotin,óhevndur,órevsaður,óskaddur,ósleiktur,ósloktur,ósnikkaður,skadleysur,skaðaleysur,snikkaleysurfrískur og ferðigur;heilur og haldin;í øllum góðum;við nøsini millum bæði eyguni↔bjarga,bjargari,bjarging,fríur,heilur,óskerdurAndheiti:brekaður
óskammaður	síósekur
óskapiliga	síógvuliga
óskapiligur	Samheiti:avbronglaður,avlagaður,avskapaður,avskapiligur,avskeiklaður,avskeplaður,bronglaður,bronglutur,bulkusligur,bulkutur,bøllutur,forkutur,forsligur,fortligur,furkutur,grefligur,grollutur,grovligur,grovskorin,grovur,handahóvsligur,klombrutur,klossutur,klumpusligur,klumsutur,krókutur,ljótur,ovurljótur,ovurtjúkkur,ovvaksin,ófantaligur,ófimsligur,ófittligur,ófittur,ófínur,ógvisligur,óhandigur,óhandiligur,ómagaligur,ómagasligur,óskaffiligur,óskotligur,óskøffiligur,óskøfligur,ósnotiligur,ósnøggur,ótelgdur,óvandaligur,óvegligur,óviðførligur,óvildrarligur,óvirkiligur,rámur,ringur,skeivur,skrumblutur,stórligur,stórskorin,sverur,tjukkur,tjúkkur,vanskaptur,vanskeplaður,øsisligurfarin, koyrdur av lagi;grovur í tí;illa, ófimsliga gjørdur;illa avrikaður, dánaður, smíðaður, úr hondum greiddur, virkaður o.fl.;í illum líki;komin í ólag;lítið ásýniligur;ringur at handfara;skeivur og krókutur;stórur og grefligur, stórur og tungur, stuttur og kubbutur, tjúkkur og klossutur;□(hon) sær út sum ein kviðin ryssa, sum ein urðnakona, eitt rognkelsi(óarbeiðsligur)føsilmikil,ófittligur,óhandigur,óhandiligur,óvegligur,óviðførligur,óvirkiligur,tungførur,ørróð,ørrøddringur at arbeiða (við);ringur at handfara↔avlagaður,brekaður,busutur,førligur,hallur,misháttur,ófarandi,torførurAndheiti:snotiligur
óskattaður	síkostnaðarleysur
óskensaligur	sínasadjarvur
óskepna	síólagna
óskepnuligur	síóheppin
óskepnumaður	sívánamaður
óskerdur	sískerjaSamheiti:allur,einbýttur,fullur,heilur,óavmarkaður,óásettur,óbýttur,óskiftur,óskorinallur samal;allur sum hann er;heilur og haldin;ikki avmarkaður, ásettur, býttur o.fl;uttan avsláttur, frádrátt, skerjing o.fl.(órørdur)ógingin,ónertur,ónomin,ónortin,óroyndur,ósøktur,ótroddur,ótroyttur,óvitjaðurikki nertur, nomin, rørdur o.fl.;□har er óroynt↔heilur,óskalaðurAndheiti:sundurbýttur
ósketni	sívansketni
óskettin	síbusutur
óskettligur	síbusutur
óskiftur	síóskerdur
óskikkaður	sídygdarleysur,ósømiligur
óskikkiligur	sínasadjarvur
óskikkur	sílótir
óskil	síhindur,levind,skipanarloysi,svik,vavstur
óskilaliga	Samheiti:barnsliga,býttisliga,býttliga,gáloysisliga,tápuliga,ørvitisliga(skilaleyst)barnsligt,býtt,býttisligt,fyrilitsleyst,høpisleyst,óskynsamt,ótonkt,óumhugsað,vitleyst,ørtav yvirhuga;frá hendi, hond;uttan at hugsa seg um;uttan fyrilit;uttan mun til...;við lítlum, ongum fyriliti, skili;□hatta er burtur úr vón og viti;hatta er býttari enn býtt;hatta er ikki ráðiligt, ráðuligt, vágandi;hatta hoyrir ongastaðni heima;tað er hvørgum høgt;tað líkist ongum↔dølskur,óvit,tápuligur,ørkymlast,ørvitisskapurAndheiti:skynsamliga
óskilaligur	sítápuligur
óskilamaður	síbýttlingur
óskildur	sífløktur
óskilgitin	síleysingabarn
óskiljandi	sífløktur
óskilliga	Samheiti:fløkjaliga,fløkjasliga,kámt,leysliga,ógjølla,ógjølliga,ógreiðsamliga,ógreiniliga,ógreitt,óneyvt,ótýðiliga↔fløktur,tokutur,vavsturAndheiti:týðiliga
óskilligur	sífløktur
óskipaður	ikki lagdur í fasta legu, ikki skipaður;út í bláan heim;við ongari (til)ætlan↔fløktur,vavsturAndheiti:greiður
óskjøttin	síbusutur
óskjøttligur	síbusutur
óskorin	síóskerdur
óskotligur	síóskapiligur
óskoytin	síbusutur
óskoytingur	síbarbrot
óskoytni	sívansketni
óskrivaður	sískriftleysurSamheiti:munnborin,munngoymdur,óprentaðurborin á mannamunni;ikki skriftfestur;ongantíð festur á blað, skrivaður niður, upp;varðveittur (millum manna);○sum hevur livað á, í mannamunni(munnligur)sagdur↔skriftleysurAndheiti:skrivligur
óskyggin	sífløktur
óskyldigur	sígóðsintur,ósekur
óskyldugur	sígóðsintur,ósekur
óskynsamt	síóskilaliga
óskynsamur	sítápuligur
óskynsemi	síbýttisskapur
óskýldur	sínakin
óskøffiligur	síóskapiligur
óskøfligur	síóskapiligur
ósleiktur	síóskalaður
ósligin	síniðurdottin
óslitin	síáhaldandi,heilur,samanhangandi
óslítandi	síhaldgóður
ósloktur	síóskalaður
óslætna	sígera aldu
óslætti	síójavni,rukka,sjóvarilska,spilla fyri sær
óslættur	síaldutur,frísutur,ójavnur,rukkutur
ósløgdur	síókruvdur
ósløkkiligur	símatfegin
ósløkkjandi	símatfegin
ósmidliga	Samheiti:bonskliga,brestandi,buldraliga,buldrandi,buldrasliga,bumsaliga,busasliga,fummisliga,gáloysisliga,glúpskliga,glúpskt,goyst,grammliga,grimmliga,grummliga,harðliga,hurlandi,hvassan,hvassliga,klumpusliga,larmandi,lorkusliga,ófantaliga,óførliga,ógvisliga,ógvusliga,ógætuliga,óhampiliga,óhandaliga,óhandiliga,óhóvliga,ólagaliga,ónærisliga,óstilt,óstortliga,óstortsliga,óstýriliga,ósømiliga,ótrivaliga,óvandaliga,óvarisliga,óvarliga,óvildrarliga,óvirðiliga,ruskusliga,sendandi,skammiliga,strangliga,tungan,tungliga,tveitandi,tvørligaav bondskleika;av grimd;av tí mesta, ringasta, versta o.fl.;hart og skjótt;ikki við eirindum, mýkindum;sum harðast, ringast, verst o.fl.;uttan ans fyri...;uttan fyrilit, hógv, miskunn o.fl.;við buldur og brak, skund og gang;við harðari hond;við hørðum, illum, óndum;við makt;við stálhandskum;vilt og ørt↔busutur,dyggiliga,forhánisliga,ovtala seg,ógjarna,órøkjutur,óvinarliga,snarsintur,vansketni,vánamaður,strangleikiAndheiti:vandaliga
ósmidligur	síharður,ófúsur
ósmurdur	sílitfarin,nasadjarvur
ósmuskaður	síreinur
ósmædni	sífrekleiki
ósmæðin	sínasadjarvur,stoltur
ósnikkaður	síóskalaður
ósnikki	síspilla fyri sær
ósnotiligur	síilla ílatin,óskapiligur
ósnøggur	síilla ílatin,loðin,óskapiligur
ósoðin	síókókaður
ósómi	síeyðmýking
óspardur	síríkiligur
ósparin	síoyðslutur
óspart	síríkiliga
óspekt	síørskapur
óspektarmaður	síóflýggjakroppur
óspektur	sístyggur
óspiltur	sífeskur,góðsintur
óspískur	síkubbutur
óspurdur	sísjálvbiðin
óstaðin	síóbúgvin,ungur
óstakur	sígiftast,para
óstandur	sískipanarloysi
ósterkur	síkraftleysur
óstillur	síófriðarligur,skundmikil
óstilt	síósmidliga
óstiltur	síófriðarligur
óstinnur	síóstúttur
óstirðnaður	sílinur
óstoktur	síókókaður
óstoltur	síóuppgjørdur
óstongdur	síupplatin
óstorkaligur	síbusutur
óstorkasligur	síbusutur
óstortliga	síósmidliga
óstortligur	síbusutur
óstortsliga	síósmidliga
óstortsligur	síbusutur
óstund	síólagna
óstundarsettur	símannvándur
óstur	síhálsur
ósturhvítur	sílitaður
óstuttligur	síkeðiligur
óstúttur	Samheiti:nøtrandi,óstøðuligur,piprutur,ridlin,ridlingarsamur,ridlisamur,ridlutur,ristandi,skelvandi,skinklutur,skjálgrutur,skjálvtamikil(risthentur)darrhentur,skjálghenturóstúttur, piprutur o.fl. á hondunum(dreivføttur)beklutur,dreivutur,fótaleysur,fótleysur,illgongdur,klossutur,klóputur,løggutur,ófimur,óstinnur,óstøðugur,óstøðuligur,rundføttur,seingongdur,sjóridlin,skjølkutur,skjørslutur,sløðrutur,sløtrutur,stetlaraligur,stólputur,striltasligur,støplutur,tungføttur,tunggongdur,tøssutur,vinglandi,vingluturargur at detta;dreivutur, lorkutur í gongulag(i), rundur undir ilini;ikki, illa, valla støðuførur;løggutur til fóts;ótryggur, ríggin o.fl. á beinunum;tungur á fótunum, upp á sporið;○sum gongur dettandi, hólpandi, klombrandi, skjølkandi, støplandi, vinglandi o.fl.;sum hevur ringt, tungligt, vánaligt gongulag;□beinini svíkja;føturnir vóru sum harraleysir hundar;hann dettur í heilum, liggur altíð og bóltar, kálvar, skølmar;hann dettur um hvønn sparlalort, hvønn stein, hvørja steinpirru;hann dettur um seg sjálvan, síni egnu bein;hann dugir ikki, hevur ilt við at fóta sær, dugir lítið til fóts;hann er drýlur undir ilini;hann er, gongur sum høna í kava, sum kálvur á trægólvi, sum kópur á glopragróti;hann er illa gongdur, illa, lítið til fóts, tungur upp á sporið;hann er sum dreivaður hani, kúgv í hafti, lómur í grasi, vatnær á gleri;hann er sum eitt ekruneyt;hann gongur ikki skjótari enn lús á tjørubót;hann skríður sum lús á tjøruspóni;hatta striltar framvið↔brekaður,danda,falla,førka,ganga,innføttur,rista,risting,seinpjakutur,snáva,útføttur,vinglan
óstýrandi	síófriðarligur
óstýriliga	síósmidliga
óstýriligur	sínasadjarvur,ófriðarligur
óstøðugur	síivasamur,ófriðarligur,óstúttur,skundmikil,støðuveikur,umskiftiligur
óstøðuligur	síófriðarligur,óstúttur,umskiftiligur
ósúrgaður	sísmakkleysur
ósvikaliga	sínevniliga
ósvikaligur	sísannur,trúgvur
ósvikin	síeinskærur,sannur
ósvitaliga	sínevniliga
ósvitaligur	sísannur
ósvitandi	sísannur
ósvivaligur	síaldutur,illa ílatin,veðurringur
ósvívið	síræðandi
ósvøvntur	sísvøvntungur
ósýni	símyrkur
ósýniligur	síkrógvaður,misháttur
ósýnligur	síkrógvaður,misháttur
ósærandi	síóvinniligur
ósærdur	síarbeiðsførur
ósæriligur	síóvinniligur
ósøguligur	síósannur
ósøktur	síóskerdur
ósømd	síeyðmýking
ósømiliga	síósmidliga
ósømiligur	sívanæruligurSamheiti:beistaligur,buffisligur,frekur,fúlur,grovligur,grovur,hálvmentaður,illavorðin,illorðaður,illortur,ljótorðaður,ljótur,morreyður,ófantaligur,ófínur,ófólkaligur,óhampiligur,óhóskandi,óhøviligur,óhøviskur,ólíkligur,ómentaður,ónæriligur,ónærisligur,óráðaligur,óráðuligur,óryggiligur,ósambæriligur,ósambærligur,ósámiligur,ósiðaður,ósiðaligur,ósiðiligur,óskikkaður,ótýdligur,óvandaður,óvandaligur,óvandur,óvirðiligur,pýggjaligur,ráur,siðaleysur,siðaspiltur,siðleysur,siðspillandi,siðspiltur,skammiligur,skammleysur,skendskur,svínafúlur,svínskurfúlur, grovur, ljótur, ringur í munninum, í orðum;○sum brúkar, nýtir fúl, grov, illavorðin, ljót orð;sum snakkar, talar, tosar fúlt, grovt, morreytt, rátt, svínskt;□hann er altíð við tí illa orðinum;hann leggur ov mikið út á bert;hann melur grovt, vandar sær ikki um orðini;hatta er ikki borðbært, mannsømandi, mannsømiligt, stovubært;hatta rívur, skræðir seg sum ráur kræklingur;sovorðið hoyrir ongastaðna heima, sømir seg ikki↔flogsutur,hjámaður,illsinnisgleps,nasadjarvur,óvandatos,óverdigur,skikka sær,spottorð,vanæruligurAndheiti:fólkaligur,hábærsligur,mannsømandi
ósøtaður	sísmakkleysur
ótakandi	síóvinniligur
ótakkargerð	síhevnd,ótakksemi
ótakksamur	síharðhjartaður,keðiligurSamheiti:óærutur,vanærutur○sum ikki sýnir takklæti, takksemi;sum sýnir ótakksemi;sum undirmetir, vanvirðir góðgerð, hjálp, løn, vælgerð o.fl.;□hann biður ikki manga takk, sigur ikki takk, takk fyri, takkar ikki fyri;hann fer, rýmir (sum) hundasjúrður, hundsjúrður;hann fer sum hundur frá borði(vera ótakksamur)ikki vera takksamur↔lønarleysur,ótakksemiAndheiti:takksamur
ótakksemi	Samheiti:haldaraløn,ótakkargerð,ótøkk↔lønarleysur,ótakksamur
ótal	sínøgd
ótaldur	sínógvur,ólýsandi
ótalligur	sínógvur,ólýsandi
ótamdur	sístyggur
ótangaár	síbarnaár
ótangagerð	sískálkagerð
ótangi	síóflýggjakroppurSamheiti:bósi,býtisbarn,dilkadrongur,dittimundur,forherðilsi,forherðingur,garvarungi,íleik,íspegil,jassur,kjálki,knektur,knevil,kraftur,kúllur,køgilsbarn,køgilsungi,køgulsbarn,køgulssonur,lortungi,lúsakjálki,lúsungi,nalvungi,ormasekkur,ormaungi,orragoggur,óargadjór,óargadýr,óargakroppur,óargaungi,ódnarstykki,óðamýli,ónjóta,ónjótadýr,óveningur,óvenjingur,reiðrarungi,rennil,reppur,ribbaldi,ribbaldur,røvari,skálkur,skelmur,spískbogi,stavnur,stúkállur,túnadrongur,úlvarungi,viðkrút,villinifár,villkattur,vittuggiein devuls kvistur;eitt ið eingin flettir við;eitt sovorðið ótøvt;óstýriligt barn;□tykkara ormaungar↔beistast,berjast,brótast,levind,óflýggjakroppur,ófriðarligur,ófúsurAndheiti:hampafólk
ótarnað	síopinberur
ótarnaður	síóttaleysur
ótarvur	síóneyðugur
ótálmaður	síóttaleysur,ræðandi,vreiður
ótelgdur	sínærgongdur,óskapiligur
óteljandi	sínógvur,ólýsandi
ótemiligur	síófúsur,óvinniligur
ótemjandi	síófúsur,óvinniligur
óterraár	sívánatíð
óterradagur	sívánatíð
óterraligt	síveðurringur
óterri	síregn
ótespiliga	síógvuliga
ótespiligur	símisháttur,ræðandi
ótilbúgvin	síófyrireikaður
ótilgjørdur	síófyrireikaður,óuppgjørdur
ótilkomin	síungur
ótiltøkur	síótøkur
ótilvitað	sítilviljandi
ótilvitaður	síóavvitandi
ótilvitandi	síóavvitandi
ótilætlað	sítilviljandi
ótilætlaður	sítilviljandi
ótíð	Samheiti:afturlatingartíð,andtíð,úrtíðikki til tíðina;í ótíð, úrtíð;meðan stongt er;ov seint, skjótt;óheppin, ólagalig tíð;óhóskandi løta, tíðarbil;uttan fyri vanliga tíð;úr tíð
ótíðarfestur	sívarandi
ótíðarhóskandi	síavlagdur
ótíðum	síviðhvørt
ótjargaður	sílitfarin
ótjøraður	sílitfarin
ótokki	símótvilji
ótol	Samheiti:illbindindi,ótollyndi,ótolni,ótolsemi↔bráðskítur,hugspentur,skunda sær,skundmikil,tráaAndheiti:tol
ótolandi	síargingarsamur,keðiligur,svárur,veðurringur,vreiður
ótoliligur	síargingarsamur,keðiligur,svárur
ótolin	sískundmikil
ótollaður	síkostnaðarleysur
ótollyndi	síótol
ótollyndur	sískundmikil
ótollyntur	sískundmikil
ótolnast	sítráa
ótolni	síótol
ótolsamur	sískundmikil
ótolsemi	síótol
ótonkt	síóskilaliga
ótonktur	síbusutur
ótorgandi	síveðurringur
ótornandi	sívarandi
ótoyggi	síóflýggjakroppur
ótódn	sííhald
ótreystur	síkraftleysur
ótreytaður	sítreytaleysur
ótriski	síótrivavætti
ótrivabjølgur	síótrivavætti
ótrivakroppur	síótrivavætti
ótrivaliga	síilla ílatin,ósmidliga
ótrivaligur	sífrísutur,illa ílatin,órøkjutur
ótrivamaður	síótrivavætti
ótrivasjógvur	sísjóvarilska
ótrivaskapur	síórøkiskapur
ótrivastanding	sígraður
ótrivavætti	síbarbrotSamheiti:brókadirðil,dassi,flók,flókatrøll,flóki,fløkjudirðil,funs,gólvskítur,grímuskortur,illryski,kloddafyl,kloddamaður,kloddaprinsur,kloddareyv,kloddatrifsi,kloddavætti,lasafar,lasafyl,lepakeili,marrukeili,ónærafólk,órudd,órussavætti,órøkjukleppur,órøkjukroppur,órøkjureyv,órøkjuvætti,ótriski,ótrivabjølgur,ótrivakroppur,ótrivamaður,ótrivski,pjøssur,runudassi,runumubbur,ruskubaldur,russur,sarpur,skálm,skeljatrøll,skepilsi,skepna,skitsarpur,skotatrøll,skølm,skølmur,sóthólkur,stinkari,súrgudólgur,svans,svín,trevsali,triski,trivski,trølltyssi,tvassaross,tveit,tøðhólkur,vansjón(óhirja)fesja,fjøgga,fjøs,fjøsi,fleyggja,frísa,harklareyv,hoffyl,hoppfyl,legmeis,órudda,órøkja,ótviga,purka,sigga,skersa,skirsa,skitfoys,skitfoysa,skitfýla,skitpurka,skitsúgv,soppatorva,sótharpa,surka,surpa,súgv,travsa,trivsa,trølltoppa,tøðhólpa,øskufoysaófýsiligur, óhampiligur persónur;□hann er, gongur sum ein kloddi, russur o.fl.;knøini eru sum á hoylambi(snorgron)snorheykur,snorhít,snorhólkur,snorkongur(skræpureyv)skitjugimbur,skitjugjólingur,skitjureyv,skorpulamb,skræpudilkur,skræpudirðil,skræpugjólingur↔dygdarleysur,illa ílatin,kloddakot,órudda,óruddiligt høli,óruddiligur,órøkiskapur,órøkjutur,skitføri,skitin,vánafólk,vánamaðurAndheiti:trivamaður
ótrivnaskapur	símáttloysi
ótrivni	símáttloysi
ótrivski	síótrivavætti
ótroddur	síóskerdur
ótroyttiligur	síraskur
ótroyttur	síómóður,óskerdur
ótrúgvur	sísvikafullur
ótrúliga	síógvuliga
ótrúligt	síádú ádú
ótrúligur	síólýsandi,ósannlíkur,óveruligur
ótrúskapur	síóreglulív
ótrygd	síivasemi
ótryggjaður	síóvardur
ótryggleiki	síivasemi
ótryggur	síbangin,dygdarleysur
ótta	síræða
óttabundin	síbangin
óttafullur	síbangin
óttakendur	síbangin
óttaleysur	Samheiti:bilvandur,ekkaleysur,fríur,hugdjarvur,móðmikil,óræddur,trygdgóður,tryggur○sum hevur hvalahjarta, ikki er bangin, ikki ræðist;□hasin hevur ikki kálvahjarta(sálarsterkur)nervastillur,ófjáltraður,ónervaður,róligur(ótarnaður)ampaleysur,óampaður,óhindraður,ótálmaður,ótyngdur↔bjartskygni,dirvi,djarvur,frekleiki,kravmikil,manniliga,nasadjarvur,sjóvandur,vága særAndheiti:bangin,mótfallin
óttaligur	síbangin,ræðandi
óttaloysi	sídirvi
óttamikil	síbangin,ræðandi
óttasamur	síbangin
óttasligin	síbangin
óttast	síræðast
ótti	síræðsla
óttusongur	síkirkjugangur
ótvask	sívánamaður
ótviga	síótrivavætti
ótvigin	sískitin
ótvítýddur	sígreiður
ótvætti	síóflýggjakroppur,vánamaður
ótyngdur	síóttaleysur
ótyrvdur	sínakin
ótystur	ikki tystur;○sum hevur sløkt tostan↔mettur,tystaAndheiti:tystur
ótýdligur	síaldutur,ósømiligur,ræðandi,sjúkur,veðurringur
ótýðandi	síbíligur
ótýðiliga	síóskilliga
ótýðiligur	sífløktur
ótýður	síharðhjartaður
ótýggi	síóflýggjakroppur
ótýggja	sívanrøkja
ótættur	síholutur,spjaddur
ótøka	síforræði
ótøki	síforræði,jarðarstykki
ótøkiligur	síófarandi
ótøkin	síófarandi,torførur
ótøkk	síótakksemi
ótøkur	síófarandi,torførurSamheiti:barnabundin,bundin,fastur,heftur,ófalur,ótiltøkur,sáttmálabundin,skerfastur,tipturbundin at e-m;bundin, fjøtrað(ur) av børnum o.fl.;ikki falur, fríur, heimatiltikin, heimatøkur, leysur, tøkur;ikki til fals, taks, sølu o.fl.;í nýtslu;○sum hevur bundið seg til e-t, situr hondum fastur(bundisligur)○sum ein er bundin av(umbiðin)burturlovaður,lovaðurheftur burtur;lagdur burtur av;lovaður burtur(eiðsvorin)bundin av svornum eiði, lyfti↔arbeiða,avtakin,ábyrgdarmikilAndheiti:arbeiðsleysur,tøkur
ótømandi	sínógvur
ótørv	sílortur
ótøti	síjarðarstykki
óumberligur	síneyðugur
óumhugsað	síóskilaliga
óumhugsin	síbusutur
óumtonktur	síbusutur
óumvarðandi	síbíligur
óundankomandi	síneyðugur
óundansleppandi	síneyðugur
óundirskrivaður	sínavnleysur
óunnileiki	síóhugnaður
óunniligur	síræðandi
óuppgjørdur	síófyrireikaðurSamheiti:gemeinur,hvønndagsligur,natúrligur,óstoltur,ótilgjørdur,vanligur,viðtalandiein miðal hampamaður;ikki stoltur;sum fólk eru flest;sum vanlig fólk↔góðsintur,hampafólk,hóvsamur,lítillátin,spakurAndheiti:óvanligur,stoltur,uppgjørdur
óuppiborin	síóverdigur
óuppígjørdur	sítómur
óupplatin	síafturlatin
óupplýstur	síheimføðisligur,tápuligur,tokutur
óuppreiddur	síófyrireikaður
óútbúgvin	síófyrireikaður
óútgjørdur	síófyrireikaður
óvakur	símisháttur
óvandaður	síbíligur,ósømiligur
óvandaliga	síósmidliga
óvandaligur	síbusutur,frísutur,óskapiligur,ósømiligur
óvandaorð	síóvandatos,spottorð
óvandaslag	síóflýggjakroppur,vánafólk
óvandasligur	síbusutur
óvandatos	Samheiti:óvandaorðbeistaligt, ófólkaligt, ónærisligt tos;fúl, ljót, ófólkalig, ónærilig, ónærislig, rá orð, tala;fúlt, rátt o.fl. orðaval, tos;□hatta er ikki borðbært, ikki stovubært;hatta er ikki fólkatos↔illsinnisgleps,ósømiligur,spottorð,vanæruligur
óvandin	síbusutur
óvandni	sívansketni
óvandur	sínasadjarvur,ósømiligur,óvanur
óvani	sílótir
óvanliga	síógvuliga
óvanligur	síósannlíkur,sjáldsamurSamheiti:almerkiligur,avpartaður,burturbýttur,egin,eginsinnaður,einkenniligur,einskilaður,einstaddur,einstakur,eyðkendur,eyðkenniligur,forborgin,framúrskarandi,kenniligur,løgiligur,løgin,løgisligur,løgligur,makaleysur,margháttligur,margpikkiligur,merkiligur,merkisverdur,órættvorðin,rangsnúgvin,sergongdur,serkendur,serligur,serlyndur,sermerktur,sersinnaður,sersintur,serskildur,serstakligur,serstakur,serur,smáløgin,snetigur,stakur,stórhendis,stórvegis,stórur,týpiskur,undarligur,undranarsamur,undranarverdur,úrsýnteitt sindur láturverdur;eitt sindur til viks;frábregðandi, frákendur, frálíkur, ólíkur øðrum;ikki sum aðrir;ikki sum fólk eru flest;ikki sum hini (fólkini), onnur (fólk);nakað fyri seg;so gandaður;uttan líka;øðrvísi enn fjøldin, hini, onnur;○sum garðar, skarar framúr, kennist burturúr, frá (øðrum);□hansara líki finst ikki↔annarleiðis,áhugaverdur,býttlingur,fjølbroytni,fjølbroyttur,ósannlíkur,sjáldsamur,umskiftiligur,ørvitisligurAndheiti:óuppgjørdur
óvanur	Samheiti:grønur,nýbyrjaður,nýggjur,óbúgvin,ókønur,ólærdur,óroyndur,óvandurikki klárur, ikki til reiðar at...;ikki turrur aftan fyri oyrað (enn);ikki vanur (við) (at)...;óvanur við e-t;við fáum, ongum royndur(ólærdur)ófyrireikaður,starvur,steinstarvurikki útbúgvin↔ófyrireikaðurAndheiti:fullkønur
óvarandi	síbrádliga
óvardur	síbrádliga,nakinSamheiti:avvápnaður,mannleysur,opin,óvápnaður,vápnaleysur,vápnleysur,verjuleysur,verndarleysuropin fyri;so berur, nakin;við ongari vakt(ótryggjaður)fyri egnu ábyrgd↔avdubba,avdubbing,nakin,verjuloysiAndheiti:herbúgvin
óvarin	síbusutur
óvarisliga	síósmidliga
óvarliga	síósmidliga
óvarni	sívansketni
óvart	síbrádliga,tilviljandi
óvaskaður	sískitin
óvápnaður	síóvardur
óváttaður	síógrundaður
óveður	síillveður
óveðursbakki	sítoka
óveðursblettur	síblettur
óveðursbrestur	síillveður
óveðursdagur	síódnardagur
óveðursfuglur	sífuglur,spámaður
óveðursgóri	sítoka
óveðurshani	sífuglur
óveðurskráka	sífuglur,spámaður
óveðursligur	síaldutur,veðurringur
óveðursnátt	síódnardagur
óveðursódn	síillveður
óveðursreyv	síspámaður
óveðursskýggj	sítoka
óveðursvetur	síódnardagur
óvegligur	síófarandi,óskapiligur
óveiðiligt	síóheppin
óveltur	síniðurdottin
óveningur	síótangi
óvenjingur	síótangi
óverdigur	Samheiti:óuppiborin (t.d. rós, sigur),óverdugur,óverðigur,óverðugur□fyrr var illa;hatta átti tú ikki uppiborið;hatta er einki at rósa av;skamm fyri(sømdarleysur)heiðursleysur,vanæruligur↔ósømiligur,vanæruligurAndheiti:verdigur
óverdugur	síóverdigur
óverðigur	síóverdigur
óverðugur	síóverdigur
óveruligur	Samheiti:dreymakendur,dreymkendur,droymandi,droymutur,hamkendur,heimsfjarur,hugsveimandi,huldukendur,óeginligur,ófastur,óítøkiligur,ónatúrligur,ónáttúrligur,ótrúligur,sagnkendur,sveimandi,yvirnatúrligur,ævintýrakendur,ævintýraligur,ævintýrkendur,ævintýrligur,ævintýrmikil(veruleikafjarur)úrtikin,úrtøkiligur,úrtøkurikki rættiligur, rættur, veruligur;ólíkur veruleikanum;uttan hald í veruleikanum↔droyma,hugfjarur,ímyndarligur,óviðkomandi,undurverk,veruleikaflóttiAndheiti:sannur
óviðeiriligur	símannvándur,ófúsur,vreiður
óviðførligur	síóskapiligur
óviðkomandi	ikki viðkomandi;□tað kemur ikki mær, tær við, rakar ikki meg, teg;tað er (alt) annað mál;tað er ein annar spurningur(ørindaleysur)óviðkomandi,ørindisleysur○sum einki hevur har at gera↔óveruligur
óvikaligur	síharður,óvinniligur,sannur
óvikandi	sífastur,harður,óvinniligur,sannur
óvikiligur	sífastur,harður,óvinniligur,sannur
óvild	símótvilji
óvildarligur	síuttanveltaður
óvildrarliga	síósmidliga
óvildrarligur	síilla ílatin,óskapiligur
óviljað	sítilviljandi
óviljaður	síófúsur
óviljamaður	síóflýggjakroppur
óvilji	símótvilji
óviljugur	síófúsur
óvilligur	síófúsur
óvinaliga	síóvinarliga
óvinaligur	síharðhjartaður
óvinarliga	Samheiti:beiskliga,bitisliga,bitut,bítskliga,firtisliga,glúpskliga,grimmliga,grískliga,grummliga,harðliga,hvassan,hvassliga,illfýsisliga,ilskliga,ilsliga,kvettisliga,ófryntliga,óvinaliga,skjarliga,snubbisliga,stívan,strangliga,stutt,stuttorðað(kaldliga)fíggindaliga,tómliga↔dyggiliga,fíggindi,harðhjartaður,hjartaloysi,illsemjast,mannvándur,mótstøðumaður,ósamdur,ósemja,ósmidliga,strangleiki,yppa klandurAndheiti:yndisliga
óvinarligur	síharðhjartaður,vreiður
óvinnandi	síóvinniligur
óvinniligur	Samheiti:mótstøðufastur,mótstøðuførur,óávinniligur,óboyggiligur,ómótstøðuligur,órørligur,ósigrandi,ósærandi,ósæriligur,ótakandi,ótemiligur,ótemjandi,óvikaligur,óvikandi,óvikiligur,óvinnandi,sigursvissur,sigursælur↔frálíkur,kraftamaður,met,oddamaður,roysnisgerð,roysnissteinur,sigra,sigur,stjórna,vald,vinnari
óvinsamur	síharðhjartaður
óvinskapur	síhatur
óvinur	síblettur,fíggindi
óvirðiliga	síósmidliga
óvirðiligur	síósømiligur,vanæruligur
óvirðing	síeyðmýking
óvirkiligur	síóskapiligur
óvirkin	síarbeiðsleysur,brekaður
óvissa	síivasemi
óvissur	síivasamur
óvist	síivasamt
óvit	síbarnaskapur,býttisskapurSamheiti:dánilsi,hæddarsuð,meldur,sansaloysi,sipilsi,svimbul,svímilsi,svíming,ørilsi(dølskni)dølski,dølskleiki,starilsi,ungdómsdølskleiki(heiladeyði)vitisloysi(hugførsla)duli,dvali(slaknan)linking,mók,slakning↔dølskur,hálvdeyður,líkasæla,óavvitandi,óskilaliga,svíma,ørkymlast,ørvitisskapurAndheiti:klókskapur
óvitaarbeiði	síarbeiði
óvitaár	síbarnaár
óvitabarn	síbarn
óvitadagar	síbarnaár
óvitadrongur	síbarn
óvitagenta	síbarn
óvitaligur	sítápuligur
óvitalótir	síbarnaskapur
óvitandi	síóavvitandi,tápuligur
óvitasjúka	sísjúka
óvitaskapur	síbarnaskapur
óvitasligur	sítápuligur
óvitaspæl	sístuttleiki
óviti	síbarn
óvitigur	sítápuligur
óvitingur	síbýttlingur
óvitinskapur	síbýttisskapur
óvitjaður	síóskerdur
óvitska	síbarnaskapur,býttisskapur
óvitskulátur	sískellilátur
óvitskutur	sítápuligur
óvitugur	sítápuligur
óvitvísur	síóavvitandi
óvísur	síkrógvaður
óvænt	síbrádliga
óvæntað	síbrádliga
óvæntaður	síbrádliga,tilviljandi
óvættasligur	sídygdarleysur,kraftleysur,úrklænur
óvætti	síavynnumaður,óflýggjakroppur,pinkulingur,rakdirðil,vánamaður
óvættisligur	sídygdarleysur,kraftleysur,úrklænur
óyrkislærdur	síleikmaður
óyvirlítandi	sífløktur
óyvirsýniligur	sífløktur
óæra	sívánamaður
óærliga	síóreiðiliga
óærligur	sísvikafullur
óærutur	síharðhjartaður,ótakksamur
óæta	síóát
óæti	síóát
óætlað	síivasamt
