d	1(lingv.)konsonant2(lingv.)4. bogstav i det færøske alfabet (kaldes )3(musik)tone og tilsvarende node4fork. fordesi-(som i desimetur, desilitur (dm, dl))
d.	fork. fordeyð(ur)
D	romersk taltegn for 500
dadda	barnepige, babysitter,sita daddavære barnepige, babysitter
daddast	(talesp.)være barnepige el. babysitter, passe børn, babysitte,vit kundu farið, um eg fekk onkran at daddastvi kunne gå, hvis jeg fik nogen at være barnepige el. babysitter
daddudrongur	plejesøn
daddusonur	plejesøn
daddusøga	ammestuehistorie, røverhistorie
dadla	(bot.)daddel
dadlupálmi	(bot.)daddelpalme(Phoenix dactylifera)
dadlusteinur	daddelkerne
daffa	bagtale, bagvaske, rakke ned, smæde,daffa fólkbagtale folk
daga	1komme til syne, dukke op, vise sig i silhuet,tindurin dagar upp móti luftinibjergtoppen kommer til syne op mod luften;teir daga uppi á egginide kommer til syne på bjergkanten;trø og hús dagaðu upp úr morguntokunitræer og huse kunne ses i morgentågen;(overf.)hava latið nakrar einstakar løtur daga upp um tær vanligulade nogle øjeblikke være mere betydningsfulde end andre i ens dagligdag2blive dag,tá var farið at dagada var det ved at blive dag
dagamunur	forskel, forandring fra dag til dag,tað sæst dagamunur á (e-m)der sker en ændring fra (den ene) dag til den anden
dagaskil	rede på ugens dage(deres tal og orden),missa dagaskiliðikke have rede på dagene;vita dagaskilhave rede på ugens dage;ikki vitael.duga dagaskil1ikke have rede på dagene2være ganske dum, enfoldig, uvidende
dagast	komme til syne, dukke op, vise sig i silhuet,ikki eitt fjall ella tindur dagaðisthverken fjeld eller bjergtop kom til syne;høgar mastrar dagaðust uppi í myrkrinumde høje master blev synlige i mørket;ein bátur dagaðist úti í fjarðarmunnanumen båd kom til syne i fjordmundingen;tað dagast fyri e-men lægger mærke til el. opdager noget,nú tað dagast fyri honum, hvat ið hent ernu han opdager hvad der er sket
dagatal	1antal dage,eg skal telja tær dagatal, so tú fert ikki villurjeg skal tælle dagene for dig, så du ikke tager fejl af dem2kalender, almanak
dagavillur	ikke klar over hvad dag det er
dagblað	dagblad, daglig avis
dagbók	1dagbog2journal
dagbóka	journalisere
dagbót	(jur.)dagbøde
dagdeild	(med.)ambulatorium
dagdreymur	dagdrøm
dagdroymari	dagdrømmer, eskapist, drømmer
dagdvølja	tidsfordriv,hon hevði funnið eina frálíka dagdvøljuhun havde en god måde at fordrive tiden på
dagfallin	forfalden, betalbar
dagfesta	datere, tidsfæste, tidsbestemme,í brævi dagfestum 25. mai 1990i et brev dateret 25. maj 1990
dagfesting	datering
dagføra	ajourføre, opdatere
dagga	gå langsomt, slentre,hann fór daggandihan slentrede af sted
daggamal	(om fisk o.lign.)daggammel
dagglæma	lysstribe på himlen ved daggry
daggrýti	(geol.)dagbjergart
daghol	hovedgang i kulmine
dagkrem	dagcreme
daglangt	í daglangthele dagen,hav tú hetta í daglangtbehold du dette resten af dagen
dagleið	dagsrejse
dagligstova	(talesp.)dagligstue
dagligur	daglig,dagligt breyðdagligt brød;-ligadag og dagligahver eneste dag;dagliga dagshver dag
dagljóst	tað er dagljóstdet er blevet dag
dagløn	dagløn
dagmerki	datomærke
dagmerkja	datomærke,nú verða nærum allar matvørur dagmerktarnu bliver næsten alle madvarer datomærket
dagna	(poet.)blive dag,minn meg á ta síðstu stund, tá ikki meir tað dagnar
dagpeningaskipan	dagpengesystem
dagpeningaveiting	dagpengeydelse
dagpeningur	1dagpenge, arbejdsløshedsunderstøttelse2dagpenge(i forb. med tjenesterejse)
dagræði	1i ordforb.fáa dagræðinå frem før det bliver mørkt2dagslys,dagræðið var ikki heilt fánað burturdagslyset var ikke helt forsvundet;dagræðið hvarv spakuliga í vestridagslyset forsvandt langsomt mod vest
dagrøkt	dagpleje
dagrøktarbarn	dagplejebarn
dagrøktarmamma	dagplejemor
dagrøktarpláss	dagplejeplads
dagrøktarskipan	dagplejeordning
dagsarbeiði	dagsarbejde
dagseta1	skumre, mørkne, aftne,nú fer at dagsetanu skumrer;nú er dagsettdagslyset er borte
dagseta2	datere, tidsfæste, tidsbestemme,brævið er dagsett 25. mai 1990brevet er dateret den 25. maj 1990
dagseting	datering
dagsetur	dagslysets ophør, mørkets indtræden, skumring, mørkning,um dagsetur í gjárkvøldiði skumringen i går aftes
dagsferð	1dagsrejse,tað var langt at fara, einar tvær dagsferðirdet var langt at gå, cirka to dagsrejser2dagsrejse,vit gjørdu eina dagsferð til Vágsvi foretog en dagsrejse til Vágur
dagsgerð	dagsarbejde,hatta er ein heil dagsgerð at gera tildet er et strengt dagsarbejde
dagsglæma	lysstribe på himlen ved daggry,dagsglæman roðar í eysturætt
dagskeið	(skole)dagkursus
dagskúli	(skole)dagskole,mods.kvøldskúli
dagsleið	dagsrejse
dagsljós	dagslys,mods.náttljós,eg síggi at lesa við dagsljósijeg kan læse i dagslys
dagslýsi	dagslys,í dagslýsii dagslys;eg fekk dagslýsi til húsjeg nåede hjem inden skumringen faldt på
dagsløn	dagløn
dagsmøði	dagens slid,bera boð um góðan frið aftan á dagsmøðina
dagsprísur	dagspris,húshaldsvørur, sum verða seldar limunum eftir dagsprísihusholdningsvarer, som bliver solgt medlemmerne til dagspris
dagsróður	dagsrejse,hiðani til Hetlands eru tveir dagsróðrar, halda mennman regner med at der er to dagsrejser fra Færøerne til Shetlandsøerne
dagssetningur	udført arbejde i en dag
dagsskipan	dagsorden, agenda
dagsskrá	dagsorden, forretningsorden, agenda,dagsskráin verður kunngjørd samstundis sum fundurin verður lýsturdagsordenen offentliggøres samtidig med at mødet bekendtgøres
dagstevndur	(om dato)bestemt,á dagstevndum degipå en bestemt dag;koma dagstevndan dagkomme en bestemt dag;hann kom dagstevnt á hvørjum árihan kom den samme dag hvert år
dagstíð	tid på dagen,um somu árstíð og somu dagstíðom samme årstid og samme tid på dagen
dagstjørna	(astronomi)morgenstjerne
dagstovnur	1daginstitution2dagcenter (hvor pensionister kan opholde sig om dagen)
dagstútt	daglig, hver dag
dagstøtt	daglig, hver dag
dagsverður	portion
dagsverk	dagsværk,tá ið dagsverkið var lokiðda dagsværket var forbi
dagtilhald	1dagcenter2daginstitution,dagtilhaldið er opið allar dagar í vikunidagcentret er åbent alle dage i ugen
dagtjóvur	dagdriver, lediggænger, drivert, flanør
dagur	1dag;ein daginen (el. anden) dag;nú ein daginforleden dag;nú á døgumnu til dags;árla dagstidligt på dagen;á degiom dagen;í dagi dag;um daginom dagen;við deg(i)numved daggry;fyri dagfør daggry;góðan daggoddag2dagslys,nú er dagurnu er det dag;tað lýsir av degiel.tynnir fyri degidagen gryr;halda e-t upp fyri daginholde noget op for lyset (for bedre at kunne se det)3døgn, dag,í árinum eru 365 dagaråret har 365 dage;átta dagarotte dage,(talesp.)en uge;fjúrtan dagarfjorten dage4isærlevetid, levedage, tid,farin av døgumdød;taka av døgumslå ihjel;á døgum hansarai hans tidel.meðan hann var á døgummens han levede;eg havi aldri í mín dag hoyrt slíktjeg har aldrig i mine levedage hørt sådan noget før;okkara dagur er ikki uppivores dage er ikke talte endnu5bevidsthed,dagurin fór frá eygunumdet sortnede for øjnene;hon fekk ikki dagin aftur, fyrr enn góð løta var farindet varede en god stund, før hun kom til sig selv igen6i ordforb.hetta var dagur í vikudet blev en usædvanlig dag;dag sum náttdag ud og dag ind (nat som dag);dag og dagligahver eneste dag;annan dag(in)anden dag (2. juledag);fyrsta daginen af de første dage;sum fyrsta daginfrisk som en fisk,tað verður seinur dagurel.seinna dagindet vil vare længe;ein av døgunumen af dagene;dagur dettur av degien dag går, en anden kommer;enn á døgumendnu den dag i dag;fyrr á døgumtidligere, i gamle dage;dag frá degiel.dag undan degidag for dag, dag efter dag;koma fyri ein dagkomme for en dag;føra til dagsajourføre;dagliga dagshver eneste dag;taka dag(ar) (í)millumtage parti for;tað man vera ilt at taka dagar partanna millumdet er svært at tage parti for den ene af de to parter
dagvakt	(mar.)dagvagt
dagverk	dagsarbejde
dala	1dale,kavaflykrurnar dala av himlisnefnuggene dalede ned2(om lys)dæmpe, afdæmpe, neddæmpe, moderere,lampan fánarlampen dæmpes
dalbingur	person fra bygden Dalur
dalbotnur	det inderste af en dal
dalbúgvi	dalbo
dalbygd	bygd som ligger i en dal
dalda	1(om mennesker)strejfe, flakke, føjte,hví gongur tú og daldar við hasum?hvorfor går du og føjter med dette?2svinge,línan daldaði nakað nógvlinen svingede temmelig meget;fossurin daldar aftur og fram (í vindinum)3logre,hundurin daldar við halanumhunden logrer med halen
dalfinna	(biol.)klitoris, kildrer
dall	lyd, kimen,tað síðsta dallið frá kirkjuklokkuniden sidste kimen fra kirkeklokken
dalla	1bralre,slatra, sleyga og dallasladre og bralre2ringe, kime,nú dallar kirkjuklokkannu ringer kirkeklokken
dalsbotnur	det inderste af en dal
dalsifals	fjas, pjank, fjant, fjolleri, pjankeri, fjanteri, fjaseri, pjatteri,fást ikki við sovorðið dalsifalsdu må ikke beskæftige dig med sådan noget pjank;tað mesta, tey vinna, fer fyri dalsifalsstørstedelen de tjener bruges til pjank og fjas
dalsíður	1sid,ganga dalsíðurgå med for langt nedhængende buksebag2tung,hatta var ein dalsíður dagurdet var tung dag
dalsmunni	dalmunding
dalur	dal,tey gingu fram ígjøgnum dalinde gik frem i dalen
Dalur	(stedn.)bygd på Sandoy,í / úr Dali;til Dals
dalverpi	en lille dal
dama	dame, kvinde
dambla	plaske, pjaske, sjaske
daml	let plasken med årerne, langsom roning
damla	plaske let med årerne, ro sagte,so damla vit okkum norður við landinumså ror vi sagte mod nord langs stranden
damm	(leg)dam
damma	spille dam
dammborð	(leg)dambræt
dammfiskur	(mar.)fisk der opdrættes i en dam
dammstilli	havblik
dammtalv	(leg)dam
dammur	dam
dampa	damp,tað dampar úr ketlinumkedlen damper
dampari	(skib.)damper, dampskib
dampketil	dampkedel
dampmaskina	dampmaskine
dampskip	(skib.)dampskib, damper
dampur	1os2damp, røg
danadái	(bot.)slægt i kurveblomstfamilien(Senecio),loðin danadáialm. brandbæger(S. vulgaris)
danadrotning	Danmarks dronning
danakongur	Danmarks konge
danastjórn	den danske regering
Danaveldi	Danmarks rige
danda1	vippe, gynge (til leg)
danda2	1rokke, vippe,akrarnir aldaðu og dandaðu undan vindinum;báturin lá og dandaði á vágnibåden vippede i vigen;tað dandar undir mærjeg er godt vippet til efter sejlturen,(overf.)ganga dandandivære åndsfraværende;hugur tín dandar sum reki á vág2(leg)vippe, gynge,børnini dandaðu á danditræbørnene gyngede på et vippebræt
dandakelda	hængedynd
dandifjøl	vippebræt
dandiskur	dannet, kultiveret, civiliseret, velopdragen, urban,hann er ikki dandiskurhan opfører sig ikke på en dannet måde
dandisligur	ikki dandisligurutiltalende
dandisvullur	hængedynd
danditræ	vippe
danga1	(neds.,mar.)plimsoller
danga2	gå langsomt,hann kemur dangandihan går langsomt
danguldrív	i ordforb.ganga upp á danguldrívdrive den af, dandere den
danguldríva	drive den af, dandere den
dani	dansker
dank	(talesp.)i ordforb.dríva dankdrive omkring
dankuldrívari	lediggænger, dagdriver, flanør, drivert
Danmark	Danmark
Danmørk	Danmark
dansa	danse,(ordsp.)mangur dansar og dansar av neyð(um)(om en som lader som om han er glad men som ikke er det);dansa undir loftiðdanse i højt humør;dansa uppidanse til den lyse morgen;dansa á breiðafótifalde på halen;dekilin dansiså for fanden;dansandi óðuraldeles rasende
dansandi	i ordforb.dansandi óðuraldeles rasende
dansari	danser,góður dansarigod danser
dansiboð	meddelelse om dans
dansifelag	danseforening(spec. for færøsk dans)
dansiferð	danseturné
dansifólk	deltagere i dans(spec. i færøsk dans)
dansifrálæra	danseundervisning
dansigildi	dans, dansegilde, dansebal
dansigólv	dansegulv
dansihugur	danselyst,dansihugin hevði hann góðanhan havde stor lyst til at danse
dansihøli	danselokale
dansikvæði	gott dansikvæðikvad, der egner sig godt til dans
dansikvøld	(søn- el. helligdags)aften med dans
dansilag	1dansemelodi2måde at synge til dans på,hann hevur gott dansilag
dansimóður	træt af at danse
dansinátt	nat med dans,eftir eina dansináttefter en nat med dans
dansingarlag	ens måde at synge til dans på;jf.kvøðingarlag
dansiorkestur	danseorkester
dansipengar	entré ved (færøsk) dans
dansiringur	kreds af dansende, dansering
dansisalur	dansesal, balsal (til engelsk dans)
dansisiður	danseskik,ikki duga dansisiðikke kunne danseskik
dansispæl	danseleg (til færøsk dans)
dansistevna	dansefestival,skipað verður fyri eini dansistevnu í summarder arrangeres en dansefestival i sommer
dansistova	sal til (færøsk) dans
dansiterandi	(talesp.)i ordforb.so dansiterandi óðuraldeles rasende
dansitíð	dansetid (fra jul til faste)
dansitónleikur	dansemusik
dansiveitsla	dansegilde, dansebal
dansivertur	dansevært
danska	1fordanske, danisere2oversætte til dansk
danskari	dansker
dansking	fordanskning
danskleiki	danskhed
dansklestur	læsning i dansk (i skolen)
danskligur	(fra færøsk synspunkt om dansk) med overdreven danskpræget udtaleel.accent,teir vóru eitt sindur danskligir;-liga,hann las nakað danskliga
danskmæltur	dansksproget
dansksinnaður	dansksindet,dansksinnaður flokkurdansksindet parti
dansksinni	dansksindethed
dansktalandi	dansksproget
danskur1	danskurindanskerne
danskur2	dansk,donsk klæðiudenlandsk tøj(især hos mænd),danskir skógvarudenlandsk (dvs. ikke færøske) sko, lædersko med sål;donsk skriftgotisk skrift;dansktdansk1dansk sprog2dansk brændevin,ein fløska av donskumen flaske dansk brændevin,danski dáibrandbæger (Senecio)
dansleikur	danseleg
dansstova	dansestue til (færøsk) dans
dansur1	dans,føroyskur dansurfærøsk dans;eingilskur dansurengelsk dans;fara í dansgå til dans;ganga í dansgå til dans jævnligt
dansur2	sømandsoliefrakke
dantalahóv	ganga upp á dantalahóvdrive den af, dandere den
dapa	skele,hon daparhun skeler
dapur	sørgmodig, melankolsk, trist,dapur í hugavære i trist humør;hví ert tú so dapur í bragdihvorfor ser du så trist ud;úrslitini eru døpurresultaterne er dystre;í døprum hugafortvivlet
dapurhugaður	trist, nedtrykt, bedrøvet
dapurleiki	bedrøvelse
dapurliga	mørkt, dystert, trist, sort,hann stardi dapurliga fram fyri seghan stirrede helt mørkt lige ud
dapurlyndi	tungsind, melankoli
dapurskygdur	1som ser bedre i tusmørke end ved højlys dag,hann velti altíð í myrkri, tí hann var so dapurskygdur2skeløjet3nærsynet4(ny bet.)pessimistisk, dyster
dapurskygni	pessimisme, sortsyn
darl	1en der kommer dryssende bagefter, sendrægtig person2vedhæng3uvedkommende tredje person
darla	1dingle, daske,hann sat uppi á einum garði og darlaði við beinunumhans sad på et gærde og daskede med benene2drysse,drumbur darlar aftast
darr	dirren
darra	1dirre, ryste, skælve,við darrandi røddmed dirrende røst2komme dryssende bagefter, gå langsomt,hann fór darrandi inn í bøinhan gik langsomt ud på marken
darran	dirren
darrhentur	som ryster på hænderne
dart	dart,spæla dartspille dart
darta1	1slænge, slynge, vifte,sat og dartaði við knívinumsad og viftede med kniven;situr bara og dartar fótsidder og laver ingenting;darta við halanum;darta við beinunum2være rastløs, være urolig,børnini darta út og inn og eru málamikilbørnene løber ud og ind og larmer meget;gongur og dartar og fær einki upp í laggår rastløs omkring og får ingenting lavet
darta2	(idr.)spille dart
dartla	slænge, slynge, vifte,kotavelið dartlaði aftur og fram, tá ið hann gekk
darva	hindre,illveður darvaði leitinginiuvejr hindrede eftersøgningen
darvaður	besværet, belemret,eg kenni meg so darvaðanjeg føler mig så besværet
darvsaki	tøj gennemblødt af uvejr, vådt tøj
dassaki	tøj gennemblødt af uvejr, vådt tøj,nú er dassaki á honumhan er helt gennemblødt
dassaklæddur	pjaltet, laset
dassi	pjaltet klædt person,ganga sum ein dassiel.sum dassinvære pjaltet klædt
dassleittur	1vejrbidt2(om får)mørk i ulden pga. vejret
dassvátur	gennemblødt, drivvåd, dyngvåd, pjaskvåd, plaskvåd
dast	1glansen af noget, det bedste el. den bedste kraft af noget,nú er dastið av(om tøj) glansen er gået af tøjet2størstedelen, det meste, de fleste,dastið av árinumdet meste af året;dastið av eini vikudet meste af en uge;dastið av manninginide fleste af mandskabet;nú er dastið avstørstedelen af arbejdet er fuldført
datt	sedetta
davidur	(skib.)david,so varð farið at fáa bátin út, sum hekk í davidunum
dáastykki	jordstykke bevokset med hanekro
dádýr	(zoo.)dådyr(Dama dama)
dáðfýsni	lyst til dåd, handling,tað tók alt dirvi og dáðfýsni frá teimumdet tog al mod og handling fra dem
dáðleysur	uvirksom, passiv, inaktiv
dáðloysi	uvirksomhed, passivitet, inaktivitet
dáðríkur	virksom, flittig, aktiv,hann er ikki bara orðaríkur, men eisini dáðríkurhan er ikke kun ordrig, men også flittig
dáhjørtur	dåhjort
dái	(bot.)slægt i læbeblomstfamilien(Galeopsis),fýrstrentur dáialmindelig hanekro(G. tetrahit)
dála	skære i skiver,dála epliskære kartofler i skiver
dálari	(rigs)daler
dáli	1rigsdaler2skive,knettini vórðu skorin í dálarfiskebollerne blev skåret i skiver
dálk	smuds, snavs,eg skolaði dálkið av mærjeg skyllede snavset af mig
dálka	smudse, snavse, grise (sig til),dálka teg ikkidu må ikke smudse dig til;nú hava tey dálkað segnu har de smudset sig til;tað dálkar so illa av særdet smudser så meget;(overf.)dálka e-n úttrække en ned i skidtet
dálkaður	1smudsig, snavset2overstænket af søvand
dálkan	1smuds, snavs2(på søen)ubehagelig bådfart,tað var ring dálkan suður
dálking	1smuds, snavs2forurening
dálkingarskaði	forureningsskade
dálkingarvandi	forureningsrisiko
dáma	synes om, kunne lide,e-m dámar e-t væl (illa)nogen synes godt (dårligt) om noget;mær dámar tað einkijeg synes ikke om det;nú dámar mær beturnu går det bedre
dámaður	illa dámaðurmeget smudsig farvet,skjúrtan er illa dámaðskjorten har et grimt (farve)skær
dámdur	afholdt, vellidt,vera væl (illa) dámdurvære meget (dårligt) afholdt
dámligur	tiltalende, sympatisk,dámligur drongurtiltalende dreng;ein dámligur angi av nýturkaðum hoyggjen dejlig duft af nytørret hø
dámur	1lød, farve, teint,dúkurin hevur góðan (ringan) dámdugen har en ren (grumset) farve;dámurin í andlitinum var hareftir;eggini eru morgrá, ofta við grønligum dámi2stemning, sindsstemning, præg,setael.leggja dám á (e-t)sætte sit præg på (noget);bygdirnar hava aloftast hvør sín dámbygderne har som regel hver sit særpræg;jólahátíðin hevur sín egna dámjulehøjtiden har sin / en egen stemning
dána	dåne, besvime
dánaður	beskaffen,væl (illa) dánaðurpassende (dårlig) beskaffen;loddið er ósnøgt og illa dánað;soleiðis er víkin dánaðsådan er vigen udformet
dáni	ei dáni íintet under
dánilsi	besvimelse, afmagt
dánt	sedánur
dánur	nogenlunde, rimelig, lala,húsini eru so dán, tey húka uppi yvir okkum;hann kann vera líka dánurhan er ikke stort bedre (end den anden);ganga tær gomlu ærnar geldar, verða tær so dánar;tað er so dánt, at hann raggardet er lige akkurat at han kan gå;dánt,hann hevur verið sjúkur, men nú livir hann so dánthan har været syg, men nu har han det så nogenlunde
dára	bedåre, besnære, dåre, blænde, forføre,eg dáraði meg til at gera taðjeg lod mig blænde til at gøre det;(bibl.)ormurin dáraði megslangen forførte mig;dárandibedårende, yndig, henrivende
dárabragð	dårskab, dumhed, stupiditet
dáragerð	dårskab, dumhed, stupiditet
dáralop	dårskab, dumhed, stupiditet
dáralæti	dårskab, dumhed, stupiditet,tað er nýtt hjá mær at hoyra, at dáralæti eru ráðini, sum bera at vísdóminumdet er nyt for mig at høre, at dumhed er vejen, som fører til visdom
dáraverk	dårskab, dumhed, stupiditet
dári	tåbe
dárskapur	dårskab, dumhed, stupiditet
dási	lille tællelys, prås
dáta	(datal.)data(datum,data)
dátt	henni var dátt viðhun blev ubehageligt overrasket, fik en pludselig forskrækkelse;varð honum dátt við daginhan blev højst ubehagelig overrasket;tað kom teimum ikki dátt viðde var nu heller ikke helt uforberedte;tíðindini komu dátt viðnyhederne kom som en ubehagelig overraskelse
dáttliga	pludselig, brat, uventet,hann fekk ein hvøkk og støðgaði dáttliga viðhan blev skræmt og stoppede pludselig
dáttligur	pludselig, brat, uventet,men tó komu tíðindi honum dáttlig;tað var eitt sindur dáttligt;-liga
dátufrøði	(datal.)datalogi
dátufrøðingur	(datal.)datalog
dátugrunnur	(datal.)database, databank
dátugrunsforrit	(datal.)databaseprogram
dátustovnur	(datal.)databank, database
dátutól	(datal.)computer, pc, datamat, datamaskine
dátuviðgerð	(datal.)databehandling
Dávur	tað vildi tann Dávur sagt(når man skal understrege noget)det er så helt sikkert
dB	fork. fordesibel
de	navn på bogstavet d
degi	sedagur
degna	blive dag, dages
degning	dagning, daggry,í degninginived daggry
degningsæl	regnbyge i daggry, regnbyge ved dagens frembrud
degningur	dagning, daggry
deiga	1gå langsomt,hann fór deigandi eftir vegnumhan gik langsomt hen ad vejen;gongur bara og deigarudretter ikke noget2gå på stedet
deigbleytur	(om kniv o.lign.)uskarp, sløv,deigbleytt eggjarnkniv med uskarp æg
deigdirðil	1(om mænd)skvat, pjok, svækling, slapsvans, pylrehoved2en kniv der slet ikke kan skære3dårligt bagt brød
deiggj	dej
deiggja	smøre,deiggja uppápåsmøre(fx maling);deiggja samanælte sammen
deiggjutur	dejet
deigiligur	(poet.)dejlig, skøn, lækker
deigur	(kvad)1(om metal)blød,stígur á tað deiga svørð;brandin tann hin deiga2blød,tann dreingin deiga;við hjørtum deigummed blødende hjerte
deila1	1trætte, strid,hatur yppar deilurhad ypper trætter2skældud, skænd, skideballe, omgang, reprimande, irettesættelse, røffel, opsang, overhaling,fáa eina deilufå en reprimande
deila2	skænde, skælde ud, irettesætte, revse,deila inn á e-nskælde en ud;loysa av at deilagive en en rigtig skideballe;deilastskændes
deila3	1dele2(mat.)dividere
deilan	skænderi, ordstrid, mundhuggeri, kiv, rivegilde, kævl, klammeri
deilari	(mat.)divisor
deild1	1afsnit, passage2afdeling, filial, sektion, institut3(militær)division4(idr.)division5(bot.)sektion
deild2	jordstykke
deildarleiðari	afdelingsleder, institutleder
deildarleiðsla	afdelingsbestyrelse, institutbestyrelse
deildarsjúkrasystir	afdelingssygeplejerske
deildarstjóri	afdelingschef
deildfrukt	(bot.)spaltefrugt
deildstovnur	(mat.)dividend
deildtal	(mat.)kvotient
deiligur	(talesp.)dejlig, skøn, lækker;-liga,tað er so deiliga kyrtdet er så dejligt stille
deiling1	1skældud, skænd, skideballe, omgang, reprimande, irettesættelse, røffel, opsang, overhaling2trætte, strid
deiling2	(mat.)division
deilingarmerki	(mat.)divisionstegn
deilurit	stridsskrift
deingja	1banke, slå,deingja áanstrenge sig med at ro,hann dongdi á, til teir mistu hann úr eygsjón2slænge, kaste,gaflar og segl hingu har og dongdu;frakkin hekk deingjandi á herðunum;ganga og deingja og einki geradrive om og lave ingenting
dekametur	(mål)dekameter
dekan	(eufem.)for pokker,dekanel.dekan fari!pokker stå i det;tað var sum dekan!det var som pokker;til dekans!så for fanden;dekans tíð!fandens tid;hann er dekan og illa farinhan er skam slemt medtaget;dekan og seinurret sen;ferðin er ofta dekan og stórhastigheden er ofte lovlig stor;hetta var dekans lagið!det var som pokker
dekansligur	forbandet
dekanssettur	forbandet,royn teg nú, dekanssettur;dekanssett!for pokker
dekanssignaður	forbandet
dekansskapur	djævelskab
dekil	for pokker,til dekilin!så for fanden;dekilin dansi!for satan
dekin	for pokker
dekk	1(skib.)dæk,eitt skip fekk 1000 á dekk henda dagin;arbeiða á dekkinumarbejde på dækket;fáa seglið til deksrebe sejlet2(husbyg.)dæk(fx i store bygninger)3(på køretøj)dæk
dekkari	(mar.)dæksmand
dekkbátur	dæksbåd
dekklisti	(husbyg.)dækliste, dækbræt
dekkverkstaður	dækværksted
deknur	(kirk.)degn
deksbátur	(båd.)dæksbåd
deksfar	dæksfartøj
deksfarmur	(i skibel.båd)dækslast
deksglas	(skib.)dæksglas(glas i dækket, hvorigennem der kommer lys ned i kahytterne)
deksmaður	(mar.)dæksmand
deksplanki	(skib.)dæksplanke
dekspláss	(på skib)hava deksplássrejse på dæksplads
dekstørn	(mar.)tørn
deksvakt	(mar.)dæksvagt,manningin var býtt í tvey, deksvakt og frívaktmandskabet var delt op i to, dæksvagt og frivagt
deld	(stedn.)lille dal
delfin	(zoo.)alm. delfin(Delphinus delphis)
demma	1dæmme op,tá ið lítið vatn var, mátti hylurin demmastnår der var lidt vand, måtte bassinet dæmmes op2(mar.)roel.sejle imod strømmen for at holde bådenel.skibet på samme sted (under fiskeri),trolarin liggur og demmir eystfallið
dentildrív	ganga upp á dentildrívdrive den af, dandere den
dentur	1interesse2fremhævelse,leggja dent á e-tlægge vægt på noget, fremhæve noget;leggja dent á góða uppfostranlægge vægt på god opdragelse
depil	1plet,við brúnum deplum á síðunimed brune pletter på siden2punkt
Depil	(stedn.)bygd på øen Borðoy,í / úr Depli,til Depils
depilsmaður	person fra bygden Depil
depla	(poet.)gøre plettet,sólargeislarnir deplaðu grasiðsolstrålerne belyste græsset pletvis
dergur	sedorg
dertingur	gavflab, flab
des	hølæs, stor høstak
desember	december
desembermánaður	december måned
desembur	december
desibel	(fys.)decibel(forkortetdB)
desigramm	decigram(forkortetdg)
desilitur	(rummål)deciliter(forkortetdl)
desimalur	(mat.)decimal,3,14 hevur tveir desimalartallet 3,14 har to decimaler
desimetur	(mål)decimeter(forkortetdm)
destin	pralende,tú vart destin í gákinum, nú skuldi tú roynt tegdu pralede jo så meget før, så du skulle nok have prøvet nu
detta	1falde, styrte (ned),detta og meiða segfalde og slå sig;detta av hestbakifalde af en hest;dagur dettur av degiden ene dag går, den anden kommer;detta á sjógvfalde i vandet;eg mundi dottiðjeg var lige ved at falde;ganga dettandigå stolprende2dratte,detta inn á gólviðkigge ind;vit duttu á hundrað skippundvi fangede lige akkurat hundrede skippund fisk;aldur var dottin á OsvaldOsvald var begyndt at se gammel ud;tey komu dettandi út á kvøldiðde kom så pø om pø hen på aftenen   / /detta á:regnið datt ádet begyndte at regne;detta afturfrá(fx i gang)sakke agterud, sakke bagud;detta afturumsakke agterud, sakke bagud;detta av1falde i søvn pga. beruselse2gå i stykker,snørið (línan, tráðurin) datt avsnøren gik i stykker3(om vind)blive vindstille,lotið datt avdet blev vindstille;detta burturfalde bort,detta burtur ímillumstilles i skygge, distanceres;detta burtur úr rovumgå bag af dansen;detta burturúrstilles i skygge, distanceres;detta fram ákomme ganske uventet;detta inn:báturin datt inn ímóti landibåden drev ind imod land;detta í:e-m dettur í hugfalde en ind;detta niðurfalde ned,garðurin datt niðurgærdet faldt ned;detta niður (fxí gongu)sakke bagud;nú datt kúgvin niður í morgunkoen kalvede i morges;tosið datt niður á Guttormtalen faldt på Guttorm;(ordsp.)fara upp á tjólegg, detta niður á langleggbegynde på noget stort, som man ikke kan magte;detta niðurfrásakke agterud, sakke bagud;detta niðurfyriikke blive til noget (om et foretagende);detta niðuryvir:náttin dettur niðuryvirdet bliver pludselig mørkt;detta omanfalde, styrte ned fra stejle steder;detta sundurgå i stykker;detta um:detta um kollfalde omkuld;detta um rygg(om kreaturer) falde på ryggen;detta úr:detta e-m úr minniglemmes;tað hvørki datt ella drap úr honumhan blev ganske tavs og indesluttet;kavin var við at detta úr honumdet begyndte at sne;detta útí1falde i søen2(overf.)slå sig på druk igen;detta uppeftirblive forbavset, forbavses,eg mundi dottið uppeftir, tá ið eg frætti taðjeg blev meget forbavset, når jeg hørte det
devil	djævel
devul	djævel,(bandeord)for devulin!for Satan;devulin steiki!for helvede
devulsligur	djævelsk;-liga
devulssettur	1forbandet2devulssett!for pokker
devulsskapur	djævelskab
devulstíð	(bandeord)pokker heller
deyda1	el.ubetydelig person, mæhæ,sita sum ein deydasidde og lave ingenting
deyda2	el.(bot.)rosenrod(Sedum)
deydakendur	sendrægtig
deydasligur	sendrægtig
deydligur	1slap,skøtan hekk so deydlig á onglinum;ein deydligur dráttur í eygunum2kedelig,her er so deydligther er meget kedeligt at være;deydligur funduret kedeligt møde3trist,tað var so deydligt at frættadet var så trist at høre;-liga
deydningabein	dødningeben
deydningur	dødning
deyð	død,við neyð og deyðmed nød og næppe
deyðaangist	dødsangst
deyðaatvold	dødsårsag
deyðaár	dødsår,føðingarár og deyðaárfødeår og dødsår
deyðabangin	dødsensangst
deyðableikur	dødbleg, ligbleg
deyðaboð	dødsbudskab
deyðabrekaður	dødsmærket,hann var deyðabrekaður maðurhan var en dødsmærket mand
deyðabrot	1med opbydelse af alle ens kræfter,tað var við deyðabrot, at vit vunnu aftur at landi2dødskamp,liggja í deyðabrotumligge for døden
deyðabúgv	dødsbo
deyðadagur	dødsdag,tað nívdi hana til deyðadag(s)det plagede hende til hendes dødsdag
deyðadómur	(jur.)dødsdom
deyðadráttur	(poet.)dødskamp
deyðadrukkin	døddrukken, stangdrukken, hønefuld, kanonfuld, skidefuld, plakatfuld, snydefuld
deyðadums	stor sendrægtighed og efterladenhed
deyðadýrd	blikstille
deyðadømdur	dødsdømt
deyðafall	i ordforb. somdeyðafall er á lambinumlammet er døden nær
deyðafíggindi	dødsfjende
deyðagivin	dødtræt
deyðagras	vissent græs
deyðahald	i ordforb. somstandael.sita við deyðahald(i)stå el. sidde og holde krampagtigt i noget
deyðakaldur	iskold
deyðakvirra	dødsstilhed
deyðakvirrur	dødstille,so var deyðakvirt eina løtuså var det dødstille en stund
deyðakvøl	(bibl.)dødskval,hann lá og stríddist í deyðakvølum
deyðakyrra	blikstille inde ved land
deyðakyrrur	fuldstændig rolig (om havet inde ved kysten),tað var so deyðakyrthavet var fuldstændig rolig
deyðalega	dødsleje, ligge for døden,hon segði frá deyðalegu prestsinshun fortalte at præsten lå for døden
deyðaleiddur	dødked
deyðalogn	vindstille
deyðalýsing	dødsannonce
deyðamein	dødeligt men, dødbringende skade
deyðamerki	dødsmærke
deyðamerktur	dødsmærket
deyðamóður	dødtræt
deyðamyrkur	(bibl.)dødsmørke
deyðamøddur	dødtræt
deyðaótti	dødsangst
deyðapøstur	fuldstændig udmattet, dødtræt
deyðarað	benrad, skelet
deyðarak	radmager,seyðurin soltnar upp í deyðarakfårene afmagres i højeste grad
deyðarák	ganske svag strøm
deyðarevsing	(jur.)dødsstraf
deyðaríki	(bibl.)dødsrige
deyðaræddur	dødsensangst
deyðaræðast	være skræmt,ferðafólkið deyðaræddistde rejsende var skræmte
deyðaræðsla	dødsangst
deyðasekur	(bibl.)skyldig til døden
deyðasina	gammelt vissent græs
deyðasjúka	sygdom til døden
deyðasjúkur	dødssyg
deyðaslættur	(om havet)fuldkommen rolig, ganske uden bølger,tað er deyðaslætt í sjónumhavet er fuldkommet roligt
deyðasong	liggja á deyðasongligge på sit dødsleje
deyðaspakur	overordentlig tam
deyðaspor	spor der leder til døden,tað vóru hansara deyðaspor
deyðastilli	fuldstændig vindstille,tað var deyðastilli og lítið rákdet var fuldstændig vindstille og strømmen var ganske svag
deyðastillur	1dødstille,tá varð deyðastilt uttan um hannda blev det dødstille omkring ham2deyðastilthelt stille, uden nogen vind;nú er deyðastilt og deyðakyrtnu er det helt stille
deyðastingur	dødsstød,Brestir kennir, at hetta er deyðastingurinBrestir føler, at dette er dødsstødet
deyðastívi	(med.)dødsstivhed(rigor mortis)
deyðastrá	liggja á deyðastráligge for døden
deyðastríð	dødskamp
deyðastund	dødstime, dødsstund
deyðasvangur	skrupsulten
deyðasynd	dødssynd
deyðasærdur	dødelig såret
deyðatak	tag der kræver den yderste anspændelse,tað var eitt deyðatak at taka seg uppfyridet var et tungt tag at klatre op
deyðatal	dødelighed
deyðatroyttur	dødtræt
deyðatystur	meget tørstig
deyðatøgn	dødstilhed
deyðavandi	livsfare,koma sær í deyðavandaudsættes for livsfare
deyðavatn	dødvande,inni á deyðavatniinde på dødvande;(overf.)hava deyðavatn í høvdinumikke kunne tænke en tanke til ende;koma á deyðavatntabe lyst og evne (til noget)
deyðavatnsfjørður	blikstille fjord
deyðaváði	livsfare
deyðaváttan	dødsattest
deyðborin	dødfødt
deyðburður	(med.)dødfødsel
deyðfolað	(om føl)dødfødt
deyðføddur	dødfødt
deyðgamal	ældgammel
deyðgingin	dødtræt af gang el. løb,eg var deyðgingin, tá ið eg kom framjeg var dødtræt, når jeg nåede frem
deyðgivin	dødtræt
deyði	1død,ganga við deyðanum í hondini (el.hondunum)el.bera deyðan uppi á særvære dødsmærket;nú er deyðin í durunumnu er der stor nød til stede;(talem.)deyðan kann eingin at lekja;sekur til deyðaskyldig til døde,liggja undir deyðavære dødtræt el. døden nær(af arbejde),vit lógu undir deyða av fiskifik stor fangst i løbet af kort tid;(om skakbrik)standa í deyðavære i fare for at blive dræbt2deyðindøden1døden personificeret,(talem.)deyðin hyggur ikki at tonnunumdøden ser ikke på tænderne for at finde ud af hvor gammel man er(den kan lige så godt tage den unge som den gamle),(talem.)hann hevði verið góður at senda eftir deyðanum(om en langsom mand);deyðans maturvære dødsens2personificering af døden(ofte som skelet),(poet.)deyðin við líggjanum
deyðiligur	1dødelig2dødbringende;-liga,deyðiliga sjúkurdødelig syg
deyðis	i ordforb.til deyðistil døde,komin til deyðis í rakived at dø af magerhed;bardur til deyðisslået ihjel
deyðklinka	(båd.)(ved bådebygning) klinke for fast,ikki mátti deyðklinka, tí so slapp borðið ikki at liva, tá ið tað gisnaði og trútnaði
deyðkomin	døden nær,deyðkomin avfxpínu, sjúku, kuldael.svongdved at forgå fx af smerte, sygdom, kulde el. sult
deyðkyrra	fuldstændig roligt hav inde ved land,gjarna er tað deyðkyrra upp undir avgongudag
deyðkyrrur	fuldstændig rolig (om havet inde ved kysten),tað er deyðkyrthavet er fuldstændig roligt
deyðlamin	næsten helt lam, yderst hjælpeløs
deyðleiður	(bibl.)dødked
deyðleiki	dødelighed,stórur deyðleikihøj dødelighed
deyðlúgvaður	dødtræt
deyðmaktaður	udmattet
deyðmóður	dødtræt
deyðmøddur	dødtræt
deyðreinsa	(med.)desinficere, sterilisere
deyðrógva	overanstrenge sig ved roning
deyðræddur	dødsensangst
deyðsaligur	apatisk
deyðsamligur	apatisk
deyðsamsligur	apatisk
deyðsboð	dødsbudskab
deyðsbúgv	(jur.)dødsbo
deyðseyðakjøt	kød af selvdødt får
deyðseyðakrógv	stene stablet op omkring selvdødt får
deyðseyðalamb	et selvdødt lam
deyðseyðaskinn	skind af selvdødt får
deyðseyðaskrokkur	skelet af selvdødt får
deyðseyðaull	uld af selvdødt får
deyðseyðaær	selvdødt hunfår
deyðseyði	et selvdødt får,skipanin liggur í deyðseyða
deyðseyður	et selvdødt får
deyðsfella	dødsfælde,nýggja rundkoyringin í býnum er ein deyðsfelladen nye rundkørsel i byen er en dødsfælde
deyðsiglari	(mar.)skib uden motor, sejlskib
deyðsjúka	dødelig sygdom,hann gekk við deyðsjúkuhan var dødssyg
deyðsjúkur	dødssyg
deyðskotin	skudt ihjel
deyðslættur	(om havet)fuldkommen roligt, ganske uden bølger
deyðsmansboð	efterretning om et menneskes død, dødsbudskab,koma við deyðsmansboðumbekendtgøre et dødsfald
deyðsmanssálmur	trist salme,syngja deyðsmanssálmargræmme sig, være modfalden
deyðsorsøk	dødsårsag,løgreglan veit ikki í løtuni hvør deyðsorsøkin erpolitiet kender endnu ikke dødsårsagen
deyðsótti	dødsangst
deyðspakur	overordentlig tam,oksin var deyðspakuroksen var overordentlig tam;rákið er deyðspakt
deyðstungin	stukket ihjel,Blikur líktist einum deyðstungnum hvali, tá ið hann søkk
deyðsvangur	skrupsulten, hundesulten
deyðsynd	dødssynd,tað var hildið at vera deyðsynd at spæla kort í føstudet blev anset for at være en dødssynd at spille kort i fasten
deyðsærdur	dødelig såret
deyðtystur	meget tørstig
deyður	død,deyður í raki(fuldstændig) radmager;deyður í kuldameget kold, stiv af kulde;vera livandi deyðurdøden er en vis,hon lá sum eitt deytthun rørte sig ikke;grind var deyð í Fámjin(dræbt);sláa deyðandræbe ved slag;standa uppi yvir deyðum(om får) have mistet sit lam;deyður ert tú høvuðleysurman er hjælpeløs uden en anfører
deyma	stinke, fimse, dunste
deymdoyvandi	deymdoyvandi evnideodorant
deymur	stærk lugt, stank, os,deymurin av vátum sjóklæðumstanken af vådt sømandstøj
deysa	dejse, falde ned,æðan deysaði niður aftur á sjógvinedderfuglen faldt ned i søen igen;hon deysaði, sum hon sathun faldt i søvn
deyvamál	døvesprog, fingersprog
deyvatulkur	døvetolk
deyvdumbur	døvstum
deyvleiki	døvhed
deyvligur	(om mad)uden smag,kjøtið er so deyvligtkødet er uden smag;-liga
deyvur	døv,deyvur sum potturinstokdøv
dg	fork. fordiagramm
diagramm	(fys.)diagram
diakonur	diakon
diamantbrúdleyp	diamantbryllup (60 års bryllupsdag)
diamantur	diamant
didda	(barn.)1lille pige2søster(som kælenavn)
diddarak	radmager
diddubragd	(spøg.)bedrift el. handling som sømmer sig en bejler
dieselmotorur	(tekn.)dieselmotor
dieselolja	dieselolie
digga1	(barn.)and
digga2	(barn.)kilde,eg diggist so illajeg er frygtelig kilden
diggast	være omstændelig, have for mange dikkedarer
digla	1lille (sort) plet i skind2tot uld
digur	1(om mennesker)tyk, svær, fyldig, fed,Búi digri2(om mælk)tyk, fed,digur mjólktyk, fed mælk
dik	1kraftanstrengelse,taka dik áel.í segoppe sig, sætte sig i sving,alingin hevur tikið dik á segder er kommet fart i fiskeopdrættet;eitt gott dik framáet stort skridt fremad;taka bátin eitt dik betur framsejle båden et stort stykke længere fremad2(fys.)acceleration
dikka	(om klokke)tikke,klokkan dikkaði uppi á hilliniklokken tikkede på hylden
dikkast	være omstændelig, have for mange dikkedarer,ganga og dikkast og dikkast við e-mgå og pusle med noget
dild	(bot.)dild(skærmplante)(Anethum graveolens)
dilla	bævre, ryste (spec. af fedme),alt dillar á honumhan er tyk og fed;hon er so dillandi feithun er overordentlig fed;tað dillar undir fótinumdet bævrer under foden
dillari	fed person
dimma1	Dimmakortform for avisen Dimmalætting
dimma2	1gøre mørk,skýflókarnir dimma luftinaskyerne gør luften mørk2mørknes, blive mørkt,dimma av náttblive nattemørkt;dimmastblive mørk(t);tá ið næturnar tóku at dimmastda nætterne blev mørke
dimmabrúnur	mørkebrun
dimmagráur	mørkegrå
dimmagrønur	mørkegrøn
dimmagulur	mørkegul
dimmalætting	daggry, dagens frembrud,í dimmalættinginived daggry
dimmareyður	mørkerød
dimmbláur	mørkeblå
dimmblettutur	sortplettet,dimmblettut bløðsortplettede blade
dimmbrúnur	mørkebrun
dimmbrýntur	med mørke øjenbryn
dimmgráur	mørkegrå
dimmgrønur	mørkegrøn
dimmholdaður	mørk i huden, mørklødet, mørkhudet, mørkladen
dimmhúgva	(mørk) hue til mænd
dimmhærdur	mørkhåret
dimmi1	1mørke,dimmi lættir (av)det dages;hann kom ikki aftur fyrr enn á dimminumhan kom ikke tilbage førend i mørkningen;tað stendur á dimminumdet er ved at blive mørkt2midnat om sommeren, den mørkeste del af natten om sommeren,um dimmið(om sommeren) ved midnat;jf.hádimmi
dimmi2	1noget der er mørkere end omgivelserne, silhuet,teir sóu dimman av landi;ein dimmi kom upp á luftinahimlen formørkedes2svag vind som kruser havets overflade, parti af havet med krusninger,ein dimmi á sjónum
dimmilíri	"líri" der fanges i mørke,draga dimmilíra;taka dimmilíra
dimmilundi	(ornitol.)lunde der fanges om aftenen el. natten,draga dimmilunda;fleyga dimmilunda;(spøg.)taka dimmilundatage sig en dram i smug
dimming	skumring, mørkning
dimmjarpur	kastaniebrun,dimmjarpt hárkastaniebrunt hår
dimmleittur	1mørkladen, mørklødet2noget mørk,henda dimmleitta stovandenne noget mørke stue
dimmligur	noget mørk,ein dimmligan dag í oktoberen noget mørk dag i oktober;andlitið var dimmligtansigtet var noget mørkt i farven;-liga
dimmlittur	mørk af farve,ein dimmlitt kúgv dagaðist har uppi í tokunien ko der var ret mørk af farve kunne ses i tågen
dimmlýsi	tusmørke
dimmmorreyður	mørk rødbrun,barkaðir húðarskógvar eru dimmmorreyðir á liti
dimmoygdur	mørkøjet
dimmprikkutur	sortplettet,dimmprikkut eggsortplettet æg
dimmreyður	mørkerød
dimmskýggjaður	med mørke skyer
dimmur	1mørk, dunkel,dímunarseyðurin var dimmur á liti;náttin var um tað dimmastadet var den mørke nat2sørgmodig, trist,so dapurt og dimt var um Føroyaland;dimmur er hesin dapri dagur niður í mold at fara3(om lyd)mørk
dimmveðraður	mørk el. tåget i vejret,hann var dimmveðraður henda sama morgundet var mørkt i vejret denne morgen
dimmviðrað	mørk el. tåget i vejret
dimmviðri	mørkt vejr,tað er dimmviðridet er mørkt (tåget) vejr
dingla	dingle
dinosaurur	(zoo.)dinosaur
dint	stød,báturin fekk eitt fast dintbåden fik et hårdt stød
dinta	støde,plankin dintaði fast niður á jørðinaplanken stødte hårdt ned på jorden
dintil	1kort hale, fårehale2bagdel,tey fingu fótin í dintilin, gjørdu tey ikki, sum hann segðide blev truet med afskedigelse på stående fod, hvis de ikke gjorde, som han sagde
dintilsbein	(biol.)sædeben(os ischii)
dintla	dintla seg tildriste sig til;eg dintlaði uppií sum ungur;fara dintlandistrejfe omkring;dintlastpusle med noget,gongur og dintlast og dintlast og fær einki í lag
dioda	(elektr.)diode
dirðil	1bagdel,skera (e-n) á dirðilingive én en skideballe2mæhæ, sløvt, viljeløst menneske
dirka	dirke,hann dirkaði seg inn í krambúðinahan kom ind i butikken ved at dirke døren op
dirkur	dirk,hann gjørdi sær ein dirk til sparikistilinhan lavede en dirk til sparebøssen
dirva	driste,dirva seg til e-tdriste sig til;dirvastformaste sig til,ikki skal hann dirvast at hyggja niður í kistuna
dirvi	dristighed, mod,seta dirvi í segstramme sig op, tage sig sammen
dirvin	dristig
dirvisgóður	modig,hann var dirvisbetri enn vanligthan var mere modig end sædvanlig
dirvisleysur	modløs
dirvisligur	dristig, modig;-ligadristigt, modigt
dirvislítil	bange, forsagt,hann var bæði ræddur og dirvislítilhan var både bange og forsagt
dirvisloysi	forknythed
dirvisloysingur	kryster, kujon
dirvismikil	dristig, modig
dirvisorð	dristigt ord
disja	bævre, ryste,tað disjar uttan á henni, tá ið hon gongurfedmen bævrer uden på hende, når hun går
diskaslá	tallerkenrække
diskblóma	(bot.)diskblómurskiveblomster
diskil	(datal.)diskette
disklastøð	(datal.)diskettestation
disklop	(med.)diskusprolaps
diskotek	diskotek
diskur	1fad, tallerken,(ordsp.)betri eru smáir fiskar enn tómir diskardet er bedre at have noget at spise end slet intet2disk(fx i butik)3(datal.)disk, pladelager4(biol.)håndskive mellem hvirvellegemerne
dism	1støv, fnug2en lille smule (mel, salt, te o.lign.),eitt dism av saltien lille smule salt
disma	støvregne,tað dismar úr honumdet støvregner
disp	= dism
ditta	være så dristig uopfordret at tilbyde sin hjælp el. at påtage sig noget, man ikke magter,hatta dittir sær (el.seg) til althan tilbyder sin hjælp i tide og utide;at tú skalt ditta tær á at fara og royna
dittimundur1	dumdristig person (som overvurderer sine evner)
dittimundur2	ubeskeden,eg eri so dittimundur at biðja um at hýsa mærjeg er så ubeskeden at bede om logi
dittin	ubeskeden
díki	mudderpøl, sump, morads
díkiblomstur	(bot.)kragefod
díkiblóma	(bot.)kragefod
díkimura	(bot.)kragefod(Potentilla palustris)
díkistyriltunga	(bot.)sump-kællingetand(Lotus uliginosus)
díkistør	(bot.)skede-star(Carex hostiana)
díkja	slå, hamre, slå løs,díkja á hestin(få hesten til at løbe),díkja áanspænde sine kræfter, press på;regnið díkti ádet styrtregnede;díkja undiroverøse;hann díkti teir undir í hálmi;(flutt m.)hann díkti fólk undir við svávuli og eldi
díkjutur	moradsagtig, pløret,lendið var vátt og díkjutterrænet var vådt og pløret
Dímun	(stedn.)1(Stóra) Dímunø syd for Sandoy;í / úrel.á / av (Stóru) Dímun,til Dímunar2bondegård på øen Stóra Dímun3Lítla Dímunlille ubeboet ø syd for Stóra Dímun
dímunarseyður	(zoo.)vikingernes får
dírindí	gengivende hjejlens lyd
dís	(mytol.)gudinde, nymfe
djarvligur	dristig, modig;-ligadristigt, modigt
djarvmæltur	frimodig i sin tale
djarvoygdur	med dristigt blik
djarvur	dristig, modig
djassur	(musik)jazz
djevul	djævel,djevulindjævelen, fanden, den onde, satan
djevulskur	djævelsk
djevulsligur	djævelsk;-liga;djevulsliga meinfýsindjævelsk ondskabsfuld
djevulssettur	forbandet
Djibuti	Djibouti
djibutibúgvi	djiboutier
djibutiskur	djiboutisk
djór	dyr
djórafóður	dyrefoder
djórafrøði	(zoo.)zoologi
djórafrøðingur	(zoo.)zoolog
djóragarður	zoologisk have
djórahandil	dyrehandel
djóraheimur	1fauna, dyreliv2dyreverden, dyrerige
djórakringur	(astronomi)dyrekreds, zodiak
djóralív	fauna, dyreliv
djóralækni	dyrlæge
djóralæra	zoologi
djórapínsla	dyrplageri
djóraplankton	(zoo.)dyreplankton
djóraringur	dyrekreds, zodiak(Zodiacus)
djóraríki	djóraríkiðgruppen af alle dyrearter på jorden,jf.steinevnaríki,planturíki
djórasavn	zoologisk museum
djóraslag	dyreart,grevlingur er djóraslaggrævlingen er en dyreart
djóraveiða	(kvad)dyrefangst
djóravernd	dyrebeskyttelse, dyreværn
djóraverndarfelag	dyreværnsforening
djóravinur	dyreven
djóravist	(zoo.)dyrepension
djúp	dyb,myrkur var yvir djúpinumder var mørke over urdybet
djúpan	dybt,draga andan djúpantrække vejret dybt;suffa djúpansukke dybt
djúpbláur	dybblå
djúpd	dybde, dyb
djúpfiskur	dybvandsfisk
djúpfrysta	dybfryse
djúpfrysting	dybfrysning
djúpgongdur	1dybtgående,djúpgongdar rannsóknirdybtgående undersøgelser2(om båd)der ligger dybt i vandet3(om sne)dyb
djúpgrund	(geol.)grundfjeld
djúpgrýti	(geol.)dybbjergart
djúpgrýtingur	(geol.)plutonisk dannelse
djúpgrønur	dybgrøn
djúphav	dybblåt hav
djúphavsfiskur	dybhavsfisk
djúphavsskorpa	(geol.)oceanskorpe
djúphugaður	dybsindig, skarpsindig
djúphugsin	dybsindig
djúphugsni	dybsindighed
djúpleittur	dybsindig,djúpleitt yrkinget dybsindigt digt;djúpleitt tosdybsindig tale
djúplendur	som har dyb jord(om jordstrækning, mark etc.),ein grøn djúplend fløtaen grøn dyb jordstrækning
djúpliga	dybt,hugsa djúpligatænke dybt
djúpmæltur	med dyb røst
djúpoygdur	med dybtliggende øjne
djúpskygdur	fornuftig
djúpstaddur	dybtliggende,djúpstødd eygudybtliggende øjne
djúpsýni	dybsindighed
djúptonktur	dybsindig
djúptøkin	dybtgående, gennemgribende,eitt djúptøkið innlit í lív og hugsan skaldsinsen dybtgående indsigt i digterens liv og tanker
djúpur	(også(også1dyb,djúpur dalurdyb dal;djúpur borðiskurdyb tallerken,(meteorol.)eitt djúpt lágtrýstet dybt lavtryk;úti á djúpumude på dybt hav;(overf.)vita hvar havið er djúpastvide alting om andre2(musik)om tone som ligger lavt på toneskalaen,djúpur tónidyb tone;hava djúpa røddhave dyb stemme;djúpt
djúpvatnstrolari	(mar.)dybvandstrawler
djús	juice
djørv	sedjarvur
dl	fork. fordesilitur
dm	fork. fordesimetur
D-markur	(økon.)d-mark
dobbi	knop(på fodboldstøvle)
doddur	1pandeuld(fx på får el. hest),doddurin varð skorin av gimburlombunum, ið best vóru skikkað til lívseyð2tot, hårtop, spec. langt pandehår (hos mænd),hann tók bugfulla hondina í doddin á mær3hårlok
doðaligur	doðaligt veðurfugtigt og tåget vejr
doðaveður	fugtigt og tåget vejr
doði	1(let) dis2lette dugdråber(fx på klæder)
doktarabátur	lægebåd
doktaraboð	bud efter læge
doktaraevni	(univ.)præses, doktorand
doktaraheiti	(univ.)doktortitel
doktarahond	i ordforb.farael.koma undir doktarahondkomme under lægebehandling
doktaralærdur	lægeuddannet
doktaranavnbót	doktortitel
doktararingur	doktorring
doktararitgerð	(univ.)doktordisputats
doktaraskapur	(med.)lægekunst, medicin
doktarastig	(univ.)doktorgrad
doktari	1(univ.)doktor (person med doktorgrad)2læge
dolkur	dolk
dollari	(økon.)dollar
Dominika	Dominica
dominikari	1dominicaner(en person fra Dominica)2dominikaner(en person fra den Dominikanske Republik)
dominiki	1dominicaner(en person fra Dominica)2dominikaner(en person fra den Dominikanske Republik)
dominikskur	1dominicansk(som har at gøre med Dominica)2dominikansk(som har at gøre med den Dominikanske Republik)
dongdi	sedeingja
dorg	1fiskesnøre (tynd snøre som bruges ved fiskeri med fiskestang)2lille snøre til sejfiskeri
dorgargarn	snøre der egner sig til "dorg"
dorur	dorn
dossa	1gøre våd, fugtig, fx om tøj,nú dossar ánu bliver tøjet fugtigt2regne lidt, dryppe
dossaligur	fugtig, tåget,dossaligt veðurfugtigt, tåget vejr
dossleittur	1(om vejr, luft)indeholdende fugtighed, med udsigt til fugtigt vejr, tung, diset,luftin er dossleittluften er fugtig;tað er so dossleitt veðurdet er så fugtigt vejr2(om farve) grumset
dossligur	tungt, fugtigt vejr
dottin	sedetta
dovin	1(om mennesker)mat, sløv, dorsk, doven2(om mad)som har tabt sin smag, doven, kraftesløs,dovið saltsalt uden smagel.kraft3fugtig,dovið hoyggjfugtigt hø
dovinskapur	dovenskab
dovisligur	doven, mat, sløv,við dovisligum eygummed sløve øjne;-liga
dovna	1blive mat, sløves, dovne,dovna burturforsvinde, blive borte;dovnastdovne, drive2(om mad o.lign.)tabe sin smag, blive kraftesløs, dovne,saltið dovnarsaltet bliver kraftesløst;(talem.)hon letur ikki mjøðin dovnahun er arbejdsom
doyðin	sedoyður
doyður	i ordforb.leggja doyðin áanstrenge sig;komael.renna við tann sturtandiel.dundrandi doyðkommeel.løbe med megen fart;dýra doyðgudsdød;halga doyðpinedød
doyggja	1dø,hann doyði á ungum árumhan døde i en ung alder;liggja at doyggjaligge for døden;grind doyði á Sandien flok hvaler blev slagtet på Sand;doyggja burtur í illumdø af vanrøgt;(om fugleunge)doyggja í egginumdø i ægget,også(overf.)ikke blive til noget2(svækket betydning)doyggja í hungri (kulda, tosta, raki)være meget sulten (kold, tørstig, mager);doyggja illa í kuldavære meget kuldskær;doyggja niður øðrumeginlammes i den ene side (af apopleksi);doyggja útuddø1dø inde hos andre(hvor man har boet den sidste tid),hann doyði út hjá dóttur síni2(om fx dyreart)uddø,geirfuglurin doyði út í Føroyum um 1820;doyggja útiomkomme ude (i uvejr);(talem.)tú doyrt ikki í ár(bliver sagt når en person kommer ind mens der tales om hamel.hende)3dø bort el. hen el. ud,doyggja burturuddø, gå af brug (fx om gamle skikke, arbejder o.lign.);lotið doyði burtur(om vind) løje af, dø hen4doyggjandidøende,til sín doyggjandi dagtil sin død(sdag)
doypa	1(kirk.)døbe(gerne i forbindelse med navngivning)2navngive
doypari	(bibl.)døber,Jóhannes doypari(n)Johannes Døberen
doypifuntur	(kirk.)døbefont
doyping	(rel.)dåb
doyr	sedoyggja
doysleittur	(om vejr, luft)tung, diset, indeholdende fugtighed
doyva	1døve, sløve, afstumpe,e-t at doyva pínuna viðnoget at døve smerterne med;fyri at doyva tey døpru minni;slíkt doyvir sinnið niður2(med.)bedøve3doyva niður á e-tpresse noget ned, trykke på noget,doyva niður á klædnapott4doyvandibedøvende,rúsdrekka og onnur doyvandi evnispiritus og andre bedøvende stoffer;eiturkoppar drepa fongin við doyvandi eitri5doyvdur(om lyd)dump, hul
doyvari	dæmper,tað vildi leggja seg eins og ein doyvari á gleði hansaradet ville lægge en dæmper på hans glæde
doyving	(med.)narkose, bedøvelse, anæstesi,tá vaknaði hon aftur av doyvinginida vågnede hun op af narkosen
dólgabýttur	torskedum
dólgaskapur	sløvhed, ligegyldighed
dólgsligur	sløv, dvask, uopvakt
dólgur	sløvt, klodset menneske, dumrian
dólgutur	sløv, dvask, uopvakt
dómadagur	(rel.)dommedag,til dómadagsi al evighed
dómarakanning	(jur.)dommerundersøgelse
dómari	1(jur.)dommer2(idr.)dommer,fótbóltsdómarifodbolddommer3(bibl.)betegnelse for gud som den der dømmer menneskene(især mht. dommen på dommedag),DómarabókinDommernes Bog
dómfella	(jur.)domfælde
dómfelling	(jur.)domfældelse
dómhús	domhus
dómkirkja	(kirk.)domkirke
dómpróstur	(kirk.)domprovst
dómsgerð	(jur.)domfældelse
dómsmaður	(jur.)domsmand
dómsmál	(pol.)retssag, sag, proces
dómsmálaráðharri	(pol.)justitsminister
dómsnevnd	dommerkomité
dómsorð	1(bibl.)dom2fordømmende ord
dómsstig	(jur.)retsskridt
dómstólur	(jur.)domstol
dómsúrskurður	dommerkendelse, retskendelse
dómsvald	(jur.)dømmende myndighed
dómsveldi	(jur.)dømmende myndighed
dómsviðgerð	(jur.)procedure
dómur	(jur.)1dom,fellael.siga dómafsige dom over;geva seg undir dómel.ganga undir dómmodtage en dom2domstol, ret3anmeldelse, recension,bókin fekk góðan dómbogen fik gode anmeldelser
dópsfat	(kirk.)døbefont
dópsgáva	dåbsgave, faddergave
dópskjóli	(kirk.)dåbskjole
dópsnavn	døbenavn
dópsseðil	(kirk.)dåbsattest;jf.navnabræv
dópsvatn	(kirk.)vand til (brug ved) dåben
dópur	1(rel.)dåb,bera til dópinholde over dåben;fara til dópinskulle døbes2navngivning
dós	dåse,leggja í dóskomme på dåser
dósakjøt	dåsekød, kødkonserves
dósamatur	dåsemad, konserves
dósamjólk	dåsemælk
dósaopnari	dåseoplukker
dósasligur	døsig
dósin	døsig
dósna	1blive døsig2(om lys)blive svagere,(overf.)blive svag, svækkes,dósnar føroyski dansurin, verður missurin stórurhvis den færøske dans svækkes, bliver tabet stort
dósutur	døsig
dóttir	datter,tey eiga tríggjar døturde har tre døtre
dótturbarn	barnebarn
dótturdóttir	datterdatter,dótturdóttir mínmin datterdatter
dótturfelag	(økon.)datterselskab
dótturmaður	svigersøn,dótturmaður mínmin svigersøn
dóttursonur	dattersøn,dóttursonur mínmin dattersøn
drabb	uroligt hav, små tætte bølger,drabbið frá brotunum fylti bátin
drabba	(om havet)være urolig,gott veður, men tað drabbaði eitt sindurgodt vejr, men havet var lidt uroligt
drabbandi	i ordforb.drabbandi fullurel.so drabbandihønefuld
drabbsjógvað	(om havet)lidt uroligt, som giver en del stænk
drabbsjógvur	lidt uroligt hav
drabbutur	(om havet)lidt uroligt, som giver en del stænk,tað var so drabbut, at sjórokið stóð um allan bátinhavet var så uroligt, at vandet skyllede over hele båden
drag	1(lang)drag,koma í dragtrække i langdrag2(båd.)fald på sejl, faldline,sita við dragiðsidde ved faldlinen3ansigtsudtryk4karaktertræk5karakteristisk træk,eitt týðandi drag í søguniet betydningsfuldt træk i historien
draga	1drage, trække, slæbe,hann dró, sum hann vildihan fangede mange fisk;tað stóð á hondum at dragader var mange fisk at få,hetta dró fólk til plássiðdette trak folkene til stedet;draga eina línuvære enige, stå sammen;liggja og draga1ligge for døden2være lige ved at falde i søvn;(talem.)tað verður hart hoyggj at dragadet bliver en vanskelig opgave;i ordforb. somsum norður dregurnår man kommer længere mod nord,fjørðurin smalkaði, sum norður drófjorden blev smallere, jo længere mod nord man kom2draga kvørnmale på kværnen3overtrække, beklæde,kistan var í gulli driginkisten var indfattet i guld4skele lidt,draga við eygunum;hann dregur á annað eygaðhan skeler lidt på det ene øje5(om sind)draga hýr á segblive melankolsk, blive tungsindig;tað dró slíkt yvri á hannhan blev meget ivrig6(om vejr)tað dregurskyerne driver;hann dregur (aftur) á luftinadet trækker op til uvejr;tað dró ikki skýggj fyri sólikke en sky formørkede solen, ikke en sky skjulte foran solen;nú dregur fyri sólinanu er det skyet7(om bølgeslaget)langsomme, rytmiske bevægelser af søen inde ved land,tað dregur í taranumder er langsomme bevægelser i tangen;tað dregur ikki um fliðunasøen er ganske rolig;tað dregur í pottinumgryden er ved at koge8bevæge sig, bevæges,i ordforb. somher hevur ikki drigið hár á høvdiher har det været dødstille  / /i ordforb.draga anda(n)ånde;draga báttrække en båd op af el. ned til søen;(ordsp.)allir draga sín bát væl omaneftirdet er nemt når alting går, som det skal;draga fisktrække fisk op af søen(med håndsnøre),draga hoyggjhente hø(til foder);draga línutrække linen op;draga lundatrække lunder ud af deres huler;draga roykryge;draga sátuudtrække det løse hø af ydersiden på en høstak (for at give den form, snit);draga seglsætte sejl;draga svarttrække tomme sildegarn;draga svørðdrage sit sværd;draga vaðskítforgæves trække fiskesnøren op i den tro at der er fisk på krogen;draga viltrække tyndtarmen ud af slagtet får  / /meddraga á:hann dregur á, áðrenn hann svararhan tøver lidt, inden han svarer;draga á bæðivære tvivlrådig, være i tvivl;draga á holdinitage på i vægt, blive fed;draga á seg(om mark) samle ukrudt;draga sjúku á segudsætte sig for at blive syg;draga aftureftirgå tilbage;draga atnærme sig, stunde til,draga at enda (hjá e-m)nærme sig afslutningen (for nogen);ylur dró at honumhan blev varm;draga at særlokke til sig;draga avgå over, drive over;draga burtur(om smerte o.lign.)fortage sig;draga fráogså(mat.)trække fra, subtrahere,megin dró frá honumkræfterne forlod ham;draga framtrække frem, fremhæve,hann royndi at draga okkurt orð fram, sum annars kundi verið gloymthan forsøgte at huske et eller andet ord, som ellers kunne være blevet glemt;draga inn1(om fiskesnøre)trække op2(om bølgeslaget)gå ind mod land,mods.draga út;draga í:draga í reiðursamle til reden;draga niður:draga seg niðurfange flere fisk end båden kan bære;draga saman1trække sammen, samle,eg dró tey oyruni saman, vit fingujeg samlede de penge sammen, som vi fik;(overf.)hann endaði við at draga saman ta mynd, sum hann hevði av skaldinumhan sluttede med at sammenfatte det billede, som han havde af digteren2nærme sig,tað var drigið saman teirra millumafstanden blev mindre imellem dem(om to som var glade for hinanden),draga saman umdække, skjule,myrkrið dregur saman um tey;draga sundurløsne, give efter, gå op,tað dregur sundur / saman millum teirraafstanden bliver større / mindre imellem dem;draga til:draga til reiðurs1bygge rede2(overf.)sætte bo;draga til sínlægge ind under sig;(om vind)vokse,hvirlan dró til sín, áðrenn hon fataði húsiniden stærke kastevind voksede, inden den tog i huset;draga undan1undslå sig2(om får)leve vinteren over3(om folk)komme igennem dårlige tider med livet i behold4overstå en farlig sygdom,eingin væntaði, at hann dró undaningen regnede med, at han overlevede;draga seg undanundslå sig;draga (inn) undir:draga (inn) undir segtilvende sig, bemægtige sig;draga upp1trække en båd op af søen2trække fiskesnøren op;draga upp á:draga upp á máliðtale langsomt;draga upp á tráð(overf.)holde en for nar,tey drógu meg upp á tráðde holdt mig for nar;draga upp á segklæde sig på, tage tøj på;draga skuld upp á segkomme i gæld;draga synd upp á segsynde, begå synd;draga upp í:draga upp í seg1(om vejr)trække sammen (til uvejr),hann hevði drigið upp í seg av landsynningi2(overf.)samle sig, forberede sig,landið bíðar eftir vetrinum, sum nú fer at draga upp í seglandet venter på vinteren, som nu forbereder sig3(om personer)sidde tavs og lytte4(om kvinde) tiltrække (mænd),handa teysin hevur drigið hann upp í seg;draga uppúrgøre en strømpe færdig(ved at trække tråden gennem den sidste maske på tåen);draga út1trække ud, trække i langdrag,tað dró út við komu skiparansdet trak ud med kaptajnens ankomst;draga út í náltræde en nål2(om bølge)trække sig ud fra land,mods.draga inn;draga yvirskjule,hulda hevur drigið yvir tað  / /dragast1trække ud, trække i langdrag,hetta dregst ov leingidette trækker i langdrag2trækkes med en,dragast undanundslå sig,hann dróst undanhan undslog sig;dragast viðvære plaget af, kæmpe med;hon lá og dróst við deyðanhun lå og kæmpede med døden;dragandi:dragandi langtanstærk længsel;kvæðið er so sterkt og dragandikvadet er så stærkt og lokkende;drigin(talem.)(vátur) sum drigin frá grunniplaskvåd
dragari	drager
dragbjálki	(husbyg.)drager, dragbjælke
draghálsur	(båd.)det nederste krumme stykke af stævnen (på en båd)(for og agter),barðholið er frammi í draghálsinum á báti
dragi	(landbr.)traktor
draging	dragning, trækning
dragmaður	(på sejlbåd)mand der passer faldlinen (drag),ikki skuldi dragmaðurin vera ringari enn hann, ið sat til róðurs
dragna	1forlænges,(overf.)dagarnir taka at dragnadagene bliver lidt længere2løsne, give efter, gå op (om reb, tov),knúturin dragnar (eftir)knuden løsnes;tenninar eru dragnaðar á ærini;naglarnir dragnasømmene løsnes;dragna úrgå ud, løs3blive længere,tað var nakað dragnað millum bátarnarder var blevet større afstand mellem bådene (der sejler i samme retning);hinir dragnaðu afturúr av møðide andre sakkede bagud pga. træthed4blive bedre,hann lá langa tíð í óviti, men so við og við fór hann at dragnael.fór at dragna hjá honum
dragsa	bære på noget tungt, slæbe,hon bæði dragsaði og barhun slæbte på en masse
dragsan	det at bære på noget tungt, slæben,tá var eingin dragsan við tungum bjargalínumda var der ingen slæben med tunge fuglefangerliner
dragsl	1noget der slæbes2skrammel, ragelse,har liggur alt møguligt dragslal slags skrammel ligger og flyder
dragsutur	ubehageligt tung, besværlig (at bære),tað er dragsut at beradet er besværligt at bære
dragudorg	lille snøre til sejfiskeri(bruges mest af børn),tann, sum hevði dragudorg, fekk ofta reyðfisk
draguhurð	skydedør
dragukista	dragkiste, kommode
dragulás	lynlås
dragulok	skydelåg
dragurenta	(økon.)morarente, strafrente
dragusong	udtræksseng
draguspæl	(musik)harmonika
dragvatn	1udtræk af hø, der gives kalve at drikke;jf.hoyløgur,hoyvatn2(spøg.)en tynd kop te
drakk	sedrekka
drakt	dragt
drama	drama
dramblátur	hovmodig, overmodig
dramblæti	hovmod, overmod
drambsligur	hovmodig, overmodig
dramma	(talesp.)få sig en dram,hann drammaði dúgligahan fik sig flere dramme
drammur	dram, gibbernakker
dranga	1(om klipper)rage op,Dalanípan og Trøllkonufingur standa og dranga himmalhøgt2drangast(om personer)sinke, opholde,standa og drangaststå i vejen (for andre), stå og fylde op
drangsfótur	(geol.)det nederste af en klippe(søjle)
drangsi	lille opretstående klippe
drangur	enkeltstående klippe(søjle),fuglabjørg við breiðum drongum uttanfyrifuglefjeld med brede klippesøjler udenfor
drankari	dranker
dranki	klippesøjle (forneden forbundet med grundfjeldet),vit løgdu línuna um drankanvi lagde linen omkring klippesøjlen
drap	sedrepa
drapp	urolig sø, små tætte bølger
drasl	1noget der slæbes2skrammel, ragelse,har liggur alt møguligt draslal slags skrammel ligger og flyder
drassa	bære på noget tungt, slæbe
dratl	1klodset, sen adfærd2klodset, sendrægtig person
dratla	gå sendrægtigt og slæbende, komme drattende bagefter
drav	1(om ølbrygning)mask;kóka upp í dravkoge for meget (fx mad)2regn,vit fingu eina sátu, alt hitt fór undir dravvi fik en stak hø, alt det andet blev gennemblødt
dravin	drivvåd, gennemblødt
dravlorkutur	1med hængerøv, ufiks2klodset,tjúkkur ert tú og dravlorkuturdu er tyk og klodset
dravsíður	gennemblødt af regn (med klæderne hængende langt ned om sig)
dravvátur	drivvåd, dyngvåd, pjaskvåd, plaskvåd
drák	1drog, sendrægtig person2forsømmelse, udsættelse
drál	1sendrægtighed, nølen2sendrægtig, langsommelig person,hatta er eitt drálsikken en sendrægtig person
drála	1trække tiden ud, vente, tøve,nú var ikki at drála longurder kunne ikke være tale om at vente længere;drála ágøre et lille ophold2sinke, opholde,tað drálaði megdet sinkede mig
drálan	nølen, sendrægtighed,tað skal vera ferð á øllum og eingin drálander skal være fart på alt og ingen nølen
drálin	nølende
drálutur	sendrægtig
dráp1	1drab,grindin er í drápiel.er komin í dráp;(overf.)tað var (eitt) dráp at bera hoyggiðdet var besværligt og tungt at bære høet;koma mitt í drápiðkomme hvor der er noget godt at få2slagteværdi,gott (lítið, einki) dráp var í kúnnigod (lille, ingen) slagteværdi i koen
dráp2	vådt hø yderst på høstak
drápa	dræbe, aflive,teir vilja meg deyða og drápade vil dræbe mig
drápiligur	dræbende, dødelig;-liga
drápshold	(om kvæg)í góðum drápsholdumtilpas fed til slagtning
drápshugaður	lyst til at myrde
drápshugi	lyst til at myrde
drápshugur	lyst til at myrde
drápskálvur	slagtekalv
drápslamb	slagtelam
drápsmaður	drabsmand, morder, banemand, dræber
drápsmál	(jur.)drabssag
drápsneyt	slagtekvæg
drápspartur	del af grind der tilfalder dem der har deltaget i slagtningen
drápsroynd	mordforsøg
drápsseyður	slagtefår
drápstorv	gennemblødt tørv
drápstorva	gennemblødt tørv
drápsvirði	slagteværdi
drápuligur	1dræbende, dødelig,drápulig sjúkadødelig sygdom2fremfusende, voldsom,eitt drápuligt villdjóret voldsomt vilddyr;-liga
dráttardýr	trækdyr
dráttarflak	stykke af helleflynder som tilfalder fangeren
dráttarlag	måde at trække fiskesnøren op på
dráttarlisti	trækningsliste
dráttarmaður	1en af de mænd som firer fuglefængeren ned med bjergline og trækker ham og hans fangst op igen2mand der er med til at trække lunder ud af deres huler3mand der trækker helleflynder op af søen,dráttarmaðurin átti beituna
dráttarskýggj	(meteorol.)slørskyer, cirrostratusskyer
dráttartíð	den tid da man trækker bjergfugle (især lunden) ud af deres huler(sidste halvdel af maj måned),hægsta dráttartíð til lunda var áttanda vika á sumri
dráttrarband	skagle
dráttrarbløðra	vabel på hånden af at trække fisk med håndsnøre
dráttrardýr	trækdyr
dráttrarflak	stykke af helleflynder som tilfalder fangeren
dráttrarlag	måde at trække fiskesnøren op på,við góðum dráttrarlagi
dráttrarland	sted hvor man fanger lunder ved at trække dem ud af deres huler,ikki varð fleygað í dráttrarlandi
dráttrarlundi	lunder som er fanget ved at trække dem ud af deres huler
dráttrarmaður	en af de mænd som firer fuglefængeren ned i en bjergline og trækker ham og hans fangst op igen
dráttrarrættur	ret hos ejendomsløse til at trække lunder
dráttrartíð	den tid da man trækker bjergfugle (især lunden) ud af deres huler(sidste halvdel af maj måned)
dráttrartræ	hammel
dráttrarvøttur	vante egnet til fiskeri med håndline
dráttur	1handlingen at drage, trække, dragning, trækning,tá ið lundin er lagstur, byrjar drátturin;tey komu altíð oman at hjálpa við dráttrinumde kom altid ned for at hjælpe til med at trække bådene2maling (på kværn, mølle), male korn,taka ein dráttur;jf.draga (2)3handlingen at trække både op af el. i søen(også den vej de trækkes ad)4den tid da man trækker bjergfugle, især lunder ud af deres huler(sidste halvdel af maj måned)5(på himlen)vindens træk i skyerne, skyernes driven for vinden,dráttur upp undir høgættmagsvejr forud for ny vindretning;fløktur drátturdobbelt skylag6(om søen)skiftevis udadgående og indadgående bevægelser i havstokken,tað er dráttur í sjónum;ilt var at lenda, tí drátturin var ógvuligur7langdrag, opsættelse,tað kom dráttur ádet kom til at trække i langdrag8uenighed,dráttur var millum teir báðar bøndurnar um markiðde to bønder var uenige om grænsen;eingin stórvegis dráttur var um ræðið í landinumder var ikke nogen større uenighed om magten i landet9spot, finte, skose,draga e-m dráttirgive en skoser10dragning, tiltrækning,drátturin móti honum var sterkurtiltrækningen til ham var stærk11savn, længsel,hann kendi ein drátt í kroppinumhan følte en længsel i kroppen12í stórum dráttumi store træk13dráttrarskagler,rossini stíga upp um dráttrarnarhestene stiger op om skaglerne
dregg1	grums, bundfald
dregg2	(mar.)dræg(især til at drægge efter muslinger med)
dreggj	dræg(især til at drægge efter muslinger med)
dreggja	(mar.)drægge
dregil	1strimmel, smalt bånd2stribe(fx på en fugls hals)3lang rad, række, kø,har stóð ein langur dregil, so har slapst ikki fram atder stod en lang kø, så man kunne ikke komme til4lang mandsperson,hatta er ein sannur dregil5(ny bet.)banner(bruges fx ved demonstration)6(ny bet.)gulvløber
dregur	sedraga
dreingiligur	tapper, modig, kæk;-liga,teir bardust dreingiligade kæmpede modigt
dreingir	sedrongur
dreingjabarn	drengebarn;tá ið nógv dreingjabørn verða fødd, verður ringur veturnår der fødes mange drengebørn, bliver det en hård vinter
dreingjabátur	(idr.)kaproningsbåd med drenge
dreingjabók	(litt.)drengebog
dreingjaflogsa	pige der holder meget af unge mænds selskab
dreingjakór	(musik)drengekor
dreingjalið	(idr.)drengehold
dreingjanavn	drengenavn, mandsnavn
dreingjaóviti	dreng
dreingjarippa	pige der holder meget af unge mænds selskab
dreingjarligur	(om voksen mand)drenget(som er ung og løssluppen som en dreng);-liga
dreingjaróður	(idr.)kaproning mellem robåde bemandet med drenge
dreingjaskóti	drengespejder
dreingjaskúli	(skole)drengeskole
dreit	sedríta
dreiv1	1sammenblanding, forvirring,koma í dreiv;eitt dreiv er í hasumder er forvirring i dette2vrøvl, snak
dreiv2	sedríva
dreiva	1hilde, fange i snare, indvikle,kvikur sum dreivaður hanihurtig som en hildet hane(om en som er meget langsom når han vil skynde sig meget),dreivað tjaldurtjaldur med uld viklet om fødderne;dreiva samanblande sammen,nú dreivaði eg hendingarnar samannu blandede jeg episoderne sammen2strejfe, stryge om,ganga og dreiva í haganumgå og strejfe omkring i udmarken3gå som om man var hildet, gå skrævende,hann dreivaði eitt sindur, tá ið hann gekkhan gik lidt skrævende, når han gik
dreivbendil	bånd rundt om midten af stor høstak
dreivføttur	langsom til bens
dreivlorkutur	med hængerøv
dreivstaddur	(bot.)dreivstødd bløðspredte blade
dreivutur	1indviklet, sammenfiltret(om uldgarn, fiskesnøre o.lign.),(overf.)ein dreivutur setninguren indviklet sætning2klodset, ubehændig,hann var so dreivutur á beinunumhan gik altid og faldt over sine egne ben;so tungligt og dreivut er gongulagiðså tung og klodset er måden at gå på
drekafiskur	(fisk.)fløjfisk
drekaskip	(skib.)drageskib
dreki	1(folketr.)drage,(kvad)drekin leyp eftir hallargólvi2(skib.)drageskib,(poet.)fram siglir Sigmundur dreka sín
drekka1	drik(fx kaffe, te),ein mjólksopa út í drekkalidt mælk i kaffeel.te;svart drekkate uden mælk;(talem.)hatta er bæði matur og drekkadet er både mad og drikke
drekka2	1drikke,drekka mjólkdrikke mælk;drekka morgundrekkadrikke morgenteel.morgenkaffe;drekka svartdrikke kaffe el. te uden mælk eller fløde;drekka seg ótystanstille sin tørst;(overf.)báturin drekkurbåden tager vand ind over rælingen2være drikfældig,hann drekkurhan er dranker;fara at drekkafalde til flasken, blive drikfældig;drekka illavære drikfældig;(talem.)drekka sum eitt dýrvære meget drikfældig;drekka vitið burturel.drekka seg av vitinumdrikke sig fra sans og samling;drekka seg avdrikke sig fuld;drekka seg fullandrikke sig fuld, blive fuld  / /drekka í:drekka í segopsuge, absorbere;drekka til:drekka e-m e-t tilbeskylde en for noget,teir vilja drekka honum til, at hann ger mannamunde beskylder ham for at gøre forskel på folk;drekka upp:drekka upp afturtage imod, tåle,hann man fara at drekka tað upp afturhan kommer nok til at undgælde for sin handling;drekka úrdrikke ud;drekkandi:tað er ikki drekkandidet er ikke til at drikke
drekkafløska	flaske medel.til varm drik (kaffe el. te)
drekkaílat	drikkekar
drekkaílát	drikkekar
drekkaker	drikkekar
drekkakerald	drikkekar
drekkaløgur	spirituøse drikke
drekkamuður	tår(fx te, kaffe)
drekkamunnur	tår, kop(te, kaffe)
drekkaskál	(kvad)drikkebæger,biður teir bera drekkaskálbeder dem bære et drikkebæger
drekkasúpan	tynd suppe
drekkatystur	tørstig(efter at få en tår)
drekkavatn	drikkevand
drekking	drikkeri
drekkingarsúpan	tynd suppe
drekkingarvatn	drikkevand
drekkivatn	drikkevand
drekkja	(kvad)drikkelag,drekkjan var óró
dren	(talesp.)dræn
drena	(talesp.)dræne
drepa	1dræbe, slagte,drepa grinddræbe en flok grindehvaler;drepa kálv;drepa mannslå en mand ihjel;drepa neytslagte kvæg;ikki drepa livandiikke fange en eneste fisk,drepa niðurdræbe, fælde i mængde(i strid)2(fx i skak)slå3dyppe, stikke ned i vand,drepa e-t (niður) í vatndyppe noget i vand,jf.droypa,hann drap fingurin í vatnhan stak fingeren ned i vand4røre sig,tað drepur ikki1(om strømmen)strømmen er ganske stille2ikke en fisk rører sig(der er ganske tomt for fisk)5(om hø) trække vand,sátan drepurhøstakken trækker vand;at hoyggið ikki skuldi verða dripið av vætuniat høet ikke skulle blive gennemtrængt af regnen6lække, dryppe,tað var sum kalt vatn drap á rygg hansaradet var som koldt vand dryppede på hans ryg;úr tínum hondum drepur blóðiðblodet drypper fra dine hænder  / /drepa á:drepa á e-tstøde på, berøre noget;(overf.)drepa gott á e-nhjælpe, trøste;tað drepur gott á hannhan er lykkelig;drepa burtur úr:drepa burtur úr e-mvaske noget ud;drepa burtur úr munnislå hen;drepa burturúr(ved fleyg)tage fuglen ud af nettet og dræbe den;drepa niður:drepa niður høvurbøje hovedet;drepa uppdyppe noget i vand for at skylle det, vaske et stykke tøj,eg havi dripið vøttirnar uppjeg har vasket vanterne;drepa úr:tað hvørki drepur ella dettur úr honumhan er fuldstændig tavs, han siger ikke et muk  / /drepa seg1begå selvmord2(overf.)tage skade ved at løfte (tage) på noget alt for tungt,tú drepur teg av hasum;drepast1dræbe hinanden2(overf.)slås voldsomt,skepilsini liggja og drepast á gólvinum;drepandi1dræbende, dødelig,um hann hevði knív ella annað drepandi vápn uppi á særom han havde kniv eller andet dræbende våben på sig2kedelig,tað er drepandidet er dødkedeligt
drepiligur	dræbende, dødbringende,drepiligt eituren dødbringende gift
drepningur	selve aflivningen af grindehvaler,grindin liggur í drepningigrindeflokken er ved at blive dræbt
drepsótt	pest
drevja1	fiber i kvannens stængel
drevja2	fjerne fibrene i kvannens stængel(før man spiser den),drevja hvonn
dreya	(talesp.)også(håndv.)dreje,dreya trædreje i træ
dreyari	drejer
dreygur	1dødt legeme, lig2genfærd, genganger
dreyibonkur	(håndv.)drejebænk
dreymaheimur	drømmeverden,hann vildi hava frið at liva í dreymaheimi sínumhan ville have fred til at leve i sin drømmeverden
dreymakendur	drømmeagtig
dreymaleysur	dreymaleysur svøvnursøvn uden drømme,hvørja nátt svav hann trygt og dreymaleysthver nat sov han trygt og uden at drømme
dreymamynd	drømmebillede,eins og dreymamynd teir hvørvade forsvinder som et drømmebillede
dreymasjón	illusion
dreymkendur	drømmeagtig
dreymmaður	(folketr.)mand der viser sig for en i drømme og forudsiger tingenes gang,skiparin mundi hava dreymmann, ið segði honum, hvar fiskur var at fáa
dreymsjón	illusion,oyðið er lív við ongum dreymsjónumet liv uden illusioner er fattigt
dreymsólja	(bot.)valmue(Papaver),rótmikil dreymsóljaalm. fjeld-valmue(P. radicatum)
dreymsóljuætt	(bot.)valmuefamilien(Papaveraceae)
dreymsýni	illusion,eitt brostið dreymsýnien tabt illusion
dreymur	1drøm,koma í dreymar fyri e-nvise sig i drømme for en;vakna við kaldan dreym1uventet få øjnene op for en slem situation2(overf.)pludselig indse sagens (situationens) alvor;(ordsp.)ofta er ljótur dreymur fyri lítlumofte varsler en styg drøm om en ringe ting;(talem.)ikki hava dul ella dreym um e-tikke have ringeste anelse om noget2drøm, fantasi
drift	1drift, gang, fart,í drift inn móti urðini2(talesp.)drift
drifta	1vippe op og ned, vippe,drifta velinumvippe med halen(om fugle),ryssan driftar hoykjaftin(i nidvise)2drive3drifta særbrovte, prale
driftari	(mar.)sildefartøj
driftingur	sving, rystelse, stød;driftingarsvær bølgegang, oprør i søen
dripin	sedrepa
driv	1fin regn(gerne i blæst)2drift, driven,so varð báturin lagdur á driv;ganga fyri drivdrive omkring3fremdrift, energi,tað var eitt driv í honumhan var fuld af energi4bank, smæk,hann fekk eitt drivhan fik smæk5motor,flogfarið letur drivini ganga og ornaflyet lader motorerne gå og blive varme
drivakker	(skib.)drivanker
drivfjøður	(tekn.)drivfjeder
drivin	(tilpas) gennemtrængt af fedt,kjøtið er driviðkødet er gennemtrængt af fedt
drivmegi	drivkraft
drivmjørki	regntåge
drivregn	småregn
drivreim	(tekn.)drivrem
drivsegl	(skib.)drivanker,leggja fyri drivsegllægge for drivanker
drivtoka	regntåge
drísla	være sendrægtig
dríslutur	sendrægtig,dríslut gongulagsendrægtig måde at gå på
drístigur	dristig, kæk
dríta	(mest om fugle) kaste sit, gøre sit behov, forrette sin nødtørft,(ordsp.)ringur er fuglur, í sítt reiður dríturel.tað er ringur fuglur, ið drítur í egið reiðurden som dadler sit eget(fx sit land, sin hjembygd etc.)er ikke meget værd
dríva	1drive,dríva handildrive handel;dríva stórhvalaveiðudrive hvalfangst;dríva dankdrive, gå ledig;dríva av(mar.)(om skib)komme ud af kurs;dríva áanspænde sine kræfter,drívið nú á, hinir rádnu!;dríva undanvige hurtigt tilbage;dríva upp ádrive på (udførelsen af) noget;drívandienergisk, ihærdig, foretagsom2sive,regnið drívur inn í kamariðregnen siver ind i værelset;sveittin dreiv av honumsveden drev af ham3bedrive,dríva horbedrive hor
drívmegi	drivkraft,hon er drívmegin í felagnumhun er foreningens drivkraft
dromedarur	(zoo.)dromedar(Camelus dromedarius)
drongla	drive, slentre
dronglutur	sendrægtig
drongsl	1sendrægtighed2sendrægtig person
drongsla	være langsom og sendrægtig
drongslutur	sendrægtig
drongur	1dreng2søn,drongur Tummassøn af Thomas;dreingirnir hjá JógvaniJógvans sønner3(en piges) kæreste,drongur hennarahendes kæreste4ungkarl, ugift mand,gamal drongurpebersvend;leysur drongurugift ung mand5(kvad)modig mand, helt,ríma um reystar dreingir;dreingir spæla í víggi6(kortspil)knægt,hjartardrongurhjerter knægt
dropa	dryppe,nú dropardet regner fint
dropadriv	(fys.)destillat
dropadríva	(fys.)destillere
dropadríving	(fys.)destillation
dropaglas	medicinglas
dropaskjól	et sted hvor man er beskyttet mod regn,har er ikki dropaskjólder er ingen ly for regnen
dropasteinur	(geol.)drypsten
dropi	1dråbe,nakrir dropar koma úr honumdet regner lidt;ein dropi av mjólken tår mælk;kúgvin mjólkar ein dropakoen giver nogle stænk fra sig;(overf.)ikki hava dropan av vitivære ret dum i hovedet2(om alkohol)dråbe, tår,eigur tú ein dropa?har du en tår brændevin?3dråber,eygnadroparøjendråber;oyrnadroparøredråber
drosl	sendrægtig person
drotning	også(skak,zoo.)dronning
drotningarligur	værdig,tað var nakað við henni, sum var so drotningarligtder var noget værdigt over hende
drotningarmaður	prinsgemal
drotningarvitjan	dronningebesøg
drottin	1konge, hersker2Herren, Gud,lovaður veri DrottinHerren være lovet
drottkvæði	(litt.)skjaldekvad
droyma	drømme,meg / eg droymdijeg drømte;droyma dreymhave en drøm;droyma e-nse en i drømme;(overf.)so góðar dagar høvdu tey ikki droymt umså gode dage havde de ikke drømt om;droymandi1fjern, åndsfraværende2drømmeagtig,út í ta droymandi summarnáttud i den drømmeagtige sommernat
droymari	drømmer
droymutur	drømmerisk,eyguni gjørdust droymutøjnene blev drømmeriske
droyrbløðra	blodblære
droyrreyður	blodrød
dró	sedraga
drógu	sedraga
drópu	sedrepa
drós	(kvad,poet.)kvinde, mø
dróttkvæði	(litt.)skjaldekvad
drukkin	drukken, beruset
drukku	sedrekka
drukna	1drukne2blive drivvåd, blive gennemblødt,klúkarnir vóru druknaðir av regninumhøknipperne var fuldstændig gennemblødte af regnen
drumbur	den sidste i rækken,drumbur darlar aftast;statt ikki sum ein drumbur!stå ikke som en sendrægtig person
drumbutur	sendrægtig
drunnhvíti	(ornitol.)lille stormsvale(Hydrobates pelagicus),sýldur drunnhvítistor stormsvale(Oceanodroma leucorrhoa)
drunnsvikin	1(om kreaturer)med spinkelt haleparti, med hængende kryds2(om menneske)med flad bagdel
drunnur	1(på kreaturer)bagdel,(talem.)hevði tú dugað at sitið so væl á munninum sum á drunninumhvis bare du kunne tie stille2(på fårekrop)korsben med halen på,senda drunnlade et korsben med halen på gå rundt i fest(den som får det skal digte et vers og sende det videre)
drunsl	sendrægtig person
drunsla	være sendrægtig, komme bagefter,farael.ganga drunslandigå langsomt
drunslutur	sendrægtig
drupu	sedrepa
drussutur	sendrægtig
drúgførur	sendrægtig, langsom til at komme,nú er eydnan komin, drúgfør var honnu er lykken kommet, det tog lang tid for hende;drúgført var at fáa heilsuna afturdet tog lang tid at blive rask igen
drúgneyt	dryssehoved
drúgt	sedrúgvur
drúgvan	næsten sikkert, nok
drúgvast	næsten sikkert, nok,dygdirnar, ið hann drúgvast ongantíð hevði havtdyderne, som han sikkert aldrig havde haft;á jú, drúgvast!mon ikke
drúgvátin	(om mad)som det tager tid at spise,livur er so drúgvátindet tager tid at spise lever
drúgvur	som varer længe, som tager lang tid, som lader vente på sig, sen,drúgv sjúkralegaet langvarigt sygeleje;tað tók drúgva tíðdet tog lang tid;(ordsp.)drúgt er tað, ið drýpurdet er forslag i det, der kommer dråbevis;drúgtdrúgt gekk, áðrenn tyngd kom á hanndet tog lang tid inden han blev træt
drúpa	(kun i præsens)drypper,so leingi tað drýpur undan kúnniså længe koen har mælk;(ordsp.)drúgt er tað, ið drýpurder er idéer i det, der kommer dråbevis;okkurt gott drýpur á hannnoget godt kommer til ham;sátan drýpurhøstakken trækker vand;drúpa høvurbøje hovedet;drúpa burtur úr munnislå hen
drúva	(bot.)drue
drúvusukur	(kem.)glukose, druesukker(tegnC6H12O6)
drykkja	drikkelag
drykkjuhorn	drikkehorn
drykkjukíkur	dranker
drykkjulag	drikkelag, bakkanal
drykkjumaður	dranker
drykkjumál	(kvad)drikkegilde, drikkelag
drykkjuoffur	(bibl.)drikoffer
drykkjupeningur	drikkepenge
drykkjusjúka	(psyk.,med.)alkoholisme
drykkjuskapur	drukkenskab, drikfældighed
drykkjusteyp	drikkebæger
drykkjustova	værtshus, bodega
drykkjuvani	drikkevane
drykkjuveitsla	drikkegilde, bakkanal, drikkelag
drykkur	drik,vín ella annar sterkur drykkurvin eller andre stærke drikke
drymbingur	1sølle kræ,hann er eingin drymbingur2den sidste i rækken, sendrægtig person
drynj	svagt og langtrukkent brøl
drynja	1give en svag og langtrukken lyd, brøle svagt og langtrukkent,kúgvin drynjarkoen brøler svagt og langtrukkent2(om sprog)tale med karakteristisk tonefald
drypp	dryp, dråbe
dryppa	1dryppe,tað dryppar undan loftinumdet drypper fra loftet2give lidt mælk,einans ein kúgv dryppaðikun en ko gav lidt mælk3malke(når der kun er lidt mælk),dryppa kúnnimalke koen
dryppari	(med.)gonoré, dryppert
dryppur	dryp, dråbe
drýggindi	det at være drøj(især om mad og drikke)
drýggja	1gøre drøj, få noget til at forslå bedre, være sparsommelig med noget,drýggja sær nakað2udsætte, udskyde,lógaruppskotini verða drýggjað til næsta árlovforslagene blev udskudt til næste år
drýggjaligur	sparsommelig
drýgsla1	drøjelse,hesum var drýgsla ídette kommer til at vare længe
drýgsla2	gøre drøj, være sparsommelig med noget,drýgslið um viðskeran!vær sparsommelig med pålægget
drýlabiti	stykke, bid af drýlur
drýladeiggj	dej til drýlur
drýlaknívur	(ironi)(foragteligt om) sløv kniv
drýlbiti	stykke, bid af drýlur
drýlendi	stump, endestykke af drýlur
drýlur	1cylinderformet, usyret brød,summi gera altíð drýlin áflatan;føroyskur drýlur2noget som ligner "drýlur",ein drýlur av garnatálg;kjøtdrýlur
drýpa	bøje, lude, sænke,drýpa høvur (niður)hænge med hovedet, sænke hovedet;drýpa burtur úr munniel.tosislå hen;drýpa niður ídyppe, stykke ned i;drýpandihængende
drýpur	sedrúpa
drøg	sedrag
drøgg1	bærme, bundfald(spec. i landstampur),tunnan er tóm, bert drøggin er eftir á botninumtønden er tom, kun bundfaldet er tilbage
drøgg2	(med.)euforiserende stoffer,turvelvandi drøggvanedannende stoffer
drøggbundin	euforisk
drøltur	bylt,hatta, sum eftir sløðist (av sátuni), er ikki meir enn ein drøltur
dubba	1udstyre, udruste, forsyne,har skuldu teir so liggja og dubba allan veturin til næsta vár;dubbaður við týggjumudrustet med seletøj2klæde (for) tykt på,hon hevur dubbað høvdið við fleiri turriklæðumhun har klædt sig på om hovedet med flere tørklæder;hví hevur tú dubbað teg so út?hvorfor har du taget så meget tøj på?3(militær)opruste, væbne,dubba seg
dubbing	(militær)oprustning
dudda	(barn.)forrette sin nødtørft
duddur	(barn.)ekskrementer, afføring
duffa	1(om et fartøj)gynge, vippe,skipini duffaskibene gynger (i den hårde sø)2(leg)duffa (træ)vippe, gynge (en leg)
duffitræ	vippebræt
duga	el.1due, kunne, være nyttig, dygtig,,duga at bindakunne strikke;duga at gangakunne gå;duga at svimjakunne svømme;duga føroysktkunne færøsk;duga væl í skúlanumvære dygtig i skolen, være lærenem;duga lítið fyri særvære ubehjælpsom;duga (væl) til hendurnarvære flink med sine hænder;eg dugi ikki við taðjeg kan ikke vænne mig til tanken;duga uppiívære i stand til at synge med i kvad,tað dugir!det er helt sikkert;ið dugirsom gør en forskel;(talem.)barnið dugir hvørki at lúgva ella loynabørn er hverken i stand til at lyve eller skjule noget2være troldkyndig,tað sigst, at hon dugdi ikki sørtdet fortælles, at hun kunne hekse
dugandi	dygtig, flink, rask,tveir evnaligir og dugandi menn;(talem.)ikki verður dugandi maður, ið nevndurel.kallaður er burtur úr ættdet bliver ikke nogen dygtig mand, som ikke er opkaldt efter sin egen slægt
dugga	(barn.)sejle
duggubátur	(barn.)båd
dugileiki	duelighed
dugna	hjælpe,dugna e-mhjælpe nogen;dugna mær eina hondræk mig en hånd
dugnadagur	god dag(til udendørsarbejde)
dugnaður	hjælp, understøttelse,veit mær ein dugnaðgiv mig en hånd
dugnafólk	dygtigt menneske; (coll) dygtige mennesker
dugnakona	dygtig kvinde(fx til husholdning)
dugnaleysur	uduelig
dugnaligur	dygtig, flink, omhyggelig
dugnaloysi	uduelighed
dugnamaður	mand med fremragende egenskaber, dygtig mand
dugnamikil	dygtig
dugnaskaparroynd	(mar.)duelighedsprøve(fx i sejlads)
dugnaskapur	dygtighed
dugni	duelighed
duguleiki	duelighed
duguligur	dygtig, flink
dugur	1dygtighed, kraft, evne,bæði hugur og dugurbåde lyst og evner2gavn, nytte,hvat dugur er í tí?hvilken nytte er i det?
duk	bank, hamren, slag, stød,eitt duk á dyrnaret bank på døren;hann gav honum eitt duk millum herðarnarhan gav ham et slag i ryggen
duka	banke, hamre løs på,hjartað dukaði í bringunihjertet hamrede mod brystkassen
dukan	banken, hamren
dukka	1dukke,spæla við dukkurlege med dukker2dukke(lille pigebarn)
dukkubarn	dukkebarn
dukkubiti	(barn.)en lillebitte bid,skera breyðflísina í dukkubitarskære stykke brød i lillebitte bidder
dukkudidda	1en lille pige2(ironi)dukke(en pæn og sød, men intetsigende kvinde)
dukkuhús	dukkehus
dukkuklæði(r)	dukketøj
dukkulappi	tøjstykke(til dukketøj),spæla við dukkulapparlege med tøjstykker
dukkuleikhús	dukketeater
dukkuligur	net, fin,hon er so dukkulighun er så net;-liga
dukkusjónleikur	dukkespil
dukkustova	dukkestue
dukkuvognur	dukkevogn
duladreymur	anelse,ikki hava duladreym um e-tikke have ringeste anelse om noget
dulakendur	dvask, sløv, ligegyldig
dularbúni	forklædning
dularfullur	gådefuld, hemmelighedsfuld, mystisk
dularklæði(r)	forklædning
dulbúgvin	forklædt
duld	1det skjulte,í duldi løn2(psyk.)kompleks
duldarfullur	gådefuld, hemmelighedsfuld, mystisk
duldarmál	hemmelighed, dølgsmål
duldi	sedylja
duldur	dulgt, hemmelig, skjult,dult nummarhemmeligt telefonnummer;í duldumi det skjulte
duli	1sanseløs tilstand, døs,hann gongur sum í einum dulahan går som i sanseløs tilstand;rakna upp úr dulavågne op fra en døs2dvaskhed,hann var ein sovorðin duli, tá ið hann var ungurhan var en dvask person i sin ungdom3(kortspil)blind makker
dulisliga	mystisk, gådefuldt,báturin hvarv so dulisligabåden forsvandt på mystisk vis
dulklæði(r)	forklædning
dulkrút	drivert, dovenlars
dulla	dulla burtur1søge at skjule, slå hen2ødsle, rutte, øde3svinde
dulleiða	hypnotisere
dulleiðari	hypnotisør
dulleiðing	hypnose
dulleiki	døvhed
dulmál	kode
dulnavn	(lingv.)noa-ord,várklukka er dulnavn á kráku
dulnevndur	pseudonym, anonym,dulnevnd lesarabrøvanonyme læserbreve
dulnevni	pseudonym
duloyra	i ordforb.hava duloyravære tunghør
dulsmál	hemmelighed
dulur1	1noget skjult el. dulgt, hemmelighed,(talem.)ikki hava dul ella dreym um e-tikke have ringeste anelse om noget;eg hevði hvørki dul ella dreym um taðjeg havde ikke den fjerneste ide om det2(folketr.)huldrefolks bolig
dulur2	tunghør,dulur sum potturinstokdøv
dulvit	(psyk.)underbevidsthed;har hugflog og dulvitið húsastder hvor fantasien og underbevidstheden findes
dumba1	1kornaffald under el. efter korntærskning2støv som fremkommer ved korntærskning
dumba2	støve,hann dumbar luftinaluften bliver stærkt diset
dumbleiki	stumhed
dumbur	stum,deyvur og dumburdøvstum
dumbuskriði	kløe(pga. dumba)
dumbutur	1opfyldt af dumba2overskyet,dumbut luftoverskyet himmel
dummur	1(talesp.)dum2stum
dumpari	dumper
dums	tungt stød el. fald, dump
dumsa	1bumpe, dumpe, falde med et bump,báturin dumsarbåden falder med et bump2lade noget falde med et bump,hann dumsaði posan á beinkinhan lod posen falde med et bump på bænken
dun	døn, brus, larm,dunið frá havinumhavets brus;nú hoyrdist sús og dun frá trimum svanumnu kunne der høres sus og brus fra tre svaner
duna	dønne, drøne, bruse,tað dunaði fyri oyrunumdet drønede for ørerne;regnið dunar niðurdet øsregner;duna í sveittavære badet i sved
dunan	drønen, larmen, brusen,dunan av brimibrusen af brænding
dundi	sedynja
dundra	dundre, buldre,nú kemur ein trolari dundrandi inn aftan á teirnu kommer en trawler buldrende bag efter dem;um sunnudagarnar dundraði prestur í kirkjuniom søndagene tordnede præsten i kirken;vit dundraðu avstaðvi jog af sted;við tí dundrandi ferðmed en voldsom fart
dundran	dunder, brag, bulder
dundur1	dundrende lyd, bulder
dundur2	kæfert, beruselse,ganga við góðum dundrivære beruset;hann hevur ein góðan dundurhan er godt beruset
dunga	dynge,kavin dungar niðursneen falder tykt;í dungandi kavarokii dyngende snestorm;hann dungar kavan niðursneen samles i dynger;dunga samandynge op
dungakavi	sne som af vinden er samlet i dynger
dungarok	meget tykt snefog
dungi	1dynge, bunke, hob,kasta upp í dungadynge op2askedynge, askemødding
duni	døn, brus, larm
dunk	dunk, dumpt lydende slag
dunka	banke, hamre løs på,hann dunkar á hurðinahan banker på døren
dunkraft	(tekn.)donkraft
dunkur	dunk
dunna	(ornitol.)1(tam) and(Anas platyrhynchos)2gråand
dunnast	pjaske(i vand el. søle),óvitarnir liggja og dunnast í ánnidrengene går og pjasker i elven
dunnuber	(bot.)slægt i nellikefamilien(Honckenya);jf.sanddunnuber
dunnubilla	(barn.)and
dunnuegg	andeæg
dunnufjøður	andefjer
dunnuhús	andehus
dunnuhylur	andedam
dunnupar	andepar
dunnuspæl	(leg)andespil
dunnusteggi	andrik
dunnuungi	ælling
dunsla	drive,dunsla tíðina burturfordrive tiden;ganga og dunslastdrive tiden hen
dupl	bøje(især på fiskeline)
dupul	bøje(især på fiskeline)
dupultur	dobbelt,dupult bókhalddobbelt bogholderi;dupult,dupult so nógvirdobbelt så mange
durafjórðingur	fáa durafjórðinginblive jaget el. smidt ud;vísael.geva e-m durafjórðinginvise en døren
duraglopp	dørsprække
duragrind	(husbyg.)dørkarm
durahella	trappesten
durakarmur	(husbyg.)dørkarm
duraklokka	dørklokke
durasnapsur	velkomstssnaps
durastavur	(husbyg.)dørstolpe
durasteinur	trappesten
duratjald	draperi
duratrepi	dørtærskel
duratræ	(husbyg.)dørtræ,húgvan bar í duratræið
duravaktari	dørvogter
duravørður	dørvogter
durum	sedyr
durur	lille forstue, entré;jf.dyr
durva	slumre, sove let,hon durvaði niður á stokkarnarhun slumrede ned over strikkepindene;durva ávære på nippet til at falde i søvn
dusa	dusa særsysle, nusse med noget som man har kært, more sig;dusa sær við (e-m)more sig med, hygge sig med (nogenel.noget);dusa tær har!nu sidder du godt i det;(med.)dusandi evnieuforiserende stoffer
dusin	(mål)dusin
duskur	dusk
dusm	støv
dusma	støve
dusmutur	støvet
dust	1støv,(bibl.)ristið dustið burtur undan fótum tykkara2gran, lille smule,eitt dust av teen lille smule te;har er ikki dustið eftirder er ikke det allermindste tilbage3(bot.)støv(pollen)
dusta	(bot.)bestøve
dustgingin	støvet
dusting	(bot.)bestøvning
dustklútur	støveklud
dustmikil	støvet
dustmotta	(zoo.)husstøvmide(Dermatophagoides pteronyssinus)
dustrikin	støvet
dustsúgva	støvsuge
dustsúgvari	støvsuger
dustutur	støvet
duttu	sedetta
dúgligur	1duelig, dygtig, flittig, rask2stor, betydelig,eitt dúgligt fýramannafaren stor firemandsbåd;-ligahårdt,tað nippar dúgliga í (snørið)det rykker hårdt i snøren;hann er dúgliga burturstaddurhan er ofte bortrejst
dúgva	(ornitol.)due(Columbidae)
dúgvuhol	duehul
dúgvuungi	(ornitol.)dueunge
dúka	1dække,dúka borðdække bord2være gunstig vind for sejlads,seglið dúkarsejlet bugner;við dúkaðum seglummed bugnende sejl
dúkur	1vævet tøj2sejldug,fýra dúkar vóru í seglinumfire sejlduge var i sejlet3borddug,biður bera dúk á borðbeder om at lægge borddug på bordet
dún	(på fugle)dun,kasta dúniðmiste dunet og få fjer(om fugleunge)
dúna	fjerne dunene af en plukket fugl,dúna fugl
dúnaður	dunet,dúnaður ungien dunet fugleunge
dúnast	(om fugleunge)få dun
dúndýna	dundyne
dúnhærdur	(bot.)dunhåret,dúnhærd plantadunhåret plante
dúningarskaft	stykke træ hvormed man stryger dunene af en plukket fugls skind
dúningartræ	stykke træ, hvormed man stryger dunene af en plukket fugls skind
dúnlættur	let som dun, fjerlet
dúnmjúkur	dunblød
dúnnappa	plukke uld så den bliver blød som dun
dúnungapílur	(bot.)selje-pil(Salix caprea)
dúnungi	1dununge, dunet fugleunge,dúnungin er dimmur við hvítum prikkum (sjógrælingur)2umoden teenager,tín dúnungi, tú ert
dúnurt	(bot.)dueurt(Epilobium),ljós dúnurtmælke-dueurt(E. lactiflorum)
dúnutur	1(om fugleunge)dunet2dun på tøjet
dúra	slumre, sove let,kanska hevði eg dúrað og droymtmåske havde jeg slumret og drømt
dúrast	slumre, sove let
dúrk	(skib.)dørk
dúrka	(kortspil)tage alle stik hjem
dúrur	slummer, blund, lur, en på øjet
dúsa1	(båd.)lille båd
dúsa2	slumre, sove let,eg svav ikki, eg dúsaði barajeg sov ikke, jeg slumrede bare
dúsi	(båd.)lille båd
dúsur	(båd.)lille båd
dúva1	(ornitol.)due,tað batar lítið, um ein dúva dansarel.tunt er, har sum ein dúva dansarman udretter ikke meget ene mand
dúva2	stole på, tro på, have tillid til,tað er sjógvurin ella jørðin, hann hevur at dúva uppádet er havet eller jordbruget, som han har at stole på;at dúva upp á fremmanda hjálp batar ikki í longdiniat stole på fremmed hjælp rækker ikke i længden
dúvuungi	(ornitol.)dueunge
dvalarviki	rasteplads(en mindre holdeplads langs motorvej el. hovedvej)
dvaldi	sedvølja
dvali	1dvale,liggja í dvalaligge i dvale;vekja úr dvalavække af dvale2døs, sanseløs tilstand,so legðist hann aftur í dvalaså lagde han sig igen i døs
dveylur	1(på skib)dvælg (til rengøring)2strithår
D-vitamin	(kem.)1D-vitamin2D-vitamin tablet
dvína	alm.1give efter,dvína undan e-mvige for en2(om uvejr, sygdom o.lign.)tage af i styrke,illveðrið dvínaðiuvejret tog af i styrke;(biol.)dvínandi(om arveanlæg)recessiv, vigende,dvínandi ílegurvigende gener
dvíning	aftagen, formindskelse
dvøl	1ophold,vit høvdu ein stuttligan dag, tó at dvølin ikki var longvi havde en sjov dag, selv om opholdet ikke var langt;uttan dvøluden tøven2(økon.)henstand,veita skuldara dvølgive en skyldner henstand
dvølja	el.1forblive, opholde sig2tøve, nøle,dvølja átøve lidt, gøre et lille ophold,hann hyggur upp á teir og dvølur á at svarahan ser op på dem og tøver med at svare;dvøljastopholde sig;her untist hon ikki at dvøljast longur3opholdeel.(for)sinke en,dvølja e-nsinke nogen, hindre nogen
dvørgamál	ekko, genlyd,dvørgamál sang í fjøllumekko sang i bjergene
dvørgamoy	dværgmø
dvørgamoyggj	(kvad)dværgemø
dvørgasteinbrot	(bot.)dværg-stenbræk(Saxifraga tenuis)
dvørgastrá	(bot.)dværgbunke(Aira)
dvørgur	1(folketr.)dværg,Beddustovuslagið var næmt sum dvørgarnir2dværgagtigt menneske
dvørgvaksin	dværglignende
dygd	1dyd, god egenskab,skipið hevði góðar dygdirskibet havde gode egenskaber2kraft, værdi,tað roynist betur í dygd, enn tað sær út tildet viser sig at have større værdi, end det ser ud til;við dygdiniaf god kvalitet,nýmjólk var við dygdininymælk var af god kvalitet
dygdarbátur	fortrinlig båd
dygdarbók	fortrinlig bog
dygdardjór	1udmærket godt dyr2udmærket menneske
dygdardýr	1udmærket godt dyr2udmærket menneske,drongurin var eitt dygdardýr í øllum lutumdrengen var et udmærket menneske i alle henseender
dygdarfar	fortrinlig båd
dygdarfjøl	fortrinlig båd
dygdarfólk	udmærket menneske
dygdargóðska	fortræffelighed
dygdargóður	af god kvalitet, fortrinlig,dygdargóður báturfortrinlig båd;dygdargott grasfortrinligt græs
dygdarhoyggj	fortrinligt hø,um dygdarhoyggj siga tey, at tað er sum vínde siger, at fortrinligt hø er som vin
dygdarkona	retskaffen kvinde
dygdarleysur	ubrugelig
dygdarlítil	dårlig
dygdarljós	dydsmønster
dygdarmaður	retskaffen mand
dygdarmikil	af god kvalitet, fortrinlig
dygdarmunur	kvalitetsforskel
dygdarringur	dårlig, skadelig
dygdarríkur	dydig, retskaffen
dygdarskip	fortrinligt skib
dygdarveður	godt vejr,frensurin man ikki vænta dygdarveður, hann er farin upp at spæla í kvøldhankatten forventer næppe godt vejr, den er begyndt at lege i aften
dygdarverk	kvalitetsarbejde
dygdarvøra	kvalitetsvare
dygdugur	dydig, retskaffen
dygðargóður	af god kvalitet, fortrinlig,dygðargóð mjólkfed og kraftig mælk;dygðargott smørfedt smør;dygðargott hoyggjsaftigt hø;dygðargott kjøtkød af god kvalitet
dygðarleysur	kraftløs, saftløs,dygðarleyst hoyggjkraftløst hø
dyggan	eftertrykkeligt,hon kundi taka dyggan til
dyggiliga	grundigt, fuldkomment, eftertrykkeligt,hann treiv dyggiliga í armin á manninumhan tog hårdt i mandens arm
dyggur	1til at stole på, tro, ærlig2solid, holdbar,dyggur kunnleikikoncentreret orientering;dyggur stuðulsolid støtte;dygt støðisolidt fundament;seyðurin er dyggurfårene er fri for diarré3eftertrykkelig,hon gav honum ein dyggan bresthun gav ham en eftertrykkelig lussing;dyggur smeiturgrundskud, hårdt slag
dygst	klos op ad, tæt til el. ved,dygst í klettinganske nær ved stenen
dygt	tæt, nær, fast, eftertrykkelig,tað tók mær dygtdet smertede mig meget;hann gav honum tað so dygthan gav ham en omgang el. medfart, som han vil huske
dyl	dumrian, fæhoved,mítt býtta dyljeg, dumme fæhoved
dylhøvd	dumrian, fæhoved
dylhøvur	dumrian, fæhoved
dylja	skjule, lægge skjul på,dylja fyri e-mskjule noget;dylja nakað inniholde noget skjult;tað dylst (el.dylist) ikki (burtur)det er tydeligt, det kan ikke skjules;tað er ikki yvir at dyljadet kan ikke skjules;hann dylur ikki fyri, at ...han lægger ikke skjul på, at ...;tað varð dult sum mansmorðdet blev bevaret som den dybeste hemmelighed
dylla	mælkebøtte
dymb	1støv, fnug,tað er so nógv dymb av hesumder er så meget fnug af dette2dis af brænding
dymba	støve, fnugge,dýnan dymbardynen fnugger
dymbi	1støv, fnug2dis af brænding
dymbildagavika	(kirk.)den stille uge, passionsugen
dynamitt	dynamit
dynamo	(tekn.)dynamo
dyngja1	dynge, hob,vindurin hevði beykað fannirnar saman í langar dyngjur
dyngja2	dynge,kavin dyngir niðursneen vælter ned;dyngja e-n undir í e-mbelæsse én med noget;(overf.)overbebyrde en med noget,tey dyngdu hana undir í arbeiðide overbebyrdede hende med arbejde
dyngjumosi	(bot.)gråmos(Grimmia hypnoides)
dyningur	dønning,eftir brimið var stórur dyningurefter brændingen var der stor dønning
dynja	el.1buldre, drøne, dundre,skot hava dynjað í alla náttskud har dundret hele natten;regnið dundi niðurel.dundi ádet regnede kraftigt2styrte frem med larm og voldsomhed,orrustan dundi á
dypp	dyppelse
dyppa	dyppe
dyppkókari	dypkoger
dyr	og1dør, døråbning,á dyrel.av durunumtil dørs, ud;fyri dyrnartil huset;fyri durunumudenfor;í durunumi døren;deyðin er í durunumnu er stor nød forestående;ganga í dyrblive stående i døren(om en der kommer udefra);gakk ikki í dyr, kom innum!;koma í dyrkomme til døren;inni í durunumtæt på huset;(inn / út) um dyrnarind (ud) ad døren;koma til stongdar dyrkomme til en lukket dør;fara út fyri dyrgå ud, gå lige uden for huset;laða upp í dyrrømme huset(pga. nød);standa fyri durumvære forestående;(talem.)sópa fyri egnum (el.sínum) durumfeje for sin egen dør2forstue, entré,kom innar, statt ikki í durunum!kom ind, stå ikke i entréen
dyrging	fiskeri (mest efter gråsej) med medestang fra sejlende båd ved at trække stangen frem og tilbage i vandet,seiður fæst á seiðabergi, á dyrging ella við nót;vit fingu so góða dyrging sum ongantíðvi havde så godt fiskeri (efter gråsej) som aldrig før
dyrgingarpláss	søområde nær kysten egnet til at fiske gråsej
dyrgingarróður	varsom roning
dyrgingarseiður	gråsej fanget ved "dyrging"
dyrgingartíð	tid på åretel.dagen når gråsej fanges ved "dyrging",heystið kom og við tí dyrgingartíðin
dyrgja	1fiske (mest efter gråsej) med medestang fra roende båd ved at trække stangen frem og tilbage i vandet2fiske efter,menn standa undir pakkhúsinum og dyrgja eftir at verða bidnir til arbeiðismændene står ved pakhuset og fisker efter at blive bedt om at arbejde;dyrgja eftir konufólkifiske efter kvinder;dyrgja eftir atkvøðumfiske efter stemmer
dyrka	1dyrke, opdyrke,dyrka jørðinadyrke jorden;dyrka upp úr hagatage udyrket jord under kultur2dyrke, tilbede,dyrka Gud
dyrkan	1dyrkning2(bibl.)dyrkelse, tilbedelse
dyrkari	dyrker, tilbeder,hann er dyrkari vakurleikanshan er skønhedsdyrker
dyrkijørð	opdyrkelig jord
dyrkilendi	1opdyrkelig jordstrækning2opdyrkningsareal,drúgt var at bróta upp úr haga og fáa tað til líkligt dyrkilendi
dyrking	dyrkning
dyrkingarvegur	vej til opdyrkelig jordstrækning
dystast	have en dyst med, dyste,politikararnir dystaðust í sjónvarpinumpolitikerne debatterede i tv;dystast við e-nhave en dyst med en
dystfýsni	flid, interesse
dystingarleikur	kapløb
dystur	1dyst, kamp,renna dystløbe om kap;til dystin fúsparat (til noget)2(idr.)kamp, sportskamp,fótbóltsdysturfodboldkamp,handbóltsdysturhåndboldkamp3kamp,millum teirra fór at standa harður dysturmellem dem kom der til at stå en hård kamp
dýggj1	morads,bøurin var traðkaður upp í dýggj;kóka upp í dýggjkoge ud, koge for meget
dýggj2	dýggj ígjøgnumgennemblødt
dýggja	1gøre noget pjaskvådt,dýggja undir í vatni2skvulpe, sprøjte,vatnið dýggjar upp úr skónumvandet sprøjter op fra skoene
dýggjandi	i ordforb.dýggjandi váturdyngvåd, drivvåd
dýggjvátur	dyngvåd, drivvåd,klæðini eru dýggjváttøjet er drivvådt
dýkja	dýkja seglbrede sejl ud til tørring
dýna1	dyne,stikað dýnakanaldyne;vera skjótur undan dýnunivære hurtig op af sengen
dýna2	fjerne dunene af en plukket fugl,dýna fugl
dýningartræ	stykke træ, hvormed man stryger dunene af en plukket fugls skind
dýnubrot	leggja saman í dýnubrot(om fx et stykke vadmel)folde sammen på en vis måde (først på langs og derpå i mindre læg på tværs
dýnuvár	(talesp.)dynevår, dynebetræk
dýnuver	dynevår, dynebetræk
dýnuvor	(talesp.)dynevår, dynebetræk
dýpa	1gøre dybere,dýpa um1gøre noget dybere,dýpa um bøingøre marken noget dybere2(overf.)behandle nærmere, uddybe,evnið verður umdýpt seinni í greininiemnet bliver uddybet senere i artiklen2blive dybere,nú fer at dýpanu bliver det dybere
dýpd	dybde,ein favn til dýpdaren favn dyb
dýpi	1dyb, dybde2(mål)en længde på 60-80 favne,eitt dýpi
dýping	uddybning
dýpshædd	(mål)en længde på 60-80 favne(om en fiskeline)
dýr	1dyr2insekt,eitt dýr!3(noaord)noa-navn for kópur4(om mennesker i nedsættende el. rosende betydning)avynnudýr,fagnardýr,friðardýr,góðdýr,olmussudýr,ódýr,ódugnadýr,ólukkudýr,týggidýr
dýra	sværge,tað dýraði hann uppádet svor han på
dýrabarur	dyrebar,tey dýrabaru minnide dyrebare minder
dýrabiðidagur	(kirk.)store bededag
dýrabærur	dyrebar
dýradoyð	(bandeord)gudsdød
dýrafilmur	dyrefilm
dýraflokkur	(zoo.)dyreklasse
dýragarður	zoologisk have
dýralækni	dyrlæge
dýralæra	(zoo.)zoologi
dýran	højligt, strengt,leggja e-m dýran viðsætte en hårde betingelser, formane el. forbyde strengt;taka dýran tilsværge, bruge kraftudtryk
dýrandi	i ordforb.dýrandi fullurel.so dýrandi1aldeles fuld, døddrukken2fuld til randen
dýrapínsla	dyrplageri
dýrasavn	zoologisk museum
dýraveiða	jagt
dýrd	1særdeles stille og godt vejr(spec. på søen),tað er dýrd í sjónumsøen er ganske rolig2(rel.)herlighed, ære,dýrd krossinskorsets ære
dýrdarfagur	yndig, dejlig
dýrdarfullur	herlig
dýrdargóður	herlig,veðrið var dýrdargottvejret var dejligt
dýrdargripur	(bibl.)klenodie
dýrdarkyrra	blikstille inde ved land,dýrdarkyrra er í sjónumsøen er blikstille
dýrdarlogn	havblik
dýrdarlutur	(bibl.)klenodie
dýrdarmikil	herlig, strålende, prægtig,brúdleypið skuldi vera bæði stórt og dýrdarmikiðbrylluppet skulle være både stort og prægtigt
dýrdarríkur	herlig, strålende, prægtig
dýrdarsjógvur	særdeles stille og godt vejr på søen, udmærket rolig sø
dýrdarslættur	(om søen)blikstille
dýrdarstilli	vindstille, havblik
dýrdarveður	udmærket godt vejr
dýrdleiki	herlighed, ære
dýrgoldin	dyrt betalt,tað er ofta dýrgoldið at vinna matindet er ofte dyrt betalt at skaffe føde
dýrgripur	klenodie, skat
Dýrindal	(kvad)Rolands sværd
dýrka	1blive dyrere,partabrøvini dýrkaðuaktierne steg2gøre dyrere, fordyre,teir dýrka vøruna upp við sínum høgu daglønumde gør varerne dyrere med høje daglønninger3(bibl.)dyrke, tilbede, ære,teir, ið Harran dýrkadem, som tilbeder Herren
dýrkan	1fordyrelse2(bibl.)dyrkelse, tilbedelse, forherligelse
dýrkari	(bibl.)dyrker, tilbeder
dýrleiki	store omkostninger
dýrligur	(bibl.)dyrebar, kostbar
dýrlingur	helgen,Ólavur kongur var mætasti dýrlingur okkarakong Olaf var den største helgen
dýrmeta	herliggøre
dýrmetin	dyrebar, kostbar
dýrmettur	dyrebar, kostbar
dýrmætur	dyrebar, kostbar,av øllum kornsløgum er hveiti tað dýrmætastaaf alle kornsorter er hvede den mest kostbare
dýrtíð	(økon.)dyrtid
dýrtíðarhjálp	(økon.)dyrtidshjælp
dýrtíðarviðbót	(økon.)dyrtidstillæg
dýrur	1dyrebar, herlig,(poet.)tú alfagra land mítt, mín dýrasta ogn;(kvad)tá bliknaðu dreingir dýrirda blegnede de herlige kæmper2dyr, kostbar,ein dýrur handilen dyr handel;í dýrum dómum, í dýra dómiel.í dýra dómai dyre domme, meget kostbart;(ordsp.)hann doyr ikki, ið dýrt keypirdet kan betale sig at købe dyrt3hård, tung,í ein dýran hasti største hast;leggja e-m dýrt viðforsikre en noget højt og helligt, forsikre en noget under ed;hetta skal verða tær dýrtel.hetta kemur tær dýrt at standadette skal du få betalt4hellig,dýri biðidagurstore bededag;hann er komin til ta dýru tíðhan ligger for døden;svørja dýrtsværge højt og helligt;dýra doyðgudsdød;dýrasturyderst, størst,vera í dýrastu neyðvære i yderste nød;hann rann tað dýrasta, hann áttihan løb alt det, som han kunne;av dýrastu maktaf alle kræfter
dýsa	(tekn.)dyse
dýva	1dyppe el. trykke ned i vand,dýva íel.undir kav;dýva niður ápresse noget ned, trykke på noget2prøve på at fange rødtorsk med stang ved at holde denne lodret i vandet
dývátur	dyngvåd, drivvåd
dællur	tilgængelig, fortrolig, behagelig
dælur	tilgængelig, fortrolig, behagelig,gera sær dælt við e-nstille sig på en fortrolig fod med en, være fri og utvungen over for en;gera sær dælt við e-mforsøge at få det bedste ud af noget;tað er ikki dælt at koma í holt við hannel.hann er ikki dælur at koma í holt viðdet er ikke behageligt (ikke nogen let sag) at komme i kast med ham;ikki vera dælur at strúkahan er ikke nem, han er ikke god at skændes med;(talem.)dælt er manni vitandi orðden forstandige mand fatter let en tale
dæmdur	af en vis hudfarve (teint),væl / illa dæmdurhave en smuk / uren teint
dæmi	ansigtsfarve, teint,hava gott / ringt dæmihave god / dårlig ansigtsfarve
døgg	dug, fugtighed,døggin setur avduggen forsvinder,(overf.)hann hevði døgg um eygunihan havde tårer i øjnene
døgga	dugge,rúturin døggarruden dugger;døggaðurdugget
døggdropi	dugdråbe
døggfalla	dugge,nú fer at døggfallanu begynder duggen at falde på
døggvátur	dugvåd,døggvátt grasdugvådt græs
døglingseyga	halvblind el. svagsynet person
døglingsspik	spæk af døgling
døglingur	1(zoo.)døgling(Hyperoodon ampullatus)2dårligt lavet høstak der blæser om kuld,fáa døgling
døgum	sedagur
døgurðabiti	lille middagsmåltid,fáa sær ein døgurðabitafå sig en lille middag
døgurðablundur	middagslur
døgurðaborð	middagsbord,sita við døgurðaborðiðsidde ved middagsbordet
døgurðagerð	middagslavning
døgurðaleysur	uden at have fået middagsmad,ganga døgurðaleysurgå uden at have fået middagsmad
døgurðamatur	mad til middagsmåltid,seyðarhøvd er góður døgurðamaturfårehoveder er god mad til middagsmåltid
døgurðamál	middagstid,á døgurðamálived middagstid
døgurðapottur	gryde hvori middagsmaden bliver kogt
døgurðasteðgur	middagspause
døgurðasvangur	sulten efter at få middag
døgurðatíð	middagstid
døgurðatími	middagspause,nú hevur døgurðatímin verið ivaleysa langurnu har middagspausen varet rigelig længe
døgurðaveitsla	festmiddag
døgurði	middag, middagsmåltid, middagsmad,eta døgurðaspise til middag;á døgurðaved middagstid (spisetid)
døkkast	1blive mørk2(om synet)sløves
døkkbláur	mørkeblå
døkkdæmdur	mørkhudet
døkkholdaður	(om mennesker)mørkhudet
døkki	1mørkt sted,hvørvur inn í døkkan í vakstrargarðinumforsvinde ind i det mørke sted i haven2silhuet,vit sóu døkkan av teimum uttan fyri glervindeygunivi så silhuetten af dem uden for vinduet
døkkleittur	mørkladen
døkkormur	(med.)hudorm(comedo)
døkkoygdur	mørkøjet
døkksveima	(zoo.)alm. græssvirreflue(Melanostoma mellinum)
døkkur	mat, dunkel, mørk,himmalin gjørdist døkkur og samdriginhimmelen blev mørk og overskyet;døkkur í holdinummørk i huden
døll1	lille lerkar;(overf.)hatta er tann døllin, ið er!1(om en gryde, som er sen til at koge)2(om en dårlig og klodset person)
døll2	drog, fæhoved
dølla	dølla særel.døllastvære langsom til bens
døllur	lille lerkar;(overf.)tungur í døllinumsom ikke gider rejse sig
døllutur	sendrægtig
dølma	være sendrægtig, komme bagefter,hygg, hvar hasin býttlingurin kemur dølmandi
dølmutur	sendrægtig
dølski	sløvhed, dvaskhed
dølskleiki	sløvhed, dvaskhed
dølskni	sløvhed, dvaskhed
dølskur	dvask, sløv, ligegyldig
dølum	sedalur
døma	1dømme, afsige en dom,døma frá lívinumdømme fra livet;døma lívleysandømme til at miste livet;døma e-m tildømme en til at få noget;døma e-m frádømme en til at miste noget2vurdere, bedømme,eftir øllum at dømaefter alt at dømme, efter al sandsynlighed, antagelig;døma umvurdere,teir gløddu upp í himmalin og dømdu um líkindinide kiggede op på luften og vurderede vejrudsigterne;dømastdiskutere,hvat standa tit og dømast um?hvad står I og diskuterer?3kritisere, dadle, klandre, laste,hann er so ringur at dømahan er så slem til at kritisere
dømi	1eksempel,dømi um e-teksempel på noget;til dømisfor eksempel2fabel,Esops dømiÆsops fabler3(kvad)begivenhed, hændelse, tildragelse, beretning, fortælling,so sigst í dømum frá;tað merkir dømi stór4(i sammensætning)magtområde, distrikt, kreds,kongadømikongedømme;læknadømilægedistrikt;valdømivalgkreds
dømileysur	utænkelig
døming	fordømmelse
dømisøga	lignelse, parabel
dønum	sedani
døpur	sedapur
døpurhugi	tvivl,vera í døpurhuga (av e-m)være forvirret og tvivlrådig, være i dyb tvivl (pga. noget)
døsi	parti sammenfiltret tråd(garn, snøre o.lign.),fløkt upp í ein døsa
døsil	parti sammenfiltret tråd(garn, snøre o.lign.),tað er komið uppel.saman í ein døsil;alt í einum døsli
døsin	dvask
døttur	1fald,ein ringur døtturet hårdt fald;hann fekk ein ringan døtthan fik et svært fald2knude, udvækst,hornið er vanskapað, mest sum ein stórur døttur á bakinum(på kaskelot)3ujævnhed på en forarbejdet genstand,hvussu hevur tú fingið handa døttin út har?4en lille byrde,ein fittan døtt hevði eg at bera
døtur	sedóttir
døv	(på menneske el. hest)kryds, bagkrop,dettael.falla á døvinael.falla aftur á døvfalde på bagdelen
