A,a	(málfr. og tónl.)A, a;hevur tú sagt a, mást tú eisini siga bin for a penny, in for a pound;frá a til zfrom A to Z
abbaba	(barnam.)granduncle, great-uncle
abbabarn	grandchild
abbabeiggi	granduncle, great-uncle
abbabróðir	(sj.)granduncle, great-uncle
abbadidd	(barnam.)grandaunt, great-aunt
abbadissa	abbess
abbadóttir	granddaughter
abbaligur	precocious; old-fashioned;hj-liga
abbasonur	grandson
abbasystir	grandaunt, great-aunt
abbati	abbot
abbi	1grandfather;(tlm.)grandpa, granddad2old man3abbar (skaldsk.)forefathers, ancestors, for(e)bears4steina abbarplay ducks and drakes
ABC	1ABC'sflt (t.d.he learned little more than his ABC's); (stavibók) spelling book; ABC-book2(byrjanarstig) ABC(t.d.the ABC of finance; the ABC of piano playing)
A. B. C. D.	(st.)American, British, Chinese, Dutch [londini, ið bardust ímóti Japan í seinna heimsbardaga]
abnorm	sífrábregðandi
abnormitet	sífrábrigdi
abonnement	síhald
abonnentur	síhaldari
abonnera	síhalda
abort	sífosturtøka
abortera	síeiga í ótíð,taka fostur
abrikosa	apricot
absoluttur	síavgjørdur;algildur
abstinensur	(lækn., tlm.)withdrawal symptom(s); sírúsfjáltur
abstraktur	síúrtøkur
absurdur	síhøpisleysur,skilaleysur
a-bumba	síkjarnorkubumba
Addis-Abeba	(sern.)Addis Ababa
adjektiv	sílýsingarorð
adjudantur	(herm.)aide-de-camp, A.D.C., ADC; (herflokkaadjudantur) adjutant
adjunktembæti	mastership
adjunktur	1upper secondary school teacher;(samb.lektari) junior teacher; master at a grammar school2(á fróðskaparsetri) lecturer at a university;(am.)assistant professor at a university
administrera	sístanda fyri,sita fyri,fyrisita,umsita,stíla fyri
admirálur	1(herm.)admiral2(firv.)red admiral(Vanessa atalanta)Vanessa atalanta ©iStock
adoptera	síættleiða
adoptivbarn	síættleiðingur
adressa	1(á brævio.tíl.ogteld)address,(t.d.not known at this address); Mr X, c/o Mr Y2(bústaður) address(t.d.he has changed his address; he has moved to another address); síáskrift3(áheitan) address, petition(t.d.present an address//a petition) to him; they got up an address to him among the people of the town)
adressera	sítilskriva
Adriahav	(sern., landafr.)the Adriatic
advent	(kirkj.)Advent,fyrsti//annar o.s.fr. sunnudagur í adventthe First//SecondetcSunday in Advent
adventistur	(átr.)Adventist
adventskransur	Advent wreath
adventssunnudagur	Advent Sunday
adverbium	síhjáorð
advokatfulltrúi	(løgfr.; svarar til)solicitor's clerk
advokatloyvi	(løgfr.)fáa advokatloyvi be admitted (as a solicitor), be called to the Bar,(am.)be admitted to the Bar;missa advokatloyvibe struck off the Rolls, be disbarred
advokatpraksis	lawyer's practice, legal practice; law firm; (solicitor's) solicitor's practice; (barrister's) practice at the Bar
advokatráð	advokatráðið (svarar til) the General Council of the Bar
advokatsamsýning	(løgfr.)lawyer's fee
advokatskrivari	(uml.)legal secretary
advokatskrivstova	(løgfr.)lawyer's office; solicitor's office; (barrister's) chambersflt
advokatur	1lawyer(t.d.place the matter in the hands of one's lawyer; seek the advice of one's lawyer);fáa ráð frá advokatitake legal advice (í Onglandi fevnir hugtakið bæði um2og3)2solicitor (íOngl.:løgfrøðiligur ráðgevi, sum einans hevur heimild at søkja mál fyri lægri dómstólum; arbeiðið svarar annars til tað hjá advokati);gerast advokaturbecome a solicitor3barrister (heimilaður at føra sak fyri hægri dómstolar); (tá iðbarristervirkar í rættinum, verður hann nevndur counsel(fltcounsel));gerast advokaturbe called to the bar;advokatur hjá ákærda(í borgaraligum máli) Counsel for the Defence/Defendant;advokatur hjá stevnandiCounsel for the Plaintiff;vera advokaturbe at the Bar;mín advokaturmy counsel; my legal adviser4(yrkisheiti) solicitor(t.d.John Doe, solicitor); barrister-at-law(t.d.Richard Roe, Barrister-at-Law); (í USA er felagsheitið fyri advokatlawyer; attorney;(yrkisheitið) attorney-at-law2og3verða ikki brúkt í USA)5(í skotskum og ikki-enskum rætti ogfl.m.)advocate(t.d.the devil's advocate)6advokatarnirthe counsel; (um stættina) (the) lawyers; the legal profession; (íOngl.um barristers) the Bar
advokatvirki	(løgfr.)law firm; firm of lawyers; firm of solicitors;(GG:firm of barristers verður ikki nýtt)
advokatvirksemi	(løgfr.)lawyer's practice(t.d.have a large lawyer's//solicitor's//barrister's practice); legal practice; law firm; solicitor's practice; (barrister's) practice at the Bar
aðal-	chief,Fprincipal, primary; (um lutir og máleis.)main
aðal1	nobility, noble birth;aðalinthe nobility; (íOngl., uml.)the peerage, the aristocracy;av aðaliof noble birth;aðal hevur skyldur við særnoblesse oblige;ríkisins aðalthe peers of the realm;hoyra til aðalinbelong to the nobility
aðal2	1síaðalkorn22aðaliðthe best, pick(t.d.the pick of the army); élite, flower(t.d.the flower of the nobility, the flower of English youth)
aðal3	(kvæð.)noble, precious, generous
aðalbláber	(plfr.)wortleberry(Vaccinium myrtillus)
aðalbláberjavongur	(firv.)golden-rod brindle. (Xylena solidaginis)© Wikimedia Commons
aðalborin	noble, of noble birth; precious, generous
aðaldubbing	general mobilization; eis.aðalherbúgving
aðalendamál	chief aim, chief purpose
aðalevni	principalel.main subject, themeel.topic;aðalevnið í hesi bókthe main theme of this book
aðaleyðkenni	chief characteristic, chief distinguishing mark; distinctive feature
aðalfulltrú	general power of attorney, general authority; blanket press(GG:we gave him a blank cheque to act on our behalf)
aðalfundarsamtykt	resolution (of a general meeting);vanlig aðalfundarsamtyktordinary resolution;aðalfundarsamtykt samtykt við kvalifiseraðum meirilutaextraordinary resolution
aðalfundur	1(í felag) annual general meeting, general meeting, plenary/general assembly,(ofta =)annual ordinary general meeting;halda aðalfundhold a general meeting;boða frá aðalfundicall(el.summon) a general meeting;eyka aðalfundurextraordinary general meeting;stovnandi aðalfundur(kann verða endurgivið) first general meeting;vanligur aðalfundurordinary general meeting2(í ST) the General Assembly, the General Assembly of the UN, the United Nations General Assembly3(onnur sambond) the Trade Unions' Congress; the Labour Party Conference; the General Assembly of the Church of Scotland
aðalfylking	(herm.) general mobilization
aðalgrann	(plfr.)(silver) fir(Abies)slag: Abies alba © Wikimedia Commons
aðalgrein	main branch
aðalherbúgving	(herm.) general mobilization
aðalhugsan	leading idea
aðalhugtak	main concept, principal idea
aðalhyrnissteinur	(bíbl.)cornerstone
aðalinnihald	1principal contentsflt2(resumé) summary
aðalkonsul	consul-general
aðalkonsulát	consulate-general
aðalkorn	1the best corn2(fl.m.)best, first, most outstanding(t.d.our most outstanding scholars); the élite; rank among the élite/the best
aðalland	mainland
aðalligur	of nobleel.aristocratic family; noble, precious, generous
aðallyndi	generosity, noble-mindedness; magnanimity
aðallýti	main flaw, principal, mainel.chief defect
aðalmaður	(kvæð.)nobleman;(sø. eis.)noble; síaðalsmaður
aðalmál	main question, main thing, principal thing, most important thing, first consideration, chief concern;tað er aðalmáliðthat's the main thing;aðalmálið er atthe great/main thing is that;fyri meg er aðalmálið atmy chief concern is that; the main thing as far as I am concerned is that
aðalmið	chief aim, chief purpose, chief object
aðalmunur	principal difference; substantial difference
aðalnevnari	(stfr.)common denominator(fyriof)(eis. fl.m.)
aðalorðaskifti	general debate, full-dressel.full-scale debate
aðalorsøk	main, chiefel.principal cause
aðalráð	(svarar til) directorate, department, executive; (Evropatingið) Directorate-General
aðalregla	principalel.chief rule
aðalrenta	1(hjá meginbanka) bank rate; minimum lending rate;(am.)discount rate;hækka//lækka aðalrentunaraise//lower the bank rate(við 1%by one per cent);við eini aðalrentu sum erat a discount of2(hjá privatbanka) market rate (of discount), market discount
aðalritari	síaðalskrivari
aðalroynd	1(sjónl.)dress rehearsal(tilof);hava aðalroyndhave the dress rehearsal(tilfor);hava aðalroynddress-rehearse2(til hátíðarhaldo.tíl.)rehearsal3(fl.m.)dress rehearsal(tilfor); trial run(t.d.the Spanish Civil War was a trial run for the Second World War)
aðalsbræv	patent of nobility
aðalsfólk	1the nobility; the aristocracy2(sø.)the nobles
aðalsfrúgv	noblewoman; (íOngl. eis.)peeress
aðalskrivari	(t.d. í ST)secretary general;aðalskrivarin í kommunistaflokkinumgeneral secretary of the Communist Party
aðalskrivstova	General Secretariat(t.d.of the European Parliament)
aðalskrúna	coronet
aðalsmaður	nobleman
aðalsmerki	(flm)hallmark, patent of nobility; characteristic; distinctive feature
aðalspurningur	mainel.principal question;fyri hann er tað aðalspurningurinthat is the question which concerns him most
aðalsstætt	nobility, noble stock, titled family
aðalstavur	(herm.)general staff
aðalstign	nobility;aðalstign hevur skyldur við særnoblesse oblige
aðalstjóri	Permanent Secretary
aðalstjórn	1governing body; central board2(starvsnevnd) executive committee
aðalsætt	noble family
aðalsøgn	(málfr.)main verb
aðaltáttur	principal line, meaning, contents, thread
aðalumboð	chief(el.principal) agency
aðalverk	chief(el.principal) work
aðalverkfall	general strike(t.d.declare (, demand) a general strike)
aðils-	(kvæð.)síaðals-
aðra	síannar
aðramáta	síannars
aðrar	síannar
aðrastaðna	síaðrastaðni
aðrastaðni(s)	somewhere else, elsewhere, in another place
aðrir	síannar
afasi	aphasia
afatikari	aphasiac
afatiskur	aphasic
affekteraður	síuppgjørdur;skaputur
affektivur	síkensluborin
affiks	síorðaskoyti
affinera	síreinsa
affinitetur	sílíkskapur;samlyndi
affirmatión	síváttan
affirmativur	síváttandi
afganari	Afghan
afgani	Afghan
Afganistan	(sern.) (landafr.)Afghanistan
afganskur	Afghan
aforisma	sífyndorð
Afrika	Africa
afrikani	1African2(hvítur suðurafrikani) Afrikaner
afrikanskur	African
afro-amerikanari	Afro-American
afro-amerikanskur	Afro-American
afroasiati	Afro-Asiatic
afrodisi	(lækn.)aphrodisia
afrodisitiskur	aphrodisiac(al)
afrohársnið	Afro-hairdo(el.-haircut), Afro;við afrohársniðiAfro-haired, Afroed
aftan1	1(kvæð.)evening2(dagurin fyri halgidagel.hátíðarhald) Eve(t.d.Christmas Eve, Easter Eve)
aftan2	1(aftanífrá) from behind, from the rear2behind; at the back3[ísamb.viðfs]aftan ábehind, after,hanngekk aftan á hann/honumhe walked behind him, he followed him;hann rópti aftan á hana/hennihe called after her;aftan fyriel.fyri aftanbehind(t.d.he was hiding behind a tree; he stood behind me; with a pencil behind his ear);hanngekk langt aftan fyri okkumhe came a long way behind us; at the back of(t.d.there was a garden at the back of the house); in the rear of;aftan fyri tjaldið(fl.m.)behind the scenes; (í sjónleikhúsi) off-stage;aftan í((fastur) fyri aftan át.d.fari),teir bundu kópin aftan í bátinthey tied the seal to the stern of the boat;aftanundanfrom behind, from astern,aftan undanhekkunifrom astern;aftan úrastern of
aftaná	1(um rað) behind(t.d.he followed behind), síaftan á2(um tíð) afterwards(t.d.they had tea afterwards), later;(forml.)subsequently
aftanbøn	(átr.)evening prayersflt
aftanfyri	behind(eis. t.d.í ítróttakapping); on the back of, at the back of,aftanfyri á brævbjálvanumon the back of the envelope;standa aftanfyri á sporvogninumride on the back (platform) of a tram;hann stendur aftan fyri alt hettahe is at the bottom of this
aftaní	((fastur) fyri aftan ít.d.fari) astern,báturin hongur aftaníthe boat is keeping astern
aftanífrá	from behind, from the rear; (øvut) backwards;(tlm.)backside foremost;álop aftanífrá (herm.)a rearguard attack;leypa á aftanífrá (herm.)attack (from) the rear; attack from behind;sæð aftanífráseen from the rear(el.from behind);skallin sæddur aftanífrá (eis.)posterior aspect(el.rear view) of the skull;biðja faðirvár aftanífrásay the Lord's Prayer backwards
aftanlestur	(átr.)evening prayerspl
aftansangur	1evening song2(gudstænasta) evensong
aftanskin	evening glow
aftansongur	(kirkj.,gl.)evensong
aftanstund	(kvæð.)evening
aftantil	behind; at the back
aftantíð	(kvæð.)evening
aftanundan	from behind
aftanúr	behind
aftanvert	at the rearmost side of (in, on), at the back of
aftari	1l miðst(longri afturi av tveimum) the rearmost;hann vildi ikki vera aftari enn hinirhe did not want to come(el.fall) short of(el.be inferior to) the others2hjmiðst;hann setti seg eitt sindur aftarihe sat down a little way behind the others
aftarlaga	a little behind;(fl.m.) standa aftarlagabe backward
aftarumegin	behind; at the back
aftast	at the back;aftast í salinumat the back of the hall
aftastatá	(Suð.)little toe
aftastifingur	(Suð., Sa.)little finger
aftastur	back(most), rear(most),(gl.)hindmost;tey aftastuthose at the back;aftasta raðthe back(most) row
aftna	become evening, get dark
aftra	í osb: aftra seg el. sær hesitate, shrink from; boggle at(t.d.paying so much);eg aftri meg við at gera tað (eis.)I don't like doing it, I hate to do it;eg aftraði meg við tankanI squirmed at the thought
aftran	hesitation,uttan aftranwithout hesitation
aftranarrættur	[the right to annul a contract or hire-purchase agreement]
aftrat	1fsaftur at2hjto it, to that; besides(t.d.besides, she is a good cook), added to that, into the bargain, moreover, furthermore, in addition (to this);halda seg aftratkeep close to
aftur	1backwards; behind, astern, abaft, in the rear2again, once more, back;aftur og framto and fro; (øvutur) inside out,troyggjan vendir aftur og framthe sweater is turned inside out;bøta e-t afturrepair sth;gjalda afturpay back;koma afturcome back again;løna e-m e-t afturpay sby sth back3close, shut,lata vindeygað afturclose the window;hurðin er afturthe door is shut4anew, afresh, (over) again5(saman við sagnorði)t.d. beina aftur;benda aftur;bøta aftur;fara aftur;fáa aftur;ganga aftur;spyrjast aftur;taka aftur;venda aftur (sísagnorð)6[ísamb.viðfs/hj]aftur aftur1again, once, more, anew, afresh2back again, once again, once more;aftur at1besides, added to that, into the bargain, moreover, futhermore, in addition (to this)2close to,hann stóð aftur at bróstinumhe was standing close to the wall;halda seg aftur at e-mkeep close to someone;aftur avbackwards, off,kassin datt aftur av vogninumthe box fell off the back of the carriage;aftur ábackwards;aftur eftirbackwards,aftur eftir hælibackwards;aftur fyriin return for(t.d.he was given a sapphire in return for the diamond);aftur umback,sníkja seg aftur um húsinisteal round the back of the house;aftur undirbehind;aftur viðwith(t.d.we drank wine with our dinner; they take tea with their meals; do you want anything else (to go) with your food?)
afturat	síaftrat
afturatbygging	extension(t.d.build an extension), addition
afturatkoma	(lækn.)sequela(t.d.scarlet fever often has deafness as one of its sequelae)
afturatlagdur	síleggja afturat
afturatløga	supplement (prentað aftast í bók); addition; appendix(flt-es,(yrkism.)appendices); (við ískoytum) addendum(fltaddenda)
afturatyrking	addition(t.d.to a poem); additional stanza (, chaptero.tíl.)
afturav	backwards(t.d.bend someone backwards);fara afturavfall backwards
afturá	1back, backwards;ganga afturágrow worse, deteriorate2(sita) upp afturásit straight3on,lúkan lá afturáthe lid is on;leggja afturádie;leggja kvæði afturá[lead the singing and dancing of a Faroese ballad];leggja eitt glas av whisky afturáknock back a whisky
afturábendur	bent back
afturáboygdur	bent back
afturbein	(dýr.)hind leg
afturbeindur	(málfr.)afturbeint fornavn relative pronoun;afturbeindur eykasetningurrelative clause
afturbendur	(málfr.) afturbent fornavnreflexive pronoun
afturbering	return
afturbleytur	(um seyð) with diarrhoea
afturblíðkaður	cooled down again
afturboðan	feedback
afturborin	síbera aftur
afturbót	1compensation(t.d.a compensation of £10,000)2(serl.tryggingarmál) indemnity, indemnification3(í rættarmáli) damagesflt
afturbragd	(lívfr.)reflex,treytað afturbragdconditioned reflex;sí eis.afturskin,endurskin
afturbregðiligur	(lívfr.)hereditary
afturbøtandi	reparable,ikki afturbøtandiirreparable, beyond repair
afturbøting	1repair2(løgfr.)atonement(t.d.in atonement for a wrong); expiation(t.d.in expiation of a crime)
afturbøttur	síbøta aftur
afturdekk	(skip.)quarterdeck
aftureftir	back, backwards, behind, to the rear
aftureining	reunion; reunification
afturendi	(skip.)stern
afturfall	(sj.)relapse
afturfarin	1weakened, (um sansar og andsevni) impaired(t.d.impaired hearing; mentally impaired); deteriorated, decreased2lost weight, become thinner;sífara aftur
afturferð	1return journey (, passage, voyage); journey(o.s.fr.)home2decline(t.d.a rapid decline; he was blamed for the decline of the party); íafturferðfalling off, declining3weakening;(forml.)impairment; (ógvisligari) debilitation; weakness; (ellisveikindi,(forml.) infirmity;hann er í afturferðhe is going downhill
afturfingin	sífáa aftur
afturfjórðingur	(av neyti) hindquarter
afturflýggjan	return
afturfløddur	sífløða
afturfótur	(dýr.)hind leg
afturfrá	drag;(t.d.he dragged behind the others)
afturfrásøgn	(sj.)retelling; reproduction
afturfunnin	sífinna aftur
afturfyri	1in return,krevja okkurt afturfyriask for sth in return, demand a quid pro quo2shut, closed
afturfyrisegkomin	recovered, rested, refreshed
afturgiftur	remarried
afturgjald	1return2refundment; (upphædd) refund
afturgjalding	refund, paying off, taking up
afturgjørdur	repaired(t.d.a road, a car, a ship); mended(t.d.a broken toy, a fountain pen, a watch, a bicycle, a fence, a shirt);(tlm.)fixed;sígera aftur
afturgoldin	sígjalda aftur
afturgonga	1weakening, weakness,(forml.)impairment; (ellisveikindi,(forml.) infirmity; decline, falling off2(the appearance of) ghosts; haunting3ghost; revenant;(tlm.) spook; (forml.)phantom
afturgongd	síafturgonga
afturgreiddur	sígreiða aftur
afturgrógvin	sígrógva aftur
afturgrøddur	sígrøða aftur
afturhald	1moderation, duga sær afturhaldbe moderate, show moderation2conservatism3(um løn) stoppage, withholding of wages
afturhaldandi	1conservative2síafturhaldin
afturhaldin	1(varin) cautious, guarded;(tlm.)cagey2(drálandi) reluctant3(kravlítil) unobtrusive, retiring, modest
afturhalds-	conservative; (um politiskan flokk) Conservative
afturhaldsandi	conservatism
afturhaldsblað	Conservative newspaper
afturhaldsflokkur	Conservative Party; (í Ongl.eis.)the Tories
afturhaldsfólk	conservative person;svartur hafturhaldsmaðurultra-Conservative person
afturhaldshugaður	conservative
afturhaldskroppur	conservative person
afturhaldssamur	conservative
afturhaldssinnaður	conservative, (um politiskan hugburð) Conservative
afturhaldsstevna	Conservatism
afturheilsan	returned greeting
afturhildin	1detained; (um løgreglu) held(t.d.he was held by the police for 24 hours);(forml.)detained; withheld(t.d.information); suppressed(t.d.the newspaper has suppressed the name of the suspect);síhalda aftur22modest;(forml.)unobtrusive, cautious
afturhitting	(sj.)reunion
afturhittur	tú skalt verða afturhittur I'll certainly get even with you
afturhjól	(á akfari) rear wheel
afturhokin	sagging
afturhond	1(dýr.)(á apu) back of the hand2í afturhond við e-mfall behind with something; (í eftirstøðu) behindhand, behind(t.d.with one's work, in one's payments); (meiraforml.)in arrears(viðwith);roknskapurin er komin í afturhondthe accounts are in arrears
afturhorvandi	retrospective,bøkur hansara eru afturhorvandihis books are retrospective
afturhógvur	(dýr.)(á rossio.tíl.)hoof on hind leg
afturi	behind, further back;har afturi(á skipiel.báti) astern, abaft
afturíaftur	1koma afturíafturcome back, return; reappear; come back into fashion2(um samband millum tvey) make up,tað kom afturíaftur hjá okkumwe made it up, we got together again3fylla afturíafturrefill, replenish4teir spurdust ongantíð afturíafturthey were never heard of again5taka afturíafturpick up the thread
afturíafturkomin	(um horvnan) found again;(forml.)retrieved
afturíkast	(sj., stb.)afters
afturímóti	1hj deila afturímótianswer back;sláa afturímótihit back, return a blow2fscompared with(el.to)(t.d.that is nothing (compared) to what I saw); to(t.d.the chances are ten to one; three goals to two)
afturjakslur	(lívfr.)back tooth, molar
afturkast	reject
afturkastaður	rejected, despised
afturkasting	(alisfr.)reflection
afturkembing1	recurrent pain
afturkembing2	(sj.)subsequent reproaches; hangover(t.d.the deficit is a hangover from the dock strike)
afturkenning	recognition
afturkensla	recognition
afturkeyp	repurchase; eis.endurkeyp
afturkeypsprísur	buy-back price
afturkeypsrættur	(løgfr.)right of repurchase
afturkeypsvirði	(av lívstryggingarskjali) surrender value; cash value
afturkleyv	(dýr.)hind hoof
afturklógv	(dýr.)hind claw
afturkoma	return, reappearance;afturkoma Kriststhe Second Coming
afturkomin	síkoma aftur
afturkoming	síafturkoma
afturkomuferð	refresh rate
afturkrevjing	claim for restitution of property
afturkroppur	hind part of body
afturlabbi	(dýr.)hind paw
afturlagdur	síleggja aftur
afturlagstur	síleggjast aftur
afturlatin	sílata aftur
afturlating	closing(t.d.handil)
afturlatingartíð	closing time
afturleið	way back (home),tey vóru á afturleiðthey were on their way back, they were returning
afturleistur	heel of a stocking
afturlimur	(dýr.)hind limb
afturlit	retrospect, in retrospect(t.d.in retrospect it is now clear that this battle was a turning point in the war)
afturlítandi	retrospective
afturljóð	echo(flt -es);(forml.)resonance;geva afturljóðresound, echo, ring
afturljós	1(á akfari) rear light, tail light2(til súkklu) rear lamp, tail lamp3(á skipi, báti) stern light
afturlykt	síafturljós
afturlæstur	locked;sílæsa aftur
afturløning	return; (fyri ilt) retribution, reckoning(t.d.the day of retribution(el.reckoning))
afturløntur	síløna aftur
afturmastur	(skip.)mizzen mast
afturmelding	1(við sjálvvirkandi stýring) feedback2(sum  viðbragd) response
afturmenning	1(eftir sjúku) convalescence2(hvíld) rest cure
afturminning	1(sj.) memoirs; síendurminning2(sálfr.) reminicence
afturmunan	retaliation
afturmunanar-	retaliatory(t.d.customs duties, measures)
afturmuningarástøði	retributive theory, retributivism
afturnørdur	recovered
afturopin	í osb: falla afturopin fall on one's back
afturpartslega	(lækn.)breech presentation
afturpartur	1hind part, behind, seat, backside2hind quartersflt
afturpikkur	síafturskarpur
afturreising	restoration
afturrenning	healing (up), closing (up)
afturrikin	rejected, refused, rebuffed, disdained
afturrindaður	sírinda aftur
afturrindan	return; (upphædd) refund
afturrit	(løgfr.)replication
afturrunnið	(um beinbrot) set
afturrútur	(á akfari) rear window;elektriskur afturrúturheated rear window
afturs	downhill, from bad to worse,koma til aftursgo downhill, deteriorate
aftursegl	(skip.)spanker
aftursending	return;(forml.)restoration
aftursetstur	1sat down again2given up the idea
afturseymaður	sewn up
aftursigin	(um grøvel.veit) collapsed, fallen in, overgrown
aftursina	(sj.)Achilles' tendon
aftursíður	sagging
aftursjúgvaður	chased away, driven back (off, away), dismissed summarily
afturskarpur	(sigl.)afterpeak
afturskin	reflection; afterglow
afturskip	(skip.)stern
afturskoðandi	retrospective
afturslag	(hjá skotvápni) recoil
aftursnúður	double twist (í tvítáttaðum garni)
aftursókn	(løgfr.)recourse;søkja um aftursókn hjáhave recourse against
aftursóknarkrav	recourse claim
afturspegling	reflection
aftursperra	shank, leg
afturstavnur	(bát.)stern
afturstev	(sj.)afturstig (1)
afturstevni	(bát., skip.)stern
afturstig	1[í føroyskum dansi: step backwards]2(lækn.)relapse3(fl.m.)step backward(s);(forml.)retrograde step, retrogression;mentanarligt afturstiga step backwards culturally;vera eitt afturstigbe retrogressive, constitute a retrograde step;henda lóggávan er eitt stórt afturstigthis legislation has put the clock back fifty years
afturstigshiti	(lækn.)recurrent fever(febris recurrens)
afturstingur	(handarb.)back stitch
afturstrev	(sj.)extreme conservatism
aftursvar	answer
aftursvarað	sísvara aftur
aftursvarðaður	sísvarða aftur
aftursøgn	(skúlam.)reproduction
afturtikin	sítaka aftur
afturtrá	nostalgia
afturtøka1	reposession
afturtøka2	(herm.)retrograde movementel.retrograde operation; fallback, pullback, pullout;(eis. fl.m.)withdrawal(t.d.of troops, of an accusation)
afturtøkukall	callback
afturum	1behind, to the rear2(over) again
afturumaftur	again, once more,koma afturumafturrake up;kom nú ikki afturumaftur við hasumdon't rake that up again;hyggja afturumaftur at e-mrevise; return, repay,onkuntíð vænti eg at koma tær afturumaftur fyri hattaI expect to repay you for that; (at lyfta arv)tað er ikki gott at koma afturumaftur harit is not easy to step into his shoes; (um eitthvørt illa úr hondum greitt) it is not easily repaired;ganga afturumafturimprove
afturumfarin	1lagging behind(t.d.í kapprenning)2(um tíð) past, gone by
afturumlagdur	síleggja afturum
afturumlestur	(sj.)proof (sheet);annar rættlesturrevise, second proof;lesa rættlestur av e-mread the proofs of sth, proofread sth
afturundir	1behind; in hiding, in shelter;fara afturundirdisappear (behind);ganga afturundirbe lost to view;krúpa afturundircrawl, creep behind2out of sight
afturundirgerð	[after the main current has turned, it still runs close to land in the opposite direction of the main current for some time]
afturúr	to the rear;dragna afturúr (fl.m.)lag/fall behind; fall back;(sigl.)drop/fall astern
afturúrsigldur	(um sjómann og fl.m.)left behind
afturút	beintafturútdead stern el. aftdragnaafturútfall behindgjalda afturútpay in arrears
afturvaldur	sívelja aftur
afturvallaður	sívalla aftur
afturvegur	síafturleið
afturvend	í osb: har er eingin afturvendthere is no way back, there is no return, it cannot be done otherwise
afturvendandi	1recurrent (t.d.vanity is a recurrent theme in her poems)2continual (t.d.violence is a continual problem in their neighbourhood)3recurring (t.d.his recurring fits of anger scare her immensely)
afturvending	return; carriage return
afturvendur	1returned, turned back, gone back2push back3refute, put right,tú kanst svara, men tú verður afturvenduryou may answer but it will be refuted
afturvið1	1with (sum viðskerao.tíl.) fáa sær breyð og kjøt afturviðhave meat with the bread2(aftur við borði á báti) past
afturvið2	1with (sum viðskerao.tíl.) fáa sær breyð og kjøt afturviðhave meat with the bread2(aftur við borði á báti) past
afturvirkandi	1. retroactive;(løgfr. eis.)retrospective;hava afturvirkandi krafthave retroactive effect, be retroactive, be retrospective; be backdated;lóg við afturvirkandi kraftex post facto law;við afturvirkandi kraft frá 1. maiwith retrospective application as from May 1; backdated from May 1;afturvirkandi dagfesting (trygg.)retroactive date;sínámillum afturvirkandireciprocal
afturvitjan	revisit
afturvitjing	síafturvitjan
afturvísa	1send (sby) back to his parish2(vísa aftur til undirrætt) remit for re-trial
afturvísing	1(løgfr.)sending (sby) back to his parish2remission of a case for re-trial
afturvongur	(dýr.)hind wing (á skordýri)
afturyvir	over, above (holel.op)
afturøvut	walk backwards
afturøvutur	backwards,detta afturøvuturfall backwards
aga	1discipline2keep discipline, keep order(t.d.in a class)3aga undir (e-n)prey on(t.d.the secret preyed on his mind, there is sth preying on his mind); gnaw(t.d.a gnawing anxiety); hag-ride; nag (at)(t.d.the suspense nagged at me); rankle (in);(t.d.the insult rankled in his mind)
aga-	disciplinary(t.d. problem; for disciplinary reasons)
agabrot	breach of discipline, disciplinary offence
agafastur	disciplined; disciplinary
agaleysur	undisciplined
agamál	disciplinary case
agaráð	[means of maintaining discipline, disciplinary measure]
agarevsing	disciplinary punishment
agat	(jarðfr.)agate;islendskt agatobsidian
agera	act, play, pose as; play-act, pose;hann agerar altíðhe is always playacting(el.posingel.acting a part)
agg	ill-will, ill-feeling, rancour, resentment, grudge,hava agg til (e-n)bear(el.have) a grudge against sby;eg beri ikki agg (eis.)I have no hard feelings; I bear (himo.s.fr.)no ill feeling(el.will);fáa agg til e-nconceive a grudge against sby;tað er gamalt agg teirra millumthere is bad blood between them;eg havi sovorðið agg av honumhe keeps nagging me
agga	1agga á (e-n)bear a grudge against sby; annoy, vex, torment2chaff, tease, banter, irritate,tað aggaði hannit annoyed him
agglomerat	sísamskipan
agglutinera	síklunkast saman
aggregat	set(t.d.a pumping set), unit
aggressión	síágongd;vreiði
aggressivur	síágangandi
agi	discipline(t.d.maintain strict discipline),brot á agabreach of discipline;hava undir agakeep(el.maintain) discipline, keep order(t.d.in a class);strangur agistrict discipline;hava strangan aga (eis.)be a stickler for discipline;agin er vánaligurdiscipline is bad
agitera	sítala fyri
agn	1bait(t.d.artifical bait; live bait)2(fl.m.)decoy; lure;hann verður ikki fiskaður við ongum agnihe is not easily lured
agnarorð	(stingandi og speirekandi orð) sneers, gibes, taunts
agnatiskur	síí kalllegg
agngágga	(dýr.)whelk(Buccinum undatum)© Wikimedia Commons
agnhald	barb
agnloysi	lack of bait
agnneyð	síagnloysi
agnostikari1	agnostic
agnostikari2	síósannkenningur
agntrot	síagnloysi
agnvandin	(um fisk) fastidious
agnvandur	síagnvandin
agorafobi1	sívíddarræðsla
agronomur1	síbúnaðarfrøðingur
agronomur2	síbúnaðarfrøðingur
agurka	(plfr.)cucumber; (lítil) gherkin
agurkusalat	cucumber salad
Ahasverus	Ahasuerus
ahorn	(plfr.)(great) maple, sycamore(Acer pseudoplatanus); eis.lynur© Wikimedia Commons
ahornsiroppur	maple syrup
ahornsukur	maple sugar
ai	(til at vísa pínslu) oh!, ouch!
AIDS	síeyðkvæmi
aidssjúklingur	síeyðkvæmissjúklingur
AIDS-smittaður	AIDS-infected
A-inntøka	[income taxed at source]
ajour	sídagførdur
aka	1(stb.) -aði s60/30,(gl., kvæð.)ride (in a carriage), drive2toboggan, sledge;(serl. am.)sled;aka (á) skíð(i)ski, go on skis;fara út at akasledge, go sledging3slip, skid, slide;aka undanrecede4push, shove,aka segpush oneself (forward)5loll(el.lounge) (about); (meiraniðr.)slouch(t.d.in front of the television)6(fl.m.) aka á knøunumbe on one's knees
akademi	(fróðsk.)academy (of)
akademikari	1(university) graduate;(gl.)university man2(universitetslærari) academic; (í Ongl. ­serl.í Oxford og Cambridge ­eis.)don
akademiseraS	make academic, academicize
akademiskur	1academic(t.d.freedom, standards)2(ástøðiligur) academic(t.d.discussion; it is of only academic interest);akademiskur borgarimember of a university;akademisk útbúgvinga university education;akademisku yrkini (uml.)the professions;akademiskt stiguniversity degree;akademiskt korter[the custom of beginning lectures a quarter of an hour after the advertised time]
akarn	(plfr.)acorn
akbreyt	roadway(t.d. don'twalk on the roadway); (í vegi við nógvum breytum) (traffic) lane
akdeild	(herm.)motorized battalion
akfar	vehicle
akferð	drive(t.d.we went for a two hours' drive), ride;(tlm.)spin
akfjøl	(sj.)ski
akflokkur	(herm.)motorized regiment
akfylki	(herm.)motorized division
akivera	síseta í gongd
akker	1(sigl.)anchor,lata akkerið fallalet go(el.drop) the anchor;akkerið sum heldurthe riding anchor;kasta ankkeriðdrop the anchor, anchor;liggja fyri akkeribe(el.ride) at anchor;liggja fyri einum akkeribe single-anchored;loysa surringina á akkerinumunlash the anchor;akkerið er lættthe anchor is aweigh;lætta akkerweigh anchor;lætta akker frá botnitrip the anchor;reka fyri akkeridrag the anchors;surra akkerstow an anchor;akkerið stendur beint upp og niðurthe anchor is apeak;akkerið tekurthe anchor holds(el.bites);venda við akkerinumclubhaul2(ravm.)armature; (í uri) anchor3(í múri) anchor
akkeri	síakker
akkersarmur	anchor arm
akkersbann	anchor restrictions
akkersbotnur	anchorage, anchor-hold
akkersboya	anchor buoy
akkersbundin	anchored
akkersflíggj	fluke (of an anchor)
akkersgrunnur	síakkersbotnur
akkersgryvja	anchor hole
akkershálsur	trend, throat (of an anchor)
akkersketa	cable
akkersklúss	hawse pipe
akkersleggur	anchor shank
akkersleið	anchorage
akkersljós	(skip.)anchor(el.riding) light
akkersmaður	anchorman
akkerspallur	moored rig
akkerspeiling	anchor bearing
akkerspláss	anchorage, berth, anchoring place;ringt akkersplássfoul berth;skifta akkersplássshift one's berth, change anchorage
akkersskógvur	anchor shoe
akkersspæl	(skip.)windlass
akkersstokkur	anchor stock
akkerssurring	anchor lashing
akkerstog	(gl.)cable
akkersvakt	(skip.)anchor watch
akkersveirur	anchor wires
akklimatisera1	síílenda
akklimatisera2	síílenda
akkord	1(um arbeiði) (piece-work) contract; piece-rate,arbeiða upp á akkorddo piecework;gjald eftir akkordpayment by the piece2(handil., løgfr.)composition, arrangement, deed of arrangement; (í sambandi við húsagang) deed of arrangement in bankruptcy, composition scheme in bankruptcy; (tvingsilsakkord) composition scheme enforced by a majority of the creditors; (uttan fyri húsagang, kann verða endurgivið) deed of arrangement; composition3(sátt) compromise,gera eina akkord um eittmake an agreement about sth4(tónl.)chord(t.d.strike a chord), harmony
akkordarbeiðari	piece worker
akkordarbeiði	piece-work; piece-work rate
akkordáseting	fixing of piece-work rates
akkordforskot	advance piece-rate payment
akkordgjald	piece rate
akkordløn	piece-rate pay, piecework wages
akkordløntur	paid at piece rates; on piece rates; paid by the job;akkordlønt arbeiði(ES) work at piece rates
akkordprísur	contract price, price contracted for
akkordroknskapur	piecework account
akkordskipan	(avtala við kreditorar) composition, arrangement settlement
akkorduppskot	proposal for a composition; composition proposal; (scheme of) arrangement proposal
akkreditera	síveita fulltrú
akkreditiv	sífulltrúarváttan
akkuleya	(plfr.)ragged robin(Lychnis)slag: Lychnis floscuculi © Wikimedia Commons
akkumulatorløgur	electrolyte
akkumulatorrikin	battery driven
akkumulatorrúm	(sigl.)accumulator room, battery compartment
akkumulatorsýra	battery acid
akkumulatortangi	storage tank
akkumulatorur	(alisfr.)(storage) battery, accumulator;løða akkumulatorinhave the battery charged
akkumulera	accumulate;(teld eis.)register;síhópa saman
akkunettur	síakkurátur
akkurát	1exactly(t.d.exactly the same), precisely, just, just so2only just, just, barely;eg náddi akkurát tokiðI (only) just caught the train;hetta er akkurát tað avbrigdi av bláum sum eg vil havathis is just the shade(el.the very shade) of blue I want;akkurát eins góðurjust as good, every bit as good
akkurátur	(um fólk) punctual, accurate, exact, painstaking, scrupulous; particular; (um lut) accurate(t.d.compass)
akkusativ	síhvønnfall
akkvisitørur	síviðskiftaútvegari
akna	(óregl.)->aftna
akrobatikkur	síloftfimleikur
akrobatur	síloftfimleikari
akronym	sístavorð
akrýl	acrylic(s)
aks	(plfr.)spike; (smáaks) spikelet; (kornaks) ear (of corn),(am.)head;standa í aksibe in the ear
aksaknokkur	dwarf corn
aksaskjótast	(um akur) grow ears
aksast	(um akur) grow ears
aksatungur	(um akur) with full ears
aksentur	síherðing
aksil	(á hjóli) axle; (úr viði) axle tree; (drívási) shaft; (klænur,t.d.á súkkluhjóli) spindle;(sigl.:skrúvuaksil) propeller shaft;fastur aksilrigid axle
aksilarmur	axle arm
aksilberi	shaft bracket
aksilbrot	axle (, shaft) fracture
aksilbúsningur	axle bushing;(am.)axle box
aksilbyrði	axle load
aksilhall	caster
aksilkíli	axle-shaft key
aksilkopling	shaft coupling
aksillega	shaft bearing; (til hjólaksil) axle bearing
aksilrør	(sigl.: til skrúvuaksil)stern tube
aksilstál	shafting steel
aksiltrýst	axle load, shaft pressure
aksiom1	símeginregla
aksiom2	sígrundregla
aksiomatiskur	sísjálvsagdur
akskari	(herm.)motorized company
aksla	1(kvæð.)shoulder, take on one's shoulder2aksla seg framshoulder one's way forward
akslabreiður	broad-shouldered
akslahallur	síslútakslaður
akslahædd	1height of the shoulders; shoulder level;rimaverk í akslahædda shoulder-high rail2(prent.)height of shank
akslar	síøksl
akslarblað	(plfr.)stipule
akslargrein	(kvæð., kenn.)arm
akslarliður	(lívfr.)shoulder joint
akslarseymur	(handarb.)shoulder seam
akslarslíðri	(plfr.)ochrea(ochrea)
akslasmalur	narrow-shouldered
akslasneiddur	with sloping shoulders
akslatræ	(coat-) hanger
akslatøk	(í glíming) shoulder hold
akslaypp	shrug (of the shoulders)
akslir	síøksl
akslíkur	(plfr.)like a spike
aksmynta	(plfr.)spearmint(Mentha spicata)©iStock
Akstovan	(sernavn)Faroese Vehicle Administration
akstólur	1carriage seat2wheel chair, bath chair
akstur	driving; (farmakoyring) haulage(t.d.the cost of haulage makes coal very expensive); transport; (við arbeiðsvogni) cartage; (ferðsla) traffic, vehicular(el.wheeled) traffic
aksveinur	(gl.)coachman; driver
aksøgn	(plfr.)glume
akt	1alertness, watchfulness,taka dagin el. morgunin í aktbe on the alert from early morning2attention, heed,geva e-m aktpay attention to someone3(sj.)intention, plan,tað er aktinthat is the intention
akta	1obey2pay attention to, notice, take notice of, pay heed to3(gl.)educate, bring up, take care of,tú aktar væl synir tínaryou take good care of your sons4(um seyð) watch, take care of, chase sheep from the infield
aktión	síatgerð
aktivitetur	sívirksemi
aktivur	sívirkin
aktól	(sj.)akfar
aktualitetur	sítíðarbæri
aktuellur	topical, of current interest, of immediate importance, existing, very popular (sum kjakast verður um í løtuni) current (t.d.a discussion of current problems); ongoing (t.d.the ongoing discussion of incomes)
aktýggi(r)	harness
akul	(kirkj.)chasuble
akupunkturlækni	acupuncturist
akupunkturur	acupuncture
akupunkturviðgerð	treatment by acupuncture, acupuncture treatment
akupunktørur	acupuncture practitioner, acupuncturist
akur	field, cornfield,skera akurreap the corn;(fl.m.) skera góðan akur av e-mbenefit (, profit) by someone;skera akur av øðrumexploit other people;(fl.m.) sum kúgv í akrido justice to the food, eat it with relish
akurbládepla	(plfr.)Wall Speedwell(Veronica arvensis)©Anne Reeves
akurfólk	harvesters
akurhøna	(fugl.)partridge(Perdix perdix)(Linnaeus, 1758)©iStock
akurkampasoppur	(plfr.)charlock(Agaricus arvensis)
akurknívur	sickle
akurlendi	farm land;(forml.)arable land
akursinnopur	(plfr.)charlock(Sinapis arvensis)
akurskrift	(fugl.)síakurskritt
akurskritt	(fugl.)corn crake(Crex crex)(Linnaeus, 1758),ríkja sum akurskrittchatty, gabby, garrulous©iStock
akurskurðarfólk	harvester, reaper
akurskurðarmaður	harvester, reaper
akurskurður	1harvest2harvest time
akursvínamjólk	(plfr.)corn sowthistle(Sonchus arvensis)©iStock
akurtistil	(plfr.)creeping thistle(Cirsium arvense)©Cathy McCray
akurull	(plfr., kvæð.)field wool
akustikkur	acoustics(t.d.the acoustics of the theatre are not good; acoustics is the science of sound); síljómburðurel.ljóðviðurskifti
akustiskur	1acoustic;akustiskur gittariacoustic guitar;akustiskur tónleikuracoustic music2hj-ally
akuttur	síbráður,bráðfeingis
akvakulturur	sígróðraraling
akvamarin	aquamarine
akvarell1	sívatnlitamynd,vatnlitur
akvarium	sífiskabúr
akvegur	carriage road
al	1quite, entirely, wholly, totally, completely2rather, fairly, somewhat, highly
al-	pan-;alafrikanskurpan-African
ala	1(um fuglar og djór) breed(t.d.breed horses, dogs); (um laks) breed; bring forth, tame(t.d.wild animals); (gera til húsdýr) domesticate, rear(t.d.rear a wild bird indoors)2educate, raise,(t.d.raise children), bring up(t.d.badly brought up; brought up to believe that), rear(t.d.she has brought up(el.rearedel.raised) six children), breed(t.d.he is a Faroese born and bred)3produce, generate;(fl.m.)beget, breed(t.d.familiarity breeds contempt),trýst elur móttrýstaction begets reaction; engender(t.d.his policy engendered a good deal of unrest);(fl.m.)you reap what you sow4(kvæð.)beget(bíbl.:Abraham begat Isaac), procreate, engender; bear(t.d.a child)5[ísamb. viðfs/hj]ala at:ala at særattract, draw,hon aldi fólk at handlinumshe attracted people to the shop;ala av:ala av særprocreate, engender;ala framgrow, raise;ala undan:ala undan særbreed;ala uppraise, bring up, rear;ala upp áel.í segel.upp at særattract,hon aldi menn upp á segshe was attractive to men
alabastur	(jarðfr.) alabaster
alamerikanskur	Pan-American
alari	fish farmer, aquafarmer, pisciculturist; (á sjónum) sea farmer, mariculturist
alarmera	síávara
alarmur	síávaring
alaskalupin	(plfr.)Lupin(Lupinus nootkatensis)
alátin	omnivorous
albani	Albanian
Albania	Albania
albann	total ban(fyrion), total prohibition
albanskur	Albanian
albatrossur	(fugl.)albatross©Wikimedia Commons
albeittur	grass-grown, grassy
albilsin	astonished(umat)
albirgur	healthy, strong
alblóðigur	bloody
albogahædd	í albogahædd elbow-high, level with the elbow
albogaleggur	(lívfr.)ulna, elbow bone
albogaliður	(lívfr.)elbow joint
albogarúm	elbowroom(t.d.give me elbowroom; have sufficient elbowroom)
albogaslag	síalbogastoytur
albogastoytur	(meint) blow on the funny bone
albogaviðbragd	triceps reflex, elbow jerk
albogavøddi	elbow muscle
albogi	elbow;brúka albogarnar (eis. fl.m.)use one's elbows;hann dugir at brúka albogarnarhe knows how to use his elbows;tað snýr seg um at brúka albogarnaryou have got to use your elbows;skumpa undir hann við alboganumnudge him; (harðliga) hit him with (a blow of) one's elbow;skorða seg fram við albogunumelbow one's way (forward)(t.d.through a crowd);hava spískar albogar (fl.m.)be pushy(el.a pusher), have sharp elbows;seta albogarnar niður á borðiðlean one's elbows on the table
albógvi	(Suð.)síalbogi
albrynjaður	1in full armour2thickly clothed
albundin	(plfr., dý.) obligate,albundin sníkurobligate parasite
albúgvin	1fully prepared, fully equipped, fully fitted out2svullurin er albúgvinthe boil is ready for lancing
albygdur	built-up
albøta	optimize
alda1	wave;(sjóm.)sea;tung(el.síð) aldaa heavy sea;tað er alda í sjónumthere is a heavy sea (running), the sea runs high, the sea is rough
alda2	1wave, swell,nú fer at aldaa swell is forming2(um bringu) heave3aldandi hárflowing locks, waving hair(t.d.her hair waves naturally);aldandi akrarwaving corn;alda aftur og framfluctuate
Aldafaðir	(skaldsk.)God
aldagamal	centuries old
aldalangur	centuries long,aldalangar royndircenturies long experience
aldamót	turn of a century,um aldamótiðat the turn of the century
aldan1	waving, undulation; (um bringu) heaving;aldan aftur og framfluctuation(t.d.the fluctuations of the battle).
aldan2	(kvæð.)tree fruit, mast
aldandi	wavy(t.d.hair), waving(t.d.corn); undulating(t.d.landscape); (veikari) billowing; (um lendi eis) rolling ((t.d.country); (um bringu) heaving; (um mannfjøld) surging(t.d.crowds)
aldansfiskur	(kvæð.)sea monster
aldanskógur	(kvæð.)mast forest
aldanskur	Danish through and through
aldansvín	(kvæð.)mast pig
aldar	síøld
aldargamal	one century old
aldaskifti	síaldamót
aldavinur	loyal friend
aldeilis	quite, entirely, wholly, totally, completely
aldin	(kvæð.)síaldan
aldingarður	(bíbl.)garden
aldinløgur	1juice(t.d.grape juice, apple juice)2(drúvusevja til víngerð) must
aldinskógur	mast forest
aldintræ	fruit tree
aldinviður	síaldintræ
-aldra	síjavn-
aldraður	elderly, old
aldrandi	elderly
aldri	never (ever)
-aldri	síjavn-
aldrin	never,so aldrinnever ever
aldring	aging
aldubára	ripple
aldubrot	breaking wave, breaker
aldudalur	trough of a wave;(fl.m.) vera í einum aldudalibe in a trough; be in the trough of a wave
aldudráttur	backsweep, drag of waves, undulation
alduegg	(á knívi) scalloped edge, wavy edge
aldufroða	foam-crested waves, white horses, whitecaps
aldugerð	(sj.)wave formation
aldukambur	wave crest
aldulongd	wavelength
aldumátari	(alisfr.)wave-meter; (at máta havaldu) wave recorder
aldumikil	(um sjógv) turbulent
aldur1	1age, life, lifetime;ein deiligur aldura lovely age;tað er eingin aldurthat's no age to talk about;hættisligi aldurinthe dangerous age;hann slítur ikki hálvan aldurhe wears himself down;allan hennara aldurall her life;náa høgan aldurlive to(el.attain) a great age, live to be very old, live to a ripe old age;aldurin tyngir hann ikkiage does not affect him;bera sín aldur vælbe well preserved, carry one's years well, not look one's age;hann ber sín aldur væl (eis.)his years sit lightly upon him2old age,aldur sæst á honum el. aldur er dottin á hannhe has begun to look old;hann er komin til aldurshe has come of years3period of life,aldur og alla ævieverlasting, perpetual4[ísamb. viðfs]á :á seks ára aldriat the age of six;hann er á aldur við meghe is my age;dreingir á hansara aldriboys of his age;á gamalsaldriat a great age;á høgum aldriat a great age; late in life;á ógvuliga høgum aldriin extreme old age;á mínum aldriat my age (um gomul fólkeis.)at my time of life;á ungum aldriearly in life, at an early age;eftir :hann er lítil (, stórur) eftir aldrinumhe is small (, tall) for his age;fyri :fyri alduron account of age, owing to age;fyri sín aldurprecocious;í:í besta aldriin the prime of life;um :teir eru um ein aldurthey are the same age;farin um tann aldurpast the age(t.d.she cannot bear children because she is past the age); over-age(t.d.he cannot get into the army because he is over-age);um miðjan aldurmiddle aged;hann er um sama aldur sum honhe is the same age as she is; (eftir navnorð) of the same age(t.d.children of the same age); (sum umsagnarliður) the same age(t.d.they are the same age;við :við aldrinumwith (the advance of old) age;tað fer við aldrinumyou grow out of it;tað kemur við aldrinumit comes as you grow older;(forml.)it comes with increasing years(el.age);nakað við aldurnot so young
aldur2	síala
aldurdómsbrek	senile decay
aldurdómstekin	hetta er aldurdómstekin this is a sign of senescencehetta er aldurdómstekinthis is a sign of senescence
aldurdómur	(old) age;(lækn.)(byrjandi) senescence;(ógvuliga) høgur aldurdómurextreme old age; Anno Domini(t.d.his chief complaint is simply Anno Domini)
aldursbólkur	age group
aldursbrek	síaldurdómsbrek
aldursbýti	age distribution
aldursformaður	president by seniority
aldursmark	age limit;falla fyri aldursmarkinumretire on reaching the age limit
aldursmerktur	enfeebled with age
aldursmeting	(fornfr., jarðfr.) dating;(t.d.av djórum) age determination; (í samb. við embætio.s.fr.)age clause;avgjørd aldursmetingabsolute dating
aldursmunur	difference in age
aldursskifti	age distribution
aldursstyrkur	(gl.)old age pension
aldurstíð	frá aldurstíð from time immemorial
alduryggur	(wave) crest
aldurøð	síalduryggur
aldurøring	(t.d. í vælindinum)undulating movements
aldusig	swell (of the sea)
alduskot	beating of waves
alduskvatl	lap (of the waves), ripple (of the waves)
aldutoppur	síalduryggur
aldutrøstur	(fugl.)scaly thrush(Zoothera dauma)(Latham, 1790)©Jason Thompson
aldutur	(um sjógv) turbulent
aldututl	lapping of waves
aleina	(sj.)only, merely, solely, alone
aleinaður	(sj.)alone, by oneself
Aleutoyggjar	(sern.)the Aleutian Islands, the Aleutians
Alfabet	sístavrað
alfabetiskur	sístavraðaður
alfaðir	1(átr.)Our Father, God; (the) Father of the Universe2(gl.)Woden, Wodan, Odin
alfaðirligur	paternal(istic);(ofta =)avuncular
alfagur	(skaldsk.)very beautiful
alfaravegur	public highway
alfarin	(sj.)alfarin vegur síalfaravegur
alfegin	delighted
alfevndur	universal
alfonsur	sípútudevil
alfólkaligur	popular
alfriða	unconditionally preserved
alfriðing	unconditional preservation
alfrøði	encyclop(a)edia
alfrøðibók	síalfrøði
alfrøðiligur	encyclopedic
alfulnaður	(trygg.) (to be) paid in full
alfundur	(á ráðstevnu) plenary meeting, plenary assembly; (í ST) General Assembly
alfúsur	enthusiastic
alføroyskur	Faroese through and through
alga	(plfr.)alga(fltalgae); (tari, slýggj) seaweed (Alga)
algebra	síbókstavarokning
algeri	Algerian
Algeria	(sern.)Algeria
algermanskur	Pan-German
algerskur	Algerian
algilda	generalize
algildi	generalization
algildistekn	(teld.)wild card
algildur	general; overall;(t.d.an overall wage increase); blanket(t.d.acceptance, restrictions)
Algir	(sernavn.)Algiers
algjørdur	total
algloypandi	omnivorous
algongdur	(vanligur) common, ordinary, much used, widely used,orðið er algongt í føroyskumthe word is widely used in Faroese; (sum fevnir um meirlutan ella øll) general(t.d.it is a general principle);algongdar treytirgeneral terms
algoritma	algorithm
algoystur	1in haste2very eager, very keen,hann var algoystur at sleppa av staðhe was very eager to go3breathless, out of breath, panting
algóður	fine, excellent, splendid;(gl.)capital(t.d.a capital fellow)
alhalgan	í osb: um alhalguna at Hallowmas
alhalgunadagur	(1. nov.) All Saints' Day
alhanda	allspice
alheims-	world-, worldwide, global, universal, international
alheimsfarsótt	pandemic, pandemy, pandemia
alheimsfarsóttar-	pandemic
alheimsgerð	globalization; eis.alheimsgering
alheimsgering	globalization; eis.alheimsgerð
alheimsheilsustovnur	World Health Organization (WHO)
alheimsligur	universal, international
alheimur	1(stjfr.)universe2all the world
ali	quality, property, characteristic, nature,tað er gott ali í honumhe has a kind nature
alias	síeisini nevndur
alibi1	sífráveruprógv
alibi2	sífráveruprógv
alibrúk	(á sjónum) (virksemið) sea farming, mariculture, marine aquaculture; (stakt virki) sea(el.marine) farm; fish farm
alidjór	domestic animal
alidýr	síalidjór
A-lið	A-team; A-liðið(fl.m.)the winnersflt
alifiskur	farmed fish(t.d.farmed salmon)
alifóður	fish feed
alifuglur	domestic bird(s) (høsn, dunnuro.tíl.)
aliker	aquarium(fltaquaria, aquariums); (ílat eisini) (fish) tank
alilaksur	farmed salmon
alimatur	(sj.)bait
alin1	(mát)two feet (24 tummart.e.62, 77 cm);(orðt.) alinin er av og sponnin er eftirthat has almost done the trick!; we have almost got it made;leggja eina alin til sín vøksturadd one cubit to one's stature;máta onnur eftir egnari alinmeasure others by one's own standard(el.yardstick);teir eru tvær alin av sama stykki (fl.m.)they are of a piece, there is nothing(el.not much) to choose between them; they are two of a kind; (eins ringir,eis.)they are tarred with the same brush, one is as bad as the other
alin2	síala
aling	1breeding, rearing2(fisk.)fish-farming, aquafarming; aquaculture; mariculture, fish culture, pond culture, pisciculture
-alingur	sítrí-
alinlangur	(mát)two feet;(fl.m.)interminable
alintráður	síalnartráður
alipisa	1tame sea bird2(stb.)spoilt child
aliringur	aquaculture cage, aquafarming cage, fish farming cage, fish farming pen
alisfrøði	physics
alisfrøðiligur	physical
alisfrøðingur	(alisfr.)physicist
alisligur	(lækn.)physical;hj­liga
alistøð	1breeding centre2(til ross) stud, stud farm3(fisk.)fish farm; (til sílaaling) trout pond farm
alisviðgerð	(lækn.)physiotherapy
alisviðgeri	(lækn.)physiotherapist
alivinna	sea farming industry
alivøkstur	cultivated plant(s)
alkavað	totally snow-covered
alkendur	well-known(t.d.actor, politician, writer; phenomenon); (og virdur,(forml.) noted(t.d.pianist, writer)
alklæddur	fully dressed, fully clothed
alkohol	(evnafr.)alcohol; (drykkjuvøra) alcohol; spiritsflt (tlm.)liquor
alkoholfríur	non-alcoholic;alkoholfríur drykkurnon-alcholic beverage, soft drink;alkoholfrí matstovatemperance restaurant
alkoholhavin	alcoholic
alkoholikari	alcoholic, habitual drunkard; (sum fær tørn) dipsomaniac
alkoholinnihald	alcoholic strength(el.content)
alkoholisera	alcoholize
alkoholisma	alcoholism(t.d.acute alcoholism; chronic alcoholism)
alkoholráðgevi	alcohol consultant
alkoholtrupulleiki	drink problem;hava alkoholtrupulleikarhave a drink problem
alkomin	complete (in number)
alkrem	universal cream
alkunnugur	familiar with, acquainted with
alkunnur	(sj.)síalkunnugur
alkønur	fully qualified, skilled, (um sjómann) able, efficient deck hand
alla	í osb: við/med alla for good, for ever, in perpetuity;tey fóru avstað við/med allathey went for good
allahalgan	síalhalgan
allahalgannadagur	síalhalgunadagur
allahanda	síalhanda
allahandakvinna	handywoman
allahandamaður	Jack of all trade, odd job man; roustabout
allar-	very biggest
allareiða	1already(t.d.he had already gone when I came back; he is back already; are you leaving already?)2as early as(t.d.as early as 5 o'clock)3even(t.d.even the ancient Romans knew it; even as a boy he could ride a horse)4as long ago as, as far back as(t.d.1850)5by now(t.d.he ought to have been here by now)
alleingi	very long
allergi	síovurviðkvæmi
allíki	1congruity2(støddfr.)congruence; [kongruensur]3(máll.)concord(viðwith)
allíkur	1identical(t.d.two identical houses; the houses are identical); (sum umsagnarliðureis.)the same(t.d.no two children are the same); exactly alike2(støddfr.)congruent;(máll.)agreeing, in agreement, concordant(viðwith); [kongruentur]
allítil	wee, tiny little
alljósur	á alljósum degi in broad daylight
alloðin	1hairy, shaggy2overgrown
allogandi	ablaze
alloysing	sovereignty
allur	1the whole, the entire(t.d.family, town, world, book; the whole truth; the whole amount)2the full(t.d.the full width of the ship; a cheque for the full amount) (samantalt eisini) the total(t.d.the total amount (, debt))3(framman fyri sernavn) the whole of(t.d.Faroes)(serl.tá ið hugsað verður um stakar limir, íbúgvar partar) all the(t.d.family, town, world); (framman fyri sernøvn) all(t.d.Denmark)4(um tíðarbil) all (the), the whole, throughout the(t.d.day, night, summer, week); all, whole,(t.d.it will be a whole week (, year) before we are ready); full(t.d.for a full week we had no electricity);allan daginthe whole day;(í) allan dagall day (long);(formligari)entire(t.d.we lost an entire week)5(um stað) throughout the(t.d.house, town, country, world); all over the(t.d.country, world)6every; undivided; wholehearted, unreserved; with no;alt sum tað erall of it; complete(t.d.a complete set of Dickens' works);hann er vátur, allur sum hann erhe is wet through;alt gjørdi túit was all your fault;alt eftir einari ferðall at once;nú er søgan øllnow the story is over;hatta er móti øllumthat is the very best thing;fyri alt taðfor all that
allýsa	define
allýsing	definition(avof);eftir allýsingby definition(t.d.by definition this phenomenon belongs under psychology)
almakt	av almakt with all one's might
almangur	almangir quite a few
almanna	1common(t.d.for the common good); public(t.d.for the public benefit)2(sum geldur tey flestuel.øll) general(t.d.of general interest)3(sum geldur øll) universal4official
almannaforrit	public domain program
almannafæ	public funds, official funds, public money
almannagagn	public benefit
almannagøta	public road, public street
almannaheilsa	public health;Deildin fyri arbeiðs- og almanna heilsuthe Department for Work and Public Health
almannahjálp	Social Security benefitsflt; social benefit(s), public assistance, supplementary benefit;(uml. =)Government supplementary allowance;(am.)relief welfare (benefits);(tlm.)the dole;fáa almannahjálpbe on supplementary benefit;(tlm.)be on the dole;(eis.)be on state benefits
almannahugsan	public opinion
almannakendur	commonly known, generally known
almannakunngera	publish(t.d.an announcement in the press)(GG: tlm.)let's break the story); release(t.d.the result of a conference; a barrage of statistics was released recently by Japan's foreign ministry); (um upplýsingar sum hava verið loyniligar) disclose(t.d.the name of the buyer);úrslitið er ikki almannakunngjørt ennthe result is not out yet(el.not yet available)
almannakunngering	publication, announcement
almannakunnigur	of common knowledge
almannakunnugur	síalmannakunnigur
almannakunnur	síalmannakunnigur
almannaleið	public highway;langt av almannaleiðfar off(el.far from) the beaten track;uttan fyri almannaleiðoff the beaten track
almannalykil	public key
almannamál	(stjm.)social affairs;landsstýrismaður í almannamálumMinister of Health and Social Affairs
almannamálaráð	(ráðharrastova) Ministry of Social Affairs
almannamálaráðharri	Social Minister, Minister of Social Affairs
almannamálum	the Minister for Health and Social Affairs
Almanna- og heilsumálaráðið	(sern.)Ministry of Health and Social Affairs
almannaogn	1public domain (t.d.the photograph had been in the public domain for 15 years);public property2public funds, public money
almannapláss	(t.d.á ferðaskipiel.í flogfari) tourist class
almannapolitikkur	social politicsflt,social policy
almannaráðgevi	social worker; (fyri almannastovuna svarar til) welfare officer; (á sjúkrahúsi) hospital almoner, medical social worker(el.adviser), councellor;(ofta =)counseller(t.d.family counseller)
almannaráðgeving	social counselling
almannastova	Social Security(el.Welfare) Office;AlmannastovanDepartment of Social Services
almannatal	common talk
almannatos	síalmannatal
almannaumsiting	social services department
almannavegur	public road
almannaveiting	social security benefit(s), public assistance;misnýtsla av almannaveiting(uml.) fraud upon public assistance
almannaverk	social agenciesflt
almáttugur	omnipotent, all-powerful; almighty;almáttugi Gudthe Almighty
almáttur	omnipotence
almenniligur	1síalmennur 22common, ordinary, general(t.d.general qualifications(el.requirements); general practitioner(stG P); general psychology), usual, universal; overall;hj-liga
almenningur	1(jarðarstykki sum øll eiga) common2the (general) public;almenningurin er fyri uppskotinumpublic opinion favours this proposal;koma fram fyri almenningincome(el.appear) before the public;til nýtslu hjá almenninginumfor public use, for the use of the public;myndin ið almenningurin hevur av honumhis public image
almennisgrundreglan	[(principle of) free access to public records]
almennisskúli	(sj.,skúl.)Board School
almennur	1public; official2public sector;almennar rakstrarútreiðslurpublic sector expenses,almennar íløgurpublic sector investments3[ísamb. viðn]almennarbeiðipublic works;ráðharrri fyri almenn arbeiðiMinister of Public Works; (ráðharrastovan) Ministry of Public Works;við almennariatkvøðu(ES) by open vote;almennirágóðarpublic goods;mál sum hevur almennanáhugamatter of public interest, public matter;almennákærapublic prosecution; (í kongsríki) prosecution on behalf of the crown;almennurákæripublic prosecutor;(am.)district attorney(stD.A.);almennurbústjóriofficial receiver;almennurbygningurpublic building;almennferðslapublic transport;almennurfíggindinr. 1public enemy number one;almennforsorg(sum hugtak) public (, national) assistance; social welfare; (ítøkiligt) public aid;á almennumfundi(ES) in open session;almennur fundurpublic meeting; (ESeis.)open sitting; (um dómstóleis.)public hearing;almennurfyrilesturpublic lecture;undir almennari fyrisitingunder public management;almennirgrunnarpublic funds;almennheilsapublic health;almennaheilsuverkiðpublic health service;almennhoyringpublic consultation;almenthúshouse of ill fame, brothel, disorderly house;almenninnkalling(proklama) notice, advertisement for creditors (, beneficiaries of an estate); subvention;almennaríløguútreiðslur(ES) government investment expenditure;almentískoytisubvention; (official) subsidy; grant from the public funds;almennkanningpublic(el.official) inquiry;(tlm.)probe;teir almennukassarnirthe public funds;almennkunngerðpublic announcement, notification to the public;tað almennalíviðpublic life(t.d.persons prominent in public life);eitt almentloyndarmálan open secret;almentløgreglumálpolice prosecution;almentmálpublic prosecution;almennirmyndugleikarpublic authorities;almennognpublic domain;almennarognirpublic funds, public money;vera almenn ognbe public property;(fl.m.)be common property;almentpartafelagpublic (limited) company(stplc, PLC);(am.)public corporation(stInc.);almentplásspublic place; place of public resort;almennurraksturpublic management(t.d.the railways are under public management);á almennumrættarfundiin open court;almennurrættargangurpublic administration of justice;í almennarirættarviðgerðin open court;almennurrætturpublic law;almennsamkomapublic assembly;brot á almentsiðalagoffence against public decency;almentskjalasavnrecord office;almennsjúkratryggingNational Health Insurance;almennskrivstovapublic office;almentstarvpublic function;almennurskúli(uml. =)municipal school; (í Ongl.eis.)State school;(am.)public school(GG:public school merkir í Ongl. privatur skúli sum fólk rinda fyri);almennurstuðul(fátækrastuðul) public assistance, relief; (ískoyti) subsidy,almenntannarøktpublic dental services;almennumberingpublic apology;geva almennaumrøðupublicize;almennur almennumsitingpublic administration;almentundirhaldpublic entertainments;almentundirskot(ES) government deficit;á almennumvegiin the public(el.open) street, in public;almennuppboðssøla(sale by) auction;almennarútreiðslurpublic spending; public expenditure; funds;almentvirksemipublic enterprise; (fyritøka) public corporation; (alment verk) public utility4[ísamb. við,,tað almenna"]tað almennathe public authorities; (ríkiðeis.)the Government, the State; the public sector(t.d.workers in the public sector); (um samríkjastjórn í USA: the Federal Authorities, tí State verður brúkt um støk ríki);(t.e.almennur peningur) (the) public funds;áhugi hjá tí almennain the public interest;fyri tað almennaat the public expense; on behalf of the State; (í Ongl.eis.)on behalf of the Crown;útreiðslurnar rindar tað almennathe expense is borne by public funds;starvsfólk hjá tí almennapublic employeeshjá tí almennain the public sector;tørvur hjá tí almennathe public good, the public interest;í tænastu hjá tí almennain the public service;evsta umboð hjá tí almenna(ES) the Attorney-General;til útreiðslur hjá tí almennaat the public expense5[sumhj] publicly, in public, to the public;alment góðkendurauthorized;alment kunnigtpublicly known;(niðr.)notorious;gera almentmake public, publicize, publish;føra seg fram almentperform (, appear) in public;alment atgeingiligtopen to the public
almenskur	common to all mankind(t.d.a problem common to all mankind)
almerkiligur	unique, outstanding
almikil	fairly big,almikiðfairly much, a great amount
almur	(plfr.)elm
almúga	(gl.)the common people, riff raff
almúgufólk	síalmúga
almúgumaður	common man
almúguskúli	(gl., skúl. svarar til)Board School
almviður	elm wood
almyrking	(stjfr.)total eclipse, total darkening
almyrkur1	total darkness
almyrkur2	totally dark
alnarlangur	two feet long
alnet	internet
alneyðugur	absolutely necessary
alnógvur	quite a few
alnót	internet
alnýggjur	brand-new
alnýtari	(teld.)superuser
aloftast	most often;(formligari)most frequently; as a rule, usually, generally; more often than not
aloyða	totally ruin, totally destroy(t.d.a town); devastate(t.d.the earthquake had devastated the town);(herm.)exterminate
alpuhúgva	beret
alpurósa	(plfr.)rhododendronslag: Rhododendron ferrugineum © Wikimedia Commons
alpusveimari	(fugl.)alpine swift(Tachymarptis melba)(Linnaeus, 1758)
alra-	(fyrri liður á lýsingarorðum í hástigi til áherðingar) most
alrasin	furious(umat, about), frantic
alráðandi	absolute; (um áskoðan og trúgv) universal
alreyður	blood-red
alríki	(sø.)alríkið, the United Monarchy
alríkur	wealthy, affluent, prosperous
alrím	(bókm.)(full) rhyme
ALS1	(st.)Arbeiðsloysisskipanin The Faroese Employment Office
als2	wholly, totally, entirely, completely,als einginnone at all;als ikkinot at all
alsamt	1still,hon svevur alsamtshe is still asleep2constantly, frequently, continuously
alsamur	constant, continuous, frequent;(teld.) alsom streymveitingUPS/uninteruptable power supply
alseta	síalfundur
alsjálvvirkin	fully automatic
alska	(gl.)love
alskari	(gl.)lover
alskhugaður	(sum umsagnarlið) in love(íwith,t.d.he is deeply (, hopelessly) in love with her); infatuated; (viðfest) loving(t.d.words, look; his loving wife);alskhugað brá (forml.)amorous glances;tvey ung alskhugaðtwo young lovers; a courting couple
alskhugi	(sj.)infatuation
alskhugsbarn	love child
alskhugsevni	aphrodisiac, love philtre
alskhugsmikil	affectionate (towards); loving(t.d.wife, words)
alskhugstankar	amorous thoughts, dreams of love
alskhugur	love (of, for,t.d.of(el.for) one's country, of literature, of music; his love for her), passion, affection
alskiligur	síelskuligur
alskin	affectionate (towards)
alskkona	mistress
alsklingur	darling
alskmikil	loving
alsktikin	in love; infatuated; lovestruck
alskur	love(tilof, for,t.d.of(el.for) one's country, of literature, of music; his love for her, a mother's love for her children);leggja alsk á e-n el. at e-mfall in love with; (veikari) take a fancy to, grow fond of
alskyns	all sorts of
alslættur	level(t.d.surface, ground, road)
alspentur	1(í miklum spenningi) anxious, keen to(t.d.I was very anxious until I knew the result; he was keen to meet her); (forvitin) curious2(huglag) tense; (andlitsbragd) intent; (viðurskifti) strained relations; (vón, væntan) eager expectation; (meira) intent expectation; (spent varsemi) close attention3(útspílaður, tambaður) tight(t.d.rope); taut(t.d.muscles, wire);(forml.)tense(t.d.muscles; your neck is tense)
alspurin	inquisitive
alstórur	almighty, great
alsveittur	drenched in sweat
alsýndur	distinct
alt1	1hj1í osb: alt at gerabe on the point of -ing; (um vanlukkuo.tíl.)be on the verge of -ing; be within an ace of ­ing, it was a close(el.near) thing(el.a close call); it was a narrow(el.close) shave;tað var alt at gera vit sluppu undanwe escaped by a narrow shave2fyri alt tað for all that3equally much4more or less, continuously; steadily; more and more,hann var alt at versnahe got worse and worse5right up to;alt til bardagin brast áright up to the time war broke out;alt at markinumright up to the border6however much (, longo.tíl.) alt tey leita finna tey einkihowever much they search they find nothing7alt fyri eitt at once, immediately;alt í einumall of a sudden;alt í sennright away8completely, entirely, fully, wholly9still, yet2sb1 although,hann mátti dvína, alt hann var størrihe had to yield although he was bigger 2alt sumas,alt sum drongurin vaksas the boy grew up 3 if, when
alt2	(tónl.)alto, contralto
altal	(stfr.)altøl real numbers
altan	balcony
altanur	síaltan
altar	(kirkj.)altar(fyrito,t.d.an altar to an Unknown God); (kristineis.)communion table, the Lord's table;fara til altarscommunicate, receive Communion, go to Communion;;altarsins sakramentithe Eucharist, Holy Communion, the (Blessed) Sacrament
altarblæa	(kirkj.,gl.)síaltardúkur
altarborð	(kirkj.)communion table
altarbók	(kirkj.)service book, prayer book, (í Ongl.) Book of Common Prayer
altarbreyð	(kirkj.)Host, communion bread, wafers
altardagur	(kirkj.)day for communion
altardiskur	(kirkj.)paten
altardúkur	(kirkj.)altar cloth
altarfótur	(kirkj.)altar rails
altargangsdagur	(kirkj.)síaltardagur
altargangur	(kirkj.)(celebration of Holy) Communion, (receiving) Holy Communion
altargonga	(kirkj.)síaltargangur
altargongd	(kirkj.)síaltargangur
altarklæði	(kirkj.)síaltardúkur
altarljós	(kirkj.)altar candle
altarsdagur	(kirkj.)síaltardagur
altarsfólk	(kirkj.)communicants
altarsfótur	(kirkj.)síaltarfótur
altarsgestur	(kirkj.)communicant
altarskammil	kneeler
altarsklæddur	(kirkj.)in one's best clothes
altarsklæði(r)	(kirkj.)best clothes, Sunday clothes
altarslag	(kirkj.)síaltarsskari
altartalva	(kirkj.)altarpiece; triptych
altarvín	(kirkj.)communion wine
alting	(sø.)Althing
altíð	1always, invariably, on all occasions;altíð og stundperpetually, continually2(eina aðru ferð) always, later on(t.d.we can do that later on)3(ið hvussu er) at least, always(t.d.that is at least(el.always) something);næstan altíðnearly always
altjóða1	international,altjóða farleiðinternational waters;altjóða felagsskapurinternational organization;altjóða hvalaveiðunevndin(the) International Whaling Commission(stIWC);altjóða rætturinternational law;altjóða samstarvinternational cooperation;altjóða sáttmáliinternational treaty (agreement, accord, convention, covenant, charter, pact, protocol);altjóða siglinginternational service;altjóða viðurkenninginternational approval (, authorisation); international recognition
altjóða2	internationalize
altjóðadómstólur	(løgfr.)the International Court of Justice
altjóðaður	síaltjóða
altjóðafelagsskapur	international organization
altjóðagera	globalize
altjóðagerð	internationalization
altjóðaligur	síaltjóða
altjóðan	internationalization
altjóðarættarliga	inel.of international law
altjóðarættur	(løgfr.)international law, the law of nations
altjóðastevna	internationalism
altó	(sj., stb.)although, though
altráin	(sj.)síaltráur
altráur	1(um vind) persistent, prolonged2(spentur, fýrisligur) eager; (sterkari) keen; (sterkari(forml.) zealous
altso	1hj (tlm.)so(t.d.he won't come so he is still offended);tú vilt altso ikki?so you won't?;(forml.)therefore(t.d.I think, therefore I am); consequently; (tað er, tað merkir) that is(t.d.tomorrow, that is in 24 hours);(st t.e.) altso um tú kanstthat is if you can2(við herðing) really(t.d.I really can't do it); (argur) really! (mótmælandi) but it is true!; (undrandi) so it is true?
altumráðandi	crucial, imperative, of vital importance, of the utmost importance
altur	alto, contralto(t.d.sing alto, an alto singer)
altvaldandi	síalvaldandi
altýðandi	(forml.)major(t.d.discovery, factor; he played a major part in the affair); momentous(t.d.decision, event); significant(t.d.gesture)
altøgn	calm, silence
altøkur	universal, total(t.d.solar eclipse; ignorance; the total amount, total war, all-out war); absolute(t.d.absolute zero)
altøl	real numbers
altørvandi	inalienable(t.d.rights)
aluminium	(evnafr.)aluminum
alún	(evnafr.)alum
alúna	aluminate
alv	(kropsstyrki, megi, máttur) strength(t.d.he hadn't the strength to do it)
alva1	síalvi
alva2	(gl.)procreate, beget
alvakin	wide awake
alvaksin	overgrown
alvakur	beautiful, fair
alvald	omnipotence
alvaldandi	(átr.)almighty
alvaldur	all-powerful, omnipotent;(átr.)almighty;(bíbl.) Gud faðir hin alvaldiGod Almighty;hin alvaldithe Almighty, God Almighty
alvandaliga	(sj.)critically
alvarligur	síálvarsamur
alváðatrygging	(trygg.)all risk insurance
alvápnaður	fully armed; armed to the teeth
alvegis	completely, entirely, exeedingly, extremely,alvegis umvarðandiof vital(el.decisiveel.crucial) importance
alverjaður	síalvápnaður
alverkfall	general strike(t.d.declare (, demand) a general strike)
alverktøka	(tøkn.)all-inclusive contract, turnkey contract
alvi1	1(sj.)strength2character, courage
alvi2	(gl.,kvæð.)child, son
alvi3	fireplace, forge
alvinur	bosom friend
alvitandi	omniscient;(spei.) hann er alvitandihe is a know-all
alvitska	omniscience
alvitur	síalvitandi
alvísur	1known to all2omniscient
alvur	(stb.)síalvi3
alvæl	1very well2even
ama	1waste, squander(t.d. one'ssavings); dish out,(forml.)dissipate(t.d.a fortune in gambling); be (too) lavish with2(fl.m.)fleece; (við órímiligum prísum) rip off; extort money from;ama út av e-mfleece sby; bleed sby white;(tlm.)clean sby out bleed
amari	spendthrift, waster, squanderer, prodigal;ein amari og ein letingia wastrel
ambivalensur	sítvílyndi,tvígildi
ambivalentur	sítvílyndis-,tvígildis
amboð	1tool (til for,t.d.a tool for digging); equipment;(serl.køksamboðel.landbúnaðaramboð,(forml.) implement(t.d.farming (, garden, household) implements); (smá, serlig køksamboð) utensil(t.d.cooking utensils, writing utensils); instrument(t.d.instruments of torture; a measuring instrument)2(fl.m.)tool(t.d.textbooks (, computers) are indispensable tools for the teacher); instrument (til for,t.d.use incomes policy as an instrument for reducing inflation)3(um fólk) instrument(t.d.he was an instrument of fate (, an instrument for good));(niðr.) tool(t.d.he was a willing tool in the hands of the tyrant)4(til fimleik) apparatus(t.d.competitors must perform two sets of exercises on each apparatus);eitt amboða piece of (gymnastic) apparatus; an apparatus;amboðapparatuses; apparatus;nógv amboða lot of apparatus
amboðsbjálki	(teld.)toolbar
amboðsfall	(málfr.)the instrumental (case)
amboðskassi	(handv.)tool box, (við innihaldi) tool kit
amboltur	anvil
ambra	ambergris(lívfr.)southernwood
ambulansi	sísjúkrabilur
amburt	síambra
ambæta	1(um kríatúr)feed2(gl.)(um fólk) wait on, attend (on), serve
ambætaraáskrift	server address(t.s.s.ambætarabústaður)
ambætarabústaður	server address(t.s.s.ambætaraáskrift)
ambætarasambinding	connection to server
ambætari	(teld.)server
ambæti	síembæti
amen	amen;tað er sum amen í kirkjunias sure as fate;(tlm.)as sure as eggs is eggs
Amerika	America;(ofta =)the United States
amerikabátur	transatlantic liner
amerikanari	American
amerikanisera	Americanize
amerikanisering	process of making (sth) American; process of becoming American
amerikanskur	American;amerikansk oljacastor oil;eyðkent (, einkenniliga) amerikanskt (fl.m., tlm.)apple pie(t.d.apple pie virtues)
amerikanskur fenheykur	(fugl.)northern harrier(Circus hudsonius)(Linnaeus, 1758)@ Wikimeda Commons
amerikanskur mækjuglámur	(fugl.)american bittern(Botaurus lentiginosus)(Rackett, 1813)© Wikimedia Commons
amerikanskur vætturhegri	(fugl.)least bittern(Ixobrychus exilis)(Gmelin, 1789)©iStock
amerikonsk frostmýrilógv	(fugl.)American golden plover(Pluvialis dominica)(Statius Muller, 1776)Pluvialis dominica ©iStock
amerikonsk krikkont	(fugl.)Green-winged teal(Anas carolinensis)(Gmelin, JF, 1789)© Jason Crotty
amerikonsk sjógvhøna	(fugl.)american coot(Fulica americana)(Gmelin, JF, 1789)© Ken Slade
amerikonsk spegilsont	(fugl.)white-winged scoter(Melanitta deglandi)(Bonaparte, 1758)© Matt MacGillivray
amerikumaður	síamerikanari
ameriskur	síamerikanskur
ameta	(handilsm.)on joint account; on a fifty-fifty basis; for common profit and loss
amfetamin	(lækn.)amphetamine
amfetaminbrúkari	amphetamine user;Sspeed freak
amfetaminmisbrúk	amphetamine abuse
amfibiu-	amphibious(t.d.craft, operation tank)
amfibiuakfar	amphibious vehicle, amphibian
amfibiubátur	amphibian (aeroplane)
amfibiuflogfar	amphibian
amfibiulandgongufar	amphibious landing craft;(tlm.)duck
aminosýra	(evnafr.)amino acid
amma	barrel, cask
ammoniakk	(evnafr.)ammonia
ammoniakkkendur	ammoniacal
ammonshyrningur	ammonite
amok	(tlm.)run amok(el.amuck); (í øðini) go berserk
A-mol	(tónl.)A minor
amoralskur	amoral, non-moral
ampa	1hinder(t.d.it hindered rather than helped his work; snow and ice were hindering traffic); hamper(t.d.one's freedom of movement); (sterkari,(forml.))impede(t.d.one's progress)2hesitate3fancy
ampaleysur	1safe, secure2unimpeded, unhindered
amper	síampera
ampera	(alisfr.)ampere, amp(st A)
amperumetur	(alisfr.)ammeter
amperutími	(alisfr.)ampere-hour
ampi	trouble, uneasiness, inconvenience, nuisance, worry(t.d.about the future, about one's children); (sterkari) anxiety (for; about,t.d.anxiety for her safety; their anxieties about their final exam);(forml.)concern(t.d.concern for his safety is growing; there is no cause for concern);geva ampagive rise to concern(t.d.his condition (, the affair) is giving rise to concern);vera til ampa fyribe inconvenient for; be a nuisance to;hava ampa avbe uneasy about(t.d.the future);hava ampa av (e-m)be nervous about;eg havi sovorðnan ampa á mær, tá ið eg skal ferðast við flogfariI am so nervous of flying
ampilára	inconvenience, incommode, make uncomfortable, disturb(t.d.you won't be disturbed in this room); pester(t.d.pester sby with stupid questions); bother(t.d.he is always bothering me with his interruptions);(tlm.)cramp sby'sstyle(t.d.the unaccustomed ground cramped the style of the players)
amputera	amputate;(fl.m.)axe, slash
amt	(stjm.)(kann verða endurgivið) county, shire
amtmaður	(stjm.)[chief administrative officer of an "amt"]; (kann verða endurgivið) prefect
amtmansflís	(sk.)thin slice of bread
amts-	(kann verða endurgivið) county
amtsborgmeistari	county mayor; (svarar til) chairman of the county council
amtsráð	county council
amutur	wasteful, extravagant, prodigal, thriftless, spendthrift, uneconomic(al)
ana	1burn weakly2(um fólk og djór) only just live
analfabetur	(tlm.)illiterate
analog (computer) technique	analogtøkni
ananas	(plfr.)pineapple(Ananas comosus)© Wikimeda Commons
anda	1breathe, draw (one's) breath(forml.)respire; (viðfsoghj) anda at e-mshow someone love, affection;anda ábreathe on,anda á brillurnarbreathe on the glasses;anda djúpandraw a deep breath, breathe deeply;anda innbreathe in;(forml.)inhale;hann livir og andar bara fyri tíit is his whole life; that is all he lives for;anda lættan(be able to) breathe again, breathe more easily, breathe a sigh of relief;anda niður í nakkan á e-m (fl.m.)breathe down sby's neck;anda við táknumbreathe through gills;anda tungligabreathe heavily;anda útbreathe out;(forml.)exhale2andastexpire, pass away, die;andaðurexpired, passed away, dead3(um vind) blow softly
andablástur	(bíbl., skaldsk.)breath
andaborin	brilliant, witty; inspired
andadráttarskipan	(lívfr.)respiratory system
andadráttarvenjing	breathing exercise
andadráttarverja	breathing mask
andadráttarvernd	breathing mask, respiratory protection apparatus; eis.andingarvernd
andadráttur	breathing;(forml.)respiration; breath(t.d.he took a breath, his breath came in short, sharp bursts);kunstigur andadrátturartificial respiration;geva e-m kunstigan andadráttadminister artificial respiration to sby;í sama andadráttiin the same breath;síðsti andadrátturthe last gasp(t.d.fight to the last gasp);til síðsta andadrátttill my last breath
andadýrkan	(átr.)necromancy
andadýrkari	(átr.)necromancer; (etnogr.) shaman; witch doctor
andagøgn	(lívfr.)breathing organ, respiratory organ
andaheimur	invisible world, ghost world
andahjálp	(lækn.)artificial respiration,geva el. veita andahjálpadminister artificial respiration to sby
andakt	1(átr.)devotion(s); silent prayer, worship; (stutt gudstænasta) prayersflt (t.d.morning prayers);halda andaktsay a few prayers; perform one's devotions2grave attention; rapt attention(t.d.he listened to her with rapt attention)
andaktsbók	(átr.)devotional book, homily book
andaktsløta	(átr.)hour of devotion
andalag	(skaldsk.)breath
andalátilsi	síandaleyp
andaleið	(lívfr.)respiratory passages, airways
andaleyp	last breath,liggja í andaleypidying, be at death's door
andaleypsbrot	liggja í andaleypsbrotum be breathing one's last, be at one's last (breath)
andaliga	síandligur
andaligur	síandligur
andalop	(sj.)síandaleyp
Andalusia	(sern.)Andalusia
andalusiari	Andalusian
andalusiskur	Andalusian
andarblak	breeze, puff
andarhald	1breath pause2moment, instant3rest, respite4(um veður, dyst, friðarbil) lull(t.d.in the storm, in the fighting, in the conversation; after a lull of one month the bombing has been resumed)
andarið	suffocation,(lækn.)asphyxia
andaris	(um hár)standa(uppi)í andarisi bristle;í andarisifurious
andartippi	difficulty in breathing; breathing difficultiesflt;(lækn.)dyspnoea
andarúm	1breathing space2atmosphere3atmosphere, air
andaræl	í hvørjum andaræli at every opportunity;í sama andaræliin the same breath
andaskifti	síandaleyp
andatak	moment, instant
andatoka	visible breath
andatrongd	síandarið
andatrúgv	(átr.)animism
andborin	witty, brilliant,ein andborin røðaa witty speech
andbráður	1fearless2proud
andeitur	(lækn.)antidote(fyrito)
andeiturtilbúgving	poison antidote preparedness, emergency preparedness
andevni	1(lækn.)antibody2antidote (t.d.there is no known antidote to the poison of the pufferfish)
andfarin	senile(t.d.decay)
andføtlingur	antipode,nýsælendingar eru andføtlingar okkaraNew Zealanders are our antipodes
andgerð	(alisfr.)reaction
andgeri	(alisfr.)reactor
andglettur	(eis. fl.m.)an exposed position;vera í andletticome under shot and shell
andhall	(jarðfr.)anticlinal
andhallgerð	anticline
andhalsfella	anticlinal trap
andheiti	(málfr.)antonym
andi	1breath;ringur andibad(el.smellyel.ill-smelling) breath;(forml.)fetid breath;(lækn.)halitosis;draga andadraw one's breath;geva upp andagive up the ghost;halda andanumhold one's breath;tungt fyri andanumoppressive, close, sultry, muggy2(mótsatt likamiel.tí evnisbundna) mind(t.d.body and mind; the triumph of mind over matter); spirit(t.d.the spirit is willing but the flesh is weak; he is young in spirit)3(persónleiki) mind(t.d.he was one of the greatest minds of his time); spirit(t.d.one of the leading spirits of the party)4(í heri) morale5(yvirnatúrligar verur, andi teirra deyðu) spirit(t.d.evil spirits; the spirits of the dead; spirits of dead warriors haunted the place); (ævintýravera) genie(t.d.the Spirit(el.Genie) of the Lamp (, of the Ring)); (spøkilsieis.)ghost(t.d.Hamlet's father's ghost)6(átr.)the Holy Spirit, the Holy Ghost,Guds andi lá á vøtnunumthe Spirit of God moved upon the face of the waters7(hugsanarháttur) spirit(t.d.the spirit of the 18th century; we accept the spirit as well as the letter of the treaty; the spirit of the law)8(veðurfr., sj.)breeze
anding	breathing
andingar-	(lækn.)breathing, respiratory(t.d.movement)
andingargøgn	síandagøgn
andingartól	(lækn.)respirator; breathing apparatus;liggja í andingartólibe on a respirator;sløkkja andingartóliðturn off the respirator, pull the plug
andingarvernd	respiratory protection apparatus, breathing mask; eis.andadráttarvernd
andkollvelting	(stjm.)counter-revolution
andkoma	inspiration
andkveikja	inspire
andlát	death
andleysur	1dull;(forml.)fatuous, inane(t.d.remark), uninspiring, boring2dead, stillborn,andleyst føtt barnstillborn child3(stb.)out of breath
andligur	1(móts.holdligur) mental(t.d.development, gymnastics, health, effort); intellectual(t.d.interests, property, work)2(móts.evnisligur) spiritual(t.d.needs, nourishment, values; his spiritual home)3(átr.)spiritual(t.d.leader, matters, welfare); religious4andliga laturmentally lazy;andlig evniintellectual(el.mental) faculties;andligur faðirspiritual father;andlig føðifood for the mind;(forml.)spiritual nourishment;tí andliga viðvíkjandimentally; intellectually; spiritually;andligur kraftmoral(el.spiritual) force;andligur lívspiritual (, intellectual) life;andligur sangirsacred songs;andligur skyldskapurcongeniality
andlit	1face;við e-m menniskjaligum andlitiwith a human face;vísa sítt sanna andlitshow oneself in one's true colours;(átr.) í sveitta andlits tínsin the sweat of thy face shalt thou eat bread;Harrin lati andlit sítt lýsa yvir teg (bíbl.)the Lord make His face to shine upon thee2[ísamb.viðfs]eg síggi taðáandlitinumI can read it in your face;íandliti(num)on one's face(t.d.with an angry look on his face);ar í andlitinumscars on the face;bleikur, reyður í andlitipale-faced, red-faced;flenna beint upp í andlitið (eyguni) á honumlaugh in his face;rodna í andlitiblush, turn red, colour up;siga honum eitt beint upp í andlitiðtell him sth to his face;eg segði honum tað beint upp í andlitiðI told him so to his face;hvussu er tað tú sært út í andlitinum?what is the matter with your face?, what have you done to your face?;sláa hann í andlitiðslap his face, strike him in the face;spýta í andlitiðspit in sby's face;hann tognaði í andlitihe pulled a long face; his face fell; his jaw fellel.dropped;andlittilandlitsface to face(viðwith);hitta andlit til andlitsmeet face to face, confront;seta ein andlit til andlits viðconfront sby with;standa andlit til andlits viðstand face to face with, confront;smílastumalt andlitiðbe smiling all over one's face; be all smiles; smile all over one's face;(bókm.)be wreathed in smiles;við e-m menniskjaligum andlitiwith a human face;vísa sítt sanna andlitshow oneself in one's true colours
andlitsbein	(lívfr.)facial bone
andlitsbragd	facial expression;hansara andlitsbragd (eis.)the look(el.expression) on his face;við grimum andlitsbragdiwith an angry look on one's face
andlitsbrá	síandlitsbragd
andlitsdrag	feature, lineament
andlitsdæmi	complexion
andlitsfríður	with a beautiful (handsome) face
andlitsføðing	(lækn.)face presentation
andlitsgrein	(á fólki, of a person) profile
andlitsgríma	face mask
andlitshúð	(lívfr.)skin of the face
andlitskrem	face cream
andlitslitur	síandlitssmyrsl
andlitslyfting	face-lifting, face-lift(t.d.she had a face lift;(fl.m.)give the house a face lift);(forml.)rhytidectomy
andlitsmassaga	faceel.facial massage
andlitsmynd	portrait
andlitsputur	face powder
andlitsskap	shape of the face
andlitssmyrsl	face cream
andlitsviðgerð	facial treatment;(tlm.)facial(t.d.I had a facial yesterday)
andlitsyvirbragd	síandlitsbragd
andlív	intellectual life
andmerktur	(málfr.)antonymous
andmót	1hindrance, impediment2adversity
andmælingur	opponent; (til doktararitgerð) official opponent
andnes	foreland, headland
andnevni	antonym (t.d.the words bad and good are antonyms)
andnæmi	síánæmi
Andorra	(sern.) (landafr.)Andorra
andorri	Andorran
andorskur	Andorran
andríkur	witty, brilliant
andrísin	stubborn(t.d.conviction, resistance, will); obstinate(t.d.resistance); (treiskur og áhaldandi)(forml.)dogged(t.d.defence, determination, refusal, perseverance, resistance)
androk	adversity, difficulties
andróður	1[rowing against the wind (, current)]2(fl.m.)adversity; hardship(t.d.he has seen a lot of hardship in his life)
andróðursflokkur	(sj., stjm.)opposition party
andróðursmaður	(sj.)(political) opponent
andrøða	(gl.)request, ask for, solicit from
andsfrælsi	intellectual liberty
andskræmiligur	horrible, terrible(t.d.crime, sight); (sterkari) horrifying, horrendous, appalling; (ljótur, ringur) awful(t.d.dress, play, weather); terrible(t.d.play, weather); (sterkari) appalling
andsperr	síandsperri
andsperra	síandsperri
andsperri	stiffness in the limbs
andstaddur	opposite(t.d.angle, leaf), facing;(støddfr.:síða í tríhyrningio.a.)subtending
andstevna	incite, instigate, urge on
andstreymur	[an-] head current, countercurrent
andstroymi	síandstreymur
andstygd	abomination(t.d.it is an abomination);tað var teimum andstygdit was an abomination to them, they held it in abomination, it was anathema to them, they hated it, they detested it; they loathed it; it stank in their nostrils
andstyggiligur	abominable
andstøða1	1(stjm.)opposition,(ting.)the Opposition, (í Ongl. eis: Her (, His) Majesty's Opposition);koma í andstøðugo into opposition;vera í andstøðube in opposition2resistance(t.d.he did it in opposition to public opinion; the friends found themselves in opposition to each other)
andstøða2	reply, answer,hon vildi einki andstøða honumshe did not feel like answering him
andstøðingur	1(stjm.) opponent (of);(forml.)adversary (of); antagonist2dissident
andstøðis	opposite,standa andstøðis hvør øðrumto stand opposite each other
andstøðisliga	per contra, conversely
andstøðuflokkur	(stjm.)the opposition party
andsvar	1answer, reply, rejoinder2(tlm.)responsibility, liability
andsøgn	contradiction
andsølis	anti-clockwise
andvarpa	1in two minds, in doubt2twist and turn (in your bed)
andveður	headwind, contrary wind
andveikur	(sálfr.)mentally deficient, mentally subnormal
andvekur	sleeplessness;(forml.)insomnia
andvekursnátt	sleepless night
andverk	(stb.)síandvirki
andvirði	equivalent value
andvirki	1corn, yield2work
andvirusforrit	(teld.)antivirus program
andvíki	(stb.)disagreement;(forml.)difference (of opinion)
andøva	1[keep the boat at rest with the oars so as not to be carried with the tide]2(fl.m.)raise objection, object to,andøva ímóti e-mobject to sth
andøvsgul	(veðurfr.)moderate breeze (5,5 - 7,9 m/sec.) (wind force 4 on Beaufort scale)
anga	smell(t.d.the flowers smell sweet);rósurnar angathe roses have(el.give off) a lovely scent; the roses smell lovely; they emit fragrance;her angar vælthere is a nice smell;anga avsmell of(t.d.the room smelt of roses);har angaði av rósumthere was a scent of roses
angaleysur	odourless
angaluktur	fragrance, scent, perfume
angan	(skaldsk.)síangi
angaroykgras	(plfr.)(við góðum anga) Sweet Vernal-grass(Anthoxanthum odoratum)© Wikimedia Commons
angaroykur	síangaluktur
angasøtur	(skaldsk.)sweet-smelling
angavatn	perfume
angi1	smell;(forml.)odour(t.d.the warm odour of freshly baked scones; the delicious odour of freshly made coffee) scent(t.d.a scent of flowers (, of new-mown hay));(forml.)perfume; (um blómureis.)fragrance(t.d.the fragrance of her hair (, of a rose); all the fragrances of the East)
angi2	1(lækn.)vertebral process2(um hjól) cog; prong3fullur upp undir angar(nar)surfeited, glutted, gorged, crammed, chock-full
angilja	(gl.)(á kalva) pectoral fin
angist	1fear (of); (brádlig) alarm; (veikari,(forml.) apprehension (of); (sterkari) dread (of); (ampi) anxiety; (heimspeki) angst;(sálarfr.)anxiety2[íyms.samb.]deyðilig angistdeadly(el.mortal) fear;vekja angist í e-minspire sby with dread;við angist og tregawith fear and trembling
angistlinnandi	(lækn.) antidepressant (medicineel.drugs)
angistnevrosa	anxiety neurosis, nervous fear, phobia
angistnevrotiskur	anxiety-neurotic
angistróp	cry of terror
Angola	(sern. landafr.)Angola
angolari,angoli	Angolan
angolskur	Angolan
angorageit	(dýr.)Angora goat©iStock
angorakanin	(dýr.)Angora rabbit
angorakøttur	(dýr.)Angora cat
angoraull	mohair
angra	repent(t.d. one'sfolly, sins; he has bitterly repented it); repent of(t.d. one'ssins); regret(t.d.doing sth); be sorry for, be penitent for;hetta fert tú at angrayou'll be sorry for this; you will live to repent this;sum ikki angrarunrepentant, unrepenting;(teld.)undo
angur	1repentance; self-reproach, regret; penitence, remorse, compunction, contrition;kenna angur umrepent (of), feel remorse for, feel penitent because of2(kvæð.)dread, fear(s)
angurbitin	síangurfullur
angurfullur	repentant (for); (sterkari) remorseful (about); conscience-stricken(t.d.look conscience-stricken);(átr.)penitent(t.d.a penitent sinner); contrite
angurleysur	(sj.)unrepenting, unrepentant
angurmerktur	(sj.)repentant (for); (meira) remorseful (about); conscience-stricken(t.d.look conscience-stricken);(átr.)penitent(t.d.a penitent sinner, with a penitent air); contrite
angurstár	tears of repentanceel.contrition
aninýtsla	standby power consumption, spare supply
ank	groaning
anka	groan, moan
ankar1	síakker
ankar2	(gl.)keg, (tunna) barrel(t.d.a barrel of beer); (til vín) cask
ankra	(sjóm.)anchor, cast anchor
annað	síannar
annaðhvørt	í osb: annaðhvørt. ella either ... or(t.d.you can stay with either me or my brother; you can either stay with me or go home);annaðhvørt tað er rætt ella skeivtwhether it is right or wrong
annaðhvørt-ella	dilemma, choice (between two alternatives); either-or situation;standa andlit til andlits við eitt annaðhvørt-ellabe faced with a dilemma; be confronted with a choice between two alternatives
annaðkvøld	í osb: í annaðkvøld tomorrow nightel.evening
annaðlags-	secondary
annaðlagsvinna	secondary industry
annað lið	(fótb.)reserve team, second team
annaðslíkt	equally much, equally big; more than
annan	síannar
annanfloksborgari	second-class citizen
annans	síannars
annar	1second(t.d.on the second floor; for the second time; there won't be a second time)2other(t.d.other plans); (sum navnorð) others, other people(t.d.there were other people present);aðrar av bókum hansaraother books of his; one (of them);annað beiniðone of my legs;annan daginthe next day3(øðrvísi) different(t.d.they were different people from the ones I had met);hann var annar maður eftir hettahe was a different man after this;hann er annar maðurhe is a better (more able, competent) man4[íyms.samb.]annað ennbut;tað ber ikki annað tilit can't be helped;ikki annað enn taðjust that;annar, hinone ... the other; (av fleiri) one ... another;hvørki annar ella annarneither ... nor(t.d.neither Peter nor I can do it); (eftir nokting) either ... or;annar svav, hin lasone of them was asleep, another was reading;annan vegin. hin veginon (the) one hand... on the other (hand);dag eftir annanday by day;hvør hjá øðrumtogether;í aðrar mátarotherwise;millum aðraramongst other;millum annað (st m.a.) among other things;millum annað kann eg nevna, atamong other things I can mention;við aðrari hondiniwith the one hand;annað ennbut, apart from;úr enda í annanfrom one end to the other
annarhvør	lt aðrirhvørjir aðrarhvørjar onnurhvørji fn1every other, every second;annanhvønn dagevery second(el.other) day, every two days;annanhvønn hósdagevery other Thursday, on alternate Thursdays;eg vitji hann annanhvønn sunnudagI visit him every other Sunday(el.on alternate Sundays)2(at kalla hvør)annaðhvørt menniskja veit taðeverybody(el.all the world) knows that
annarleiðis	síøðrvísi
annarligur	secondary;annarlig endurvinningsecondary recovery
annars	1(um so er, um ikki, ella) or(t.d.put up your hands or I fire); or else(t.d.hurry up, or (else) you will be late); if not; otherwise(t.d.go home at once, otherwise you'll catch a cold); failing which; failing this(t.d.you will have to buy a car; failing this, you must borrow one)2(aðramáta) otherwise(t.d.otherwise he is quite a nice chap); as for the rest, besides(t.d.besides, I did not look very closely at them); moreover(t.d.moreover, they had no ammunition); incidentally(t.d.his brother, who incidentally is a friend of mine; incidentally, what did you mean by that remark?); for that matter(t.d.I don't like him and, for that matter, he does not like me (either))3(við fornøvnum) else(t.d.who (, what) else? anything else?; no one (, nothing) else)4(um mótsøgn) but,eg helt annars at...but I thought that ...5(vanliga) usually, normally(t.d.normally everything is quiet here)6(sagt so hissini) by the way(t.d.by the way, what do you think of my new car?); you know(t.d.it is your responsibility, you know); come to think of it;fyrr enn annarsearlier than usual;hatta er annars ein flottur bilur, tú hevur fingið tær!that's a jolly fine car you've got!;annars takkthank you all the same; (speiskliga)nei annars takk!not likely! I'm not having any!
annám	grip
annáma	(sj.)grab, snatch,tann grái annámi hanndamn him!
annuitet	síjavngjald
annuitetslán1	síjavngjaldslán
annuitetslán2	annuity loan
anoda	(alisfr.)anode
anorakkur	anorak; (serliga við hettu úr feldi) parka; (til at smoyggja niður um høvdið) cagoule
anriða	(stb., fisk.)síeyrriði
ansa	1(røkja, vera um, hava umsjón við), take care of(t.d.the children, the dog, the garden); look after(t.d.the children); (fyribils) look after, mind(t.d.the baby, the children, the dog; look after the garden for them); (um sjúkling) look after(t.d.he was well looked after in hospital); (røkta) nurse; (um maskinu) operate; (hava ábyrgd av) be in charge of; (stutt bil) look after, mind(t.d.the shop, the office); (arbeiði, skyldur) go about(t.d. one'swork, one's duties);(forml.)attend to(t.d. one'swork, one's duties)2(ansa eftir) pay attention; (vera varin) look out, take care, be careful(t.d.be careful when you cross the road); mind(t.d.mind the step (, your head)!); beware of(t.d.beware of the dogs (, of pickpockets)!); (hóttandi) watch it!;ansa eftir at (síggja til at)take care to(t.d.do it correctly);ansa tær, so tú ikki detturbe careful(el.mind) (that) you don't fall;ansa eftir hvat tú sigur!be careful what you say!;ansa eftir ikki attake care(el.be careful) not to(t.d.say too much);tú mást ansa eftir tíðini (t.e. ikki vera ov drúgvur)you must watch your time
ansaleysur	1heedless, reckless, (náðileysur) ruthless2reckless (t.d.driver)
ansaligur	1superior, conceited, arrogant, haughty,ansaligur sum hann var helt hannin his arrogance (he believed)(GG:cock-sure as he was, he believed)2cool-headed, cool, steady
ansaloysi	(sj.)indifference, lack of interest
ansalótir	conceit, pretence; simulation, shamming, putting on airs,hann er tær beru ansalótirhe is full of conceit, he is putting on airs,við sínum ansalótumbeing so arrogant(t.d.being so arrogant, he seemed ridiculous), haughtiness, brag
ansalæti	síansalótir
ansin	cautious, careful (about, of,t.d.about(el.of) what you say;við atabout -ing, of -ing); wary (of, about; of -ing, about -ing,t.d.about believing what he says), attentive, alert
ansingarstovnur	day-care centre, day-care institution
ansjá	(gl.)opinion;tað er mín ansjáthat's my opinion
ansjós	(fisk.)anchovy(Engraulis encrasicolus)© Wikimedia Commons
ansmikil	remarkable;(forml.)notable
ansni	carefulness, care; precision
ansur	1interest, regard, consideration, attention; watchfulness, alertness; stir, sensation,søguligur ansurhistorical interest;geva e-m anspay attention to sby;vekja ansattract attention; create(el.cause) a stir; (sterkari) create(el.make) a sensation2flair, understanding, sympathy(t.d.he has no understanding (, sympathy) for their problems), appreciation(t.d.he has no appreciation of the finer points)3care(t.d.the child needs good care)4supervision, inspection5vera í ansibe about to, be on the point of (doing something)
antabus	(lækn.)antabuse; disulfiram;taka antabuson antabuse
antabusviðgerð	antabuse treatment
antakrist	(átr.)Antichrist
antar	síont
antaregg	duck's egg, duck egg
antarfuglur	(fugl.)duck
antenna	(útv.)aerial;(am.)antenna
antennubákn1	
antennubákn2	(brit.)aerial signal;(amr.)antenna signal
antennubjálvari1	aerial isolator
antennubjálvari2	aerial isolator
antennufesti	aerial plug socket
antennumastur	aerial mast
antennurá	spreader
antennuskipan	communal aerial installation (, system)
antennuspoli	aerial tuning inductance
antennustikk	(útv.)antenna plug
antennustyrki	(útv.)antenna power
antennutráður	(útv.)antenna
antikrist	síantakrist
antil	(stb.)síantin
antilopa	(dýr.)antelope
antin	1í osb: antin ellaeither or2if, whether
antrasitt	anthracite
antrast	síaftrast
apa1	1(dýr.)monkey; ape2(sjóm., skemt.)deck hand
apa2	1mimic, ape(t.d. sby'smanners);hann apar seg eftir hinumhe is a copycat2(sj.)(bera seg býttliga at) play the fool(t.d.stop playing the fool); (skapa sær) put on an act(t.d.he is not hurt, he is only putting on an act)
apaldgarður	apple orchard
apaldgráur	(kvæð.)dapple-grey
apaldur	(plfr.)apple-tree(Malus sylvestris)© Wikimedia Commons
A-partabræv	(bú.)A-share, class A share
apokrýfiskur	(bíbl.)apocryphal;apokrýfisku bøkurnarthe Apocrypha
Apostlasøgan	(bíbl.)the Acts (of the Apostles)
apotek	chemist's (shop), pharmacy;(am.)drugstore, pharmacy; (á sjúkrahúsi) dispensary
apotekarahjálpari	chemist's assistant
apotekari	chemist; pharmaceutical(el.dispensing) chemist;(am.)pharmacist, druggist
apoteksassistentur	assistant dispenser
apoteksvørur	medical drugs
app	(teld)app (nýtsluritbúnaður)
apparat	1(tlm.)instrument(t.d.a measuring instrument); apparatus(fltapparatus (es))(t.d.the room was filled with complicated apparatus(es));(serl. ravm.)appliance(t.d.electrical appliances);(serl.smærri) device(t.d.an electronic device);(útv., sjónv.)set2(háð.um fólk) fool,títt býtta apparatyou fool
appilsin	(plfr.)orange©iStock
appilsingulur	(barn.)orange
appilsinhúð	orange-peel skin
appilsinskal	orange peel, orange rind; (a piece of orange peel(el.rind)
appilsintræ	(plfr.)orange(Citrus sinensis)
aprikosa	(plfr.)apricot©iStock
aprikosulittur	apricot
apríl	April;senda el. lokka hann aprílmake an April fool of him; make him an April fool;(fl.m.)send him on a fool's errand;fyrsti aprílthe first of April; All Fool's Day;tann sum er sendur aprílApril fool;apríl skemtApril fool's joke(el.hoaxel.prank);apríl veðurApril weather
aprílmánaður	the month of April
apteringsarbeiði	interior fittings
apublóma	(plfr.)monkey flower(Mimulus)slag: Mimulus lewisii © Wikimedia Commons
apuhár	monkey fur
apukattalótir	monkey tricks
apukattur	1monkey2(hermari) copycat3(fják) fool
apupallur	monkey board
apuspjað	síapuspjót
apuspjót	fool
apuspæl	monkey tricks
aputur	1foolish2affected
aputýggi	scoundrel, rascal
apuungi	young monkey
apuveitsla	rowdy party, rave-up, do, binge
ar	(mát)are; 100 sq. metres
arábatøl	Arabic numerals
arábi	Arab
arábiamaður	Arab
arábiskur	1Arab(t.d.the Arab countries (, world); an Arab village (, politician, sheik); Arab policy (, philosophy); an Arab horse)2(viðvíkjandi Arabia) Arabian(t.d.the Arabian desert (, Peninsula, Gulf))3(um mál, bókmentir, tekn) Arabic(t.d.alphabet, letters, numerals, script)
arbeið	síarbeiði
arbeiða	1work; (hart) labour;(skald.)toil; (virka, vera í gongd; oftatøkn.)operate(t.d.the machine operates by steam); function(t.d.the heart functions during sleep); work(t.d.the engine works very well); (um tilfar: broyta skap) work(t.d.the wood works)2[ísamb.viðseg]arbeiða seg burtur úrwork one's way out of; extricate oneself from;arbeiða seg fríanextricate oneself; work oneself free;arbeiða seg heitanwork oneself into a sweat, work up a sweat;arbeiða seg inn í eittgo deeply into sth; get to the bottom of sth;arbeiða seg ígjøgnumwork (one's way) through(t.d.a book, a pile of work); (liva, liðast)arbeiða seg leysan (t.d.um skrúvu) work loose;arbeiða seg móðanwork till one is tired, tire oneself out;arbeiða seg uppwork one's way (forward); (svinga seg upp) rise from the ranks, work one's way up, carve out a career for oneself, make good, make one's way(t.d.from a lower to a higher post(el.rank))3[ísamb.viðfs/hj]arbeiða skuldavsærwork off a debt;arbeiðaáe-m blaðiwork on (the staff of) a paper;arbeiðaágrýtinwork with a will;arbeiða ágrýtin viðapply oneself (diligently) to(t.d.a task);arbeiðafram ímótie-mdirect one's efforts to(el.towards) sth; work towards sth;arbeiða fram ímóti e-m málipursue an object;arbeiðafyriat útvega sær viðhaldsfólkwork(el.endeavour) to get adherents;arbeiða fyri eitt virkiwork for a firm;arbeiða fyri e-m máliwork for at cause;arbeiðahartwork hard;arbeiða illawork badly, be a bad worker;arbeiða samanwork together(t.d.they work well together);arbeiða saman umcollaborate on(t.d.a book);arbeiðasaman viðwork with(t.d.he can't work with the others);arbeiða saman við e-mwork together with sby,collaborate with sby,co-operate with sby;arbeiða tætt saman viðwork in harness with;arbeiða eitt virkiuppwork up a business;arbeiða reyvinaúrsærslave one's guts out, work like a horse (el. slave);arbeiðaútfrá tí ástøði atwork on(el.according to) the theory that;hon arbeiðirútishe works from home;arbeiðaviðwork at (, on)(t.d.a book); be engaged on(t.d.a novel), be engaged in(t.d.collecting materials for a book);arbeiða við(vera í holt við) work on(t.d.a new book); be engaged in(t.d.writing a novel); (stríðast við) work at(t.d.a problem, an invention); (um reiðskap, vøruo. a.)work with(t.d.a computer; computers; children); (um evni, førleikao.a.)develop(t.d. one'screative talents; he needs to develop his reading);arbeiða við atwork at -ing(t.d.being accepted);hann arbeiddi við at stovna eina virkisdeild (eis.)he was endeavouring to establish a branch;arbeiða við e-m amboðiwork with a tool;arbeiða við hálvari kraftwork at half-strength (,(tlm.)half-steam);arbeiða við eini maskinuoperate a machine;arbeiða við lítlum pengumwork with a small capital;arbeiða við pumpunumwork the pumps;her verður arbeitt við tjøru!tarring in progress!arbeiða við einum trupulleikawork at(el.on) a problem;arbeiða við træiwork in(el.with) wood;arbeiðavælwork well, be a good worker;arbeiðayvirwork(el.do) overtime4[íyms.samb.]fara undir at arbeiðaset to work;hann letur fólkið arbeiða ógvuliga harthe works (, drives) his employees very hard;arbeiðandi fólkiðthe working population
arbeiðarafamilja	working-class family
arbeiðarafelag	workers' union;(am.)blue-collar union
arbeiðarafjøld	arbeiðarafjøldin the labouring masses
arbeiðaraflokkur	workers' party,Arbeiðaraflokkurinthe Labour Party
arbeiðarahús	workmen's houses; (til leigu) tenements
arbeiðaraløn	(vikuløn) wage(s); (mánaðarløn) salary; (um báðar) pay
arbeiðaramentan	working-class culture
arbeiðararáðstevna	altjóða arbeiðararáðstevnan the International Labour Conference
arbeiðararørsla	labour movement, working class movement
arbeiðarastjórn	Labour government
arbeiðarastætt	arbeiðarastættin the working(el.industrial) class(es)
arbeiðaratrygging	industrial insurance
arbeiðarauppreistur	rising of the workers
arbeiðaravernd	protection of workers; occupational safety and health; industrial safety;(ofta =)employers' liability
arbeiðaraverndarlóg	Factory Act
arbeiðaraøki	working-class district(el.quarter)
arbeiðari	1worker(t.d.factory worker, skilled worker); workman(t.d.a good (, quick) workman); blue-collar worker, working man2(verksmiðjuarbeiðari) workman(t.d.some workmen were digging up the road (, putting up a fence))3(um stættin) worker, working man4(í landbúnaði) labourer5(um býflugur) worker6arbeiðarar (eis.)working people; (sum stætt) the workers, the working people; labour;andans arbeiðararintellectuals; workers in the field of the intellect;faklærdir arbeiðararskilled workers;handans arbeiðarar(the) manual workers;arbeiðarar og kapitalistarCapital and Labour;eg eri bara arbeiðariI am only a working man;arbeiðarin er løn sína verdur (bíbl.)the labourer is worthy of his hire;arbeiðarar skipaðir í felagorganized labour;ófaklærdir arbeiðararunskilled workers(el.labourers)
arbeiði	1work(t.d.the work of building a house; it is hard work; she has a lot of work to do)2(likamligt; hart)labour(t.d.manual labour(el.work); it took ten days of backbreaking labour)3(skaldsk.)toil4(yrki)work(t.d.be looking for work; find work); (meiraforml.)employment(t.d.find employment; this will give employment tosøkja sær arbeiðibe looking for a job(el.for work);(forml.)seek employment;fáa sær arbeiði sumtake a job(sumas);(forml.)take up employment;leggja arbeiði frá særstop work; (fara í verkfall) (go on) strike, come out, walk out;(tlm.)down tools;fara til arbeiðisgo to work; (fara í holt við) set to work;koma til arbeiðisget to work, get to one's job(t.d.I can get to my job in 20 minutes);fara aftur til arbeiðis(eftir verkfall) go back (to work)5sí eis.avrik,listaverk,tilvirking6[ísamb. viðnogl]almenn arbeiðipublic works;bílagt arbeiðicommissioned work;hava fast arbeiðihave a permanent job; be in regular employment;tað er hart arbeiðiit is hard work;(tlm.)it is a tough job;húsligt arbeiðidomestic work;arbeiði og kapitalurCapital and Labour;leyst arbeiðijobbing; piecemeal jobs;ótakksamt arbeiðian ungrateful(el.a thankless) task;skrivligt arbeiðiwritten work; (verkevni) paper;spilt arbeiði(a) waste of energy;svart arbeiðiundeclared work, "black" work, undeclared job, moonlighting7[ísamb. viðs]átaka sær alt fyrifallandi arbeiðido (, accept, undertake, take on) odd jobs; be willing to do any odd job;(tlm.)be willing to do any old job;bjóða arbeiði út(í licitatión) invite tenders for a job;gera eitt arbeiðido a piece of work; perform a piece of work;geva arbeiðiemploy, give a job; (til nógv fólk) give (, create) employment;geva nógv arbeiðicause a lot of work;arbeiðið gongur væl (, illa o.s.fr.)the work is going well (, badly,o.tíl.) hann heldur einki arbeiði (tlm.)he cannot hold down a job;hava arbeiðihave a job, be in work (, employment);ikki hava arbeiðibe unemployed, be out of a job(GG: (tlm.)be on the dole);hann hevur 40 menn í arbeiðihe has 40 man at work(el.working for him);eg hevði eitt øgiligt arbeiði av at fáa hatta gjørtwhat a job I had getting it arranged;hava fyrifallandi arbeiðihave casual (, temporary) work;hann legði nógv arbeiði í bókinahe took great pains over the book;leggja stórt arbeiði í eittmake a great effort with sth(í atto); take great pains with sth(í atto);(tlm.)put one's back into sth;nógv arbeiði er lagt í hasa bókinaa good deal of work has gone into the making of that book;leggja eitt arbeiði á e-nassign sby a job (, task); give sby a job to do;leggja arbeiðið niður(go on(el.come out on)) strike;(tlm.)down tools;missa arbeiðiðlose one's job;seta til arbeiðisset to work(t.d.the prisoners were set to work building roads; Why don't you set him to work at sth?);sóknast eftir arbeiðibe looking for work;steðga arbeiðinumstop work;(tlm.)down tools;taka arbeiðið uppafturresume (, go back to) work8[ísamb. viðfs]fara aftur í arbeiðiresume work; (eftir verkfall) go back;vera aftur í arbeiðibe back at work again; be working again;tónleikur aftur við arbeiðinummusic while you (,o.s.fr.)work;liva av sínum arbeiðilive by one's work;koma frá arbeiðicome from work;seta e-n í arbeiðiset sby to work (við on, at);vera í arbeiðibe working, be employed; (= í sving) be at work(t.d.he was hard at work ploughing); (í gerð) be in hand, be in preparation, be in progress;fara til arbeiðisgo to work; (= fara undir eitt) set to work
arbeiðis-	síarbeiðs-
arbeiðsamboð	tool, implement
arbeiðsandi	love of working;(forml.)zeal
arbeiðsavrik	work performed; performance; (námsfr.: hjá næm.) application
arbeiðsavrit	(av filmi) rough cut; work(ing) print, workprint
arbeiðsávísing	1assignment of work; (virksemið) job provision; (skipanin) employment service, placement servicesflt2(skrivstova) job centre; (amr) public) employment agency; (privat) employment agency
arbeiðsborð	work(ing) table; (skriviborð) writing table, desk
arbeiðsbólkur	working group, working party(t.d.a working party has been set up to deal with the problem); task group;(polit. ofta =)task force
arbeiðsbrúk	til arbeiðsbrúks for work(ing) purposes
arbeiðsbuksur	working trousers, denims
arbeiðsbyrði el. -byrða	(alment) (burden of) labour, toil; work load;(í samb. v.undirvísing) teaching load
arbeiðsbýti	1division of labour(t.d.a fair division of labour in the home)2(til tess at fyribyrgja arbeiðsloysi) work sharing; short-time working
arbeiðsdagur	1(daglig arbeiðstíð) hours(t.d.longer hours), working day;(am.)workday2(gerandisdagur) working day(t.d.a working day of eight hours), workday, weekday;sjey tíma arbeiðsdagura seven-hour (working) day3(hagtøl) man-day(t.d.percentage of man-days lost)
arbeiðsdýr	beast of burden;(fl.m.)drudge
arbeiðseftirlit	working environment service, ArbeiðseftirlitiðThe Faroese Working Environment Service
arbeiðsevni	working capacity, capacity for work
arbeiðsfelagi	fellow worker;(tlm.)workmate
arbeiðsfelagsskapur	(working) partnership
arbeiðsferð	speed, rate of working;økt arbeiðsferðspeed-up;minking í arbeiðsferð(sum darv) go-slow
arbeiðsformaður	foreman
arbeiðsfólk	employees, workpeople; domestic servants
arbeiðsfótbúni	industrial footwear
arbeiðsfriður	(í samfelagnum) industrial peace; (privat) peace to work;kann eg fáa arbeiðsfriðcan't you let me work in peace
arbeiðsføri	capacity for work, fitness
arbeiðsførur	fit, able-bodied;fólk í arbeiðsførum aldripeople of working age;(stjm.) arbeiðsførur meirilutia working majority;(stjm.) ting ið ikki er arbeiðsførta hung parliament
arbeiðsgenta	housemaid
arbeiðsgevaraábyrgd	vicarious liability
arbeiðsgevaraábyrgdartrygging	employers' liability insurance
arbeiðsgevarafelag	employers' association(el.organization);arbeiðsgevarafelagið(í Ongl.) the Confederation of British Industry
arbeiðsgevari	employer
arbeiðsgleði	zest, pleasure taken in one's work; (nøgdsemi) job satisfaction(t.d.schemes to improve job satisfaction);tað oyðileggur arbeiðsgleðinait takes all the pleasure out of one's work.
arbeiðsgongd	1(working) procedure; flow of work(t.d.ensure a steady flow of work); organization (, successive stages) of the work, procedure, pattern of work(t.d.the pattern of work on a farm);dagliga arbeiðsgongdinthe daily routine;(tlm.)the daily grind;kunna ein um arbeiðsgongdinashow sby (, know, learn) the ropes2(um maskinu) cycle of operations
arbeiðsgoymsla	(teld.)working store, internal store(el.storage)
arbeiðsgrev	hard worker; (um lestur, oftaniðr.)swot;(am.)grind; (oftaniðr.)he is a workaholic
arbeiðshandski	protective glove
arbeiðsharri	(gl.)employer
arbeiðsháttur	working method, (hjá maskinuo.s.fr.)mode of operation
arbeiðsheiti	working title
arbeiðshestur	draught horse;(fl.m.um fólk) work-horse; drudge; slogger
arbeiðshjálmur	safety helmet; skullguard;(am. tlm.)tin hat
arbeiðshugaður	willing to work
arbeiðshugur	love of working;(forml.)zeal, zest;góðan arbeiðshug!I hope you get on well with your work!
arbeiðsinntøka	earned income
arbeiðsjarn	síarbeiðsgrev
arbeiðsklæddur	dressed in one's working clothes; wearing the dress of a working man
arbeiðsklæði(r)	working clothes
arbeiðskona	maid, housemaid
arbeiðskor	working conditions
arbeiðskraft	síarbeiðsmegi
arbeiðskrevjandi	1(bú.)labour-intensive2(tungt) demanding, strenuous; operose;(forml.)onerous
arbeiðskroppur	síarbeiðsgrev
arbeiðskvinna	woman worker
arbeiðskvinnufelag	women workers' union
arbeiðslag	hava gott arbeiðslag be skilful at, be a good hand at; be good at
arbeiðslega	1work camp2(tvingsilsarbeiðslegur) forced-labour camp
arbeiðsleiðari	supervisor; (á hægri stigi) executive
arbeiðsleysur	unemployed, jobless; (sum umsagnarlið.eis.)out of work; redundant;tey arbeiðsleysuthe unemployed;ein arbeiðsleysuran unemployed person;vera arbeiðsleysur (eis.)be out of a job;gerast arbeiðsleysurlose one's job, be thrown out of work; be made redundant;gera tey arbeiðsleysthrow them out of work; make them redundant;melda seg arbeiðsleysansign on; eis.vinnuleysur
arbeiðslið	(work) team; working party; (skifti) shift
arbeiðsligur	functional, practical;(teld t.d.)ergonomical
arbeiðslíkindi	working conditions
arbeiðslív	working life(t.d.women's working lives have lengthened);arbeiðslíviðthe world of work(t.d.prepare young people for the world of work)
arbeiðsloysi	1unemployment; joblessness2(prosent) unemployment rate;stórt arbeiðsloysihigh unemployment; a high unemployment rate, (a) high (rate of) unemployment, a high level of unemployment;arbeiðsloysi upp á 10%10 p.c. unemployment; an unemployment rate of 10 p.c.;langtíðar arbeiðsloysilong-term(el.chronic) unemployment;fyribils arbeiðsloysitemporary(el.short-term) unemployment;støðugt arbeiðsloysipermanent unemployment;støðuga arbeiðsloysið (eis.)the hard core of unemployment;arbeiðsloysið vaks við 5000unemployment rose by 5000
arbeiðsloysisdagpeningur	(samsvarar við) unemployment benefit
arbeiðsloysisgjald	unemployment contribution
arbeiðsloysisgrunnur	unemployment fund
arbeiðsloysishagtøl	unemployment statistics
arbeiðsloysiskassi	1unemployment fund2(skrivstova) unemployment benefit office3arbeiðsloysiskassarnir(sum heild;eis.)union insurance system
arbeiðsloysisskipan	(skipanin) employment service; (virksemið) job provision; (skrivstova) job centre;(am.)public employment agency; (privat) employment agency; (ES) placement servicesflt
arbeiðsloysisspurningurin	the unemployment problem
arbeiðsloysisstuðul	(frá tí almenna) unemployment relief,(tlm.)the dole, (trygging) unemployment benefit;(am. eis.)relief;fáa arbeiðsloysisstuðulbe in receipt of(el.draw) unemployment benefit;(tlm.)be on the dole;vanligur arbeiðsloysisstuðulstandard unemployment relief/benefit
arbeiðsloysistal	unemployment figure(s);arbeiðsloysistalið (eis.)the jobless figures
arbeiðsloysistrygging	unemployment insurance
arbeiðsloysisøki	distressed area
arbeiðsloyvi	permission to take up employment, labour permit, work permit
arbeiðslóggáva	labour legislation
arbeiðslýsing	job description(el.specification)
arbeiðsløn	(vikuløn) wage(s); (mánaðarløn) salary; (um báðar) pay;hægri (, lægri) arbeiðslønhigher (, lower) wages;arbeiðslønin minkaði (, vaks)wages fell (, rose);vøkstur í arbeiðsløninia wage increase, a pay rise;arbeiðslønin hjá honum er 100 krónur um daginhis wages are
arbeiðsmaður	unskilled labourer
arbeiðsmannafelag	(trade) union (of workers);(am.)labor union
Arbeiðsmarknaðareftirlønargunnur	(sernavn)Labour Market Supplemental Pension Fund
arbeiðsmarknaðarnevnd	manpower committee;(tingm., kann verða endurgivið) industrial relations committee
arbeiðsmarknaðarútbúgving	(kann verða endurgivið) labour market courses; job retraining programme; (í Ongl.) training opportunities scheme
arbeiðsmarknaður	labour market;á arbeiðsmarknaðinumon(el.in) the labour market;fara út á arbeiðsmarknaðinenter the labour market;friður á arbeiðsmarknaðinumindustrial peace;partarnir á arbeiðsmarknaðinumthe two sides of industry; the unions and the employers' organizations;viðurskifti á arbeiðsmarknaðinumindustrial(el.labour) relations
arbeiðsmál	working language
arbeiðsmálaráðharrastova	ministry of labour; (í Ongl.) Department of Employment and Productivity(stDEP)
arbeiðsmálaráðharri	minister of labour; (í Ongl.) secretary (of State) for Employment, Employment Secretary
arbeiðsmedisin	work medicine, industrial medicine, occupational medicine
arbeiðsmedisinskur	work medical
arbeiðsmegi	1(evni) capacity for work, working power(el.capacity)2(arbeiðarar) labour(t.d.foreign labour; non-union labour); manpower(t.d.the available manpower should be used systematically);hann er góð arbeiðsmegi hjá virkinumhe is an asset to the firm;hann er øgiliga góð arbeiðsmegihe has an enormous capacity for work;faklærd arbeiðsmegiskilled labour;ófaklærd arbeiðsmegiunskilled labour;óskipað arbeiðsmeginon-union labour;skipað arbeiðsmegiunion labour;samlaða arbeiðsmegin í landinumthe total manpower(el.labour force) of the country;tørvur á arbeiðsmegishortage of labour, labour(el.manpower) shortage, scarcity of labour;yrkislærd arbeiðsmegiskilled labour;brúka yrkislærda arbeiðsmegiemploy skilled labour
arbeiðsmoralur	attitude to work; work ethic(t.d.they lack a work ethic)
arbeiðsnarkomani	workaholism, being a workaholic
arbeiðsnarkomanur	work addict, workaholic
arbeiðsnáðir	industrial peace
arbeiðsnevnd	working group, working party(t.d.a working party has been set up to deal with the problem)
arbeiðsond	workhorse
arbeiðsorka	síarbeiðsmegi
arbeiðsósemja	industrial dispute(el.conflict), labour dispute
arbeiðspláss	1place of work(t.d.at my place of work); workplace; (byggipláss) site2(pláss har tú stendur (, situr)) working place; (teldel.á verksmiðju) work station3(pláss har tú kanst arbeiða) place to work, work space4(starv) job(t.d.create new jobs; save 200 jobs);á arbeiðsplássinumat one's place of work;demokrati á arbeiðsplássinumstaff (, worker) participation; participatory democracy;ófriður á arbeiðsplássinumunrest among workers; industrial unrest
arbeiðsross	1draught horse2(fl.m.)work-horse; drudge; slogger
arbeiðsrót	síarbeiðsgrev
arbeiðsrúm	workroom; study
arbeiðsrættur	1(dómstólur) labour court, industrial (relations) court2(rættarreglur) labour legislation, labour law
arbeiðssamløga	working collective
arbeiðssamur	hard-working; (meiraforml.)industrious
arbeiðssálarfrøði	occupational psychology, industrial psychology
arbeiðssáttmáli1	contract of employment(el.service) contract of employment
arbeiðssáttmáli2	contract of employment(el.service)
arbeiðsseðil	(workman's) timesheet, job sheet (, card)
arbeiðssemi	industry
arbeiðssetningur	termsfltof reference, mandate
arbeiðsskaðatrygging	industrial injury insurance
arbeiðsskaði	(trygg.)industrial injury;(lækn.)work-related disorder;(tlm.)on-the-job injury
arbeiðsskrá	working plan, work schedule
arbeiðsskrivstova	altjóða arbeiðsskrivstovan the International Labour Office, I.L.O.
arbeiðsskúrur	workmen's shed(el.hut)
arbeiðsskylda	(løgfr.)obligation to work
arbeiðsskýggjandi	work-shy, jobshy
arbeiðssparandi	labour-saving
arbeiðssteðgur	stoppage(el.interruption) of work, work stoppage; (frá arbeiðaranna síðu) strike; (frá arbeiðsgevaranna síðu) lock-out
arbeiðsstøða	working posture
arbeiðstakari	contractor; síverktakari
arbeiðstekning	workshop drawing
arbeiðstilboð	[limited-period] job offer
arbeiðstittul	provisional title, working title
arbeiðstíð	working hours, hours (of work); time for working(t.d.the evening is my best time for working);eftir arbeiðstíðafter hours;forskotin arbeiðstíðstaggered working hours, spread-over;føst arbeiðstíðregular working hours;hava óregluliga (, langa) arbeiðstíðwork irregular (, long) hours;stutt arbeiðstíðshort hours;arbeiða stytta arbeiðstíðwork(el.be on) short time;vanlig arbeiðstíðstandard hours
arbeiðstól	tool (til for,t.d.a tool for digging); implement(t.d.farming (, garden, household) implements); instrument(t.d.a measuring instrument)
arbeiðstrygd	safety at work
arbeiðstrýst	pressure of work, working pressure
arbeiðstrælur	(sj.)workhorse
arbeiðstvingsil	forced(el.compulsory) labour
arbeiðstøka	building contract
arbeiðstøkur	unemployed, jobless, out of work
arbeiðstørvur	shortage of work
arbeiðsumhvørvi	work(ing) environment
arbeiðsumhvørvislóg	health and safety at work act
arbeiðsuppgáva	task
arbeiðsvanlukka	(við ongum persónsskaða) industrial accident; (við persónsskaða) industrial injury
arbeiðsvika	working week;36 tíma arbeiðsvikaa 36-hour (working) week
arbeiðsvirkin	working; engaged in active employment;í eins arbeiðsvirkna líviduring one's working life
arbeiðsvit	(niðr.)ikki hava arbeiðsvit limited talents
arbeiðsøki	sphere, field of activity; (í kanning) topic of inquiry;(tøkn.)region of operation
arga	tease(viðabout,t.d.they teased him about his red hair; they teased him by hiding his schoolbooks); (góðsliga,tlm.)kid(viðabout); (góðsliga, bara við orðum) banter; irritate;argast innábe annoyed with
argapetti	síargapisa
argapisa	1tease, teaser2ill-tempered person, bad-tempered person
argasjón	eyesore; offensive sight
Argentina	(sern. landafr.)the Argentine (republic), Argentina;(am.)Argentina
argentin(ar)i	Argentine, Argentinian
argentinskur	Argentine, Argentinian
arggivin	addicted (to), desirous (of)
argiligur	scandalous, offensive
arging	teasing, banter, chaff
argingarsamur	mischievous(t.d.mischievous child)
argjalimur	1pauper2ramshackle thing
argjamáltíð	snack
argjamunnur	síargjamáltíð
argument	sípróvgrund,grundgeving
argumentatión	sípróvførsla
argumentatiónsanalysa	sípróvførslugreining
argur	1given to(t.d.be given to gossiping, stealing, biting)2furious (with), infuriated (by); embittered3greedy (to, for),argur eftir ogn og ræði4wicked, bad, nastyhansara argasti fíggindihis worst enemy;hansara argasti mótstøðumaðurhis bitterest opponent;hin argastithe odious one, the Devil
aria	(tónl.)aria
ariaraváttan	Aryan certificate
ariari	(sø. og við nazistiskum heiti)Aryan
aristokrati	aristocracy
aristokratiskur	aristocratic
aristokratur	aristocrat
aritmetikk	algebra
aritmetiskur	arithmetic(al)
ark1	sheet;eitt pappírsarka sheet of paper
ark2	(bíbl.)ark;Nóa arkNoah's ark;sáttmálaarkinthe Ark of the Covenant; síannarsørk
arkabrot	folio
Arkangelsk	(sern. landafr.)Archangel
arketýpa	archetype;viðvíkjandi arketýpumarchetypal
Arkimedes	(sern.)Archimedes;lóg ArkimedesarArchimedes' principle
arkir	síørkel.ark
arkitektakapping	architectural competition
arkitektavirki	firm of architects
arkitektlampa	adjustable lamp, anglepoise lamp ®
arkitektteknaður	designed by an architect, architect-designed
arkitektur	architect
arkitekturur	architecture
arkiv	archives;(handilsm.)files; samansetingarsískjalasavn,skjalagoymsla,ríkisskjalasavno.tíl.
arkivarur	archivist, keeper of the archives;sískjalavørður
arkivera	arkivera eitt skjal file a document
arktiskur	arctic;Arktiska ráðiðthe Arctic Council
arma	arma út impoverish
armadómur	síarmadømi
armadømi	poverty, indigence, wretchedness, misery
armakot	armpit
armalangur	with long arms
armasterkur	strong-armed
armastuttur	with short arms
armatøk	(Suð.)(í glíming) shoulder hold
armaveikur	with weak arms
armband	bracelet
armbandsur	wristwatch
armbind	(bandage) bandage; (at stuðla armin) sling; (sum eyðkenni) armband(t.d.a black armband)
armbrot	armfracture
armen(ar)i	Armenian
Armenia	(sern. landafr.)Armenia
armenskur	Armenian
armføtla	Brachiopoda
armingi	poor creature
armingshús	(gl.)workhouse
armleggur	(lívfr.)humerus;(tlm.)funny-bone
armóð	1poverty, distress, need(forml.)destitution;djúpasta armóðextreme poverty;andalig armóðspiritual poverty2wretchedness, misery, squalor, misery3exhaustion, fatigue
armóðsligur	poor, needy, penniless, miserable, wretched
armóðsmaður	poor man
armringur	arm ring, bangle
armslongd	arm's length
armstólur	arm chair
armstyrki	arm strength
armtak	(í svimjing) stroke
armur1	1arm;taka í armin á e-mtake sby by the arm; take (hold of) sby's arm;við frakkanum á arminumwith a coat on one's arm;við einum barni á arminumcarrying a child on one's arm;hon gekk arm í arm við honumshe walked arm-in-arm with him;hon tók undir armin á honumshe took his arm;leggja armin um e-nput one's arm round sby;við opnum ørmumwith open arms;renna beint í armarnar árun straight into the arms of;tveita seg í armarnar á (eis. fl.m.)throw oneself into sby's arms2(á stólio.tíl.)arm3(á ljósakrónu, ljósastakao.ø.)branch4(fl.m.) lógarinnar (langi) armurthe (long) arm of the law;longdi armurauxiliary arm; right-hand man; tool, puppet,hansara longdi armur (t.e.hjálpari) his right-hand man;dómstólarnir vóru bara longdi armurin hjá einaræðinginumthe courts were merely an extension of the dictator's power; the courts were merely the dictator's stooges(el.tools);(fl.m.) geva tí allan armin (tlm.)pull out all the stops, give it the works, give it all you've (,o.s.fr.)got, go the whole hog, go to town, go all out;(fl.m.) vit mugu taka tað við stívum armiwe must grit our teeth and bear it; we must keep a stiff upper lip5[ísamb.viðfs]armíarmarm in arm;bera eitt (barn) í ørmunumcarry sth (, a child) on one's arm;doyggja í ørmum hansaradie in his arms;hava í sínum ørmumhold in one's arms;mátti klípa seg í arminhave to pinch oneself;reka e-n beint í armarnar á e-mdrive sby into the arms of sby;renna beint í armarnar á e-mrun straight into sby's arms;taka í armin á e-m (og rista hann)seize sby by the arm (and shake him);hava bindumarmin(eyðkenni) wear an armband (, armlet);hann hevði hanaundirarminumhe had her on his arm;bera undir arminumcarry sth under one's arm;hon tók undir armin á honumshe took his arm, she linked arms with him;halda eittviðstívum armilift (, hold) sth at arm's length;hatta mugu vit taka við stívum armiwe must grit our teeth and bear it; we must keep a stiff upper lip
armur2	1poor, miserable, needy, penniless2unfortunate, unhappy
armvøddi	arm muscle
arnar	síørn
arnarklógv	eagle's talon
arnarnev	eagle's beak
arnarnøs	aquiline nose
arnarreiður	eyrie; eagle's nest(flteagles' nests);(serl. am.)aerie
arnarungi	eaglet
arnarvongur	eagle's wing
arr1	1scar(eftirfrom,t.d.a scar from a blow); (langt smalt) seam2(fl.m.) scar(t.d.the terrible experience had left a scar; the scars of the recent war)
arr2	(stb.)(um ljóð hjá lomviga)síkarr
arrutur	scarred
arsbøllur	buttock
arsenikk	(evnafr.)arsenic; arsenic trioxide
arshol	asshole
arsur	backside, behind, seat, arse
art	1nature, character, disposition2(um kríatúr)vigour3(hjá kríatúri) sperm, semen
arta	1arta seg(bera seg at) behave(t.d.I hope the children will behave properly)2(mennast) develop;(tlm.)shape (up)(t.d.the boy is shaping well; things are shaping up nicely); (hilnast) turn out(t.d.let's see how he (, it) turns out; it turned out all right in the end)
artaður	væl artaður well disposed,illa artaðurbadly disposed
artargóður	of a good disposition
arva	1inherit(t.d.a large sum of money; a lot of problems; one's mother's sweet temper);hann arvaði tað eftir mammusystrinahe inherited it from his aunt;hann fer at arva mammusystrinahe is sole heir to his aunt; (um pening o. a.eis.)come into(t.d.he came into a fortune when his father died; he has been left some money);(forml.)succeed to(t.d.the estate, the throne; he succeeded to his father's property)2(lívfr.)inherit;arvaðir eginleikarinherited characters;sum kann arvastinheritable
arvaavgjald	1(sjálvt búgvið) estate duty (tax)2(hjá einstøkum arvingi) inheritance duty (tax)
arvaavkall	waiver of inheritance
arvaavkannan	síarvaavkall
arvaavsøgn	síarvaavkall
arvaborin	entitled to inherit
arvabrek	hereditary defect(el.vice)
arvabræv	1(løgfr.)will, last will and testament2[ísamb. viðs]broyta arvabrævalter one's will;fáa kongliga váttan fyri arvabræv[obtain Royal confirmation of a will];fullgera eitt arvabræv (løgfr.)execute a will;geva honum eina upphædd í arvabrævinumleave him a sum of money;kalla arvabræv afturrevoke a will;lata arvabræv uppopen a will;lata e-m við arvabrævileave sth to sby;leggja arvabræv eftir segleave a will;nevna e-n í sínum arvabrævimention sby in one's will;ógilda arvabrævaside(el.invalidate) a will;arvabræv sambært lógumwill in proper form;skriva arvabrævmake a will, draw up a will;doyggja og ikki hava skrivað arvabrævdie intestate;vitna um arvabrævwitness a will;av tí at einki arvabræv erin the absence of a will3[ísamb. viðl]eitt burturmist arvabræva lost will;eginhandar arvabrævholograph will;falsað arvabrævforged will;felags arvabrævmutual willsflt;gilt arvabrævvalid will;sínámillum arvabrævmutual willsflt4ískoyti til arvabrævcodicil
arvabýti	distribution of an estate
arvadúnurt	(plfr.)Alpine Willowherb(Epilobium anagallidifolium)
arvaeginleiki	(lívfr.)heredity, gene
arvafall	succession
arvafesti	copyhold
arvafíggindi	hereditary enemy;arvafíggindin (fjandin)the archfiend
arvafíggindskapur	hereditary enmity
arvaforskot	advancement(t.d.the advancement made by the deceased; he has had an advancement from his father);veita einum arvaforskotmake an advancement to sby
arvafrøði	síarvalæra
arvafylgja	order of succession; succession
arvafylgjukríggj	war of succession(t.d.the War of the Spanish Succession)
arvafylgjulóg	law of succession;(svarar til)Administration of Estates Act; (um trúnfylgju) law regulating succession to the throne; (í Ongl.) the Act of Settlement
arvagingin	síarvaskotin
arvagjald	(løgfr.)death duty, succession duty, estate duty
arvagóðs	1(arvaðir ognarlutir) inheritance2(arvað jørð) hereditary estate
arvagranskari	geneticist
arvagransking	genetics; genetic resesarch
arvagrein	síarvalutur
arvagrógvin	síarvaskotin
arvagull	heirloom of gold, family gold
arvajørð	hereditary land
arvaklandur	dispute about a will
arvakongur	heriditary king
arvakrav	claim to succeed to property; (til trúnu) hereditary claim
arvaleivd	(bíbl.)share of (an) inheritance
arvaleysur	disinherited;gera arvaleysandisinherit,(tlm.)cut off (with a shilling);arvaleyst góðsbona vacantia; (við ongum arvingum) without heirs
arvaligur	hereditary(t.d.monarchy);(lívfr.)hereditary(t.d.characteristic; defect, disease, malformation);arvaliga ásetthereditary;arvaligt brekhereditary taint; genetic deficiency;arvaligur eginleikihereditary character;arvaligt hjáhereditary in; inheritable;arvaliga tyngdur(afflicted) with a hereditary taint, tainted
arvalóg	1(løgfr.)inheritance act2(lívfr.)law of heredity
arvaluting	distribution of an estate, handing over an inheritance
arvalutur	hereditary part; share of an inheritance
arvalæra	(lívfr.)theory of heredity; (sum lærugrein) genetics
arvapartur	hereditary part
arvaprinsur	heir presumptive (to the throne)
arvareglur	rules of succession
arvarenta	(trygg.)temporary annuity
arvaríki	hereditary realm
arvarættarligur	concerning the law of wills and succession
arvarættindi	hereditary right
arvarættur	1(rættur til arv) right of inheritance(el.succession)2(rættarreglur um arv) law of wills and succession
arvasáttmáli	covenant concerning the succession to property; (um trónfylgju) covenant concerning the succession;(løgfr.)dispositive
arvasilvur	family silver
arvaskeyti	(løgfr.: kann verða endurgivið)conveyance by assent
arvaskifti	(løgfr.)administration of a deceased person's estate
arvaskjal	(løgfr.)will, testament
arvaskotin	overgrown with weeds
arvastríð	dispute about a will or succession to property
arvastykki	heirloom
arvasynd	(átr.)original sin;ljótur sum arvasyndinas ugly as sin
arvavaksin	síarvaskotin
arvborin	síarvaborin
arvbærur	(lívfr.)hereditary(t.d.characteristic; defect, disease, malformation)
arvfrøði	(lívfr.)genetics
arvi1	(plfr.)(various) weeds
arvi2	(kvæð.)síarvingi
arviligur	hereditary(t.d.characteristic; defect, disease, malformation)
arvingi	heir (to); (um konufólk) heiress(t.d.the heir(ess) to the estate);rættur arvingilawful successor;arvingi til stórar ognirheir to a fortune;lógligur arvingiintestate successor;rættur arvingilawful successor;tey hava fingið ein arvingthey have had a baby, (um tann fyrsta) they have had an heir;arvingar í fallandi ættleggiheirs in direct line of descent;arvingar í rísandi (stígandi) ættleggiheirs in lineal ascent; heirs in the direct line of ascent;arvingar í sama ættleggiheirs in direct line
arvingur	síarvingi
arvland	hereditary kingdom
arvleggjari	1testator; (kvinnuligur) testatrix2(við ongum arvabrævi) intestate
arvleiddur	testamentary;hjby will;arvleidd ásetingtestamentary disposition;arvleidd gávabequest, legacy;arvleidd veiting í samb. við fastogndevise;arvleiddur verjiguardian appointed by will; testamentary guardian
arvleiðingarbræv	síarvabræv
arvleysur	síarvaleysur
arvmentir	tradition
arvorð	(málfr.)native word
arvríki	(sø.)hereditary realm
arvsynd	(átr.)síarvasynd
arvtakari	(løgfr.)síarvtaki
arvtaki	(løgfr.)síarvingi
arvtøka	tradition
arvur	1inheritance(t.d.the money came to him by inheritance; he received a large inheritance from his uncle; he soon spent all his inheritance); (við arvabrævi) legacy, bequest(t.d.the stamp collection is a legacy from an uncle); (peningur, ognarvirði) fortune(t.d.his father left a large fortune; he came into a large fortune when his father died); (føst ogneis.)devise;arvur sambært sáttmálainheritance under a will2(tað ið verður arvað) inheritance, succession, estate; (sambært testamenti) legacy, bequest; (av fastari ogn,eis.)devise; (eftir faðirel.forfedrar;serl. sø.ogskaldsk.)patrimony3(mentanarliguro. a.)heritage(t.d.our cultural (, national) heritage; the proud heritage of England)4(fylgjur) legacy(t.d.it is a legacy of the 18th century; the Stalinist legacy)5(lívfr.)inheritance(t.d.does it depend on inheritance or environment?; his stubbornness is an inheritance from his mother); heredity(t.d.they seem to be good-looking by heredity; his weak nerves were an inheritance from his mother);(lívfr.) arvur og umhvørviheredity(el.inheritance) and environment6[ísamb.viðsogfs]fáaí arvinherit, be left(t.d.a fortune), succeed to;ganga í arvbe handed down(t.d.it has been handed down in our family for generations);gangaí arv tilpass to; descend to(t.d.the estate descended to the eldest son); pass to(t.d.the estate passed to his younger brother);(fl.m.t.d.um klæði) be passed on to(t.d.this tradition has been passed on from father to son through generations); be handed down(t.d.it was handed down from father to son);(lívfr.)be transmitted to(t.d.this quality was transmitted to his son);lata ganga í arv tilpass on to;gevahonum tað til arvs og ognarmake him a present of it;góðtakaarv og skuldaccept the inheritance(el.take over the estate) with its assets and liabilities;(fl.m.)lyftaarvin eftir e-nfollow in sby's footsteps, succeed sby; take on(el.assumeel.wear) the mantle of;hava tungan arv at lyftahave much to live up to;ogna við arviacquire by inheritance, inherit;ognast honum sum arvurfall to him by inheritance;takaarvin upp eftir hannfollow in his footsteps;taka við arvienter upon an inheritance;útihýsafrá arviexclude sby from the succession; disinherit sby;viðarviby inheritance
A-rættur	(handilsm.) share right;tilluting av A-rættiallotm. share right;umbýti av A-rætticonv. share right
as	toil, struggle, heavy work
asa	toil, struggleasa seg útwear oneself out
Aserbadjan	(sern. landafr.)Azerbaijan
aserbadjan(ar)i	Azerbaijani
aserbadjanskur	Azerbaijani
asfalt	tarmac
asfalta	síasfaltera
asfaltera	tarmac;asfalteraður vegurtarmac road
asfaltfrumskógur	asphalt jungle
asfaltmálari	pavement artist
Asia	Asia
asiati	Asian
asiatiskur	Asian(t.d.the Asian flu);(niðr.)Asiatic;asiatiska TurkalandTurkey in Asia
ask	(plfr.)ashslag: fraxinus ornus © Wikimedia Commons
A-skatta	tax at source
A-skattur	[tax deducted from income at source]
askorbinsýra	ascorbic acid
askur	(plfr.)ash;eis.ask
askviður	ash wood
asnafoli	ass's foal(el.colt)
asnafyl	ass's foal, ass's colt
asnagreðingur	he-ass, jackass
asnaross	(dj., sj.)síasni
asnaryssa	she-ass
asnaspark	(uml.)hit(el.kick) a man when he is down; stab sby in the back, kick sby in the teeth
asni	(dýr.) (Equus asinus)ass, donkey;(tlm.)moke;(am.bara) donkey;(tað er) søgan um asnan og gularótinait's the story of the stick and the carrot;treiskur sum asnin(as) stubborn as a mule;villur asniwild ass;líkur asnaass-like
aspargus	(plfr.)asparagus;eitt aspargusan asparagus stalk(el.shoot); (sum matur) an asparagus spear;(tlm.)an asparagus(fltasparagus)
aspargushøvd	asparagus tip© Wikimedia Common
aspirantur	probationer;(ofta =)applicant, candidate
ass1	shit, fuck, bugger it
ass2	be about to, be on the brink of
assa	(stb.)twaddle
assistentur	assistant; (á skrivstovu) clerk; (sjúkrasystir) ward sister
assuransi	(gl., tlm.)insurance; (um lívstryggingeis., fakl.)assurance
assýri	Assyrian
Assýria	(sern.) (sø.)Assyria
assýriskur	Assyrian
astma	(lækn.)asthma
astrologi	sístjørnuspeki
astrologur	sístjørnuspámaður
astronautur	sírúmdarfari
astronomi	sístjørnufrøði
astronomur	sístjørnufrøðingur
at1	í osb: sum;at í sjónumrough sea
at2	1(um broyting) to,komin at endacome to an end;av mold ert tú komin, at mold skalt tú verðaearth to earth, ashes to ashes, dust to dust2(um tíð) towards,at kvølditowards evening3(umskriving fyri hvsf.)faðir at barninumthe child's father;upprunin at e-mthe origin of sth4í osb: verða manni at banabe the cause of someone's death;kom ikki at málingini!don't touch the paint!;halda sær at gaman el. gamnibe merry (, gay, jolly);væl at sær komincompetent, capable, proficient, able;hava at e-mrebuke, reprove, reprimand sby;finnast at e-mblame, criticize sby;síannarsatí sambandi við navnorð og sagnorð
at3	1(vanligir at-liðsetningar)1that(t.d.is it true that he is so rich? I know that it is impossible); (sagt ofta við ing-sniði í sagnorðinum)(t.d.I do not like his saying so; I hope you will excuse my being late); (verður ofta ikki týtt)(t.d.I would rather you did not go; I know it is impossible); (verður stundum sagt við navnhátti)(t.d.I know it to be impossible)2(um ætlan) in order that(t.d.I am telling you this in order that you may be on your guard); (so) that3(um fylgju) that(t.d.so fast that)4(í útrópum) that(t.d.that such a thing should happen to me)5(= síðan) since, that(t.d.what have I done since(el.that) you are so angry?)
at4	(navnháttarmerkið) to
ata	síøt
atborið	handled, done, performed,skjótt mátti verða atboriðthey had to act swiftly
atburðar-	behavioural
atburðargranskari	ethologist; behavioural scientist
atburðargransking	ethology; behavioural research
atburðarmynstur	behaviour pattern
atburðarnormur	behavioural norm
atburðarsálarfrøði	behaviourism
atburðartrupul	maladjusted(t.d.children) with behaviour difficulties;(tlm.) atburðartrupult barna problem child
atburðartrupulleikar	behavioural problems
atburðarviðgerð	behaviour(al) therapy
atburðarvísindi	behavioural sciences
atburður	1behaviour (mótvegistowards),(t.d.unconventional behaviour), demeanour2(sálarfr.)behaviour, way of behaviour, behavioural pattern3(virkisháttur) conduct(t.d.brave conduct)4(fólkaskikkur) mannersflt (t.d.teach them good manners; apologize for their bad manners)5practice, procedure, course, approach6[íyms.samb.]eygleiða atburð hjá børnum (, dýrum)observe (, study) children's (, animalo.s.fr.)behaviour;hava løgnan atburðbehave suspiciously;hava sømiligan atburðconduct oneself in a seemly manner; observe the proprieties;tað var ein undarligur atburðurwhat peculiar behaviour; what a peculiar way of behaving;heiðurstekin fyri góðan atburðgood-conduct prize; demeanour
atdjúpur	deep close into land
atdráttarkraft	(alisfr.)attractive force, force of attraction, gravitation; eis.atdráttarmáttur
atdráttarlóg	(alisfr.)law of gravitation
atdráttarmáttur	síatdráttarkraft
atdráttarmegi	1charm, attraction;(forml.)allure2(alisfr.)attractive force, force of attraction
atdráttarmikil	attractive (to, for)
atdráttur	1attraction(t.d.of a magnet, of the earth, of the moon)2attraction, fascination(t.d.the mountains held an irresistible fascination for him); call(t.d.the call of the great open spaces);kenna atdrátt at e-mfeel drawn towards sth; (sterkari) yearn for sth.
atdýpi	(sj.)depth close into land
atelier	(til myndlist og film) studio
atevni	additive
atfangakvøld	eve
atfeingi	materials
atferð	behaviour, conduct, demeanour;sí eis.atburður
atferðardrag	(sálfr.) behavioral traits
atferðarfrøði	(sálfr.)ethology
atfinnari	critic
atfinning	objection, grievance, criticism
atfinningarsamur	critical (of), inclined to criticize
atfinningarsemi	criticism, inclination to criticize
atfinningarstig	level of criticism
atfinningarverdur	open to criticism(t.d.a procedure which is open to criticism); (siðvenjuliga skeivt,(forml.) reprehensible(t.d.there is nothing reprehensible about this procedure)
atfinsla	síatfinning
atføri	strategy
atgeingi	accessibility
atgerð	1measure, precaution, step;hálvar atgerðirhalf measures;seta í verk atgerðiradopt(el.take) measures, take steps, take precautions(ímótiagainst);seta í verk atgerðir móti (eis.)provide against(t.d.provide against accidents; we must provide against inflation in time);seta í verk álvarsligar atgerðirtake severe measures, take a strong line;seta í verk hóskandi atgerðir (eis.)take appropriate action; take action accordingly(t.d.we heard the news, and took action accordingly)2attack (on)(t.d.make an attack on), (hevndar-) retaliation3initiative, enterprise, attempt, act4(teld.)operation
atgerðaloysi	lack of initiative, ineffectiveness
atgerðarnevnd	action committee
atgerðarætlan	contingency plan
atgjørt	tað er einki atgjørt at that cannot do any harm; there is no harm in -ing
atgonga	1attack, assault2(sj.)admittance, access, approach;veita e-m atgongulet someone in
atgongd	1(loyvi at koma inn) admission(t.d.no admission after 10 o'clock);(forml.)admittance;fáa atgongdbe admitted;(forml.)obtain admission, gain entrance(tilto);geva atgongd tiladmit to; give access to;sum gevur atgongd tilbe a qualification for(t.d.university studies);henda próvtøkan gevur atgongd tilthis examination (, degree) qualifies the holder for2(møguleiki at fáa, sleppa framato.tíl.)access(t.d.access to books (, computers, information); public access to woodlands; easier access to abortion; have access to the minister)3facilitiesflt (t.d.for cooking; for golf and tennis);við atgongd til køkwith use of kitchen4(vegur til) access(t.d.Switzerland has no access to the sea); approach(t.d.the only approach to the house); entrance(t.d.entrance is by the side door)5(loyvi at tosa við) access(t.d.he has access to the minister);fáa atgongd til atget the opportunity of -ing(t.d.reading the report):6[íyms.samb.]banna e-m atgongd tilrefuse sby admittance to, refuse to admit sby to;banna honum atgongd til leikvøllinwarn him off the sports ground;banna honum atgongdrefuse to let him in(el.to admit him);(forml.)forbid him to enter;banna honum atgongd tilrefuse him admittance to; refuse to admit him to; bar him from(t.d.the club);banna afrikanarum atgongd til universitetið (eis.)debar Africans from the university;atgongd bannað, eingin atgongdNo Admittance (except on Business); (á vegaskelti) No Road!, No Thoroughfare!; Private; (til skóg, bøo.tíl.)Private, No trespassing, Trespassers will be Prosecuted;eingin almenn atgongdthe public is not admitted;fáa atgongdobtain admission, be admitted;frí atgongd tilfree access to;hava (, geva honum) fría atgongd til garðinhave (, give him) the run of the garden;kortið gevur atgongd til parkinathe card admits the holder to the park;50 pence gjald gevur atgongd tilon payment of 50 p. visitors are admitted to;nokta honum atgongdrefuse to admit him;við atgongd til køkwith use of kitchen
atgongdartíð	(teld.)access time
atgongdur	accessible
atgonguambætari	access server
atgonguávaring	access warning
atgongueftirlit	admittance control;(teld.)access control
atgongugjald	admission
atgongukoda	(teld.)access code
atgonguloyniorð	password
atgonguloynital	pass code
atgonguloyvi	admission, permission to enter; (skrivligt) permit;(teld.)access permission
atgongumerki	1(admission) ticket (til to), admission card, entrance card, pass2(fl.m.)open sesame (to,t.d.his name became my open sesame to the most exclusive clubs)
atgongupeningur	admission, (pay (for) admission)
atgonguprógv	1entrance examination2admission(el.entrance) card(el.order); admittance card; admission(el.entry) ticket
atgongupunkt	access point
atgongustað	access point
atgongutreyt	admission(el.entryel.entrance) requirement
atgonguvertur	access server
athall	(málfr.) convergence
athugaverdur	síáhugaverdur
athugi	síáhugi
athyggjandi	worth looking at, worth watching
athyggjari	(sj.)onlooker
atknýti	attachment
atkoma	1arrival(serl.of young seabirds)2access (to),vit høvdu atkomu at øllum skjølunumwe had access to all the documents3(sj.)opportunity4(teld.)admission
atkomandi	accessible,available
atkomuligur	accessible,lættliga atkomuligureasily accessible, easy of access; within easy reach (of); well within reach (of); easily comprehensible;alment atkomuliguropen(el.accessible) to the public; public
atkomupláss	landing place
atkomuvegur	approach (road)(t.d.to the city)
atkúpa	(lækn.)síeygnakúpa
atkvøða1	(stjm.)vote;greiða atkvøðuvote;(forml.)cast one's vote;fáa tað til atkvøðuput it to the vote;formaðurin hevur avgerandi atkvøðunathe chairman has a casting vote;fáa flestu atkvøðurnarhead the poll;fáa næstflestu atkvøðurnarbe runner-up;fáa fæstu atkvøðurnarfoot(el.be at the bottom of) the poll;atkvøðurnar sum flokkurin eigurthe voting strength of the party;hvussu er atkvøðan?what is the vote?;atkvøðurnar standa á jøvnumthe voting is equal; it is a tie;ein atkvøða ímótia dissentient vote;samtykt við 30 atkvøðum móti 20passed (, adopted) by 30 votes to 20;samtykt við øllum atkvøðum móti einaripassed with (only) one dissenting(el.dissentient) vote;vrakað (viðtikið) við 30 atkvøðum ímóti 10rejected by thirty votes against(el.to) ten;misálitisatkvøðavote of censure, vote of no confidence;álitisatkvøðavote of confidence;tann avgerandi atkvøðanthe casting vote(t.d.the Chairman has the(el.a) casting vote)
atkvøða2	(stjm.)vote;atkvøða skrivliga ella loyniligavote by ballot;atkvøða við at rætta hondina uppvote by show of hands;atkvøðacast one's vote;atkvøða fyricast one's vote foratkvøða fyrigive one's vote to;atkvøða um taðput it to the vote, take a vote on it;ikki greiða atkvøðuabstain (from voting); í samb.v. atkvøðu spyr formaðurin: all those in favour? all those against?;1000 atkvøddu fyri honum1000 votes were cast for him
atkvøðugreiðsla	1voting; (einstøk) vote(t.d.the bill will probably come to a vote soon)2(í klubba, yrkisfelag; loynilig, skrivlig) ballot3(skrivlig,serl.um val til ting) polling; (einstøk atkvøða) poll;greiða atkvøðutake a vote (, balloto.tíl.); koma til atkvøðugreiðslucome to a vote(t.d.the bill will probably come to a vote soon);avgera málið við atkvøðugreiðsludecide the matter by a vote4[ísamb.viðfs]fara til atkvøðugreiðslutake a vote (, balloto.tíl.); fáa til atkvøðugreiðsluput to the vote;fáa broytingaruppskot til atkvøðugreiðslu(ES) put the amendment to the vote;hann fekk flestar atkvøður á atkvøðugreiðslunithe ballot (, voteo.s.fr.)resulted in a majority for him; he headed the poll;hetta uppskot varð lagt fram og kom til atkvøðugreiðsluthe following motion was proposed and put to the vote;avgerð varð tikin við atkvøðugreiðslu millum eigararnarthe owners decided the matter among themselves by a vote;viðtikið við ongari atkvøðugreiðslupassed without being put to the vote;(ting.)passed without a division;atkvøðugreiðsla við at rætta hondina upp(voting by) show of hands;við almennari atkvøðugreiðslu(ES) by open vote;atkvøðugreiðsla við fulltrúvote by proxy;atkvøðugreiðsla við navnakallivote by roll call;atkvøðugreiðslan fer fram við navnakallithe vote shall be taken by roll5[íyms.samb.]hava atkvøðugreiðsluballot, take a vote (, balloto.tíl.); hava atkvøðugreiðslu um verkfallhold a strike-ballot;hava skrivliga atkvøðugreiðslutake a poll (, ballot);krevja atkvøðugreiðslu (tingm.)challenge a division;krevja skrivliga atkvøðugreiðsludemand a poll (, ballot);loynilig atkvøðugreiðslavoting by ballot, secret vote
atkvøðugreiping	clearing agreement
atkvøðuhøli	polling station, polling place; poll(t.d.turnout at the polls was sluggish); polling booth, voting booth
atkvøðukassi	ballot box
atkvøðumissur	loss of votes
atkvøðuprosent	(valluttøka) poll(t.d.the poll was 73 per cent); turn-out
atkvøðurættur	1(politiskur) the right to vote;(forml.)franchise(t.d.franchise was confined to men);(tlm.)the vote2(partaeigari) voting right;vanligur atkvøðurætturuniversal suffrage;atkvøðurættur hjá konufólkumvotes for women;(forml.)woman suffrage;veita e-m atkvøðurættgive sby the vote;(forml.)enfranchise sby;við ongum atkvøðurætti(í samkomuel.um partabræv) nonvoting(t.d.delegate, member; share);við atkvøðurættientitled to vote; (veljari) elector;veljari sum hevur atkvøðurætteligible voter;limur við atkvøðurættivoting member;sum ikki hevur atkvøðurættnonvoting
atkvøðuseðil	voting paper, ballot paper
atkvøðuslúkur	(sk., stjm.)vote getter, vote catcher
atkvøðuspill	1(at spilla) a waste of votes2(spiltar atkvøður) wasted votes
atkvøðutal	number of votes, poll; atkvøðutølini(t.e.hagtølini) the voting figures(t.d.the voting figures started to come in)
atkvøðuteljing	counting of (the) votes
atkvøðuúrslit	poll, result (of the voting);staðfesta atkvøðuúrslitiðestablish the result of the count
atkyrktur	(stb., sj.)with a short tether
atlaðaður	(sj.)sloping(t.d.wall)
atlagari	(teld.)adapter, interface unit
atland	associated country
Atlantshav	(stn.)the Atlantic (Ocean);(sk.)the (Herring) Pond;ferð tvørtur um AtlantshavAtlantic crossing
Atlantsmót	(sern.)Atlantic Margin
atlantssamgonga	(herm.)the North Atlantic Treaty Organization;(stNATO)
atlas	atlas
atlask	satin
atlát	1signal2(teld.)password
atlátið	síláta at
atlimaskapur	associated membership
atlit	(e-m)við atliti at with regard to;við fíggjarligum atlitumfor financial reasons
atlop	(bjarg., stb.)attack, push, thrust
atløga	1attack, assault2initiative, campaign3landing place
atløgubrúgv	landing quay
atløgubryggja	landing quay
atløgupláss	landing place
atmosfera	1(jarðfr., stjfr.)lofthav, lofthválv2(al)lufttrýst, lofttrýst3dámur, huglag, hýrur
atom	(alisfr., evnafr.)atom;býta eitt atomsplit an atom
atombumba	(herm.)atom(ic) bomb, nuclear bomb;(am.) Snuke
atomorka	(evnafr.)nuclear(el.atomic) energy
atomøld	the Atomic Age
atra	síaftra
atreið	(kvæð.)attack (á hestbaki)
atrenning	(sj.)swig
atroynd	(gl.)heroic deed, combat, fight
atsansaður	sísansa at
atsetur	(teld.)address
atskoyti	(málfr.)affix
atslag	(stb., sj.)attack, assault
atsligin	sísláa at
atsmakkur	after-taste
atsókn	1attack, assault; persecution2visit
atsóknari	(gl., løgfr.)accuser; counsel for the prosecution, prosecuting counsel
atsóknarmaður	attacker;(forml.)assailant; aggressor
atstøða1	1assistance, relief, aid, help2treatment, care, nursing,
atstøða2	assist (at, in)
atstøðari	assistant
atstøðingur	assistant
atstøður	situation, circumstance, possibility, opportunity, chance
atstøðuskip	(skip.)standby vessel, standby boat
atsúgvandi	(t.d.atsúgvandi oljuverja) absorbent; eis.atsúgvin
atsúgvin	(t.d.atsúgvin oljuverja) absorbent; eis.atsúgvandi
atsøkin	aggressive
atsøkjari	1attacker;(forml.)assailant; aggressor2(løgfr., gl.)complainant
atsøktur	sísøkja at
attala	(løgfr.)complaint (about); objection
attalað	síátalað
atvendur	sívenda at
atvent	síadvent
atventa	síadvent
atvik	síatviki
atviki	(málfr.)indirect object
atvinna	trade, business, industry, occupation; sívinna
atvold	cause(t.d.malnutrition is the cause of many diseases);tað var ein atvoldin tilit was a contributory cause;vera atvold til e-t (eis.)cause sth; reason,hava atvold til e-t: tað er eingin atvold til at hava illgruna til hansarathere is no reason to suspect him
atvoldin	1cause (of,t.d.malnutrition is the cause of many diseases; the assassination was the occasion, not the cause of the war)2reason (for,t.d.what is the reason for his refusal?)
augitt	(jarðfr.)augite
august	August
augustmánaður	the month of August
auktión	(tlm.)auction, sale (of); hold an auction(el.a sale); buy it at an auction(el.a sale); sell it by auction; put it up for auction
av	1from,av bygdfrom the country2(í smb. við ávís staðanøvn) from,av Eiði;av Glyvrum3off,hann høgdi eina grein av trænumhe chopped a branch off the tree4(liva av) by(t.d.he lives by his pen)5(um ættirnar)av eystrifrom the east6(um tilfar ið nýtt verður til e-t) of(t.d.the house is built of wood; a curtain of silk; made of iron); from(t.d.tea made from strawberry leaves); out of(t.d.a cage made out of an old packing-case)7(viðv.uppruna)(t.d.a man of humble origin; goods of Faroese origin; a car of British make);av góðum fólkiof good family8(umskriving fyri hvsft.d.um part av størri heildel.um nøgd og innihald) of(t.d.I want two of these apples; most of them died; one of my friends); out of(t.d.nine out of every ten died; nine times out of ten); in(t.d.one in a thousand)9(um orsøk) of(t.d.die of hunger); from(t.d.he got a cold from staying out in the rain); with(t.d.he was green with envy; half-dead with fear; the grass is wet with dew; black with soot; tremble with fear; blush with shame); for(t.d.he jumped for joy)10(viðv.eginleikael.eyðkenni) of(t.d.a man of my type; a man of enormous strength; a man of high rank; a town of this size; a person of the same name)11(um tíð) past(t.d.it is past ten o'clock; a quarter past five; it is past midnight); after(t.d.it was after midnight when he came home; just after six o'clock)12(um tilelving) out of(t.d.he did it out of curiosity (, fear, jealousy, malice, pity, spite)); from(t.d.from politeness, from curiosity)13(um tilverugrundarlag, føðiel.pening) on(t.d.live on vegetables, on a small income; I don't want to live on my wife)14(niðr.andi) of(t.d.that fool of a woman); (av... at vera) for(t.d.highly educated for a peasant; I must admit that for a German he speaks English surprisingly well)15(í smb. við tolsøgn) by(t.d.the house was built by an architect; the ship is propelled by a screw; a novel by Dickens)16(saman við hjáorði)off(t.d.he took the lid off; he scraped the paint off; he knocked the top off)17í osb: av og á,now and then, now and again, occasionally, off and on, at intervals, from time to time18GG: viðv.øðrum sambondum viðavsíseinnalið
avafturrunnið	> nú er avafturrunnið he has sobered up now
avbardur	1beaten, thrashed2knocked down (av vindi)
avbeklaður	(um skógv) worn down at one side
avbending	turning, deflection, deviation;avbending av ljóðbylgjudiffraction of a sound wave;avbending av ljósstráludeflection of a ray;magnetisk avbendingmagnetic deflection
avbendingarpláta	deflector plate
avbera	síavbæra
avbitin	cropped
avbjóðandi	(ertandi) provocative(t.d.a provocative reply; provocative conduct, provocative glances, provocative laughter); (treiskur) defiant(t.d.gestures); aggressive(t.d.manners, speech); challenging
avbjóðari	challenger
avbjóðing	challenge(t.d.to a duel, to a match; seek new challenges; he saw the job as a challenge);senda e-m eina avbjóðingsend sby a challenge;taka av avbjóðingaccept(el.take upel.meet) a challenge;(fl.m. eis)meet the challenge, take up the glove;eg taki av avbjóðingini (eis., tlm)I'll take you on, I'll take you up on that; you're on!
avblásin	(stb.)swollen, tumefied, tumescent, tumid
avblástur	neat, tidy
avblomstra	(um plantu) cease flowering; (um blómu) wither, fade;hon er avblomstraðit has finished flowering
avblóma	síavblomstra
avboð	cancellation(t.d.the dentist had a cancellation at 2 o'clock)
avbragdsstyrki	(sj.)extraordinary strength
avbrandaður	(gl.)in embers
avbreiddur	covered with, covered in
avbrek	injury, damage, harm
avbrendur	síavbrandaður
avbrigdi	variant
avbrongla	distort;(teld.)decrypt, decipher
avbronglaður	distorted
avbronglan	distortion
avbrotin	interrupted;síbróta av
avbroyting	(sj.)variant
avbrótari	(ravm.)switch; (á sjónvarpio.tíl.)on/off button
avbrýndur	polished; ground;síbrýna av
avbukaður	beaten, thrashed;síbuka av
avbundin	(veðurfr., stb.)overcast (and heavy with rain clouds)
avburðarmaður	outstanding man
avburðarseyður	top-grade sheep
avbygd	remote village, retired village
avbygdarfólk	people from other villages
avbygdarligur	(um útl. viðurskifti) provincial
avbygdarmaður	man from another village
avbygdarskapur	(um útl. viðurskifti) provincialism
avbygdur	1densely built-up2(við fuglit.d.)settled
avbyrgdur	secluded, isolated, shut off; segregated; (einsligur) solitary;sum er eitt sindur avbyrgtstanding somewhat apart, having a somewhat isolated position
avbyrging	1seclusion, isolation, (um lívshátt) retirement(t.d.live in retirement)2(sigl.)blockade; (arbeiðspláss) boycott; blockade; picket,taka av avbyrgingraise a blockade3(stjm.)containment(t.d.of communism)
avbyrgingarpolitikkur	(stjm.)policy of containment
avbyrgja	síbyrgja av
avbæra	most, exeedingly, extremely, highly
avbærur	excellent, superb, splendid, first-rate
avdagast	become night,nú avdagast ikkithere is daylight all night long
avdalur	remote village
avdankaður	1(oyðin) deserted(t.d.village)2(um bygning) derelict(t.d.farm, house)3abandoned(t.d.car, child, village);(forml.)forsaken(t.d.village);avdankað skipderelict ship;(oljuv.) avdankaður brunnurjunked well
avdálkaður	dirty; (sterkari) filthy;(tlm.)mucky; grimy;(tlm.)grubby
avdegnast	síavdagast
avdeyða	(um kríatúr)worn-out, decrepit
avdeyðadýr	(sj.)decrepitel.worn-out animal
avdeyðahundur	decrepit dog
avdeyðakúgv	worn-out cow
avdeyðalag	komin í avdeyðalag worn-out
avdeyðalamb	lamb from a worn-out ewe
avdeyðaneyt	worn-out cattle
avdeyðaross	worn-out horse
avdeyðaseyður	worn-out sheep
avdeyðaær	worn-out ewe
avdeyði	1worn-out sheep2(sk.)geriatric
avdeyður	(um seyð) worn out, decrepit
avdottin	sídetta av
avdoymi	deodorant
avdráttarfríur	(bú.)free of amortization;avdráttarfríur í fimm árno repayment for the first five years
avdráttargjald	(bú.)payment by instalments
avdráttarskái	(bú.)exemption from payment (by instalments)
avdráttarskeið	(bú.)period of repayment
avdráttartreytir	(bú.)repayment conditions(el.terms)
avdráttur	1(bú.)part-payment, instalment;í avdráttumby(el.in) instalments;gjalda í mánaðarligum avdráttumpay for it by monthly instalments;gjalda £50 í avdráttumpay off £502(um lán) repayment, instalment;rentur og avdrátturinterest and repayment;rentur og avdráttir av skuldini (eis.)the service of the debt;avdráttur av ríkiskuldrepaymentel.reduction of the national debt;sum avdrátturon account
avdrift1	sítvørburður
avdrift2	sítvørburður
avdrivin	sídríva av
avdubba	(herm.)disarm
avdubbaður	1warmly dressed2disarmed
avdubbing	(herm.)disarmament
avdúka	1unveil(t.d.a statue)2(opinbera, vísa) reveal(t.d.a secret, one's methods, one's plans, one's ignorance, what was discussed; the light revealed his hiding place; without revealing any details; the dress revealed rather too much of her)3(eitthvørt loyniligt) disclose(t.d.one's identity, one's intentions, his name, one's plans, a secret; the journalist refused to disclose (, reveal) his sources); unveil(t.d.one's plans, next year's models);(forml.)divulge(t.d.the details, one's fears, one's plans)4(ósjálvboðin) betray(t.d.one's ignorance; her tone of voice betrayed what she really felt);(tlm.)give away(t.d.his accent gave him away(el.betrayed him))¸avdúka seg sumreveal oneself as5(brotsgerðo.tíl.)expose, uncover(t.d.a crime, a plot, a scandal; new details have been uncovered by the press; expose his ignorance);(forml.)bring to light(t.d.a conspiracy)6(um brotsmann) find out(t.d.at last he was found out); expose(t.d.expose him as a thief); uncover, unmask(t.d.a spy);(forml.)unveil(t.d.a traitor);avdúka ein sum (eis.)show sby up as(el.to be)(t.d.a bad loser)
avdúkandi	revealing(t.d.comment, remark); telltale(t.d.blush)
avdúking	1unveiling2revelation(t.d.the revelation of the scandal; scandalous revelations in the press)3disclosure(t.d.the disclosure of the secret; new disclosures in the press);(sø. eis., (forml.) exposé4exposure(t.d.the exposure of the plot; he had to resign as a result of these exposures)
avdýpi	1abyss2(fl.m.)abyss(t.d.an abyss of horror; the country is on the edge of an economic abyss)
avdøma	condemn(t.d.everybody condemns violence)
avdøming	condemnation
avegna	[take a bait off the hook]
avegndur	[who has lost a bait off the hook]
aveimdur	(gl.) tað er aveimtthe fire has stopped smoking
aveldast	become obsolete, impaired by age
aveldur	obsolete(t.d.way of thinking), old fashioned(t.d.ideas)
avetin	cropped
avfaksa	cut a horse's mane
avfall	downpour, fall of rain (snowo.tíl.),rainfall, snowfall;(yrkism.)precipitation
avfallin	1(um hús) dilapitated, ramshackle, tumbledown2(um gras) died down3(um gomul fólk) weak, brittle, fragile4síavdottin
avfarin	come off, gone off,hann er avfaringone ashore;húðin er avfarinthe skin is raw
avfáing	1(lækn.)evacuation, motion, bowel movement, defecation2(um avføring) stoolsflt (t.d.hard (, thin) stools)
avfáingarevni	(lækn.)laxative
avfeitta	degrease
avfeitting	degreasing
avfelling	(gl. , handarb.)decreasing (í binding)
avferma	unload(t.d.a cargo, a ship, a lorry); (um lasteis.)discharge
avfita	(sj.)emaciate, slim
avflogin	síflúgva av
avfløði	(jarðfr.)regression
avfólka	depopulate
avfólkan	depopulation
avgaddaður	cropped
avgamal	very old, exceedingly old
avgangandi	1sloping, slanting2wedge-shaped3(veðurfr.)(um vind) about to change, becoming southerly
avgangur	end, departure, result
avgera	sígera(15)
avgerandi	1decisive(t.d.battle, influence, phase, step) (for);(forml.)crucial(t.d.moment, mistake, step) (to, for); key(t.d.factor, figure, issue)2(sannførandi) conclusive(t.d.argument; evidence against sby)3(endaligur) final(t.d.decision);siga avgerandi orðiðsay the (decisive) word;avgerandi atkvøðanthe swing vote;formaðurin hevur avgerandi atkvøðunathe chairman has the casting vote;av avgerandi týdningiof vital(el.decisiveel.crucial) importance;í avgerandi løtuat the critical(el.psychological) moment
avgerð	1decision(t.d.the final decision on this matter), settlement(t.d.settlement of a dispute); determination;avgerðin í málinumthe decision on the matter; the settlement of the matter;avgerðin fellur í morginthe matter will be decided tomorrow;hvussu avgerðin fer at verða (tlm.)which way the cat will jump;lata øðrum avgerðinarefer a decision to sby;(tlm.)leave it up to sby;leggja eina avgerð fyri e-nrefer a decision to sby;(tlm.)leave the decision (up) to sby;avgerðin var ímóti honumthe decision went against him;koma til eina avgerð(um persón) arrive at a decision; (um mál) be decided;avgerðin er hansarathe (final) decision lies with him;tá ið avgerðin skal verða tikin (tlm.)when it comes to the crunch;taka eina avgerðdecide, arrive at(el.takeel.make) a decision;tað er hann ið skal taka avgerðinathe decision rests with him;avgerð verður tikin í hvørjum máli særeach case is decided on its own merits2(í kappingel. løgfr.)adjudication3(hjá myndugleika, orðstýrara) ruling(t.d.the ruling of the committee (, the chairman) on the matter); (eftir orðaskiftiel.umhugsan) verdict(t.d.the panel will be giving their verdict tomorrow; the competitors were waiting for the verdict of the judges)4(viðv.gjaldi) payment, settlement5(hjá dómstóli) order
avgerðargongd	decision-making(el.decision-taking) (process); (at leggja ætlanir) policy-making process
avgerðarrættur	right to decide; decision-making power, power of decision
avgerðarstøði	basis for decision(s)
avgerðarvald	decision-making power, power of decision (t.s.s.avgerðarrættur)
avgingin	1defeated2(um sólina) gone down3(um klokkuna) past
avgirdur	fenced off
avgjald	1part-payment, (til tað almenna) duty (í flteis.)dues;(t.d.impose a duty on sth; pay duty on imported cars);), tax(t.d.impose a tax on), (excise) duty, tax(t.d.on tobacco, alcohol and petrol),skattir og avgjøldtaxes, rates and dues;leggja avgjald átax, put a tax on;(tlm.)slap a tax on; impost,skattir og avgjøldimpostsflt; (ESeis.)charge; (innlendis brúksgjald) tax, excise(t.d.on beer and tobacco)2(t.d.fyri pass, loyvio.tíl.)fee3(til høvund, tónasmiðo.tíl.)royalty(t.d.the royalities on his book amounted to £500)4(veggjald, brúgvargjaldo.tíl.)toll(t.d.the Panama Canal tolls)5instalment;í avgjøldumon account;í hondina ella í avgjøldumcash or by instalments; buy it on instalments(el.on hire-purchase);(tlm.)buy it on the never (-never);(am.)buy it on the instalment plan
avgjalda	pay by(el.in) instalments, pay instalments on;avgjalda eitt mánaðarligapay off sth by monthly instalments
avgjaldsamboð	(handilsm.) duty instrument
avgjaldsflokkur	(kann verða endurgivið) excise class
avgjaldsfríur	duty-free, tax-free; free of(el.exempt from) duty
avgjaldshækking	increase of indirect taxation
avgjaldslóg	fiscal act
avgjaldsolja	tax oil
avgjaldssáttmáli	(handilsm.) hire-purchase agreement/contract
avgjaldsskipan	1hire-purchase system;(am.)instalment system(el.plan)2(løgfr.)conditional sale; hire-purchase sale(el.deal el. trading);selja eftir avgjaldsskipansell it on hire-purchase
avgjaldsskylda	instalment obligation
avgjaldsskyldug	dutiable, liable to duty
avgjaldsstig	rate of levy(t.d.provisional rate of levy); rate of tax;hægsta avgjaldsstig(ES) maximum rate of charge
avgjaldsteggja	package (of increases in duties(el.taxes)
avgjaldstiltak	(indirect) taxation measure
avgjaldsvíðkan	increase of indirect taxation; increase of dues
avgjørdur	1settled,tað er avgjørt málthat has been settled;tað er (at kalla) avgjørt atit is (as good as) settled that2(týðiligur) definite;(forml.)decided(t.d.advantage, improvement)3(uttan iva) unquestionable, incontestable4(um fólk) decided(t.d.she was very decided)5[íyms. samb.]tað er avgjørt at hann kemurit is certain that he will come; there is no doubt that he will come;tað er at kalla avgjørt atit is as good as settled that, it is practically certain that;men tí er ikki avgjørt atbut that is not the same as to say that, but that does not necessarily mean that, but it does not follow that;men við tí er ikki alt avgjørtbut that does not dispose(el.is not the end) of the matter;tað er avgjørtit is settled;(t.e.tað kemur av sær sjálvum) it is a foregone conclusion, it goes without saying;ein avgjørdur fyrimunura decided (el. definite) advantage;ein avgjørd ábóta decided improvement(t.d.on the old system);ein avgjørdur meirilutian outright majority;tað er avgjørdur munur teirra millumthere is a decided(el.marked) difference between them;avgjørt sáttmálabrota definite breach of the treaty;avgjørdur sigura signal victory;ein avgjørdur stuðulan out-and-out supporter of free trade
avgjørt	1decidedly(t.d.I decidedly think so); unquestionably(t.d.he is unquestionably one of the greatest strategists of history); definitely(t.d.it was definitely a mistake to do that; I definitely prefer this tobacco to the other); certainly(t.d.it was certainly a mistake); without a doubt(t.d.that is without a doubt the best thing to do); emphatically(t.d.men who are emphatically boring); specifically(t.d.dismiss their credit as just another straight loan, which it specifically is not)2[íyms. samb.]sjúklingurin er avgjørt batnaðurthe patient is decidedly(el.definitely) better;eg havi heilt avgjørt ta fatan atI am decidedly(el.definitely) of the opinion that;jú avgjørt!yes, definitely!, certainly!okkara lið er avgjørt tað sterkara av teimum báðumours is easily the stronger team of the two;hann er avgjørt besti nevaleikari í Onglandihe is easily the best boxer in England;vilt tú hava hatta starvið? - nei avgjørt ikkido you want that job? ­ most emphatically not!
avglaðing	(jarðfr.) devitrification
avglaring	(jarðfr.)devitrification
avglasaður	(sj.)covered with ice
avgleraður	(sj.)covered with ice
avglering	(jarðfr.)deglaciation
avgloymdur	(sj.)forgotten, fallen into oblivion, consigned to oblivion
avgonga	1(veðurfr.)change of weather2(likam.)ejaculation;óviljað avgonga um náttina (lækn.)nocturnal emission
avgreiða	1(viðskiftafólk) serve(t.d.she serves in a bookshop; are you being served?);(forml.)attend to(t.d.are you being attended to, madam?)2(um bílegging) carry out;(forml.)execute(t.d.we are unable to execute your order before 1 April); (taka sær av) attend to, give attention to(t.d.your order will be given prompt attention)3(um vøru: senda) send (off);(forml.)forward, dispatch4(vørur í havn) handle5(skip, flogfar) turn (a)round6(mál) deal with, attend to7(resept) make up;(serl. am.)fill8(sleppa sær av við) dispose of9pay10[ymisk samb.]tá ið avgreitt verðurwhen delivered; on delivery;at rinda tá ið avgreitt verðurpayable on delivery;rinda í hondina tá ið avgreitt verðurcash on delivery, COD
avgreiðsla	1(skrivstova) office2(av viðskiftafólki) service3(av bílegging) execution4(av vøru: sending) forwarding, dispatch5(av vøru í havn) handling6(av skipi, flogfari) turn-around7(resept) making up8[ymisk samb.]átaka sær avgreiðslu avundertake to supply;klárur til avgreiðsluready for delivery;avgreiðsla seinniforward delivery;skjót avgreiðslaearly delivery;vantandi avgreiðslanon-delivery;avgreiðsla umgangadiprompt delivery
avgreiðsludagur	day of delivery
avgreiðslufráboðan	declaration, tender (form);(am.)notice of delivery, transferable notice
avgreiðsluskylda	obligation to deliver(el.to supply)
avgreiðslustaður	place of delivery
avgreiðslutíð1	time of delivery
avgreiðslutíð2	(teld.)turn-around time
avgreiðslutreytir	terms of delivery
avgreiðsluútreiðslur	cost of delivery
avgrevstur	removed sods, removed greensward
avgrivin	sígrava av
avgrund	1(bratt berg) precipice(t.d.on the brink of the precipice; fall over a precipice)2(gjógv) chasm; (heljareyga) gulf(t.d.a great gulf opened before them);(bókm.)abyss3(fl.m.)abyss; on the edge of the abyss(t.d.the country is on the edge of an economic abyss; an abyss of horror (, despair));(t.d.fall into an abyss); (sum skilir) gulf(t.d.there is a gulf between them); their points of view are poles apart; going down the slippery slope(t.d.the economy is going down the slippery slope)
avgrundsdjúpur	abysmal(t.d.ignorance)
avguda-	idolatrous
avgudadyrkan	idolatry
avgudadyrkari	idolater
avgudur	idol;dyrka avgudaridolize
avgustur	sperm whale(Physeter macrocephalus)
avgýttur	finished spawning
avgøta	wrong way
avhald	abstinence from alcohol
avhaldsdrykkur	non-alcoholic beverage(el.drink), soft drink
avhaldsfelag	temperance society
avhaldsfólk	total abstainers, teetotallers
avhaldslosja	temperance lodge
avhaldslyfti	(total abstinence) pledge;geva avhaldslyftitake the pledge;(am.) Sgo on the (water) wagon
avhaldsmaður	teetotaller, total abstainer
avhaldsmatstova	temperance restaurant
avhaldsrørsla	temperance movement
avhalga	profane; (sterkari) desecrate
avhamaður	beside oneself, madly in love,hann gekk so avhamaður eftir hennihe was madly in love with her
avhálaður	(sjóm.)síhála av
avhálkaður	extremely slippery
avheimila	(løgfr.)certify, verify, (við eiði) certify (on oath)
avhelli	(kvæð.)side cave
avhenda	transfer, convey, assign, make over, hand over, surrender (sth to sby)(t.d.make over the property to him; transfer the shares to him; assign a task to him; surrender the property to him; hand over the command to him; assign the command of an army to him)
avhending	transfer, transference, conveyance, handing over, making over, assignment, surrender;avhending av fastari ognconveyance of real property;avhending av ognarrættitransfer of ownership
avhendingarváttan	(serl.= skeyti) deed of conveyance; (um partabrøv) share transfer
avhildin	(generally) liked, well-liked; popular (with);hann er ógvuliga avhildin (eis.)he is a great favourite(t.d.with the pupils);ikki avhildinunpopular
avhoyra	1(løgfr.)(í rætti) examine; (vitnieis.)hear,verða avhoyrdur undir eiðibe heard on oath2(um løgreglu) interview(t.d.refugees; the police have interviewed all the neighbours); (serliga um mistonktan) question(t.d.a man is being questioned by the police); take a statement from; (gjølligari) interrogate
avhoyring	1examination; hearing2(løgregluavhoyring) interview; (serliga um mistonktan) interrogation
avhoyringarháttur	methods of cross-examination
avhómast	(stb.)decolourize; take on a darker colour
avhylja	síavdúka
avhæsaður	ended, stopped, ceased
avi	(kvæð.)síabbi
avillur	í osb: tað er avilt í brimi the breakers are nasty
A-vitamin	(lækn.) h3evitamin A
avís	(tlm.)(news)paper;hann sat og las avíshe was reading the newspaper
avísaður	covered with ice
avjaglaður	gnawed off
avjavnaður	levelled, smoothed
avkanna	avkanna sær rættin tilrenounce(el.relinquishel.waive) one's right to; disclaim(t.d.disclaim the authorship, all responsibility)
avkanning	(løgfr.) renunciation, waiving;óviljað avkanninginvolutary conversion
avkappaður	síkappa av
avkast	1(kortsp.)discarding2(bú.)síavlop
avkavað	covered with snow
avkálkaður	(sj.)avkálkaður í krími with a heavy cold
avklárnað	brightened up
avklæðast	undress
avkolaður	charred(t.d.the charred remains; the charred bodies of the victims)
avkom	1(um (ali)dýr) offspring(flt-) (of);(yrkism.)progenyflt(of)2(um fólk:skemt.)offspring(flt-)(t.d.her offspring are rather unbearable); progenyflt (t.d.her numerous progeny(el.offspring));(løgfr.)issue(t.d.leave issue; die without issue);alsamt fáa avkombreed true;sunt avkomhealthy offspring; a healthy progeny
avkomi	(sj.)descendant
avkomin	exhausted, worn out
avkotari	decoder
avkoyrdur	(sjóm.)dismissed, sacked
avkógvið	(stb.)síavkøvt
avkristna	(royna at) venda frá kristindómi,avkristna e-n
avkrossingarteigur	(teld.)checkbox
avkrókur	1remote corner; ((forml.) el.skemt.)nook2(av landinum) recess, corner, remote place, backwoods, out-of-the-way place, backwater;búgva í einum avkróki onkustaðnilive at the back of beyond3(lítil býur) one-horse town4(fl.m.)recess(t.d.the hidden recesses of the mind; the darkest recesses of the heart
avkubbaður	síkubba av
avkutaður	síkuta
avkúgan	extortion
avkvettur	síkvetta
avkvist	1[wings, tail and feet cut from a plucked bird]2(skemtum fólk) limbs (arms and legs);avkvistið á honum er so óstortsligthis limbs are so clumsy
avkvista	[cut off wings, tail and feet from a (plucked) fowl]
avkynja	desexualize, desex
avkynjaður	sexless
avkyrktur	avkyrktur í krími with a heavy cold
avkøvdur	síkøva av
avlaga	distort, garble, spoil, misrepresent, bring out of order
avlagan	distortion, misrepresentation
avlagdur	síleggja av
avlagi	(gl.)exceedingly, extremely
avlaging	1distortion, misrepresentation2(jarðfr.)dislocation
avlamdur	beaten, thrashed, flogged
avlami	disablement, invalidism
avlamin	disabled
avlamingi	disabled person
avlamisbilur	car for a disabled driver; (serligt slag) invalid car; (á bilaøkjum stendur) disabled drivers
avlamisforsorg	the care of disabled persons
avlamisfólk	disabled person
avlamislag	disablement
avlamispensjón	invalidity pension
avlamisstig	degree of disablement
avlamistrygging	disability insurance
avlamni	disablement, invalidism
avlamningur	disabled person
avland	remote (part of a) country
avlandsvindur1	offshore wind
avlandsvindur2	offshore wind
avlandsætt	offshore wind
avlangur	oblong
avlatin	sílata av
avlát	(átr., sø.)indulgence;fáa avlátget an indulgence
avláta	(sj., stb.)avláta seg fart
avlátsbræv	(átr., sø.)(letter of) indulgence
avleggur	(tlm.)layer
avleiddur	derivative, secondary;avleitt orðderivative
avleiðing	consequence(t.d.with disastrous consequences);fáa avleiðinghave consequences (for);fáa sum avleiðingresult in(t.d.a divorce);hava sum avleiðing athave the result that;taka avleiðingarnartake the consequences
avleiðingargreining	consequence assessment
avleiðis	off the track, on the wrong road
avleiðsla	(málfr.)derivative
avleiðsluending	(málfr.)(derivative) suffix
avlembdur	finished lambing
avlendis	abroad
avliðin	past, passed by
avlinju	(teld.)off-line
avlippaður	sílippa av
avlitka	decolourize; (bleikja) bleach
avlittur	(um lit) decolourized
avlíva	kill, put down, do away with
avlívis	í osb: skera, stinga seg til avlívis jab oneself badly
avljóð	(málfr.)ablaut, gradation
avlogaður	burned out
avlop	1left-over2surplus, profit, excess;(evnafr., likam. o.s.fr.)excess3(vinningur) profit, surplus, excess, balance;(rakstraravlop) trading(el.operating) profit;avlop eftir skattprofit(el.income) after tax;avlop fyri skattpre-tax profit(el.income);avlopið annan ársfjórðingsecond-quarter profits;avlopið fer til St. Jude's sjúkrahúsiðproceeds benefit St. Jude's Hospital;avlop á gjaldsjavnváginibalance-of-payments surplus; payments surplus; surplus on the balance of payments;avlop á fíggjarlóginibudget surplus;avlop á handilsjavnváginitrade surplus;geva avlopyield a profit; be remunerative;geva £100 í avlopiyield a profit of £100;hava avlop (eis.)be in the black;4residue(t.d.the residue from the experiment was mainly water)5surfeit(t.d.the country had a huge surfeit of corn)
avlops-	surplus(t.d.production, steam); excess(t.d.air, water)
avlopsgass	gas spiloff
avlopsgoymsla	surplus stock,avlopsgoymsla hjá herinumArmy Surplus
avlopshiti	surplus heat; waste heat
avlopsmegi	surplus strength
avlopspeningur	surplus of money, profit
avlopsskattur	(bú.)overpaid tax; (refund for) overpayment of tax
avlopsskifti	(gl., sj.)dividend
avlopsterri	(stb.)Indian summer
avloysa	1relieve (watch on ship) (t.d.anothersignalmanrelievedhim at 5.30)2(gl.)grant absolution
avloysari	1relief (t.d.the relief nurse was late)2substitute (t.d.Stewart was the Rovers substitute)3successor (t.d.Schoenberg saw himself as a natural successor to the German romantic school;Marywas the rightful successor to the Englishthrone)4replacement (t.d.please stay until we find a replacement for you)
avloysing	1relief2(átr.)absolution
avlukta	síavluta
avluta	part with, do without, dispense with
avlúsa	delouse
avlýsa	cancel, call off, declare off, (bílegging) cancel, annul, countermand(t.d.an order for goods)
avlýsing	1cancellation, calling off; (um ítróttartiltak) scratching; abandonment2dusk, twilight, gloaming
avlærdur	(gl.)fully trained, fully qualified
avlæsing	1(handarb.)casting off (í binding)2end, conclusion
avlæstur	sílæsa av
avlætting	1(jarðfr.) ablation2(handilsm.)adoption of the report (and accounts);geva avlættinggive discharge to; adopt the report;aðalfundurin gav stýrinum avlætting(uml. =)the general meeting discharged the directors from their obligations; the general meeting adopted the report
avmaktaður	worn out, exhausted; (og viknaður) run down;(tlm.)dead beat, all in, washed out
avmaktarsveitti	síómegasveitti
avmaktast	weaken(t.d.he weakened daily); lose strength
avmanna	1overpower2depopulate
avmarka1	re-earmark sheep
avmarka2	1(halda innan fyri mark) limit(t.d.armaments, one's desires, one's expenses; limit the working day to seven hours);avmarka vav (, ávirkan) av e-mlimit the extent (, effect) of sth; confine(t.d.one's activities to a minimum);(loyvið) verður avmarkað til (at galda fyri) (tey elstu)(the authorisation) is confined to (the eldest);avmarkaseglimit(el.confine) oneself to(t.d.speakers must confine themselves to a few brief remarks)2(minka um) reduce, restrict(t.d.restrict imports);avmarka atgongd til (eina útbúgving)restrict admission to (an education);(kongsvald) verður avmarkað við (grundlóg)(the powers of the sovereign) are restricted by (the constitution); curtail(t.d.sby's freedom, their rights); restrain(t.d.their activities); narrow down(t.d.the issue has been narrowed down)3(fl.m.: hugtak, evni) delimit(t.d.a subject, a problem) (from);tað er trupult at avmarka hetta evniðit is difficult to delimit this subject4define(t.d.a concept);avmarka hansara myndugleikadefine the limits of his authority;klárt avmarkaður (fl.m.)well-defined;týðiliga avmarkaður (fl.m.)well-defined(t.d.they are arranged in certain well-defined groups)5(um landaøki: vera mark til) bound(t.d.the country is bounded on the north by high mountains; England is bounded on the north by Scotland);(forml.)demarcate(t.d.a territory); (við hegnio.tíl.)divide off(t.d.part of a field); enclose(t.d.a square is enclosed by four equal sides)
avmarkaður	1bounded, limited2reduced, diminished
avmarking	1limitation,avmarkingar í tíð og rúmdlimitations of time and space2reduction;seta avmarkingar ámake reductions in sth ;3restriction;seta avmarkingar áimpose restrictions on sth;(t.d. are there any restrictions that we need to be aware of?)4limit; (t.d.the limits placed upon them were unfair);innan fyri ávísar avmarkingarwithin certain limits5restraint(t.d.a system of voluntary restraint on imports; conomic restraint kept him from proceeding6constraint(t.d.the only constraint they could think of was the weather)7circumscription(t.d.he refused to agree to a circumscription of his rights)8qualification(t.d.the qualification that we agreed upon was that he only worked part-time)9curtailment(t.d.they protested against the curtailment of civil rights)10containment(t.d.the containment of the damages was successful)11definition(t.d.by definition this phenomenon belongs under psychology)12(í uppgávu, frágreiðing) scope(t.d.he started by writing the aim and the scope of the thesis)13delimitation(t.d.the paper begins with a brief delimitation of the research object)
avmarvaður	rubbed off
avmáaður	símáa av
avmáttaður	weak, feeble, powerless
avmegingur	1enfeebled sheep2(um fólk) weakling
avmergja	impair(t.d.impair one's health), weaken,
avmergjaður	impaired, enervated; skinny, (ógvisligari) scrawny
avmintur	(sj.)forgetful
avmona	cut a horse's mane
avmóður	rested, refreshed
avmynda	1portray, picture, photograph2(støddfr.)map
avmyndan	1portrayal; portrait2(støddfr.)relation, mapping
avmyrking	darkening; blackout
avmæltur	hoarse, be struck dumb
avmøddur	1worn out, exhausted; (og viknaður) run down;(tlm.)(sum umsagnarliður) dead beat, all in, washed out2(stb.)rested, refreshed
avnema	síavtaka
avnokta	deny(t.d.deny the truth of a statement; he denied that he had done it(el.having done it)), disown, disclaim
avnoktan	denial, disavowal
avnoktari	denier (of God), atheist
avnor	stunted person (, animal), runt
avnoyðsla	extortion; (pengaavnoyðsla) blackmail, extortion
avnór	síavnor
avnutaður	rubbed off, worn (off)
avnøggaður	sínøgga
avokado	(plfr.)avocado(Persea gratissima)©iStock
avoldaður	out of date, obsolete, antiquated
avoyða	exterminate, extirpate, eradicate, wipe out, kill off, root out; deplete of fish(t.d.deplete a lake of fish); fish out(t.d.a lake);(GG:fish supplies in the Atlantic will be exhausted by the turn of the century)
avoyraður	without a handle
avparta	(tlm.)ganga avparta on one's own, solitary
avpartaður	(tlm.)odd, peculiar, funny, queer, in a class apart
avpiðaður	scrawny(t.d.she was not so much slim as scrawny),as thin as a rake(el.lath)
avpláss	out-of-the-way place, solitary place, remote place
avrak	(sj.)skinny, scrawny
avráddur	síráða av
avráða	1decide,síannarsavtala22dissuade from(t.d.dissuade him from doing it), advise against(t.d.advise him against doing it)
avráðing	decision, determination, resolution
avreiða	sell, dispose of (by way of trade)
avreiðari	seller
avreiðing	selling
avreiðingarprísur	selling price
avreks-	excellent, superb, capital, first-class
avrigging	decommissioning
avrik	1performance(t.d.he put up a good performance; the team gave a poor performance);ídni og avrikeffort and performance2(oftaniðr.)effort(t.d.that was a good (, poor) effort)3(gott avrik) achievement(t.d.that was quite an achievement; his athletic achievements)
avrika	1do(t.d.do a great amount of work; is that really the best you can do?);avrika tað ótrúligastado wonders; perform2achieve(t.d.great results)3accomplish4complete
avrikaføri	capacity
avrikamikil	prolific
avriksalbøting	(teld)performance optimization
avriksarbeiði	(bú.)piecework
avriksevni	capacity
avriksfjáltur	performance anxiety
avriksløn	(bú.)payment by the piece; piece-rate pay
avriksmappa	portfolio
avriksmeting	(handilsm.)scorecard;samskipað avriksmetingbalanced scorecard; sí eis.samskipaður
avriksroynd	benchmark-test
avrikssáttmáli	performance contract
avrisp	refuse, waste, rubbish
avrit	1copy (of),taka avrit avcopy, take a copy of;váttað avritcertified copy; duplicate (of,t.d.of the report, of the contract; of a key)2(um listaverk, fornluto.a.)replica (of,t.d.a plaster replica of the statue; a replica of the Eiffel Tower)3(lmynd.)print4(fl.m.) satt avrita carbon copy of(t.d.he wanted to make his son a carbon copy of himself; he looked like a carbon copy of everyone else the same age);skriva brævið við tveimum avritumwrite the letter in triplicate(el.in three copies)5transcript
avrita	copy;(lmynd.)print, make prints, xerox
avritan	copying;(lmynd.)printing
avritsvardur	(teld.)copy-protected
avríma	defrost(t.d.a refrigerator); demist
avríming	defrosting
avrokin	(um eld) stopped smoking
avrokna	settle (accounts) (with), settle up (with)
avrokning	1settling (of accounts), settlement (of accounts);avrokning so hvørtdaily settlement2(skrivlig) account, bill, statement (of account);kontant avrokningcash settlement
avrók	remote ledge
avrundaður	rounded off
avrúm	isolated room
avryski	villain
avrætta	execute, put to death
avrætting	execution
avsag	(handv.; um slíkt ið verður sagað av og ikki nýtt) offcut
avsagdur1	banned
avsagdur2	sísiga av
avsaka	apologise, make an excuse
avsakan	apology, excuse,um nøkur avsakan erin extenuating circumstances
avsalta	desalinate, desalt
avsanna	weaken; invalidate(t.d.an argument); detract from(t.d.detract from the force of an argument); (nokta) deny;(eis.)disconfirm(t.d.disconfirming evidence); (mótprógva) disprove; explode(t.d.this theory has been exploded);sanna ella avsannaconfirm or deny;avsanna eini tíðindidisprove a rumour;(tlm.)scotch a rumour
avsannan	weakening, invalidation; denial; (av gramli, sleygi, tíðindum,o.s.fr.)disproof;avsannan av gramlirefutation of a rumour
avsáddur	covered with
avseta	1(um hoyturking) drying2(um veving) ends of warp
avseting	1drying2(bú.) gera avsetingarmake appropriations; set aside reserves (for contingencies);avsetingar til partafelagsskatt(ES) allowance for income tax;avsetingar til tiltaksgrunntransfer(ence) to the reserve fund
avsettur	1dismissed, removed (from office); (um yvirmann) relieved of his command; (um prest) unfrocked2set aside, set apart, earmark(t.d.a sum for a certain purpose)3(um gras) dried
avsiga	ban;síannarsavtaka
avsigast	S yield, give in (to, t.d. him, his threats),hann avsegðist at enda og tók undir við at gera taðat last he gave in and agreed to do it
avsintur	frantic, frenzied
avsissaður	ended, brought to peace
avsíðis	1remote,tey búgva ógvuliga avsíðisthey live in a very remote (, solitary) place; they live well off the beaten track;(tlm.)they live at the back of beyond2l(uttan fyri alfaraveg) out-of-the-way(t.d.place); (fjarur) remote(t.d.part of the country); (fyri seg sjálvan) secluded(t.d.spot); (einsamur) solitary
avskamta	(lækn.)[stop administering medication]
avskamtan	(lækn.)[stopping administering medication]
avskapa	distort(t.d.distorted features; a face distorted with pain); (avbrongla) twist(t.d.the facts, the truth, his words);(forml.)distort(t.d.his meaning, his statement, the truth); (lýsa skeivt) misrepresent(t.d.the facts; his meaning); garble;við avskapaðari røddin a feigned hand voice
avskapan	1distortion; misrepresentation(t.d.a gross (, deliberate) distortion (, misrepresentation) of the facts)2(alisfr.)deformation
avskapiliga	extremely, enormously
avskapiligur	deformed, malformed, misshapen;(fl.m., skemt) misbegotten
avskarvaður	sískarva av
avskarving	decrease, diminution, reduction, falling off
avskáldaður	1scorched2(upptornaður) parched(t.d.soil)
avskeiklaður	crooked; lopsided; out of joint
avskepla	distort(t.d.his meaning, his statement, the truth); (avbrongla) twist(t.d.the facts, the truth, his words); (lýsa skeivt) misrepresent(t.d.the facts; his meaning); garble
avskeplaður	1distorted(t.d.distorted features; a face distorted with pain; a distorted version of the story)2twisted, garbled(t.d.he gave a garbled account of what had happened)3warped (t.dwarped wooden planks; a warped sense of humor)4(jarðfr.)deformed
avskeplan	distortion; misrepresentation
avskepling	síavskeplan
avskila	most, highly, extremely, very
avskilaður	síavskildraður
avskildraður	divided off;sískildra av
avskipa	(sjóm.)(vøruro.a.)ship(tilto, for), consign to
avskipari	shipper, consignor
avskiping	(handilsm.)shipping, shipment; (av hermonnum) embarkation
avskipingarbók	(handilsm.)cargo-book
avskipingarhavn	port of shipment (, embarcation)
avskipingarháttur	mode of shipment
avskipingarkredittur	shipping credit
avskipingarland	country of shipment
avskipingarpláss	place of shipment (, embarcation)
avskipingarskjal	shipping document
avskjaldraður	síavskildraður
avskorin	sískera av
avskotin	(um akur) fulleared, fully grown
avskrift	1copy2(útskrift,t. d.av bandupptøku) transcript3(svik, stuldur) crib(t.d.your essay is a crib from John's)4(at skriva av) copying; transcription; cribbing;gera avskrift eftirmake a copy of
avskriva	(bú.)write off (for depreciation), transfer to the depreciation account;avskriva á roknskapinumwrite off in the balance sheet;avskriva til at endurgjalda tapwrite off to meet losses
avskrivaður	forged
avskriving	1copying; transcription; cribbing2(bú.)(provisjón fyri) depreciation; writing off; (upphædd, ið er avskrivað) write-off;fremja avskrivingarmake provision for depreciation (el.for bad debts);avskrivingar av útistandandi krøvumprovision for bad debts;rakstraravskrivingarbook depreciation;samlað avskrivingaccumulated depreciation;(skattlig) avskriving(ES) capital consumption allowance;skattligar avskrivingar (handilsm.)fiscal depreciation
avskrivingarfrádráttur	depreciation allowance
avskrivingarfyrimunir	depreciation allowances
avskrivingarháttur	depreciation method
avskrivingarkonta	depreciation account
avskrivingarlóg	Depreciation Act
avskrivingarmøguleiki	opportunity (, possibility) for tax write-offs
avskrivingarregla	depreciation principle; depreciation provision
avskrivingarrættur	entitled to depreciation; which entitles to depreciation
avskræmiligur	1(ræðandi) terrible; (sterkari) horrifying, appalling2(vánaligur; stórur) terrible, awful(t.d.weather, food; he is a terrible fool); dreadful(t.d.novel; he is a dreadful coward);(tlm.)frightful(t.d.smell, mistake, nuisance); (sterkari) appalling3hj-liga,terribly, dreadfully, frightfully; (sterkari) appallingly
avskurður	(stfr.)segment (of a circle, parabola, sphere)
avskøða	avskøða seg take off one's shoes
avsláttarkort	1(í handlio.s.fr.)discount ticket2(bussavsláttarkorto.s.fr.)[ticket coupon]; bus pass
avsláttarmerki	trading stamp, discount voucher;(am.)trading ticket trading stamp, discount voucher;(am.)trading ticket
avsláttarútgjald	(handilsm.) off payment
avsláttur	1discount(avon);geva avsláttallow a discount;geva 5% (í) avsláttri, geva avsláttur upp á5% allow(el.grantel.give) a 5 per cent discount;avsláttur fyri kontant gjalddiscount for cash;krav um ávslátt(ur)claim for relief2(handilsm.)deduction, abatement, discount, rebate, (sales) allowance
avsleipin	slippery (and steep)
avslipaður	slimy(t.d.a slimy rock)
avslitin	síslíta av
avslættaður	(stb.)sunk, settled;(forml.)subsided
avsmurdur	thrashed soundly;sísmyrja av
avsmurningur	flogging, thrashing(t.d.what you need is a good thrashing)
avsmyrjing	flogging
avsneiddur	1sloping, slanting, tapered2fail;(tlm.)let down(t.d.a friend)
avsovnaður	dropped off
avspáking	time-off(t.d.time-off can be exchanged for cash); time off in lieu of wages;sum avspákingin lieu (of wages)(t.d.staff were given time off in lieu (of wages))
avspákingargjald	overtime payeint.
avspákingartíð	compensation time
avstað	away; along; off(t.d.run (, dash, rush, gallop) off (, along)); (avstað! (við tær!)) off you go! be off!
avstaðarfólk	(stb.)out-of-town people
avstaðferð	departure
avstarvaður	1exhausted, fatigued, tired out2dead
avstikaður	fenced off, enclosed;sístika 2
avstilt	(um veður) calm;sístilla av
avstokkin	in pieces
avstoktur	avstoktur í krími with a heavy cold
avstoyping	casting; cast(t.d.take a cast of sth)
avstoyttur	iced up
avstrali	Australian
Avstralia	(fastlandið) Australia; (heimsparturin) Australasia;(polit.)the Commonwealth of Australia
avstralnekari	(niðr.)síAboriginal11íen.-før. orðabókini
avstralskur	Australian
avstrokin	(stb.)avbukaður
avstubbaður	1(um menn) close-cropped; (karsahár) crew-cut; (um konufólk) bobbed, shingled2(snubbutur) curt(t.d.reply), (kvettin) brusque; (gronutur) gruff; (kensluliga) callous
avstøða	consequence, result
avstøka	1waste2expenses, costs
avstøktur	sístøkkja av
avsviðin	scorched;sísvíða av
avsýnis	out of sight
avsýra	acid-wash; (fáa máling av) strip the paint off
avsøgn	passing(t.d.of the sentence)
avtaglaður	sítagla
avtaka	1abolish(t.d.a custom, a privilege; abolish slavery; abolish the use of capitals; a plan to abolish the House of Lords; the law abolished some of the private schools), do away with, discontinue; (stig fyri stig) phase out(t.d.the submarines will be phased out)2(eitthvørt lógarfest) repeal(t.d.the Corn Laws); abrogate(t.d.the old system of poor relief); annul; revoke(t.d.an edict, the regulations)
avtakafólk	first-rate person
avtakamaður	síavtakafólk
avtakaveður	terrible storm
avtakin	1hidden, covered, concealed2covered, overgrown;(viðwith);avtakin við ókrútiovergrown(el.rank) with weeds, overrun by weeds; (við skógieis.)wooded, timbered3avtakin við heiðursmerkjumplastered with decorations
avtala1	1(skipan) arrangement(viðwith;umabout,t.d.I made an arrangement with him about looking after the house)2(semja) agreement (viðwith;umabout,t.d.we came to an agreement with them about the pay; sign the agreement; a trade agreement);(tlm.)deal(viðwith;umon,t.d.they did a deal with them on a wage increase);so er tað ein avtalathat's settled then;(tlm.)that's a deal;gera avtalu viðenter into(el.conclude) an agreement with; do a deal with;(serl. am.)make a deal with;eftir avtalu, sambært avtaluas (previously) arranged, as agreed;(forml.)as per agreement;ein avtala um atan arrangement (, agreement) to(el.about -ing), (+ setn.) an arrangement (, agreement) that3(avráða at hittast) appointment(viðwith,t.d.I have an appointment with my lawyer; he cancelled all his appointments)4(politisk avtala, avtala millum ríki) accord(t.d.the Helsinki accord; the Camp David accord)
avtala2	1farewell speech;(forml.)valedictory speech2funeral oration
avtala3	1arrange(t.d.a meeting),avtala atarrange to(t.d.go to the theatre);avtala at hitta e-n kl. 6arrange to meet sby at 6 o'clock; make an appointment with sby for 6 o'clock;avtala ein dagagree on a day;avtala við e-n atarrange (, agree) with sby to;(tlm.)make a date to;avtala e-t við e-narrange sth with sby;avtala tíð og staðarrange (, agree on) (the) time and place;fundur er avtalaðura meeting has been arranged;tað er avtalað atit has been arranged (, agreed) that;sum avtalaðas arranged (, agreed)2(semjast um) agree on(t.d.a day for the next meeting);avtala atagree to(t.d.act in concert); contract; (treyta sær) stipulate; (at hittast) make an appointment(t.d.we made an appointment to meet at the Café Royal)
avtaluinnskot	(handilsm.) fixed term deposit;skráseting av avtaluinnskotiregistration of fixed term deposit;avtøka av avtaluinnskotisettlement of fixed term deposit; rentur av avtaluinnskotiinterest on fixed term deposit
avtaluvinnari	contracting party
avteipaður	exhausted, fatigued, tired out; dead tired, dead beat
avteyggjaður	closely hung, closely draped;síteyggja
avtikin	1abolished(t.d.a rule, a tax; the death penalty);(tlm.)do away with; (stigvíst) phased out(t.d.leaded petrol)2(lógo.tíl.)repealed(t.d.a law)3(umt.d.seyð) put down4sore, raw(t.d.place)5photographed6lost weight, become thinner;sítaka av
avtíð	(stb.)tað er eingin avtíð enn it is not too late yet
avtoftaður	be(el.lie) in ruins
avtorna	sítorna
avtrivnast	hann avtrivnast he doesn't thrive
avtrivni	(stb.)stuntedness, weakliness, failure to thrive
avtryggleikagerð	(samfr.) desecuritization
avturkaður	síturka
avtuskaður	exhausted, fatigued, tired out, flat out
avtúgva	unpack
avtøka	1(likvidatión) winding-up, liquidation;fara í avtøkugo into liquidation;felag undir avtøku(joint stock) company in (course of) liquidation;fullføra avtøkunacomplete the winding-up;rættarlig avtøkacompulsory winding-up;sjálvboðin avtøkavoluntary winding-up;(kurs)virði tá ið avtøka verður framdbreak-up value2abolition(t.d.of Negro slavery); repeal(t.d.of the Corn Laws); suppression(t.d.of piracy); dissolution; revocation, annulment, cancellation; abrogation; (í stigum) phase-out; giving up3rawness (of the skin);(forml.)excoriation; sore place, (avtikin blettur) a raw place4(kortsp.)cut(ting)5(handarb.)decreasing (í binding)
avtøkumaður	síavtakamaður
avtøkustjóri	(løgfr.)liquidator
avundsjúka	síøvundsjúka
avundsjúkur	síøvundsjúkur
avvaksin	overgrown
avvallaður	covered with greensward
avvandur	(frá stimbrandi evnum) cured (of)(t.d. he is cured of drug addiction); weaned off(t.d.weaned off heroin); (um alkoholikaraeis)dried out;sívenja av
avvarðandi	1relative (t.d.the relatives had been informed at this point)2next of kin (t.d.we need to contact his next of kin)3relation (t.d.he did not have that many relations)4concerned, in question
avvarra	(málfr.)delabialize
avvarran	(málfr.)delabialization
avvavdur	covered, veiled
avvápna	(herm.)disarm
avvápnan	(herm.)disarmament
avvápning	(herm.)síavvápnan
avvegis	síavleiðis
avvegur	detour, roundabout way
avveiting	draining, drainage, land-draining
avveittur	(umt.d.bø) drained, dry
avvenjing	1treatment(t.d.drug treatment); cure2(frá drøgg, alkoholi, heilivági) detoxification, detox (t.d.he ended up in detox for three months; I'd been waiting to get into the clinic for a detox)3weaning (t.d.the doctor tried to wean her off the sleeping pills);(um bróstabarn) (t.d.the child is old enough to start weaning)
avvenjingarstovnur	home for alcoholics (, drug addicts etc.); (fyri alkoholikarar)(tlm.)drying-out centre
avvenjingarviðgerð	cure(el.treatment) for alcoholism (, drug addiction etc.); (við evnum, ið elva mótboð fyri tí, ein er fallin til) aversion therapy; (frá narkotika við ongum heilivági)Scold turkey
avverkað	accomplished, finished
avviðaður	(um við) cross-veined, cross-grained
avvik	1deviation2førka samrøðuna inn á eitt avviksidetrack the conversation;(fl.m.) hann er komin á eitt avvikhe digresses all the time, he is wandering from the point; he has got sidetracked
avvitandi	conscious; (við vilja) deliberate, calculated; (politiskt) aware
avynna	(gl.)misfortune, ill fortune, bad luck, ill luck
avynnubarn	child of sorrow
avynnudýr	wretched personel.creature, miserable personel.creature, poor creature, pitiable man
avynnuligur	wretched, miserable, poor
avynnumaður	síavynnudýr
avynnuting	síavynnudýr
avynnutíð	unfortunate hourel.time, disasterous hourel.time
avýtaður	síýta(av)
avýting	1(sigl.) bearing2(handilsm.; hava eyguni eftir hvussu tey bestu virkini skipa seg/framleiðsluo.a.m.) benchmarking; sí eis.ýta22
