d	(eis. tónl.)D, d
d.	(st.)day, date; died
dadda	1nurse,(tlm.)nanny; baby(-)sitter;sita daddababy-sit2little sister; little girl
daddast	(tlm.)baby-sit
daddudrongur	sídaddusonur
daddumentan	nannyism
daddusonur	foster son
daddusøga	old wives' tale,(tlm.)cock-and-bull story, baloney
dadla	(plfr.)date
dadlupálmi	(plfr.)date palm(Phoenix dactylifera)©iStock
dadlusteinur	date stone
daffa	slander, calumniate,daffa fólkslander people
daga	come into sight,daga upp móti luftinibe silhouetted against the sky
-daga	síupp-
dagamunur	difference from day to day,tað sæst dagamunur á honumyou see a difference in him from day to day
dagaskil	ikki vita el. duga dagaskil1lose track of time, lose (all) sense of time2be simple (-minded)
dagast	come into sight, loom (up)
-dagast	síav-
dagatal	1number of days2calendar, almanac
dagblað	daily (paper)
dagbók	diary; journal; (at skriva avtalur í) appointments diary;(sigl.)log;skriva dagbókkeep a diary (of);(sigl.)keep a log;skriva í dagbókinaenter into the diary (, log)
dagbóka	journalize, enter in the journal;(tlm.)log
dagbókarhøvundur	diarist
dagbókasavn	medical archivesflt
dagbót	1(løgfr.)[fine proportionate to the offender's daily income]2daily penalty, daily fine
dagbretting	(sj., stb.)dawn, daybreak;í dagbrettinginiat daybreak
dagdeild	(lækn.)day section
dagdreymur	daydream, reverie
dagdroymari	daydreamer
dagdvølja	1pastime(t.d.watching television now seems to be the most popular national pastime)2(spæl) puzzle3(fl.m.,stb.) tú vart mær ein rættilig dagdvøljayou completely wasted my time
dagfallin	due, payable, falling due,dagfallin veksilbill which has fallen due, matured bill
dagfastur	fixed (date)
dagfesta	date(t.d.a letter dated May 2nd, 1890);bræv tygara dagfest 2/5your letter of May 2nd;tilnevning dagfest fráappointment to date from;dagfesta segdate(fráfrom, back to);ikki dagfestundated, not dated
dagfesting	date, dating; (handilsm.)ár til dagfestingyear to date;við ongari dagfestingundated
dagføra	bring sth up to date; update sth;(teld.)update;dagføra bøkurnarkeep the books up to date;dagføra okkum viðkeep us up to date with, keep us informed(el.posted) as to;dagføra segkeep up (to date) with, keep abreast of(el.with)
dagførdur	updated, up-to-date(t.d.information)
dagga	amble(t.d.we ambled down to the beach; they ambled along for miles),koma daggandicome trailing(el.straggling);koma daggandi aftanáamble along in the rear
daggamal	one day old, day-old(t.d.chicks);daggomul eggeggs straight from the nest;daggomul tíðindiup-to-the-minute news
daggari1	1idler, loafer2dagger
daggjald	day rate
dagglæma	sídagsglæma
daggrýti	(jarðfr.)extrusive rock, effusive rock
daghol	(kolanám) main shaft
-dagi	síbar-,ó-
daginar	(stb.) í osb: um daginarthe other day
dagin-eftir-bolli	morning after pill
dagini	sídaginar
dagkrem	day cream
daglangt	for the whole day
dagleið	day's journey
dagligstova	(tlm.)sitting room, lounge
dagligur	1daily,(bíbl.) dagligt breyðdaily bread; everyday, familiar2hj-ligadaily, every day(t.d.he comes here every day);dag og dagligaevery single day
daglilja	(plfr.)day lily(Hemerocallis)
dagljóst	tað er dagljóstday has come
dagløn	1(løn fyri arbeiði í ein dag) day's wages, day wage2(móts.akkordløn, vikuløn) wages by the day;arbeiða fyri daglønbe paid by the day
dagmerki	date-marking, date-stamping
dagmerkja	date sth, mark the date of sth
dagmiðstøð	day-care centre
dagna	sídegna
dagpeningur	maintenance(el.subsistence) allowance, daily(el.per diem) allowance; unemployment benefit; (sjúkrapengar) sickness benefit(s); (ES) daily subsistence allowance;(trygg.)daily benefit;fáa dagpeningbe on the dole
dagrúm	(stb.)sídagræði
dagræði	1í osb: eg fekk dagræði aftur til húsI reached home before it got dark2daylight (by daylight, in daylight)
dagrøkt	day-care (in private homes)
dagrøktarheim	day-care center
dagrøktarmamma	child-minder, baby-minder;kommunal dagrøktarmammaregistered child-minder
dagsarbeiði	day's work
dagsbrúgv	(gl.)dawn, daybreak
dagsbrún	sídagsbrúgv
dagseta1	í osb: nú fer at dagseta now daylight is fading;nú er dagsettdaylight has gone
dagseta2	sídagfesta
dagseting	sídagfesting
dagsetur	close of the day, twilight, dusk, gloaming,um dagseturin the dusk
dagsetursskeið	(hour of) twilight
dagsferð	day's journey
dagsfreist	(løgfr., handilsm.)day of grace
dagsgerð	1day's work,hatta er ein heil dagsgerð at gerathat is a whole day's work2(sj.)the business of the day, the day's work, the daily round
dagsglæma	streak of dawn
dagskeið	(skúlam.)day course
dagskúli	(skúlam.)day school
dagsleið	day's journey
dagsljós	daylight;í dagsljósiby daylight, in daylight,eg síggi at lesa við dagsljósiI can see to read by daylight
dagslýsi	daylight,í dagslýsiby daylight, in daylight
dagsløn	sídagløn
dagsmøði	the day's toil
dagsprísur	current(el.today's) price, market price;fyri lægsta dagsprísat today's lowest prices
dagssetningur	day's work
dagsskipan	sídagsskrá
dagsskrá	1(fundarskrá) agenda, (the) business of the day; order paper;fundur við hesari dagsskráa meeting to discuss the following agenda (um bert eittans mál: the following matter);fara til næsta mál á dagsskránnigo on to the next item on the agenda, move on to (the) next business;seta á dagsskránnaplace on the agenda;(fl.m.)bring up for discussion;vera á dagsskránnibe on the agenda;(fl.m.)have come up for decision;viðgera sum fyrsta mál á dagsskránniplace at the head of the agenda2(fundarsamtykt) resolution;seta fram uppskot um dagsskrámove a resolution
dagssýni	sídagræði
dagstevndur	1(um tíð) fixed, appointed,koma dagstevndan dagcome on the appointed day2hann kom dagstevnt á hvørjum árihe came on a fixed day every year
dagstíð	time of day
dagstjørna	(stjfr.)morning star
dagstovnur	day-care centre
dagstútt	sídagstøtt
dagstøtt	every day, daily
dagsverður	day's ration
dagsverk	(whole) day's work
dagsvirði	current(el.marketel.present) value;(tlm.)going rate
dagtilhald	day-care centre
dagtjóvur	idler, loafer
dagur	1day,ein daginone day; another day;nú ein daginthe other day;dag og dagliga sídagligur;allar dagaralways, ever;allan daginall day (long), the whole day;allan dagin í dagall (of) today;árla dagsearly in the day;fjúrtan dagara fortnight,(am. serl.)two weeks, fourteen days;fyrsta daginone of these days;hann er sum fyrsta daginhe is like a new man;góðan daghullo; good morning; good afternoon; (hátíðarligari) how do you do;biðja e-m góðan daggreet sby;seinna daginhardly ever2(ljós, lýsi; vit) daylight, light of day;dagurin fór fyri eygunumhe blacked out;fyrstu ferð eygu hansara sóu daginthe first time his eyes saw the light of day;halda e-m upp fyri daginhold something up to the light;fáa dagin afturcome round again3(lív, æviskeið) time,á døgum hansarain his time, while he was alive;í mínar dagarin my lifetime;eg havi aldri í mín dag hoyrt slíktI've never heard such nonsense;í gamlar dagarin the old days, in olden times;meðan hon var á døgumwhile she was alive;nú á døgumnowadays;hansara dagar eru taldirhis days are numbered;okkara dagur er ikki uppiour time has not come yet4[ísamb. viðfs]avfara av døgumdie;tað lýsir av degidawn is breaking;taka av døgumkill;taka seg av døgumcommit suicide, take one's own life, do away with oneself;mett(ur) av døgumfull of years;á1.á degiby day, by daylight, in the daytime;á hvørjum degievery day;á alljósum degiin broad daylight;hesa tíð á degnumat this time of (the) day;tað var liðið væl á dagday was far advanced;2.days, time(t.d.in Cromwell's days);á døgum hansara el. meðan hann var á døgumin his time;á okkara døgumnowadays;eftirdag eftir dagby day;dagin eftirthe following day;annan dagin eftiron the second day;fyrifyri dagbefore dawn;lýsa fyri degidawn, break (of day);nú tynnir fyri degidawn is breaking;koma fyri ein dagcome to light, turn up, be disclosed;fáa fyri ein dagbring to light, bring out, elicit;leggja fyri dagindisplay, manifest, show;frádag frá degiel.dag undan degiday by day;frá tí degiever since that day, ever since then;frá og við tí degifrom that day on;(løgfr.)on and after that day;frá degi til dagsfrom day to day, day by day, from one day to the next;frá e-m degi til annanovernight(t.d.public feeling changed overnight);liva bara frá e-m degi til annanlive from day to day, live from one day to the next; (fíggjarliga) live from hand to mouth;íí dagtoday;(skald.)this day; (nú á døgum) today, at the present time, nowadays;hvør dagur er í dag?what is today?;í dag er leygardagurtoday is Saturday;tann dag í dagto this very day, even today;eg skal gera tað tann dag í dagI will do it this very day;í dag fyri tjúgu árum síðantwenty years ago today;í dag fyri átta døgum síðana week ago today;til dagin í dagup to(el.till) this day, till(el.up to) the present, till now, until now;í dag um eitt ára year from today, this day twelvemonth;við postinum í dagby today's post;í døgunum frá fimta til tíggjunda maiduring the period from May 5 till May 10;í mínar dagarin my lifetime;í gomlum døgumin (the) days of old, in former times, in the old days, in olden times;í mínum ungu døgumwhen I was young(er), in my young days;í døgum sum komain the days to come;ímillumtaka dagar ímillumdiscriminate between(t.d.the Government does not discriminate between nationals and foreigners in this matter);tilfrá degi til dagsfrom day to day, day by day, from one day to the next;frá einum degi til annanovernight(t.d.public feeling changed overnight);umum daginby day, during the day, in the daytime;um dagina day(t.d.he drinks a bottle a day);eg arbeiði um dagin hesa vikuna og um náttina næstu viku (tlm.)I'm working days this week and nights next;um nakrar dagarin a few days;dag um dagday in, day out, day by(el.after) day;seinni um daginlater in the day;undandag undan degiday by day;út áút á daginlate in the morning;tað var liðið langt út á daginthe day was far advanced;viðvið deg(i)numat dawn; early in the morning;frá og við tí degifrom that day on;(løgfr.)on and after that day;til lukku við degnum!best wishes for the day!5[íyms.samb.]ein fagran dag(um fortíðina) one (fine) day; (um framtíðina) one of these days, some day;hvør dagur hevur nóg mikið í síni plágusufficient unto the day is the evil thereof;hava góðar dagarbe in clover;hann hevði ein av sínum stóru døgumhe had a field day;allan tann líðilanga dagall day long;(skaldsk.)the livelong day
dagvakt	day watch;(sjóm. morgunvakt) morning watch;hava dagvakt (t.d.um sjúkrasystur) be on day duty (, day watch)
dagverk	day's work
dala	1sink, go down, drop(t.d.the temperature (, the shares) dropped), descend, fall(t.d.prices are falling; his courage fell)2(vera í afturferð) decline(t.d.his power declined), come down, be on the wane(t.d.his fortune (, influence) is on the wane), fall off(t.d.attendances fell off); decrease;dala niðurdescend, alight;dala niður ádescend on, light on;dala skjóttfall rapidly
dalbotnur	(jarðfr.)valley floor
dalbúgvi	dalesman
dalda	1(um fólk) dawdle, idle, loaf, laze, slack2(um línu) stretch; swing(t.d.as he pushed her, she swung higher and higher)3wag,hundurin daldar við halanumthe dog wags its tail
dalfinna	(lívfr.)clitoris
daljøkul	(jarðfr.) glacial valley
dall	pealing, ringing, peal,tað síðsta dallið frá kirkjuklokkunithe last peal from the church bell
dalla	1ramble(t.d.what is she rambling on about now?)2chime(t.d.I heard the clock chime)
dalsaki	disarray(t.d.we're decorating, so everything's in complete disarray at home), tangle, mess, muddle(t.d.make a muddle of)
dalsbotnur	sídalbotnur
dalsifals	tomfoolery, fooling about(el.around), nonsense
dalsíður	laden(el.heavy) with rain
dalur	valley; (á nøkrum leiðum) dale;(skaldsk.)vale
dalverpi	small valley
dama	woman, girl
dambla	sídamla
daml	slow rowing
damla	row slowly
damm	(spæl) draughts,(am.)checkers;spæla dammplay draughts,(am.)play checkers
damma1	(gl.)lady; (í kortum) queen; (í dansit.d.)partner
damma2	play draughts,(am.)play checkers
dammborð	(spæl) draughtboard,(am.)checkerboard
dammskip	(gl., skip.)welled fishing vessel, wellboat
dammstilli	dead calm;(eis.) tað var dammstillithe sea was as smooth as a mill-pond
dammtalv	sídamm
dammur	1(demdur) pond;(am.: grunnur hylur) lagoon2(á skipi) dam
dampa	1steam(t.d.the kettle (, the wet clothes, the wet earth) began to steam)2(vera fyri dampi) steam; (urtag.) fumigate; (dampkóka) steam3(taka ráan úr)dampa klæði avair, give(t.d.the sheets) an airing4(gl.)smell, stink;síguva
dampari	(skip.)steamship, steamer, steamboat;damparin MacS/S "Mac";fara við damparago by steamer
dampjarn	(strúkijarn) steam iron
dampkamar	steam chest
dampkassi	steam box; (til bað) (Turkish) steam cabinet
dampkóka	steam, cook by steam
dampkókaður	steam-cooked
damplokomotiv	steam engine, (steam) locomotive
dampmaskina	steam engine
dampmongd	quantity of steam
dampreinsa	steam-clean
damprikin	steam-driven, steam-powered
damprúm	(í ketli) steam space, steam chest; (í baðihøll) steam room
dampskip	sídampari
dampskipasigling	steam navigation; (samband) steamship service
dampskorsteinur	(sigl.)funnel, smokestack
damptrolari	steam trawler
damptrýst	steam pressure
damptrýstmátari	manometer, steam (pressure) gauge
dampur1	1(alisfr.)vapour(t.d.condensed vapour; saturated vapour), (úr vatni serl.) steam(t.d.get up steam; at half steam);sum dampurin the form of vapour (, steam);síguva 22(sum máttur) steam3reek, smell, odour
dampur2	end of a line
dampventilur	steam valve
danadái	(plfr.)groundsel(Senecio)
danadrotning	Queen of Denmark
danakongur	King of Denmark
danastjórn	the Danish Government
Danaveldi	the Kingdom of Denmark
danda1	seesaw,(am. eis.)teeter
danda2	1swing; rock, bob up and down,(am. eis.)teeter, roll;(fl.m.) ganga dandandibe lost in thought2seesaw, play at seesaw,(am. eis.)teeter
dandakelda	síflotkelda
dandifjøl	seesaw,(am. eis.)teeter
dandisfrú	(gl.)honourable lady
dandiskur	fine, upright, honest, honourable, well-conducted, well-mannered,hann er ikki dandiskurhe conducts himself badly
dandisligur	ikki dandisligurunacceptable
dandist	(stb.)reasonable, acceptable,tað man vera so dandistit is quite acceptable;ikki so dandistnot worth while; unattractive
dandisvullur	quagmire
danditræ	sídandifjøl
danga1	(niðr., sjóm.)coffin ship, ballahoo;Sballyhoo of blazes
danga2	walk slowly
dangbukka1	sídanga
dangla	sídingla
danguldrív	í osb: ganga upp á danguldrív idle, loaf, lazeSskive, be on the skive;(am.)Slollygag
danguldríva	sídanguldrív
dangutur	1ineffective2inelegant, unsmart, not chic
dani	Dane,hon er danishe is Danish
danimaður	(gl.)man of honour,(ofta =)gentleman; (verjandi) worthy
dank	(tlm.)í osb: dríva dank sídanguldrív
dankalahov	sídankulhov
dankast	síavdankastdankast av
dankuldrív	sídanguldrív
dankuldrívari	idler, slacker, lazybones, lazyboots
dankulhov	(stb.)í osb: ganga upp á dankulhov sídanguldrív
Danmark	Denmark
Danmørk	Denmark
dansa	dance; (um ross) prance; cavort;dansa viðdance with;dansa væl (, illa)be a good (, a poor) dancer;skulu vit dansa ?shall we dance?;dansa valswaltz;dansa á línuwalk on a tight-rope;dansa á rósum(samsvarar við) lie on a bed of roses;tung(ur) at dansa við(trekur, seinur) cumbersome(t.d.bureaucracy); (trupul) hard to handle
dansandi	dancing;tey dansandithe dancers;í osb: dansandi óðurhopping mad
dansari	dancer
dansiferð	dancing tour
dansifólk	dancers
dansigólv	dance floor
dansilag	1dance tune2way of dancing
dansingarlag	way of dancing
dansióður	dancing-mad
dansiringur	circle of dancers
dansisalur	ballroom
dansistova	(public) dance hall, ballroom
dansiterandi	(tlm.)í osb: so dansiterandi óður hopping mad, off the handle
dansitíð	dancing-time
dansitónleikur	dance music
dansiveitsla	dance; (størri) ball
danska	1danicize2translate into Danish
danskari	Dane
danskklæddur	(um mann fyrr) in foreign clothes
danskleiki	Danish nationality, Danish national feeling, Danishness
danskligur	in Danish style (, manner); (pro-)Danish, Danish-minded, with Danish sympathies
danskmæltur	Danish-speaking
dansksinnaður	(pro-)Danish, Danish-minded, with Danish sympathies
dansksinni	Danishness
danskt	(málið) Danish
dansktalandi	Danish-speaking
danskur1	danskurin the Danes
danskur2	Danish
dansstova	sídansistova
dansur1	dance; (kynstrið at dansa) dancing;bjóða einari upp til dansask sby for a dance;kann eg fáa henda dansin?may I have this dance(el.this one)?dansurin gongurthe dance is on;ganga til danstake dancing lessons;ein dansur á rósum(samsvarar við) a bed of roses;treða dans (skaldsk.)tread a (stately) measure
dansur2	síoljudansur
dantalahóv	sídanguldrív
dantilára	(stb.)hang about, lounge about
dapa	squint;hann dapar eitt sindurhe has a slight squint(el.cast)
dapan	(stb.)squint, cast(t.d.she has a slight cast)
dapur	sad, joyless, melancholy, sorrowful; gloomy,eitt dapurt bragda gloomy air;framtíðarútlitini eru døpurthe future outlook is gloomy;dapur í hugamelancholy;eitt dapurt sinnia brooding disposition, a tendency to melancholy;tann dapri tónin í bókinithe gloomy tone of the book;døpur útlita bad outlook, poor prospects, a bad(el.poor) lookout(t.d.that's a poor lookout for us)
dapurhugaður	sad, distressing
dapurleiki	grief, distress, sorrow, sadness
dapurliga	sadly, joylessly
dapurlyndi	sadness, melancholy, depression, gloom
dapurskygdur	pessimistic
dapurskygni	pessimism
dardakoy	(stb.)skinny, bony, scraggy, scrawny
dardalatur	(stb.)bone lazy
darl	1dangler, appendage; gooseberry2(stb., barn.)dick, peter, Willy, WillieSdingle-dangle
darla	1dangle(t.d.his legs dangled over the side of the boat)2straggle(t.d.on the way the kids straggled behind us); lag behind(t.d.the little boy lagged behind his parents);koma darlandi aftanácome staggering up
darr	quiver(t.d.Jane couldn't help the quiver in her voice)
darra	1quiver,(t.d.her lip quivered and then she started to cry), vibrate2sídarla
darran	sídarr
darrarak	(stb.)skinny, bony, scraggy, scrawny
darrhentur	with shaky hands
darsum	(gl., tlm.)if
dart	(spæl) darts
darta1	1swing, wave, brandish,hann sat og dartaði við knívinumhe was brandishing his knife; reel,snælda dartarthe spindle reels2dash about(t.d.he kept dashing in and out of the room)
darta2	(ítr.)play darts
dartla1	sídarta
darva	1delay, detain2obstruct, hamper(t.d.our efforts were severely hampered by a lack of money; snow hampered traffic; my heavy boots hampered me; constant headaches may hamper the patient in his work), hinder(t.d.the snow hindered the movements of the troops; his talk hindered me in my work))
darvaður	1troubled2hampered; hindered3late, delayed
darvi	1hindrance, impediment(t.d.the level of inflation is a serious impediment to economic recovery)2delay
darviligur	1(stb.)laborious(t.d.digging his garden was a laborious task; this computation is very laborious); toilsome, difficult2hjwith difficulty, laboriously
darvsaki	sídassaki
dassaklæddur	dressed like a tramp
dassaklæði(r)	(sj.)í osb: ganga í dassaklæðum look like a tramp
dassi	í osb: ganga sum ein dassi look like a tramp
dassleittur	weather-beaten
dassvátur	sodden, dripping wet, sopping wet, wet to the skin, wet through;dassvátur av regni (, sveitta)drenched with rain (, sweat); rain-soaked
dast	1the best (av e-m), lustre(t.d.her hair had lost its lustre), gloss(t.d.this scandal has taken the gloss off the occasion)2the greater part(t.d.of the cargo (, of the goods, of the population)); the major part, the bulk(t.d.the bulk of the population (, of the imports)); the better(el.best) part(t.d.of his fortune)
dastin	sídestin
datt	sídetta
dauriskur	daurian;(dýr.) dauriskur staridaurian starling
davidur	(skip.)davit
dádýr	(dýr.)fallow deer(Dama dama)© Wikimedia Commons
dádýratjógv	[haunch of fallow deer]
dáð	1(avrik) achievement, exploit, feat (of valour)2(gerð) act, deed
dáðleysur	inactive, inert, idle
dáðloysi	inactivity
dáðríkur	active, glorious
dáhind	doe
dáhjørtur	fallow buck
dái	(plfr.)fýrstrentur dái hemp nettle(Galeopsis tetrahit)
-dái	sísummar-
dála	slice, cut into slices
dálamb	fawn
dálari	sídáli
dáli	1(peningur) rix-dollar2slice
-dáli	sísummar-
dálk	dirt; slush
dálka	1dirty, soil, foul, begrime, smudge(t.d.the mirror was smudged with fingerprints);(fl.m.)sully(t.d.sully one's hands with a crime), tarnish(t.d. one'sname), smudge2pollute(t.d.polluted water; to pollute a river, the atmosphere), cause (, spread) pollution; (ógvisligari,fl.m.)defile; contaminate(t.d.breathe contaminated air; contaminate an area with radioactivity); foul(t.d.few animals foul their own nests)
dálkaður	1dirty, smudged2polluted, sullied
dálkan	sídálking
dálkandi	polluting;dálkandi evnipollutant
dálkari	despoiler(t.d.despoilers of rivers and lakes), polluter, pollutant
dálking	1soiling, defiling, tarnishing2pollution, contamination, fouling; (ógvisligari,fl.m.)defilement; (um geislavirkni) contamination; (óreinskaeis.)impurity
dálkingarevni	pollutant
dálkingarfyribyrging	prevention of pollution
dálkingarkelda	pollutant
dálkingarlæra	environmental studiesflt.
dálkingarmátari	(í samb. v. geislavirkni) contamination meter
dálkingarmáting	pollution measurement
dálkingarskaði	pollution damage
dálkingarvandi	pollution risk
dáma1	like;mær dámar betur kaffi enn teI prefer coffee to tea; I like coffee better than tea;mær dámar betur perurI like pears better, I prefer pears;tað mær dámar best erwhat I like best is; what I prefer is(GG:the dog slept in my armchair for choice);hatta dámar mær!that's the spirit!,(ofta =)now you're talking!;dáma vælbe fond of;tað sum mær dámar væl við honumwhat I like about him;ikki dámanot like, dislike, object to, hate(t.d.I hate seeing(el.to see) you behave like that); resent(t.d.I resent his familiarities); not take to(GG:the Christmas rose does not take to transplanting); (høviskari) not care for(t.d.I don't care for his books (, Italian cooking));mær dámar hatta ikki rættiligaI'm not too keen on it
dáma2	get colour,dámast burtur í einkibe discoloured
dámaður	skjúrtan er illa dámað the shirt is discoloured
dámdur	regarded, popular,vera væl dámdurliked, popular;vera illa dámdurunpopular
dámligur	nice, kind, decent, pleasant, attractive;dámligur drongura decent chap, a good sort
dámur	1colour, hue(t.d.his face took on an unhealthy whitish hue); tinge(t.d.pink tinged her pale cheeks), tint2appearance, look, touch; atmosphere; air(t.d.the room had an air of luxury); sí eis.huglag
dána	faint, swoon, lose consciousness,(tlm.)pass out
dánaður	shaped, made, arranged,væl (illa) dánaðurwell (badly) shaped (made);(stb.) so dánaðonly just, barely, with great difficulty,tað var so dánað at vit slitu land uppwe only just made land
dánarfæ	treasure trove belonging to the Danish state
dáni	ei dáni íno wonder
dánilsi	fainting fit, swoon
dánt	sídánur
dánur1	(stb.)ei dánur í no wonder
dánur2	1tolerable, fairly good,húsini eru so dánthe house is in a fairly good condition;teir kunnu vera líka dánir báðir tveirthere is nothing (, not much, little) to choose between them; it is six of one and half a dozen of the other2hjdánt; tolerably, fairly, slightly;hann hevur verið sjúkur, men nú livir hann so dánthe has been very ill, but now he is slightly better;so dántonly just, barely;hann dugdi so dánt at lesa og skrivahe could barely read and write;eg sá hann so dánt í myrkrinumI only just saw him in the darkness;hann kláraði próvtøkuna so dánthe scraped through
dára	1charm, captivate, fascinate; (sterkari) infatuate2tempt(t.d.tempt sby beyond his power of resistance), seduce, beguile,(bíbl.) ormurin dáraði megthe serpent beguiled me;dárandicharming, tempting, seductive
dárabragð	sídáragerð
dáragerð	folly(t.d.giving up a secure job seems to be the height of folly; it would be folly to turn the offer down), thoughtless action
dáralop	sídáragerð
dáralæti	(eginleiki) folly; (gerð, útsøgn) gaffe, blunder
dáraverk	sídáragerð
dári	fool(t.d.fortune favours fools)
dárskapur	folly, thoughtlessness, rashness
dási	small candle
dáta	1data; facts;(teld.) viðgera dátaprocess data;hansara dátahis record, his curriculum vitae;dáta í málinumthe facts of the case;(teld.) vald dátasampled data2(gl., sj.)date, dating(t.d.from date, after date; of today's date)
dátarvur	fallow buck
dátt	henni var dátt viðit was a surprise to her, it found(el.caught) her unprepared, it caught her unawares; she had not expected it, she got a sudden fright, she was taken by surprise;varð honum dátt við daginhe was taken aback;tað kom teimum ikki dátt viðthey were not taken by surprise, they were not the least surprised;tíðindini komu dátt viðthe news was brought unexpectedly
dáttliga	suddenly, all of a sudden, abruptly, unexpectedly
dáttligur	sudden, abrupt, unexpected
dátuábyrgdari	(teld.)data controller
dátuberi	(teld.)data carrier
dátubygnaður	(teld.)data structure
dátufløga	(teld.)CD-ROM
dátufrøði	(teld.)datamatics, automatic data processing, computer science
dátufrøðingur	(teld.)graduate in computer science, computer scientist
dátugrind	(teld) data grid
dátugrunnur	(teld.)database
dátugrunsforrit	(teld.)database (management) system
dátuheilskapur	(teld.)data integrity
dátuheiti	(teld.)identifier
dáturøkjuskapur	(teld.)data discipline
dátusending	(teld.)data transmission
dátuskrá	(teld.)data dictionary
dátustovnur	(teld.)data bank, data base
dátutól	(teld.)data processing machine, data processor, computer
dátuviðgerð	(teld.)data (, computer) processing, computation; datamation
dB	: Perceived Noise Decibel
definera	síallýsa
definitión	síallýsing
degi	sídagur
-degis	síár-
degna	dawn, become day
-degnast	síav-
degning	dawn, daybreak,í degninginiat dawn
degningsæl	(eitt) dawn shower
degningur	dawn, daybreak,í degninginumat dawn, at break of day, at daybreak
deiga1	(gl.)maiden; (skotskt ogskald.)lass, lassie
deiga2	saunter, stroll, slouch,hann kom deigandi eftir vegnumhe came sauntering(el.slouching) along the street
deigbleytur	(um málm) soft, malleable; (um knívo.tíl.)dull, blunt
deigdirðil	1(um mannfólk) spineless man2blunt knife
deiggj	dough; (tunt) batter; (við smøri) paste;leggja deiggjprepare the dough
deiggja	daub(t.d.the walls of the building were daubed with red paint);deiggja samanknead; concoct(t.d.he concocted some elaborate story to explain her absence)
deiggjhøna	(niðr.,stb.)feminine man
deiggjutur	doughy
deigiligur	(skaldsk.)lovely(t.d.poem, voice); delightful(t.d.book, person, sight; it is delightful to live like this); beautiful, exquisite, charming(t.d.house);(tlm.)(frálíkur) wonderful, grand, splendid, excellent
deigna	(gl.)prepare the dough
deignari	(gl.)feminine man
deigur	1(um málm) soft, malleable2(um fólk) soft-hearted
deigutur	(stb.)slow, languid, sticky
deila1	1quarrel, dispute, disagreement, discord; strife2(átala) reprimand, rebuke, reproof; (skeld) wigging, dressing-down, ticking-off, telling-off
deila2	quarrel, dispute, fight;deila inn á e-nabuse sby, (tlm.)call sby names, give sby the sharp end of one's tongue;(am.)bawl sby out;hon deildi inn á hannshe hauled him over the coals; she ticked him off; she gave him a (real) straightening-out;deilastabuse each other, call each other names
deila3	1divide, share (out)2(stfr.)divide,deila y við xdivide y by x
deilan	deiling1
deilari	(stfr.)divisor
deild1	1part(t.d.this part of the room, another part of the building); division, section2(avmarkaður partur av flata) section, compartment;býta í deildirdivide into compartments(el.sections); (á pappírsarki) square off3(rúm) compartment4(í ráðharrastovu) division, (sub-)department;Deildin fyri arbeiðs- og almanna heilsuthe Department for Work and Public Health; (ES: av Dómstólinum) Chamber5(handilsm.) department; branch6(á sjúkrahúsi) ward(t.d.a maternity / surgical / psychiatric / children's ward);vera lagdur inn á eina deildbe admitted to a ward;læst deildclosed ward; clinic; department(t.d.psychiatric department)7(í fongsli) block8(herm.)battalion, unit(t.d.the lieutenant received orders to join his unit), detachment(t.d.a detachment of artillery); (serdeild) task force9(lið) section, batch(t.d.of recruits); gang(t.d.of workmen)10(ítr.)division; league11(úthandil, útbanki) branch(t.d.the Oxford branch of the bank)12(plfr.) section
deild2	piece of land, allotment
deildar-	(ofta =)senior, head, chief(t.d.nurse, consultant, architect)
deildarformaður	(í yrkisfelag) branch chairman
deildarleiðari	head of (a) department (, sectiono.tíl., sídeild); (á verksmiðjueis.)department(al) manager
deildarlækni	(uml. =)deputy superintendent, medical assistant
deildarroknskapur	divisional accounts
deildarsjúkrasystir	(fyrr) assistent matron, senior clinical nurse; (lægri stig) ward(el.charge) nurse
deildarskrivari	section secretary, department secretary
deildarskrivstova	branch office, area office
deildarstjóri	branch manager; (í banka) bank manager; head of a department; (á ráðharrastovu) head of (a) division, chief of a section; (svarar í Ongl. til) assistant secretary
deildfrukt	(plfr.)split fruit, mericarp
deildstovnur	(stfr.)dividend
deildtal	(stfr.)quotient
deiligur	1(tlm.)lovely, delightful2hj-liga;tað er so deiliga kyrtthe sea is so delightfully calm
deiling1	quarrel, dispute, disagreement, discord;sídeila1
deiling2	(stfr.)division
deilingarmerki	(stfr.)division sign
deilurit	controversial pamphlet, polemical pamphlet(el.treatise); squib
deingja	1beat, strike, hit2fling, throw, chuck, toss3lounge about, hang about
dekametur	decametre
dekan	(fríðk.)the deuce,dekan fari!confounded!, damnation!;dekan fari um hann ikkiI'll be damned if he didn't!;til dekans!damn!;dekans tíðhell, no!, don't talk rot!;hann er dekan og illa farinhe is in too bad shape;dekan og seinurtoo late
dekansligur	spiteful, malicious
dekanssettur	royn teg nú, dekanssettur well, come on you rogue;dekanssett!I'll be damned!
dekanssignaður	sídekanssettur
dekansskapur	nuisance, abomination
dekil	sídekan,dekilin dansi!oh hell!, oh blast!
dekin	sídekan
dekk	1(skip.)deck(t.d.one-deck vessel; two-deck vessel; lower deck; weather deck);við dekkidecked;við ongum dekkiundecked;á dekkinumon deck;allir mans á dekkið!all hands on deck!spula dekkswab the decks2(húsasm.)floor3(á akfari) tyre,(am.)tire
dekka	(ítrótt.) síverja
dekkari	(sjóm.)deckhand; (olju) roustabout
dekkbátur	sídeksbátur
dekklisti	1capping2(byggl.:til klædningsplátur) splat
dekkspor	tyre track
dekktrýst	tyre pressure
dekkur	(gl., skip.)sídekk
deknur	(kirkj. uml. =)parish clerk
deksbátur	(bát.)decked boat
deksbjálki	(skip.)deck beam
deksdrongur	(skip.)(ship's) boy;(serl.á fiskiskipi) deckie(-learner)
deksfar	decked vessel
deksfarmur	(á skipiel.báti) deck cargo
deksglas	(skip.)deck light;runt deksglasbull's-eye deck light
deksgluggi	(sigl.) skylight
dekshús	deck house, doghouse
dekshædd	(skip.)freeboard
dekslast	(skip.)deck cargo
dekslúka	(skip.)hatch; (lítil) scuttle; (opið) hatchway
deksmaður	sídekkari
deksmanning	(skip.)deck hands
deksplanki	(skip.)deck plank
dekspláss	(á skipi) steerage;ferðast á deksplássitravel steerage
deksportur	(skip.)port
deksstólur	(skip.)deck chair
deksstútta	(skip.)deck pillar, stanchion
dekstúrur	sídeksvakt
dekstørn	sídeksvakt
deksvakt	1service on deck2deck hands
deld	(stn.)small valley
delfin	(dýr.)common dolphin(Delphinus delphis)© Wikimedia Commons
demens	síminnissvinn
demma	dam
demokrati	sífólkaræði
demokratisera	democratize
demokratisering	democratization
demokratiseringstilgongd	process of democratization
demokratiskur	sífólkaræðisligur
demokratisma	democratism
demokratur1	(niðr.)pseudo-democracy, sham-democracy
demokratur2	sífólkaræðingur
demonstrantur	símótmælisfólk
demonstratión	símótmælisgonga,sýning
demonstrera	símótmæla,sýna (fram)
denotatión	denotation
dent	sídentur
dentildrív	sídanguldrív
dentilhóv	sídanguldrív
dentur	1diligence, industry2interest3emphasis,leggja dent á e-tmake a point of sth(t.d.of accuracy), stress sth, lay stress on sth, set great store by sth, attach (great) importance(el.weight) to sth(t.d.we attach great importance to this treaty), emphasize(t.d.his speech emphasized the importance of attracting industry to the town), endeavour to(t.d.I will endeavour to do my best for my country)
deodorant spray	deodorant spray
deodorantstift	deodorant stick
deodorantur	deodorant
depil1	1dot, spot2point
depil2	centre;(am.)center
depla	(skaldsk.)spot, fleck(t.d.the fabric was red, flecked with gold)
deplutur	(seyðal.)spotted
dergur	sídorg
dermatologi	dermatology
dermatologur	dermatologist, skin specialist
dertingur	nonentity; nobody(t.d.he is a mere nobody); person of no account
des	haystack
desasneið	(gl.)harvest festival
desember	December
desembermánaður	sídesember
desembur	desember
desibel	(alisfr.)decibel(st dB)
desigramm	decigram(me)(st. dg)
desilitur	(rúmmál) decilitre(st dl)
desimalur	(stfr.)decimal
desimálbrot	decimal fraction, decimal
desimálrokning	decimal arithmetic;læra desimálrokning í skúlanumlearn decimals at school
desimálskipan	decimal system; (myntskipan) decimal currency;fara yvir til desimálskipandecimalise(t.d.weights and measures),(tlm.)go decimal
desimáltal	decimal figure; decimal numeral
desimálur	decimal
desimálvekt	decimal balance
desimetur	(mát)decimetre(st dm)
desmin	(lívfr.) desmin
dessert	sweet, dessert; afters(t.d.we had figs for afters);(tlm.)pudding
dessertfat	dessert dish
dessertfrukt	dessert fruit
dessertgaffil	dessert fork
dessertkirsuber	sweet cherry
dessertknívur	fruit knife
desserttallerkur	dessert plate
dessertvín	dessert wine
destillatión	distillation, distilling
destillatiónsskipan	distilling plant
destillatiónstól	distilling apparatus, still, distiller; (í skipi) freshwater generator
destillera	distil
destin	boastful, bragging
detalja	sísmálutur;æs
detektivfilmur	detective film
detektivsøga	detective story
detektivur	detective;Sgumshoe
detta	1fall, tumble, tumble down(el.over), topple down, flop down2beat, pound3[ísamb. viðfs/hj]detta á:1regnið datt áit started raining2just manage,vit duttu á taðwe just managed it3aldur var dottin á hann he had begun to look old;detta afturfrá(t.d.í gongu) fall behind, lag behind;(sigl.)fall astern;detta afturumsídettaafturfrá;detta av1doze off, fall asleep2fall off(t.d.a horse)3break,tráðurin datt avthe thread broke4(um vind) become calm5(í fuglaveiðu) stop, cease, leave off6(drukkin) pass out;detta burturvanish, disappear, be lost;detta burtur ímillumbe outdone, be outstripped, be put in the shade;detta burtur úr rovum, sírov;sí eis.: detta burtur ímillum;detta fram ácome across, stumble upon, pick up(t.d.I picked up that chair in Italy);detta inn ádetta inn á gólviðpay a visit, look in, drop in, call in(t.d.he occasionally looks in here);detta í:mær datt í hugit occurred to me, it struck me, it crossed my mind, it entered my head;detta niðurfall down(t.d.the picture has fallen down); drop (down); tumble (down);(flogm.)crash(t.d.the plane crashed in flames);(t.d.í gongu) lag behind, be unable to keep up;detta niðurfrásíafturfrá;detta niðurfyricome to nothing;detta niðuryvir:náttin dettur niðuryvirnight is falling;detta omanfall down from cliffs;detta sundurfall apart, fall to pieces;detta um:fall down, tumble down, come down, drop(t.d.he came down(el.dropped) like a felled ox); (smokka saman) collapse(t.d.with fatigue);detta um av látri (tlm.)fall about;detta úr:tað hvørki datt ella drap úr honumhe did not utter a word; he was positively taciturn;detta útí1fall into the water, fall in2(fl.m.) fall off the wagon3(detta í felluna) walk into a trap; (gera mistak) slip;detta uppeftirbe amazed, be astounded, be taken aback, be disconcerted; (ógvisligari) be dumbfounded, be nonplussed;(tlm.)be gobsmacked
devil	sídevul
devul	devil,(illb.) for devulin!;devulin steiki!hell!, (oh) damn!, (oh) blast!;hví devulin náddi tú ikki tokið?why the devil didn't you catch the train?
devulsligur	sídjevulsligur;hj-liga
devulsoyra	(sj., stb., bát.) sílúsoyra
devulssettur	1damned, cursed, accursed, confounded2mðlv: devulssett!damned!, confounded!
devulsskapur	a nuisance(t.d.I think cars are a nuisance); abomination,(t.d.nuclear arms and that sort of abomination)
devulstíð	(illb.)hell, no!
deyda1	slowcoach,(am.)slowpoke, idler
deyda2	(plfr.)stonecrop(Sedum)
deydakendur	sídeydasligur
deydasligur	slow in(el.on) the uptake, slow off the mark(GG:the authorities are dragging their feet)
deydligur	1lifeless2boring(t.d.a boring evening), tedious, dull, slow3sad;hj-liga
deydningabein	dead men's bones;krosskastað deydningabeincrossbones
deydningadansur	dance of death
deydningahøvur	death's head, skull;deydningahøvur við tveimum krosskastaðum beinumskull and crossbones
deydningur	(lík) corpse, (dreygur) ghost, spectre; (beinagrind) skeleton
deyð	í osb: við neyð og deyð with difficulty; only just(t.d.we only just caught the train); barely(t.d.I barely managed to crawl upstairs);(tlm.)by the skin of his (, her) teeth(t.d.he just got into university by the skin of his teeth); a near thing,eg náddi tokið við neyð og deyðI caught the train, but it was a near thing;eg slapp undan við neyð og deyðI had a narrow(el.hairbreadth) escape; I escaped by the skin of my teeth; it was a close shave;tað var við neyð og deyð at hann ikki druknaðihe narrowly escaped drowning
deyða	(kvæð.)slay
deyðaaks	(gl.um korn) empty ear
deyðaangist	fear of death; (ring angist) mortal dread(el.fear), agony (of fear)
deyðaatvold	cause of death(t.d.the police inquired into the cause of death; the cause of death was poisoning)
deyðaár	year of his (, hero.s.fr.)death
deyðabangin	sídeyðaræddur
deyðableikur	deadly pale, pale as death, cadaverous, livid
deyðaboð	sídeyðsboð
deyðabrekaður	marked(t.d.he was then already a marked man), doomed
deyðabrot	1í osb: tað var við deyðabrotit was by exerting all our strength2death struggle, agony, death throes
deyðabúgv	estate of a deceased person;sita í óskiftum (deyða)búgviretain undivided possession of the estate
deyðadagur	death-day, day of sby's death;tað fari eg at minnast til deyðadag(s) I shall remember it till my dying day;til deyðadag(s) till the day of my death
deyðadansur	the Dance of Death
deyðadómur	(løgfr.)death sentence, sentence of death;(fl.m.)death warrant(t.d.this was the death warrant of the party; in doing this he signed his own death warrant);fella deyðadómpass a sentence of death
deyðadráttur	(skaldsk.)death struggle, agony, death throes
deyðadrukkin	dead drunk,(tlm.)blind (to the world), plastered
deyðadums	carelessness, indifference, recklessness, apathy
deyðadýrd	dead calm
deyðadømdur	sentenced(el.condemned) to death; the scheme has not got the ghost of a chance);klivi teirra deyðadømduthe condemned cell;(am.)the death cell;tann deyðadømdithe condemned man (, woman);(fl.m.)doomed(t.d.our plans are doomed; Europe is doomed; the scheme is doomed in advance(el.is foredoomed to failure);ætlanin er deyðadømd frammanundanthe scheme is doomed in advance(el.is foredoomed to failure); the scheme has not got the ghost of a chance
deyðafall	í osb: deyðafall er á lambinumí osb: deyðafall er á lambinumthe lamb is dying
deyðafíggindi	mortal enemy
deyðagivin	exhausted, dead beat, dead tired
deyðagras	withered grass
deyðagríma	death mask
deyðahald	í osb: standa el. sita við deyðahald(i)cling desperately to something
deyðahavsrullurnar	(sø.)the Dead Sea Scrolls
deyðakaldur	síísakaldur
deyðakav	(kvæð.) komin av deyðakavinarrowly saved from drowning
deyðakossur	kiss of death
deyðakuldi	chill of death
deyðakviðin	mortal
deyðakvirra	dead (, complete) silence(el.quiet)(t.d.a dead silence reigned)
deyðakvirrur	silent as the grave, deathly still
deyðakvøl	(bíbl.)fear of death
deyðakyrra	dead calm sea
deyðakyrrur	dead calm
deyðalega	deathbed;iðranir hansara á deyðaleguhis deathbed repentance;arvabræv á deyðalegudeathbed will;játtan á deyðalegua deathbed confession;á síni deyðaleguon his (o.s.fr.)deathbed.
deyðaleiddur	fed up, bored stiff
deyðalogn	dead calm sea
deyðalýsing	announcement of a death; death notice; (dømi: On March 18, 1994, at 26 King Street, Birmingham, Jessie Smith, second daughter of the late Alexander Smith, and sister of Mrs Alfred Dobbs. Funeral private. No flowers by request)
deyðamannalitur	cadaverous colour, lividness
deyðamein	deadly harm, fatal injury
deyðamerktur	marked(t.d.he was then already a marked man), doomed
deyðamóður	dead tired, dead beat; tired to death(t.d.I'm tired to death of his complaints); dog-tired,(tlm.)whacked,Sbuggered;eg eri deyðamóður (eis.)I am all in;eg eri so deyðamóður av hansara klagumI'm sick and tired of his constant complaints
deyðamyrkur	(bíbl.)deyðans myrkur
deyðamøddur	sídeyðamóður
deyðaótti	sídeyðaangist
deyðapøstur	sídeyðamóður
deyðarað	skeleton
deyðarak	skinny, bony, scraggy, scrawny,hann er deyðarak (eis.)he is all skin and bone
deyðarák	weak tide
deyðarevsing	(løgfr.)capital punishment, death penalty;avtaka deyðarevsingabolish capital punishment(el.the death penalty);fáa deyðarevsingbe sentenced(el.condemned) to death;misbrot sum deyðarevsing er fyricapital offence;deyðarevsing var fyri falsanforgery was a capital offence;undir deyðarevsingon pain of death
deyðaríki	(bíbl.)kingdom(el.land) of the dead
deyðaræddur	dead scared
deyðaræðsla	mortal dread(el.fear), agony (of fear)
deyðasina	withered grass
deyðasjúka	fatal disease, mortal illness
deyðasjúkur	mortally ill, terminally ill, dying;deyðasjúkur av krabbadying of cancer, mortally ill with cancer
deyðaskuggi	shadow of death
deyðaslættur	(um sjógv) dead calm
deyðasong	deathbed;á síni deyðasongon his (, hero.s.fr.)deathbed, when about to die
deyðaspakur	extremely tame
deyðastilli1	(sigl.)dead calm
deyðastilli2	dead (, complete) silence(el.quiet)(t.d.a dead silence reigned)
deyðastillur1	silent as the grave, deathly still;(sigl.)dead calm
deyðastillur2	1silent as the grave, deathly still2(um sjógv) dead
deyðastingur	death blow,geva e-m deyðastinggive sth the deathblow(el.coup de grace);geva særdum dýri deyðastingput a wounded animal out of its misery;geva ætlanini deyðastinggive the plan the kiss of death
deyðastívi	(lækn.)rigor (mortis);deyðastívi kemur írigor (mortis) sets in
deyðastívleiki	rigor (mortis)(t.d.rigor (mortis) sets in)
deyðastrá	liggja á deyðastrá be on one's deathbed
deyðastríð	death struggle, agony, death throes;í deyðastríðiin extremis
deyðastund	hour of death,á hansara deyðastund (eis.)when he was dying, in his last hour, on his deathbed;til mína deyðastundtill my dying day
deyðasuff	death sweat
deyðasvangur	starving,eg eri deyðasvangurI'm starving
deyðasvíkur	(sj.)mortal wound
deyðasynd	mortal(el.deadly) sin
deyðasærdur	mortally wounded
deyðasøk	(bíbl.)blood guilt
deyðatak	í osb: tað er eitt deyðatak at it takes all one's strength to
deyðatal	mortality, death-rate(t.d.a higher death rate, a higher rate of mortality; mortality curve)
deyðatalshagtøl	death-rate statistics
deyðatalsprosent	percentage of mortality, death rate, mortality
deyðatalssannlíkindi	probability of mortality, probable mortality
deyðatekin	sign of death
deyðatíttleiki	death rate, mortality rate
deyðatrá	(sálarfr.)death urge, death wish
deyðatroyttur	dead tired, dead beat, tired to death(t.d.I'm tired to death of his complaints), dog-tired,(tlm.)whacked,Sbuggered,eg eri deyðatroyttur (eis.)I am all in
deyðatystur	parched(t.d.let's get a drink ­ I'm parched)
deyðatøgn	utter silence, dead (, complete) silence(el.quiet)(t.d.a dead silence reigned)
deyðavandi	danger of one's life, mortal(el.deadly) danger;bjarga e-m úr deyðavandasave sby's life;hann var í deyðavandahe was in danger of his life(el.in mortal danger), his life was in danger;seta seg í deyðavandarisk one's life, expose one's life to danger
deyðavatn	(sigl.)dead water; (andligt) backwater;(fl.m.) hava deyðavatn í høvdinumbe unable to think;koma á deyðavatnlose interest
deyðaváði	sídeyðavandi
deyðaváttan	death certificate, certification of cause of death
deyðborin	stillborn(t.d.she gave birth to a stillborn child);ein deyðborin ætlanan abortive project;ætlanin var deyðborinthe project was doomed from the very start, the project was abortive, the project never had a chance(el.never got off the ground)
deyðbóltsstøða	(fótb.)set piece, set play
deyðbóltur	(fótb.)dead ball
deyðburður	(lækn.)stillbirth
deyðfolað	(um fyl) stillborn
deyðføddur	sídeyðborin
deyðgamal	ancient, exeedingly old
deyðgingin	tired out, exhausted (av gongd)
deyðgivin	tired out, exhausted, jaded(t.d.horse),(tlm.)done up, dog-tired, fagged, fagged out, dead beat
deyði	1death(t.d.die a glorious death; a sudden death; his tragic death; his premature death);nú er deyðin í durunumnow death is stalking the streets;hann gekk við deyðanum í hondunumhe was doomed;hatta verður mín deyðit will be the death of me;eins deyð annans breyð[one man's loss is another man's gain];(uml. =)it is an ill wind that blows nobody any good;møta deyðanummeet one's death, lose one's life, perish;líða deyðansuffer death, die, be killed, meet one's death, lose one's life;vera deyðanum nærat death's door, near death(GG:he very nearly died of his wounds);deyðans pylsaa deadly bore,Sa drag;standa andlit til andlits við deyðanface death;í deyðans stundin the hour of death;søkja deyðan fyri egnari hondtake one's own life2(løgfr., formligteis.)decease, demise(t.d.on the demise of the Crown)3(fataður sum persóngjørdur máttur) Death(t.d.no one can cheat Death; the Black Death)4[ísamb.viðfs/hj]frá:bjarga e-m frá deyðasave sby's life, save sby from death;fyri:liggja fyri deyðanumbe on one's deathbed, be dying, be at death's door;í:fara í deyðandie, face death, meet one's death;millum:hann sveimar millum lív og deyðahis life hangs in the balance;(tlm.)it is touch and go with him;til:døma til deyðacondemn (, sentence) sby to death;dømdur til deyðacondemned to death, under sentence of death;hann mintist tað til sín deyð(a)he remembered it till his dying day;keða seg til deyðabe bored to death, be bored stiff;(bíbl.) trúgvur til deyðan(s)faithful unto death;vera búgvin til deyðanbe prepared for death;úr:líkjast deyðanum úr Lybæklook like death warmed up;við:við deyðanum í hjartanumwith death in one's soul;dragast við deyðanbe in one's last throes;morð verður revsað við deyðamurder is punished by death, murder is a capital offence
deyðiligur	1(sum kann doyggja) mortal(t.d.all men are mortal); (sumn)mortal(t.d.we mortals; ordinary mortals)2(lívshættisligur, drepandi) mortal(t.d.mortal wound), deadly(t.d.a deadly blow), fatal(t.d.(alment) a fatal(el.terminal) disease; (um einstakling) a fatal illness, lethal(t.d.lethal dose of poison; a lethal weapon)3(líkur deyða) deathlike, deathly4(ógvisligur) mortal(t.d.mortal fear)5(fl.m.um keðsemi) deadly(t.d.deadly dullness)6hj-liga,mortally, fatally,deyðiliga sjúkurfatally ill; deadly(t.d.deadly dull)
deyðis	í osb:til deyðisto death,komin til deyðis í rakion the point of death due to starvation;bardur til deyðisbeaten to death
deyðísur	(jarðfr.) dead ice
deyðkomin	dying,deyðkomin av pínu (svongd)dying from pain (hunger)
deyðkyrra	completely calm sea
deyðkyrrur	(um sjógv) completely calm
deyðlaðin	(stb.)sísøkklaðin
deyðlamin	paralysed, helpless
deyðleiður	(bíbl.)sídeyðaleiddur
deyðleiki	mortality (rate)
deyðlúgvaður	sídeyðgivin
deyðmaktaður	exhausted, fatigued, tired out
deyðmóður	sídeyðgivin
deyðmøddur	sídeyðgivin
deyðpunkt	(tøkn.)dead point, dead centre;(fl.m.)deadlock, impasse;koma um deyðpunktið (tøkn.)pass (the) dead centre;steðga við deyðpunktiðstop at dead centre
deyðreinsa	(lækn.)disinfect
deyðræddur	dead scared, scared stiff, in mortal fear
deyðsaligur	sídeyðsamligur
deyðsamligur	dull, lethargic, apathetic
deyðsamsligur	sídeyðsamligur
deyðsboð	news of someone's death
deyðsbúarumsiting	administration of an estate (of a deceased person)
deyðsbúgv	(løgfr.)estate of a deceased person;óskift deyðsbúgvundivided estate (of a deceased person)
deyðsbúskiftari	executor(t.d.he was appointed executor under the will)
deyðsbúskifti	administration of the estate of the deceased
deyðseyður	[sheep dead from accident or disease]© Absalon Hansen
deyðsfella	death trap; (eldhættisligur bygningur) fire trap
deyðsgáva	donatio mortis causa
deyðsgong	death row
deyðshjálp	euthanasia
deyðsiglari	(sjóm.)sailing ship, sailing vessel,(t.d.in the sailing ship era); (slupp) smack
deyðsjúka	a fatal illness
deyðsjúkur	fatally ill
deyðskotin	shot dead
deyðslop	death leap
deyðslættur	sídeyðaslættur
deyðsmanssálmur	dirge,syngja deyðsmanssálmarcomplain; be worried
deyðsmessa	mass for the dead, requiem
deyðsorsøk	cause of death(t.d.the police inquired into the cause of death; the cause of death was poisoning)
deyðsótti	sídeyðaangist
deyðspakur	sídeyðaspakur
deyðstungin	stabbed to death
deyðsvangur	ravenous, famished
deyðsvanlukka	fatal accident, fatality
deyðsváttan,deyðaváttan	death certificate, certification of cause of death
deyðsynd	mortal(el.deadly) sin
deyðsærdur	mortally wounded
deyðtíð	downtime
deyðtystur	with burning thirst
deyður	1(lívleysur) dead,deyður og jarðaðurdead and buried,Sunder the daisies, pushing up the daisies;deyður og farindead and gone;deyður ella livandidead or alive;liggja deyðurlie dead; (látast deyður) sham dead, play possum;smella deyður(down) dead, drop (down) dead; inanimate(t.d.a rock is an inanimate object), lifeless2(fl.m.)dead(t.d.that custom is completely dead);deyð vektdead weight; slack(t.d.a slack period; dull(el.slackel.flat) market);Deyðahaviðthe Dead Sea;(tøkn.) deytt punktdead centre, dead point;(fl.m.)impasse(t.d.the negotiations have arrived at an impasse); deadlock(t.d.the negotiations have reached a deadlock)3(sum navnorð)tann deyðithe dead man (, womano.tíl.),the deceased;tey deyðuthe dead;(bíbl.)let the dead bury their dead);tey livandi og tey deyðuthe living and the dead;(bíbl.)the quick and the dead;rísa upp frá deyðumrise from the dead;(tlm.)do a Lazarus;ikki tala ilt um tey deyðude mortuis nil nisi bonum; one must not speak ill of the dead;garður teirra deyðuGod's acre;ríki teirra deyðuthe land(el.kingdom) of the dead;deyð og særddead and wounded;(herm eis.)casualties4(um likamspart: kensluleysur) numb, dead(t.d.the fingers were numb(el.dead) with cold);(lækn.) deyður vevnaðurdead tissue;(lækn.) deytt kjøtslough; (um kolubrand) gangrened tissue5(keðiligur) dull, tedious, dead, dead-and-alive;deyður í tídull, sluggish, listless, stodgy; dozy; (óáhugaverdur) listless, spiritless; (tómur) vacant(t.d.eyes, look), expressionless(t.d.an expressionless face))6(um bólt) dead)7(um ljóð) dead, dull)8(um fólk: dølskur) dead, dull, lifeless, spiritless)9(um pening)deyður kapitaluridle (, dead, dormant) capital)10(sigl.) skipið lá deyttthe vessel was lying stationary; (um kumpass) hang(t.d.the compass hangs)
deyðvekt	(eis. fl.m.)dead weight(t.d.the business carries the dead weight of an enormous debt; children and old people are a dead weight on the community);1000 tons deyðvekt1000 tons dead weight(el.d.w.);deyðvekt tonsataldead weight tonnage
deyðvektslast	(sigl.)dead weight cargo
deyma	stink, reek, smell
deymkorra	(plfr.)coriander
deymur	stench,(tlm.)stink, pong
deysa	tumble, topple; doze off,hon deysaði, sum hon sat framman fyri eldinshe dozed off in front of the fire
deyvalærari	teacher of(el.for) the deaf
deyvamál	sign language(t.d.American sign language)
deyvaskúli	school for the deaf
deyvastovnur	home for the deaf
deyvatulkur	signer
deyvblindur	deaf and blind
deyvdumbur	deaf-mute, deaf-and-dumb;ein deyvdumbura deaf-mute, a deaf-and-dumb person, a surdomute;tey deyvdumbuthe deaf-mutes, the deaf-and-dumb
deyvføddur	born deaf
deyvleiki	deafness
deyvligur	1(um mat) tasteless, insipid, vapid(t.d.vapid beer)2(um fólk) dull, sluggish, lethargic, weak
deyvoyra	a deaf person
deyvur	deaf, hard of hearing,deyvur sum potturinstone-deaf, deaf as a post;hann tosaði fyri deyvum oyrumhis words (, his warning, his appealo.s.fr.)fell on deaf ears; he preached(el.talked) to deaf ears;venda deyva oyrað tilturn a deaf ear
dg	
diagramm	(alisfr.)diagram, graph, chart(yvirof)
diagrammpappír	chart paper
diakonissa	deaconess; nursing sister, welfare worker
diakonur	(gl.)deacon; male nurse
diamantborur	diamond borer, diamond drill
diamantbrúdleyp	diamond wedding
diamanthandil	diamond trade
diamanthandlari	diamond dealer
diamantharður	hard as a diamond;(fl.m.)adamantine
diamanthavin	diamondiferous
diamanthálsband	diamond necklace
diamantkendur	diamond-like, adamantine
diamantklárur	limpid
diamantlega	diamond field
diamantlím	diamond cement
diamantnál	diamond pin; (til plátuspælara) diamond stylus, diamond needle
diamantprýði	diamond ornament
diamantskin	diamond lustre, adamantine lustre
diamantslípari	diamond cutter
diamantur	1(eis, sigl.:bákn) diamond;ektaður diamanturreal diamond;óektaður diamanturimitation diamond, paste diamond;óslípaður diamanturuncut(el.rough) diamond;ráur diamantur síóslípaðurdiamantur;slípaður diamanturcut diamond;svartur diamanturblack diamond2(glarmeistaradiamantur) glazier's diamond3(prent.)diamond
didda	1(little) girl2sister (sum kelinavn)
diddarak	skinny, bony, scraggy, scrawny
diddur	í osb: tað er diddur í honum he is mere skin and bone
diddurak	(sj., stb.)sídiddarak
didrarak	(stb.)sídiddarak
dieselmotorur	(tøkn.)diesel engine, oil engine;dieselmotorur við forkamariprecombustion engine;dieselmotorur við beinleiðis innspræningdiesel engine with direct injection
dieselolja	diesel oil
dieselsmyrjiolja	diesel lubricating oil
digagóður	(óregl.)-sídygðargóður
digaleysur	(óregl.)-sídygðarleysur
digg	(sj.)pottering
digga1	(barn.)duck
digga2	(barn.)tickle
diggast	potter about (with)(t.d.potter about one's garden)
diggudigg	tickle-tickle
diggur	(sj.)drop,ein diggur er eftir í fløskunithere is a drop left in the bottle
digla	1(á skinni) small (black) spot2(lítil) tuft of wool3(skýggj, royk) wisp(t.d.a thin wisp of smoke)
diglutrøstur	(fugl.)mistle trush(Turdus viscivorus)(Linnaeus, 1758)Turdus viscivorus ©iStock
diglutur	(seyðal.)spotted
digst	sídikst
digur	1(um fólk) stout; thick, plump, fat; (um lutir) bulky2(um mjólk) rich
dik	1(gl.)powerful blow, powerful push2exertion, effort,taka dik á el. í segpull oneself together, exert oneself, get going;eitt gott dik framáone big step ahead;taka bátin eitt dik betur framtake the boat a bit further forward3(alisfr.)acceleration
dika	1dika ástrike, hit powerfully2come at speed
dikevni	(um bil) acceleration, accelerating capacity;(tlm.)pick-up
dikferð	acceleration
dikka	(um klokku) tick
dikkast	sídiggast
dikkur	(stb.)dinghy
dikst	(upprfr.) -sídygst
dikt	(upprfr.) -sídygt
diktíð	acceleration time
dild	(plfr.)dill, bishop's weed(Anethum graveolens)
dilkadrongur	(niðr.,stb.)prankster, good-for-nothing, a ne'er-do-well
dilkur	(festival) dish
dilla1	(um móta) fad, craze(t.d.it's the latest craze, it's the craze of the moment, it's all the craze), whim(t.d.the whims of fashion, a passing whim); rage,postmodernisma er tann heilt stóra dillan í løtunipostmodernism is all the rage(el.the big thing) at the moment
dilla2	quiver
dillari	pig, piggy, piggy-wiggy
dimma1	(sj.)sídimmi
dimma2	darken, become dark,gøtur tóku at dimma(the) streets darkened, became dark; make dark
dimmabrúnur	sídimmbrúnur
dimmagráur	sídimmgráur
dimmagrønur	sídimmgrønur
dimmagulur	dark yellow
dimmalætting	dawn, daybreak
dimmareyður	dark red
dimmbláur	dark blue
dimmblettutur	dark spotted
dimmbrúnur	dark brown
dimmbrýntur	with dark eyebrows
dimmevni	(stjfr.) dark matter
dimmgráur	dark grey
dimmgrønur	dark green
dimm helsigás	(fugl.)Brant Goose(Branta bernicla bernicla)(Linnaeus, 1758)© iStock
dimmholdaður	of dark complexion, dark skinned, dark(-skinned), swarthy;(skaldsk.)dusky
dimmhærdur	dark-haired
dimmi1	1dark(t.d.after dark), darkness, gloom;á dimminumin the dusk, in the twilight, in the gloaming;dimmi lættir (av)dawn is breaking2(midnátt á sumri)um dimmiðat midnight
dimmi2	silhouette,eg hómi dimman av landiI can dimly see the silhouette of land
dimmikjarnbítur	evening grosbeak
dimmilíri	[young Manx shearwater which is cought in the dark]
dimmilundi	[young puffin which is caught in the dark];(sk.) taka dimmilundatake a drop in secret, tipple in secret
dimmilætting	sídimmalætting
dimming	dusk, twilight, gloaming
dimmingarseta	(stb.)sískýmingarseta
dimmjarpur	dark brown
dimmleittur	1(um húðarlit) swarthy(t.d.a swarthy complexion; a swarthy face), dark-complexioned, darkish, dusky(t.d.her skin turned a dusky gold in the sun)2dusky(t.d.dusky light inside the cave; dusky pink)
dimmligur	darkish, dusky, rather dark
dimmlittur	dark(-coloured), dark in colour
dimmlýsi	semi-obscurity, half-light; (skýming) dusk
dimmmorreyð ont	(fugl.)American Black Duck(Anas rubripes)(Brewster, 1902)© Henry T. McLin
dimmmorreyður	dark brown; American Black Duck síDimmmorreyðont
dimmorka	(stjfr.) dark energy
dimmoygdur	dark-eyed
dimmprikkutur	dark-spotted
dimmreyður	dark red
dimmskýggjaður	with dark clouds
dimmur	1(við ongum ljósi) dark, obscure2(um lit) dark(t.d.green); sombre; (um klæði ofta) subfusc(t.d.in subfusc shades);(um hár)dark, brunette3(dapur) dark, sombre(t.d.thoughts)4(fugl.) dimmur velreyðiblack redstart
Dimmur havskrápur	(fugl.)Sooty Shearwater(Puffinus griseus)(Gmelin, JF, 1789)©iStock
dimmur velreyði	(fugl.)black redstart(Phoenicurus ochruros)(Gmelin, SG, 1774)Phoenicurus ochruros ©Ferran Pestaña
dimmviðrað	gloomy, dull
dimmviðri	gloomyel.dull weather
dingla	dangle, swing
dinkuldrív	(sj.,gl.)idler, slacker, lazybones, lazyboots
dinosaurur	(dýr.)dinosaur
dint	bump
dinta	oush, thrust
dintil	1(á seyði) tail2back, behind, seat
dintilsbein	(likam.)seat bone,(yrkism.)ischium (os ischii)
dintilsgóður	self-confident; well-balanced
dintla	dintla seg til venture, dare to;hann gongur og dintlasthe is pottering about
dioda	(ravm.)diode, two-electrode valve
dioritt	(jarðfr.;málmur) diorite
dirðil	1(gl.)tail2back, behind, seat
direktiv	sífyriskipan,boð,boðskriv
dirka	open with a skeleton key;dirka lás upppick a lock
dirkur	skeleton key, picklock; dub
dirl	(stb.)dangler;(tlm.)gooseberry
dirla	(sj.)dangle; lag behind
dirtl	(stb.)dangler
dirtla	(stb.)ganga og dirtla potter about
dirva	> dirva seg til e-t venture, presume, dare to
dirvi	boldness, daring, audacity, heart, courage,(tlm.)pluck;Sguts
dirvin	bold, audacious
dirvisgóður	bold, courageous, brave
dirvisleysur	faint-hearted, dispirited, despondent
dirvisligur	bold, daring, courageous, brave
dirvislítil	faint-hearted, dispirited, despondent
dirvisloysi	timorousness, timidity, faintheartedness
dirvisloysingur	coward
dirvismikil	bold, daring, courageous, brave
dirvisorð	bold words
disja	quiver
diskadriv	(teld.)disc drive
diskaslá	plate rack
diskast	(stb.)potter about
diskil	(teld.)diskette, floppy disc; minidisk, flexible disc
disklastøð	(teld.)disc drive
disklop	(lækn.)slipped (, herniated, ruptured) disc
diskonto	síaðalrenta
diskotek	discotheque;(tlm.)disco; (plátusavn) record library
diskrúmd	(teld.)disk volume
diskskúmari	disc skimmer
diskur	1dish, plate, platter,(orðt.) betri eru smáir fiskar enn tómir diskar(kann sigast:) half a loaf is better than no bread2(kirkj.)paten3counter(t.d.í handli)4(teld.)disc5(lívfr.)disc
diskusprolaps	sídisklop
dism	1dust, fluff2(t.d.av mjøli, salti, teo.tíl.)bit, a little bit, grain3(gl.)drizzle
disma	drizzle,tað dismarit is drizzling
disp	sídism
ditta	venture to(t.d.assert that), make so bold as to(t.d.ask him), presume to, dare to,(tlm.)have the nerve to
dittimundur1	sídittin
dittimundur2	rash
dittin	bold, daring; rash
díki	1puddle2swamp (t.d.the ceaseless deluge had turned the lawn into a swamp),marsh, bog(eis. flm.)(t.d.a bog of legal complications)
díkiblomstur	sídíkimura
díkiblóma	sídíkimura
díkimura	(plfr.)Marsh Cinquefoil(Potentilla palustris)© Wikimedia Commons
díkistyriltunga	(plfr.)Greater Bird's-foot-trefoil(Lotus uliginosus)© Wikimedia Commons
díkistør	(plfr.)Tawny Sedge(Carex hostiana)© Wikimedia Commons
díkja	(gl.)whip, flog, thrash, beat,díkja á hestinwhip the horse;(um arbeiði) díkja áwork very hard; throw oneself into a task;regnið díkti áthe rain was beating down;hann díkti teir undir í arbeiðihe overburdened them with work
díkjutur	boggy, marshy, slushy, muddy
díli	sídigli
dílutur	sídiglutur
dímuningur	person from Dímun
dís	(gudal.)goddess, nymph
djarvligur	1hj-ligaboldly, audaciously2rather bold
djarvmæltur	in bold words
djarvnasaður	impudent
djarvur	courageous, brave, bold; stouthearted;(tlm.)plucky
djassur	(tónl.)jazz
djevladyrkan,djevladýrkan	devil worshipping
djevlarí	(gl., tlm.)devilry
djevlatilbiðari	devil worshipper, satanist
djevlatilbiðing	devil worshipping, satanism
djevul	devil, fiend, demon,djevulinthe Devil, Satan
djevulskur	djevulsligur
djevulsligur	1diabolical, fiendish, devilish2hj-ly(t.d.diabolically clever)
djevulssettur	diabolical; damned, beastly, confounded
djór	1animal;sum eitt elt djórlike a hunted animal;lægri djórlower animal;vera góður við djórkind to animals; (um stór súgdjór) beast; (á garði) livestockflt; animals(t.d.feed the animals)2(niðr.)brute, beast(t.d.he is an absolute beast);órið í menniskjanumthe beast within
djóraaling	animal husbandry (, breeding)
djóraátin	zoophageous, carnivorous; eis.dýraátin
djórafápil	animal fable
djórafiti	animal fat
djórafrøði	(dýr.)zoology; (lærubók) zoology (text)book
djórafrøðiligur	zoological
djórafrøðingur	(dýr.)zoologist
djóragarður	zoological garden(s), zoo
djóraheimur	(á e-m ávísum øki) fauna; animal population; (djóraríki) animal kingdom
djórakringur	(stjfr.)the zodiac, (the signs of the zodiac)
djóralív	animal life(t.d.he writes about animal life); fauna; (ótamd) wildlife
djóralæknaeftirlit	veterinary supervision, veterinary inspection;undir djóralæknaeftirlitisubject to veterinary inspection, inspected by a veterinary surgeon, under veterinary supervision
djóralæknakynstur	the veterinary science
djóralæknaskúli	veterinary school, school of veterinary science
djóralæknastova	veterinary hospital
djóralæknaviðgerð	veterinary treatment
djóralæknavirksemi	veterinary surgeon's practice
djóralæknavísindi	veterinary science
djóralækni	veterinary surgeon,(tlm.)vet
djóralæra	zoology; (lærubók) zoology (text)book
djórapínsla	cruelty to animals
djóraringur	(stjfr.)the zodiac
djóraríki	animal kingdom
djórasjúkrahús	veterinary hospital
djóraslag	species (of animal);hótt djórasløgendangered species
djórastovnur	animal population
djórasýning	cattle show
djóraveiða	(kvæð.)hunt for (wild) animals
djóravernd	prevention of cruelty to animals, animal protection
djóraverndarfelag	animal lovers' league, Our Dumb Friends' League; society for the prevention of cruelty to animals;Djóraverndarfelagið(í Ongl.) the Royal Society for the Prevention of Cruelty to Animals, the RSPCA;(am.)the Society for the Prevention of Cruelty to Animals, the SPCA
djóravinur	animal-lover
djúp	deep, abyss; sí eis.dýpi
djúpan	deeply,draga andan djúpanbreathe deep(ly), draw a deep breath;suffa djúpanheave(el.fetch) a deep sigh
djúpaskáp	(sk.)tommy
djúpbláur	deep-blue
djúpd	depth; the depth of the sea, a cave, a hole, the perspective, his feelings, his voice, a well;(fl.m.)profundity(t.d.the profundity(el.the depth) of his thoughts);(tónl.)depth, (low) pitch;tað er djúpd í myndinithe picture has depth;fara í djúpdinago into(t.d.the matter) in depth; (gjølligari) plumb(el.sound) the depths;hann fer ikki í djúpdina (eis.)he merely scratches the surface
djúpfals	deepfake
djúpfiskur	deep-sea fish
djúpfrysta	deep-freeze
djúpfrystari	deep freezer, deep freeze
djúpfrysting	deep freezing
djúpgongdur	1profound, thorough, searching, in-depth; (víðtøkin) radical;djúpgongdar atfinningarsearching criticism;djúpgongdar rannsóknirin-depth(el.intensive) studies;djúpgongdar broytingarradical alterations2(um kava) deep
djúpgrund	(jarðfr.)bedrock
djúpgrýti	(jarðfr.)plutonic rock, plutonite
djúpgrýtingur	(jarðfr.)pluton
djúpgrønur	deep green
djúphav	deep sea
djúphavs-	deep-sea(t.d.basin; fishes; formation);(lívfr.,eis.)benthic
djúphavsdýr	deep-sea animal
djúphavsfiskaslag	djúphavsfiskasløg(eis.)abyssal species(el.variety)
djúphavsfiskur	deep-sea fish
djúphavsgranskari	oceanographer
djúphavsgransking	deep-sea(el.oceanographic) exploration, oceanography; oceanics
djúphavskanning	deep-sea exploration
djúphavsrannsóknarferð	deep-sea exploration expedition, oceanographic expedition
djúphavsrækja	deep-sea shrimp
djúphavsskorpa	(jarðfr.) oceanic crust
djúphavsslætti	(jarðfr.)abyssal plain
djúphavstøkni	deep water technology
djúphugaður	profound, deep
djúphugsin	meditative, speculative
djúphugsni	meditation, speculation
djúpleittur	meditative, profound
djúplendur	(um lendi) with deep soil
djúpliga	profoundly, deep
djúpmæltur	with a deep voice
djúpoygdur	with deep-set eyes
djúpskygdur	intelligent; profound, penetrating; conscientious, scrupulous
djúpstaddur	deep-set
djúpsteikifeitt	deep-frying fat
djúpsteiking	deep-(fat-)frying
djúpsteikja	deep-(fat-)fry
djúpsteiktur	deep-fried
djúpsýni	meditation, speculation
djúptonktur	meditative, speculative
djúptøkin	profound, thorough, searching, in-depth; radical(t.d.reform), drastic; thorough(going)(t.d.clean-up, examination, reform); root-and-branch, all-out(t.d.reform); full-dress(t.d.investigation)
djúpur	(eis. djypri)hást djúpastur(eis. djypstur)1deep(t.d.a deep valley, well); (um kenslu) deep, profound; (um lit) deep(t.d.a deep blue);(tónl.)deep, low;djúpur bassura deep bass2[íyms.samb.]djúptbukka deep(el.low) bow;djúptfalla fall from a great height, a long drop;(fl.m.)a heavy fall;djúpurfriðurprofound peace;djúparkenslurdeep(el.profound) emotions;tann djúparameininginvið hesumits underlying meaning;djúptmyrkurprofound darkness;við djúparirøddin a deep voice;djúptsára deep wound;djúpursjógvurdeep water;seta djúpspormake a deep impression(íon), exercise a great(el.profound) influence;djúpursvøvnurprofound(el.deep) sleep;í djúpum svøvnifast asleep, deep in sleep;í djúpumtonkumdeep(el.lost) in thought; in a brown study;djúptøgndeep(el.profound) silence)3(um skip: sum stingur djúpt): heavy-draught; (sum hugsar djúpt) profound, penetrating
djúpvatnstrolari	(sjóm.)deep-sea trawler
djús	juice
djørv	sídjarvur
dl	decilitre
dm	decimetre
D-markur	(bú.)D-mark, Deutschmark
doddur	1tuft2front hair, forelock
doða	dampness
doðaligur	damp
doðaveður	damp weather,tað er doðaveður í dagit is a damp day
doði	1(slight) haze2drizzle
dogma	dogma
dogmatiskur	1dogmatic2hj. -ally; tala dogmatisktdogmatize
dokk	1(sigl.)dock;fáa í dokkdock, bring into dock;fara (el. koma) í dokkdock, go(el.come) into dock;skipinum tørvar at fara í dokkthe vessel requires docking;vera í dokk (eis.)be docked;turr dokkdry (el. graving-) dock;vát dokk(wet) dock2(teld.)docking station
dokkstøð	(teld.)docking station
dokkur	lock (of hair), frizzy hair
doktarabátur	ambulance boat
doktaraevni	(fróðsk.)candidate (for the doctorate)
doktaragildi	[celebration of the successful defence of a thesis]
doktaraheiti	(fróðsk.)the title of doctor
doktarahond	í osb: fara el. koma undir doktarahondhave medical treatment; come under the doctor's care
doktaralærdur	medically trained
doktararáð	(gl.)medical advice;gamalt doktararáðan old remedy;(ofta =)a household remedy
doktararingur	doctor's ring; (verður ikki brúkt í Ongl. og USA)
doktararitgerð	(fróðsk.)thesis (for the doctorate), doctoral thesis; doctoral dissertation;doktararitgerðin varð góðkendthe thesis was accepted;doktararitgerðin varð vrakaðthe thesis was rejected(el.turned down);verja doktararitgerðdefend one's thesis;skriva doktararitgerðprepare a thesis
doktaraskapur	(lækn.)medical knowledge
doktarastig	(fróðsk.)doctor's degree, doctorate
doktari	1(fróðsk.)doctor2doctor, medical practitioner, medical adviser
doktrin	doctrine;sí annars:læra, lærusetningur, lærdómssetningur, ástøði
dolkur	(sø.)dagger;(nýtíð.)sheath knife
dollaralán	dollar loan
dollari	(bú.)dollar
dollarseðil	dollar note, dollar bill
dolomitt	dolomite
dominikanskur	Dominican;Dominikanska lýðveldiðthe Dominican Republic
domino	(spæl) dominoes; (t.d.play (a game of) dominoes)
dominoástøði	domino theory
dominoávirkan	domino effect
dominospæl	(game of) dominoes
dongdi	sídeingja
dongla	(teld) dongle
dongul	(teld) dongle
donkraft2	jack;hydraulisk donkrafthydraulic jack;donkraft við skrúvuscrew jack;hevja við donkraftjack up
dorg	fishing-line
dorma	(stb.)slumber
dorur	drift, mandrel
dossa	1become moist,(el.humidel.damp)2drizzle
dossaligur	damp, moist
dossasligur	(stb.)sídeyðsamligur
dossin	sídossutur
dossleittur	1(um veður, luft) heavy, hazy, misty2grimy(t.d.face), grubby(t.d.grubby hands), (um lit) muddy
dossligur	sídossleittur
dossutur	(sj.)damp (um klæði)
dottin	sídetta
dovin	1(um fólk) lazy, idle, indolent; sluggish2(um drykk, mat) insipid, flat, stale3(umt.d.hoyggj) damp
dovinbjølgur	(Suð.)idler, slacker, lazybones, lazyboots
dovindansari	(Suð.)sídovinbjølgur
dovinskapur	laziness, idleness, indolence, sloth
dovisligur	lazy, idle; sluggish, lethargic
dovna	1become weak; idle, loaf, laze2(um mato.tíl.)become insipid,(el.flatel.stale)
doyða	(gl.)kill
doyðin	sídoyður
doyður	í osb: leggja doyðin ámake a point of sth(t.d.of accuracy); stress sth, lay stress on sth, set great store by sth, attach (great) importance(el.weight) to sth(t.d.we attach great importance to this treaty);leggja størri doyð á hetta enn annað (eis.)let sth outweigh sth else(t.d.he let economic considerations outweigh the claims of nationality);leggja ov stóran doyð á eittmake too much of sth; attach too much weight(el.exaggerated importance) to sth;leggja doyðin á at (t.d.at økja um framleiðsluna) direct one's efforts to(t.d.increasing production);leggja doyðin á at verða valdurmake a big effort to get elected
doyggingardagur	(sj.) í osb: til sín doyggingardagto one's dying day
doyggja	1die, breathe one's last, expire, pass away, pass on;Sgo west, peg out, kick the bucket, cash in one's chips, croak; (farast, látast) perish, be killed, meet one's death; (um likamspart, gerast kensluleysur) grow numb2[ísamb.viðfs]av(fl.m.) hasum doyr hann ikki avthat won't do him any harm(el.hurt himel.kill him);doyggja av drykkjuskapidrink oneself to death;hvørjum doyði hann av?what did he die of?um at doyggja av keðsemibe bored to death;doyggja av kuldadie from exposure;at doyggja av forvitnibe dying of(el.burning with) curiosity, be dying to hear all about it;um at doyggja av ræðslube frightened(el.scared) to death;doyggja av sorgdie of grief;doyggja av svongdstarve (to death); die of starvation;doyggja av sjúkudie of a disease;doyggja av tostadie of thirst;ádoyggja á bálidie(el.perish) at the stake;doyggja á sjónumdie at sea;burturdie away(t.d.the song died away in the distance; the wind died away); die down(t.d.the storm is dying down); fade away(t.d.his enthusiasm faded away);málið doyði burturthe matter died a natural death(el.was forgotten);samrøðan doyði burturthe conversation flagged; die out, become extinct, become obsolete, become out-of-date; (um vind) fall, drop, die away, die down(t.d.the breeeze died away);frádoyggja frádie leaving(t.d.she died leaving a child)foreldrini doyðu frá teimumthey were left orphans;hann doyði frá konu og børnumhe died leaving a wife and family;fyridoyggja fyri fosturlandiðdie(el.give one's life) for one's country;doyggja fyri egnari honddie by one's own hand, take one's own life, commit suicide;doyggja fyri tíðinadie before one's time; die prematurely;ídoyggja í barnferðdie in childbed;doyggja í føðinginidie at birth;doyggja í Harranumdie in the Lord(el.in the odour of sanctity);tú doyrt í kulda (eis.)you will catch your death of cold;eg mundi doyð í látriI nearly died with laughter(el.laughing), I was killing myself laughing;doyggja av svongd og kuldadie of hunger and exposure;tað slapp ikki at doyggja í syndinithey never heard the last of it;niðurdoyggja niður øðrumeginbe paralysed down one side;útdoyggja útdie out(t.d.the family died out); die off, become extinct3doyggjandi: til sín doyggjandi dagto his dying day
doymi	odorant
doypa	(kirkj.)baptize, christen; (eitt skip) christen, name; (við ongum ávirki) administer baptism;hann læt seg doypahe was baptized; he was received in baptism;hann varð doyptur Johnhe was christened John;doyptir jødarJewish converts (to Christianity);hann varð doyptur John eftir abbanumhe was christened John after his grandfather
doypari	(bíbl.)(umdoypari) baptist;(sø.)anabaptist;Jóhannes doypari(n)St John the Baptist
doypifuntur	(kirkj.)(baptismal) font
doyping	(átr.)baptism, christening; (skip,eis.)naming ceremony
doyr	sídoyggja
doysin	(sj.)hanging slack, drooping
doysleittur	sídossleittur
doyva	1subdue, moderate, damp, temper, calm, mitigate,doyva hansara sorgmitigate his grief;doyva hansara vreiðimitigate his anger; put a damper on,doyva gleiminput a damper on the mirth; numb, quieten,doyva sína ringu samvitskunumb (, quieten) one's bad conscience; ease, assuage, alleviate,doyva pínunaalleviateel.ease the pain;doyva ein littone down a colour, soften a colour;doyva ljóðiðdeaden the sound; keep the noise down;doyva røddinalower one's voice; hush up(t.d.a scandal); (um tónleik) mute2(lækn.)give an anaesthetic, administer an anaesthetic to, anaesthetize; render unconscious; (við drøggi) drug; dope(t.d.he was doped before they murdered him);doyva e-n lokaltadminister a local anaesthetic to sby;doyva eina tonn (tlm.)freeze a tooth3(gl.óhvessa), blunt, dull, deaden4doyva niðurpress (down)
doyvari	put(el.cast) a damper on, damp(t.d.damp their ardour; damp sby's spirits);leggja ein doyvara á gildið (el. gildisrómin)throw a wet blanket over the party, be a party-pooper
doyving	(lækn.)(tað at doyva) anaesthetization; (doyvd støða) anaesthesia; (við drøgg) drugging, doping;lokal doyvinglocal anaesthesia;geva honum lokala doyving (eis.)give him a local anaesthetic;undir doyvingunder an anaesthetic;vakna upp úr doyvingcome round from(el.out of) an anaesthetic
dólgabýttur	a downright fool, bone-headed
dólgaskapur	dullness, lethargy, indifference
dólgsligur	dull, lethargic, apathetic; sleepy, dull-witted
dólgur	clumsy person; a good-for-nothing
dólgutur	sídólgsligur
dómadagsmálmur	(tónl.)doom metal
dómadagsprofeti	prophesy of doom
dómadagsprofetur	Doomsday prophet, prophet of doom
dómadagsprædika	hell-fire(el.fire-and-brimstone) sermon
dómadagsprædikumaður	Bible-thumper;(fl.m.)prophet of doom
dómadagur	(átr.)the Day of Judgment, the Last Day, Doomsday; (Michelangelosar) the Last Judgement;á dómadegion the Day of Judgment;til dómadagstill the crack of Doom, till Doomsday
dómalóg	(løgfr.)case-law
dómarabrá	judicial manner; magisterial air
dómaraeiður	(løgfr.)judicial oath
dómaraembæti	(løgfr.)judgeship; justiceship; recordership; (sum friðardómari) commission of the peace, magistracy
dómarafulltrúi	(løgfr.)magistrate's clerk; (stundum) deputy judge
dómarafundur	(løgfr.)magistrate's
dómarakanning	judicial inquiry
dómarakappi	judge's robes
dómarakast	[ball dropped by the referee]
dómaranevnd	committee(el.panel) of judges; (til djórasýning, framsýningo.s.fr.)judges, jury
dómaraskrivstova	court registry
dómaraskylda	duty as a judge
dómarastarv	(løgfr.)justiceship, duties as a judge
dómarastætt	judiciary;dómarastættin (eis.)the Bench
dómarasæti	judgment seat, judge's seat;dómarasætið (eis.)the Bench;sita í dómarasæti(meðan mál fer fram) be on the Bench, hear the case(t.d.the case was heard before the Lord Chancellor)
dómaratorn	(til kappríðing) the judges' box(el.stand)
dómaraúrskurður	(løgfr.)(search) warrant
dómaravakt	judge ((í Ongl.:) magistrate) on duty
dómari	1(løgfr.)judge; (í hægstarætti) justice; (friðardómari) magistrate, justice of the peace; (býrættardómari) recorder;dómararnir(um samdómarætt) the Bench; (um stættin) the judiciary, the Bench;harra dómari(sagt við friðardómara) Your Worship; (í County Court) Your Honour; (í hægstarætti) My Lord;X var dómari í málinumthe case was heard before X.;(bíbl.)the Book of Judges;seta seg sum dómara yvirset oneself up as a judge of2(í samb. við djóraframsýning og framsýning) judge3(ástøðumaður, dómari í tennis, golf, kricket, baseball) umpire; (ítrótt)vera dómariumpire; referee(t.d.he refereed the football match), act as umpire (, referee); (í fótbólti) referee, ref(am.)umpire,(am.) Sump; (í nevaleiki) referee; (kapprenning, kappsigling) judge; (í hernaðarvenjingum) umpire; (til kappsiglingeis.)the Committee; (til framsýningareis.)the jury
dómbók	(løgfr.)record
dómfella	(løgfr.)pronounce a sentence; (døma sekan) convict(t.d.be convicted of a crime);(viðv.revsing) sentence(t.d.sentence sby to hard labour), pass sentence upon; (banna) condemn
dómfelling	(løgfr.)sentencing, conviction
dómfordømi	(løgfr.)precedent
dómhús	court(house);dómhúsið (eis.)the Law Courts
dómkirkja	(kirkj.)cathedral
dómpróstur	(kirkj. uml. =)dean (of the chapter)
dómsfólk	sídómsmaður
dómsfullgerð	(løgfr.)execution
dómsgerð	(løgfr.)sentencing, conviction
dómsgrundir	(løgfr.)grounds of the judgment
dómskraft	legal force
dómskunngerð	(ES) service of the judgment
dómsmaður	(løgfr.)lay assessor
dómsmálaráðharri	(stjm.)Minister of Justice; (í Ongl. er embætið býtt millum fleiri,serl.:)Lord Chancellor, Home Secretary;(am.samsvarar við) Attorney-General;(da.)Minister for Justice
dómsmorð	(løgfr.)miscarriage of justice; (lívtøka) judicial murder
dómsnevnd	committee(el.panel) of judges; (til djóraframsýningar, framsýningaro.tíl.)judges, jury
dómsorð	1(bíbl.)judgment; (glatan) damnation, perdition2condemnatory word
dómsskjóta	(løgfr.)appeal;skjóta dóm inn fyri hægstarættappeal (the case) to the supreme court; carry(el.take) the case (up) to the supreme court;dómurin kann verða skotin inn fyrian appeal lies to(t.d.a superior court)
dómsskot	(løgfr.)appeal
dómsskotsfráboðan	(løgfr.)notice of intent to appeal
dómsskotsfreist	(løgfr.)time-limit for an appeal
dómsskotsgrund	(løgfr.)ground(s) of appeal
dómsskotsvald	(løgfr.)court of appeal, appeals committee
dómsstig	(løgfr.)instance,føra málið gjøgnum øll dómsstiginicarry the case through all the courts;fyrsta dómsstig (løgfr.)court of first instance;hægsta dómsstigfinal court of appeal
dómssøgn	(løgfr.)(í brotsmáli) passing of a sentence, pronouncement of sentence; (í borgaraligum máli) delivering judgment
dómsting	(sø.)parliament with judicial authority
dómstólur	(løgfr.)lawcourt, court (of law(el.of judicatureel.of justice)); (mestfl.m. el.um søguligel.ikki-ensk viðurskifti) tribunal(t.d.the tribunal of my own conscience);(serl. bíbl.)judgment seat;dómstólarnir (eis.)the judiciary, the Bench;Altjóða dómstólurinthe International Court of Justice;blandaður dómstólurmixed tribunal;deildir dómstóla(ES) the Chambers of the Court of Justice;leggja málið fyri dómstólarnar, fara til dómstólarnargo to court about the matter, take the matter into court;forseti dómstólsins(ES) the President of the Court;fyri e-m dómstóliin court, before the court;hernaðardómstólurmilitary tribunal;seta e-n til svars fyri dómstólinumsue sby;seta e-n fyri ein dómstólput sby on trial, try sby;søgunnar dómstólurthe Court of History
dómsvald	(løgfr.)judicial power
dómsveldi	sídómsvald
dómsviðgera	(løgfr.)try, hear
dómsviðgerð	(løgfr.)hearing, oral pleadings; (í brotsmálumeis.)trial;áseta til munnliga dómsviðgerðset down for trial;til munnlig dómsviðgerð verðuruntil the case is heard by the court
dómur	1(í brotsmáli) sentence,hansara dómur varhe was sentenced to; conviction;harður dómursevere sentence;mildur dómurlight sentence;treytaður dómursuspended sentence;fáa treytaðan dómbe bound over;(am.)get a suspended sentence2(í borgaramáli) judgment; decree3(meining) opinion, judgment; verdict(t.d.the verdict of history)4(heimsp.)proposition; judgment(t.d.propositions are judgments expressed in words)5(gudfr.)judgment,evsti dómurthe Last Judgment; (banning) damnation, perdition; (í heimsins enda) judgment6(í ítrótt) judgment, decision,skeivur dómuran erroneous decision7[íyms.samb.]málavgjørt viðdómires judicata;fáaharðandómget a severe sentence;ein órímiliga harður dómur (eis.)a savage sentence;fáatreytaðandómbe bound over;(am.)get a suspended sentence;felladóm yvir(1) pass sentence upon, sentence;(serl.ikki løgfrøðiliga) pronounce judgment on;dómurin fellur(1) sentence is pronounced; (2) judgment is delivered;fremjadóm(1) carry out the sentence; (2) execute the judgment;dómuringekkhonumímótijudgment was given(el.passed) against him;kunngeradómin fyri(1) pronounce the sentence (of the court) on;kæradómappeal against the judgment (, sentence);dómur kann verða kærduran appeal can be made to a higher court;kæra dóm til yvirhúsiðcarry the case to the House of Lords;latamálinn tildómssubmit a case for judgment;ógildadóm(1) quash a conviction; (2) reverse a judgment;staðfestadóm(í brotsmáli) confirm a sentence; (í borgaramáli) affirm a judgment; (bæði samsvara í Ongl. við) dismiss an appeal;málið verðurtikið upptil dóms[the case reaches the stage of judgment];tulkaein dómconstrue a judgment
dópsdagur	day of christening
dópsfat	(kirkj.)baptismal basin
dópsgáva	christening present
dópshátíðarhald	christening ceremony
dópskalikur	chalice; christening cup
dópskapell	baptistery, baptistry
dópskjóli	(kirkj.)christening robe
dópskýsi	christening cap
dópslyfti	baptismal vows
dópsnavn	Christian name, first name, forename; given name
dópsorð	baptismal words
dópssáttmáli	baptismal covenant;vátta sín dópssáttmálaconfirm one's baptismal vows, be confirmed
dópsseðil	(kirkj.) certificate of baptism; sí eis.navnabræv
dópssiður	baptismal ritual(el.service)
dópsvatn	(kirkj.)baptismal water
dópsvitni	godparent, sponsor
dópur	1(átr.)baptism, christening;bera eitt barn til dópinstand sponsor(el.godparent) to a child2(skip,eis.)naming ceremony
dós	box, canister; (til te, kaffio.tíl.)can; (teblikk) tea-caddy; (til dósamat) tin, can,(am., bara) can; (stikkdós) socket; (koplingsdós, tlf.) box;sjóða niður í dóstin, can,(am., bara) can;í dós(niðursjóðað) tinned(t.d.tinned meat, vegetables), canned;(am., bara) canned;(fl.m.)canned(t.d.music)
dósa	(stb.)slumber
dósakjøt	bully (beef), tinned (, canned) meat
dósakóking	(sj.)tinning, canning,(am.bara) canning
dósamatur	tinned (, canned) food
dósamjólk	tinned (, canned) milk
dósaopnari	tin-opener,(am.)can opener
dósasligur	sídósin
dósin	drowsy
dósna	1become drowsy, become sleepy2(um ljós) fána,(fl.m.)decline, decrease, lose ground, drop, recede, go downhill
dósutur	sídósin
dóttir	daughter;hon er dóttir Xshe is the daughter of Mr X
dótturbarn	grandchild, daughter's child
dótturbóndi	(gl.)son-in-law
dótturdóttir	granddaughter, daughter's daughter
dótturfelag	(handilsm.)subsidiary company
dótturmaður	son-in-law
dóttursonur	grandson, daughter's son
drabb	rough sea
drabba	(um sjógv) be rough
drabbandi	í osb: drabbandi fullur el. so drabbandi (as) drunk as a lord(el.a billy goat);(óvand.)pissed as a newt
drabbsjógvað	rough
drabbsjógvur	rough sea
drabbutur	(um sjógv) rough
drafsa	(sj.)sídragsa
drag	1koma í dragspin out(t.d.an affair); drag out(t.d.a speech);(óáv.)drag on(t.d.the war dragged on); make slow progress(t.d.the negotiations are making slow progress); take a long time, hang fire(t.d.negotiations are hanging fire)(GG:the crisis threatened to prolong itself)2(bát.)halyard3(andlitsbragd) feature(t.d.coarse (, handsome, regular) features); line(t.d.the savage lines of his mouth); (veikt) touch(t.d.a touch of sadness)4(lyndiseyðkenni) trait(t.d.the chief traits of his character); feature(t.d.interesting features of bird behaviour); streak, strain5(serligt eyðkenni) characteristic, distinguishing(el.distinctive) feature(el.mark)
draga	1(toga í) draw, pull, haul; (sleipa) drag, trail;draga andadraw (one's) breath;draga andan lættanbreathe a sigh of relief;draga síðsta andadráttbreathe one's last, draw one's last breath;(fl.m.) draga eina línustand together, stand united;(tilt.) tað verður hart hoyggj at dragait will be hard to save the day;draga svørðdraw the sword2(draga til sín) attract, charm, allure,kenna seg drignan at e-mfeel drawn to(el.attracted by); (ógvisligari) yearn for somebody;verða drigin at fjøllunumfeel the call of the mountains3(leggja (við e-m)), cover, coat, board, plate4(sj.)draw, sketch, paint5(skeita)hann dregur eitt sindurhe has a slight squint(el.cast);draga inneftirbe cross-eyed;draga úteftirbe wall-eyed;hann dregur á vinstra eygahe has a squint(el.a cast) in his left eye6(um sinni)draga hýr á segbecome sad, become melancholy7(gl.)collect, gather, amass, accumulate8(um veður) drive, drift;tað dregurthe clouds are drifting9[ísamb. viðfs/hj]draga á:hann dregur á, áðrenn hann svararhe hesitates before answering;draga á bæðibe in doubt, be doubtful, irresolute;draga á báðar vánir, sívánir;draga á holdiniput on weight;draga á seg(um veltu) weed;draga aftureftirweaken(t.d.he is weakening daily; the market weakened); grow(el.become) weak(el.weaker); lose (one's) strength;draga atapproach, come nearer, draw near;draga avpass off, vanish, blow over;draga burtur(um pínuo.tíl.)ease; vanish, pass off;draga frá1weaken, lose (one's) strength2(stfr.) subtract3(teld.) decrement4draga gardinurnar frádraw the curtains (back);draga framcall attention to, emphasize, stress;draga fyri(gardinur) draw the curtain;draga inn1(um snøri, línuo.tíl.)haul up; heave the lead2(teld.) indent;draga niðurdraga e-n niður í lortindrag sby down (into the mire);verða drigin niður í kyksendibe sucked in(el.swallowed) by the quicksands;verða drigin niður við tí druknandibe pulled down by the drowning man (, woman);íða ið dregur skip niðurwhirlpool that sucks down ships;draga saman1draw together, gather, collect, scrape together2(nærkast) approach, draw(el.go) near, draw nearer, come nearer;(tlm.)get closer to; (tá ið jagstrað verður) close on;(fl.m.)draw together(t.d.the two statesmen gradually drew together);myrkrið dregur samanumnight is drawing on;draga sundurdrift apart,tað dregur sundur millum teirrathey drift apart;draga til:draga til reiðurs1gather materials for a nest, build(el.make) a nest, nest(t.d.the birds are beginning to nest)2(um vind)draga til síngain momentum;draga undan1decline, refuse, excuse oneself2(mest um seyð) survive the winter3(um fólk) get past, pull through(el.tide over) sth(t.d.a crisis, a difficulty); tough out sth(t.d.the crisis);draga(inn) undir:draga (inn) undir segappropriate, take possession of, seize;draga upp1draga bát upp pull a boat up2(um snøri, línuo.tíl.)haul up;draga upp á:draga upp á máliðdrawl;(fl.m.)pull sby's leg;draga upp á segput on; wear;draga skuld upp á segrun into debt, incur debts;draga synd upp á segbe guilty of a sin;draga perlur upp á bandstring(el.thread) pearls (, beads);draga upp í:draga upp í seg1(um veður) cloud over, blow up2(fl.m.) collect oneself, prapare oneself3attract;draga uppúrfinish a stockning;draga útdrag on, make slow progress;draga viðverða drigin við inn í eittbe drawn into sth, be mixed up(el.involved) in sthtey draga børnini við sær til altthey drag their children with them everywhere;draga e-n við sær allastaðnihave sby in tow(t.d.he always has his family in tow)10dragast1dragast við drag on, last2be afflicted with, be encumbered with;dragast við álvarsama sjúkube afflicted with a serious illness;hann hevur nógv at dragast viðhe has many troubles; he is a sorely tried man; put up with,eg orki ikki at dragast við teg longurI can't put up with you any longer11dragandi:heartfelt, sincere, fervent; tempting12drigin(tilt.)(vátur)sum drigin frá grunnidrenched, soaking wet
dragari	porter,(am.)redcap;rinda dragaranumpay the porter, (í Ongl.vanl.)tip the porter
dragbjálki	(húsasm.)girder
dragi	(bún.)tractor
dragil	(teld.)slider
draging	attraction, fascination, call
dragistýrari	(teld)slider control
dragna	1lengthen, grow longer, draw out(fl.m.) dagarnir taka at dragnathe days are drawing out again2loosen, yield, give way;(fl.m.um samband) begin to cool3recover, get better
dragsa	drag, haul, log
dragsan	drag
dragsl	1load2junk, odds and endsflt,bits and piecesflt; rubbish, trash
draguhurð	sliding door
dragukista	chest of drawers,(am.)bureau, dresser; (í listídnaði) commode
dragula	sídragulunál
dragulás	zip (fastener),(serl. am.)zipper;læsa við dragulásizip up;lata upp við dragulásizip open
dragulok	sliding lid
dragulunál	(sj.)(large) needle
dragurenta	(bú.)interest on overdue payments; default interest
dragusong	sliding bed
draguspæl	(tónl.)accordion
dragvatn	(sk.)weak tea
drakk	sídrekka
drakt	1(til konufólk) (tailor-made) suit, coat and skirt2(baby's) sleeping suit
drama	drama
dramblátur	haughty, arrogant, overbearing, proud, conceited
dramblæti	haughtiness, arrogance, pride, presumption
drambsligur	sídramblátur
dramma	(tlm.)have a drink
drammur	drink, snifter,(serl.skotskt) dram
dranga	1(um drangar) rise, stand up, tower2drangast(um fólk) stand in the way
drangi	sídrangur
drangur	stack, sea stack
drankaranøs	bottlenose, carbuncle nose
drankari	(habitual) drunkard, alcoholic, heavy drinker, sot;(am.)Sjuicehead, juicer, lush
drap	sídrepa
drapp	sídrabb
drasl	sídragsl
drassa	sídragsa
dratl	1awkward behaviour2tardy person
dratla	walk slowly; walk with a shuffeling gait; straggle behind
drav	1(við ølbrygging) draff, mash2(gl.)thin beer3rain,alt fór undir draveverything was soaked
dravila	(óregl.)->dragula
dravin	wringing wet, drenched, soaked
dravlorkutur	1with sagging seat2clumsy, awkward
dravsíður	wringing wet, drenched, soaked
dravvátur	wringing wet, drenched, soaked
dravveður	damp (moistel.humid) weather
drák	1dullard; tardy person2neglect, delay
drál	1slowness; tardiness; delay2tardy person
drála	1delay, dally; hesitate2hinder, hamper
drálan	hesitation, delay, tardiness
drálin	sídrálutur
drálutur	hesitating, reluctant
dráp	1homicide, killing;óviljað dráp (svarar til)manslaughter2(fl.m.)grind, drudgery, toil
drápa1	(sø.)heroic poem; (til eins heiður) panegyric (um on)
drápa2	kill
drápiligur	sídrápuligur
drápsdeild	murder squad;(serl. am.)homicide (department)
drápshugaður	bloodthirsty, murderous
drápshugi	sídrápshugur
drápshugur	bloodthirstiness
drápskálvur	calf for slaughter
drápsmaður	killer, homicide
drápsmál	(løgfr.)trial for homicide (, manslaughter)
drápsneyt	fat stock, beef cattle; cattle for slaughter
drápspartur	share of whalemeat
drápsroynd	assault with intent to kill, attempted murder, assassination attempt;(ofta =)outrage(t.d.a dynamite outrage);(fl.m.)attempt, assault, attack (on);drápsroynd varð framd ímóti honumthere was an attempt on his life;fremja drápsroynd móti honummake an attempt on his life
drápsseyður	sheep for slaughter
drápsvirði	slaughter value
drápuligur	1mortal, deadly, fatal,drápulig sjúkamortal illness2stalwart(t.d.grenadiers); (ræðandi) formidable; (krígshugaður) fire-eating(t.d.the fire-eating patriots of the home front); (reypandi) swashbuckling; (ovurvaksin) stupendous, prodigious, colossal, tremendous, enormous, huge
dráttardýr	draught animal(t.d.the mule is a good draught animal)
dráttarlisti	list of prizes, list of bonds drawn
dráttarskýggj	(veðurfr.)cirro-stratus
dráttarstyrki	tensile strength
dráttrarband	trace
dráttrardýr	sídráttardýr
dráttur	1pulling2(í sjónum) surge(t.d.a tidal surge)3protraction, deferment,tað kom dráttur áit dragged on, progress was slow4disagreement, difference (of opinion), dispute5mockery, sneer(s), taunt, gibe6attraction, fascination7longing, yearning8í stórum dráttumin broad outline
dregg1	dregs, sediment, deposit
dregg2	(sjóm.)grapnel; dredge
dreggj	sídregg
dreggja	(sjóm.)dredge, sweep;dreggja eftirdredge for, grapple for
dreggjan	(sjóm.)dredging, dredging up
dregil	1ribbon2stripe(t.d.á hálsinum á fugli)3(rað, hali) long row, crocodile(t.d.a school crocodile),tað er ein dregil, hon hevur aftur úr særit's a long crocodile she has behind her4tall man5(avlangur dúkur) runner
dregilsont	(fugl.)falcated duck
dreglakøka	(stb.)marble cake
dregur	sídraga
dreingiligur	brave, valiant, courageous, plucky, bold
dreingir	sídrongur
dreingjaár	(years of one's) boyhood
dreingjabarn	little boy, boy child
dreingjabók	(bókm.)boy's book, book for boys
dreingjaflogsa	sídreingjarippa
dreingjahár	(gentuhársnið) Eton crop;hon hevur dreingjahárshe has an Eton crop
dreingjaklæði	boy's(el.boys') clothes
dreingjakór	(tónl.)boys' choir
dreingjalið	(ítr.)boys' team
dreingjaligur	boyish;(niðr.)puerile;dreingjalig gentatomboy
dreingjalótir	boyish prank
dreingjanavn	boy's name
dreingjaóviti	boy, lad
dreingjarippa	floosie (, floosy, floozie, floozy)
dreingjarligur	boyish
dreingjaróður	(ítr.)boys' race
dreingjaskóti	boy scout
dreingjaskúli	(skúlam.)boys' school
dreit	sídríta
dreiv1	1confusion,koma í dreivget confused2nonsense, twaddle, rubbish, stuff, drivel
dreiv2	sídríva
dreiva	1ensnare, catch in snare, entangle(t.d.the bird had become entangled in the wire netting);kvikur sum dreivaður haniquick as a snared rooster2rove around, roam around3walk4(gl.)twaddle, talk nonsense, drivel5/flutt m.) entangle(t.d.he became entangled in a series of conflicts with the management), ensnare(t.d.he became ensnared in the complexities of the legal system); complicate6dreiva samanmix up;eg dreivaði hendingarnar samanI mixed up the events
dreivføttur	slow at walking
dreivlorkutur	sídravlorkutur
dreivutur	1tangled,fløktir endartangled threads; entangled2confused; complicated, intricate3clumsy
drekablóð	(harpeis) dragon's blood
drekafiskur	(fisk.)common dragonet(Callionymus lyra)
drekaflogfar	hang-glider
drekafluga	(dý.) dragonfly
drekaflúgving	hang-gliding; (ikki flúgva sjálvur) flying a kite(el.kites)
drekafuglur	(fornsø. dý.)archaeopteryx
drekamánaður	(stjfr.)draconic month
drekaskip	sídreki
drekastavnur	(sø., skip.)dragon stem;við drekastavnidragon-stemmed
drekastevni	(sø., skip.)sídrekastavnur
dreki	1(fólktr.)dragon2(leika) kite3(skip.)dragon ship, dragon-stemmed ship; warship, man-of-war
drekka1	drink;svart drekkatea without milk
drekka2	1drink;Sput away(t.d.a bottle of whisky); (hátíðarliga) take(t.d.the family take tea at 5 o'clock; won't you take a glass of sherry?);(ofta =)have(t.d.I have had my tea; we have coffee instead of tea in the morning; I have had five whiskies); (vera fallin til drykk) drink(t.d.I think he drinks);(tlm.)hit the bottle too hard;hann er farin at drekkahe has taken to drink;drekka eina fløsku saman (eis.)split a bottle;drekka e-n fullanget sby drunk;(tlm.)get sby tight;drekka seg fullanget drunk;hann hevði fingið ov nógv at drekkahe had had a drop too much;hvat vilja tygum drekka ?what will you have?,(tlm.)what's yours?,Sname your poison;geva hesti (kúgv) at drekkawater a horse (, cow);et, drekk og ver glaður (bíbl.)eat, drink, and be merry2[ísamb.viðfs/hj]av:drekka av fløskunidrink out of(el.from) the bottle;drekka av glasidrink out of a glass;drekka av ølinumdrink some of the beer;eg drekki ongantíð whisky (eis.)I never touch whisky;drekka seg av vitinumget blind drunk; drink oneself into a stupor;burtur:drekka sorgirnar burturdrown one's sorrows in wine (, beero.tíl.);inn:vit drukku nýggja árið innwe drank to the New Year;við:drekka eitt glas við e-mdrink a glass of sth with sby; (heilsa við glasinum) raise one's glass to sby;upp:drekka upp(drykkin) drink up, finish(t.d.you must finish your milk); (pengar) spend on drink(t.d.he has spent his fortune on drink); drink up(t.d. one'sfortune); drink up(t.d. one'sbeer); empty one's glass (, cup,o.s.fr.)finish (one's tea,o.tíl.); drekk upp!(eis:) down the hatch!, bottoms up!;hann man fara at drekka tað upp afturhe will surely pay for his acts
drekkafløska	® thermos (flask)
drekkaílat	drinking vessel; (til dýr) drinking trough
drekkaílát	sídrekkaílat
drekkaker	sídrekkaílat
drekkakerald	sídrekkaílat
drekkaløgur	alcoholic beverages, spirits
drekkamuður	drop of tea
drekkamunnur	sídrekkamuður
drekkaskál	(kvæð.)drinking bowl
drekkasopi	(stb.)drop
drekkavatn	drinking water
drekking	drinking,(tlm.)boozing
drekkingarvatn	sídrekkivatn
drekkivani	drinking custom
drekkivatn	drinking water
drekkja	(kvæð.)drinking bout
drekt1	(stb.)load
drekt2	(stb.)speed,hann tók drekt í seghe hurried up
dren	(tlm.)drain(pipe)
drena	(tlm.)drain
drepa	1kill;(gl.)slay; slaughter2(í talvi og øðrum spølum) take3put, shoot, stickdrepa e-t (niður) í vatnto stick sth into water4move,tað drepur ikki(um streym) the current is still5soak6drip, leak7[ísamb.viðfs/hj]drepa á:drepa á e-tstrike, touch, brush sth;(fl.m.) drepa gott á e-nhelp (comfortel.console) someone;tað drepur gott á hannhe is successful; he is happy;drepa burtur úr:drepa burtur úr e-mwash something out;drepa burtur úr munniignore, disregard;drepa niður:drepa niður høvurbow(el.bend) one's head;drepa uppdip (, immerse) in water;drepa uppi(um vind) be calm;drepa úr:tað hvørki drepur ella dettur úr honumhe is completely silent8[ísamb.viðseg]drepa seg1take one's own life, commit suicide, kill oneself, do away with oneself;(tlm.)do oneself in2(fl.m.)overburden oneself;drepast1kill each other2(fl.m.)fight violently;drepandi1death-dealing(t.d.blow)2boring;drepa langligtdeadly monotonous;drepa keðiligtdeadly dull;hann er drepa keðiligur (eis.)he is a crashing bore
drepiligur	sídrápuligur
drepningur	(um grind)í drepningiabout to be killed(el.slaughtered)
drepsótt	plague
drevja1	sítrevja
dreya	1(handv.)lathe2(tlm.)turn(t.d.to the left); (brádliga) swerve(t.d.the car suddenly swerved to the right)
dreygur	1dead body, corpse2ghost, apparition, spectre
dreyibonkur	(handv.)lathe
dreymaheimur	dream-world
dreymakendur	dreamlike; oneiric
dreymaleysur	dreamless(t.d.I fell straight into a dreamless sleep)
dreymamynd	vision, phantasm
dreymasjón	sídreymsjón
dreymkendur	dreamlike
dreymsjón	illusion, delusion;skapa sær dreymasjónircherish illusions(umabout;um at(to the effect) that)
dreymsólja	(plfr.)poppy(Papaver)
dreymsóljuætt	(plfr.)Papaveraceae, the poppy family(Papaveraceae)
dreymsýni	sídreymsjón
dreymur	1dream; reverie(t.d.he stood as if lost in reverie); vision;hann hevði ein dreymhe had a dream, he dreamt;dreymurin gjørdist veruleikithe dream came true;í dreymiin a dream, in one's dreams;nýggi bilurin koyrir sum ein dreymurSmy new car is a dream to drive;fyri mær er hetta sum ein dreymurit seems to me like a dream;týða dreymurinterpret a dream;(gl., skaldsk.)read a dream2(um fólk, bilar o.a.) dreamboat (t.d.hisnewcarisadreamboat)
dribla	(ítr.)dribble (t.s.s.krússa)
drift	1drift2(tlm.)working, running(t.d.the working(el.running) of the factory); operation(s)(t.d.the operation(s)(el.working) of a machine; operations are at a standstill)
drifta	1drifta velinumwag the tail2roam about3drifta særboast, brag, swagger
driftaragarn	(sjóm.)drift net
driftari	(sjóm.)drifter
driftingur	shake, push; rough sea
driftinivel	1apron2(serl.um barn) always dogging one's footsteps
dripin	sídrepa
drit	(gl.)dirt, dung
dritta	sídrifta
driv	1drizzle2(við streymi) drifting,3drive, enterprise, energy,tað var eitt driv í honumhe had a drive4(hart) slap, smack, beating, hiding,geva honum eitt drivtake(el.have) a smack at him5engine, motor6(teld.)drive7(tøkn.)pinion
drivakker	(skip.)floating(el.sea) anchor, drag (anchor), drogue
drivásur	pinion shaft
drivfjøður	(tøkn.)mainspring
drivin	(um kjøt) marbled
drivmegi	motive power, driving force; (úr fossi) water power; (motiv) motive, motivation, impetus, incentive;hann er drivmegin í fyritøkunihe is the driving force behind the undertaking;veita drivmegisupply (motive) power
drivmjørki	rainy mist
drivregn	heavy drizzle
drivreim	(tøkn.)driving belt, drive belt
drivsegl	(skip.)ringtail
drivtoka	sídrivmjørki
drísla	be hesitant, dilatory, tardy
dríslutur	hesitant, dilatory, tardy
drísta	(kvæð.)trust
drístigur	brave, bold, daring(t.d.person, undertaking), audacious
drístiliga	(kvæð.)bravely, boldly, daringly(t.d.person, undertaking) audaciously
drístin	(gl.)brave, bold, daring
dríta	excrete, throw its dirt,(orðt.) ringur er fuglur, í sítt reiður drítur el. tað er ringur fuglur, ið drítur í egið reiðurit is an ill bird that fouls its own nest
dríva	1carry on, conduct, run(t.d.a firm, a business)2(um vind, streym) drift with, carried by;dríva av(sjóm.)(um skip) drift off;dríva áexert one's strength; speed up; incite, urge (on), spur (on);dríva undandraw back, retreat, yield, give round;dríva upp ábe busy with3ooze(t.d.the walls were oozing with water); seep(t.d.water seeps through the wall)4commit,dríva horcommit adultery5drívandiindustrious
drívari	(teld.)driver
dríviligur	(stb.)hard-working, industrious
drjúgvur	(gl.) sídrúgvur
drjúpa	(gl.) sídrúpa
drobbløðra	(óregl.)->droyrbløðra
dromedarur	(dýr.)dromedary, one-humped camel(Camelus dromedarius)Camelus Dromedarius ©iStock
drona	(tøkn.) drone
drongla	stroll, lounge, saunter,koma dronglandi (aftaná)come straggling behind
dronglutur	slow, dilatory, tardy
drongsl	slow (dilatory, tardy) person
drongsla	be slow, (dilatory, tardy)
drongslutur	sídronglutur
drongur	dreingir1boy, lad;frá dreingisince boyhood, man and boy(t.d.I have lived in London, man and boy, for 80 years);babbasa drongurrich man's son;mammusa drongurmother's darling;raskur drongura boy of spirit, a brave lad, a plucky little fellow;sum dronguras a boy, when I (, heo.s.fr.)was a boy, in my (, hiso.s.fr.)boyhood2boyfriend3bachelor4(kvæð.)courageous man; hero5(kortsp.)knave, Jack
dronkl	(stb.)sídrongsl
drontl	(stb.)sídrongsl
drontlast	(stb.)sídrongsla
drontlutur	(stb.)sídronglutur
dropa	drip, drop;(oljuv.)condense
dropadriv	(alisfr.)distillates; distillation, distilling
dropadríva	(alisfr.)distil(t.d.distilled water)
dropadríving	(alisfr.)distillation, distilling
dropagass	condensate
dropaskjól	shelter,nú mugu vit fara at fáa okkum dropaskjólwe've better find a shelter
dropasteinspípa	(jarðfr.)stalactite
dropasteinsstubbi	(jarðfr.) stalagmite
dropasteinstubbi	(jarðfr.)stalagmite
dropasteinur	(jarðfr.)dripstone
dropi	drop; (minsta vætumál) minim;dropar flt(heilivágur) tincture, drops;dropa fyri dropadrop by drop;dropin sum fekk bikarið at flóta yvirthe last straw (that breaks the camel's back);dropin matar steininconstant dripping wears away the stone;tað er sum ein dropi í havinumit is a drop in the ocean(el.in the bucket), it is a mere flea-bite;tøma til seinasta dropadrain(el.drink) it to the dregs;ein dropi av vatnia drop of water;gev mær ein lítlan dropa av whiskygive me just a spot of whisky
droplittur	(seyðal.)dark-spotted
dropp	(lækn.)drip, intravenous line, IV line
drops	(Suð.)sweet
droputur	(seyðal.)dark-spotted(serl.á skortinum)© Eyðbjørn Jacobsen
drosl	sídrongsl
drotning	1queen(t.d.reigning queen; the Queen of Sheba; Queen Elizabeth; Venice, Queen of the Adriatic);sum ein drotning, lík eini drotningqueenly, queenlike2(talv)queen3(dýr.)queen bee
drotningarfirvaldur	(firv.)bedstraw hawk-moth(Hyles gallii)© Wikimedia Commons
drotningarligur	queenly, queenlike, like a queen
drotningarmaður	Prince Consort
drotningaumfar	(polit.)[round in Danish cabinet-forming negotiations, involving the Queen]
drottin	1king2Lord, God
drottur	vanl.drottin
droyma	dream;droyma um eitt(í svøvni) dream about(el.of) sth(t.d.what did you dream about last night?); (í huganum) dream of sth(t.d.dream of marrying a prince);eg hevði ikki droymt um at gjørt nakað tílíktI wouldn't dream of doing such a thing;eg droymdi ikki um at hann fór at gera taðI never dreamt that he would do it; not in my wildest dreams did I suppose that he would do it;køkurin hon gongur og droymir umthe kitchen of her dreams(GG:he's her dream man);sita og droymabe lost in a reverie; daydream;hann droymdi seg aftur í barnaár (fl.m.)he imagined himself back in his childhood
droymari	dreamer
droymutur	dreamy
droypa	(gl.)sprinkle, (allow to) drip
droypioffur	(bíbl.)libation, drink-offering
droyrbløðra	blood-blister
droyri	(kvæð.)blood
droyrreyður	blood-red, scarlet
dró	sídraga
drógu	sídraga
drópu	sídrepa
drós	(kvæð., skaldsk.)kv maiden; virgin
druður	(sj.)sídrunnur
drukkin	intoxicated, drunk, inebriated, tipsy,(tlm.)tight;S(heldurgl.)blotto; half seas over, pissed, sloshed, sozzled;drukkin(when) intoxicated;eitt sindur drukkinslightly intoxicated;koyra bil drukkinbe drunk in charge of a car;illa drukkinvery intoxicated;(tlm.)blind drunk, drunk as a lord,Spissed out of his (, her) mind(tlm.)tight,Splastered, blind to the world
drukkinskapur	drunkenness, inebriety
drukku	sídrekka
drukna	1drown(t.d.to drown a kitten);(óáv.)drown, be drowned(t.d.he fell into the water and (was) drowned); (tólh nt.)drowning(t.d.help, I am drowning!);øll manningin druknaði (eis.)the whole crew were lost; the ship was lost with all hands;drukna segdrown oneself2(fl.m.)be soaked;(fl.m.) drukna í arbeiðibe up to one's ears in work; be snowed under with work;tað hann segði druknaði í látriwhat he said was drowned in laughter; he could not make himself heard for laughter;røðan druknaði í larminumthe speech was drowned by the noise;drukna í fjøldinibe lost in the crowd;hann var um at drukna í tølumhe was up to the ears in figures;drukna í møsnifizzle out;hann druknaði sorgirnar í brennivínihe drowned his sorrows in drink
drumbur	dilatory (, tardy) person
drumbutur	dilatory, tardy
drunngulur	drunngulur ljómari yellow-rumped warbler
drunnhvíti	(fugl.)European storm petrel(Hydrobates pelagicus)(Linnaeus, 1758), leach's storm petrel sísýldur drunnhvíti© Wikimeda Commons
drunnhvítur	with a white patch on the rump
drunnmorreyður ljómari	(fugl.)palla's grasshopper warbler(Locustella certhiola)(Pallas, 1811)©Shanaka Aravinda
drunnsvikin	with a slender rump
drunnur	1(á kríatúrum) rump and tail2behind, seat, backside;(tilt.) hevði tú dugað at sitið so væl á munninum sum á drunninum[if only you knew how to keep tight]
drunsl	dilatory (, tardy) person
drunsla	be dilatory, be tardy
drunslutur	dilatory, tardy
drupu	sídrepa
drussutur	dilatory, tardy
drúgførur	dilatory, tardy, slow in coming
drúgneyt	dilatory (, tardy) person
drúgsamur	(sj.)dilatory, tardy, slow in coming
drúgt	sídrúgvur
drúgvan	sídrúgvast
drúgvast	almost certainly
drúgvátin	(um mat) lasting
drúgvur	1economical, lasting, that goes a long way, that lasts a long time2long in coming3lengthy (t.d.the meeting was lengthy and boring);protracted (t.d.the protracted delays upset many people);long-standing (t.d.the long-standing war finally came to an end last year);prolonged (t.d.his prolonged speech bored the audience immensely);ample(t.d. she has ample experience within this field)4extensive (t.d.extensive analytical work)
drúpa	drip
drúva	(plfr.)grape;bláar drúvurblack grapes;grønar drúvurwhite(el.green) grapes
drúvusukur	(evnafr.)grape sugar, dextrose, glucose
dryfta	(óregl.)sídrifta
dryftingur	(óregl.)sídriftingur
drykkja	drinking bout, bacchanal,(tlm.)binge
drykkjubøli	groggery
drykkjuhorn	drinking horn
drykkjukíkur	drunkard, alcoholic, heavy drinker, sot; (sum fær tørn) dipsomaniac;(am.)Sjuicehead, juicer, lush
drykkjulag	drinking bout, bacchanal,(tlm.)binge
drykkjumaður	(habitual) drunkard, alcoholic, heavy drinker, sot;(serl.kvartalsdrankari) dipsomaniac;(am.)Swino, juicehead, juicer, lush
drykkjumál	(kvæð.)drinking bout, bacchanal,(tlm.)binge
drykkjuoffur	(bíbl.)libation, drink offering
drykkjupeningur	tip, tips, gratuity, gratuities;geva drykkjupeningtip, give a tip(el.tips);geva nógvan drykkjupeningtip lavishly, give a generous tip(el.generous tips);geva tænaranum 20 kr í drykkjupengumtip the waiter twenty kroner;geva ov lítið í drykkjupengumgive too small a tip, undertip;geva ov nógv í drykkjupengumgive too big a tip, overtip;ongan drykkjupening!no tips!, employees are not permitted to accept gratuities
drykkjusjúka	(sálfr., lækn.)alcoholism (acute alcoholism; chronic alcoholism)
drykkjuskapur	drinking; drunkenness,Sboozing, booze;fallin til drykkjuskapaddicted to drink(ing); drunken, intemperate, bibulous
drykkjuskál	(kvæð.)drinking bowl; (stór skál við tveimum oyrum, sum fer frá einum til annan í gildinum) loving cup
drykkjuskáli	(kvæð.)drinking hall
drykkjusteyp	drinking cup
drykkjustova	tavern, taproom, tap
drykkjuveitsla	drinking bout, bacchanal,(tlm.)binge
drykkur	drink,(gl.)beverage;sterkir drykkirstrong drinks, spirits, intoxicants,(am. eis.)hard liquor;(fl.m.) ein beiskur drykkura bitter cup
drymbingur	sídrumbur
drynj	bellow
drynja	bellow
drypp	drop, drip, dripping
dryppa	drip, drop
dryppari	(lækn.)gonorrh(o)ea,Sclap,(She has got a dose (of the clap))
dryppur	drop, drip, dripping
drýggja	1be thrifty, be economical, make sth go a long way2postpone, defer(t.d.a matter for a week); (um eitthvørt ófýsiligteis.)stave off(t.d.the day of reckoning); (fundiro.tíl.)adjourn(t.d.a debate, an inquiry, a sitting)
drýggjaligur	economical, thrifty
drýgsla	be thrifty, be economical, make sth go a long way
drýlaknívur	(spei.)blunt knife
drýlur	[unleavened bread loaf]
drýpa	bend, bow, droop,drýpa høvur (niður)lower one's head, hang one's head
drýpur	sídrúpa
drýsla	(upprfr.)sídrísla
drýslutur	(upprfr.)sídríslutur
drøg	sídrag
drøgg1	(í løgi) sediment, deposit;(evnafr. eis.)precipitate; (í víni) lees, dregs; (í olju) bottoms, draff
drøgg2	(lækn.)drug
drøggbundin	addicted to, given to;gerast drøggbundin atbecome addicted to(t.d.drink), become an addict to(t.d.drug-taking)
drøltur	bundle
dubba	1equip, fit (out), dress,hví hevur tú dubbað teg so út?why have you dressed so warmly2(herm.)equip, arm
dubbing	(herm.)armament
dubragd	(sk.)sífríggjarabragd
dudda	(barn.)dirty, mess
duffa	1(um skip, bátaro.tíl.)rock, roll, toss2(spæl)duffa (træ)seesaw
duffitræ	seesaw
duga	1be able to, know how to; be useful, be skilful, be capable2serve, help, assist3have magic powers
dugaligur	sídoðaligur
dugandi	1good, competent, capable, proficient, able;(serl.= sum hevur sítt í lagi) efficient, sound;(serl.= fermur) skilful, dexterous, adroit; (kønur) expert, proficient; (evnaríkur) gifted, ingenious; able-minded; (framúr) fine2(gl.)beneficial, advantageous, profitable; useful, serviceable
dugg	(stb.)kóka upp í dugg boil to a mash
dugga	(barn.)sail
duggubátur	(barn.)boat
dugileiki	sídugur
dugna	help, aid, assist, dugna mær eina hondlend (, give) me a hand
dugnadagur	good day (til útiarbeiði)
dugnaður	help, aid, assistance, support, service
dugnafólk	capable people
dugnagóður	(sj.)sídugnaligur
dugnakona	able wife
dugnaleysur	incapable
dugnaligur	1good, competent, capable, proficient, able(t.d.a very able admiral, general, statesman; an able (, clever) craftsman);(serl.= við góðum handalago.s.fr.)skilful(t.d.a skilful dentist, negotiator, surgeon), dexterous, adroit; (kønur) expert, proficient; (evnagóður) gifted, ingenious; able-minded;framúr dugnaligurbrilliant;dugnaligur næmingura good pupil, a promising pupil, a gifted pupil;vera dugnaligur í skúlanumbe doing well at school;vera í arbeiðinumknow(el.be good at) one's job, be a good man2hjdugnaligawell, efficiently(t.d.work well; do one's job efficiently), skilfullyo.tíl. (t.d.he bandaged my hand very skilfully)
dugnaloysi	incapability, inability
dugnamaður	able man, capable man
dugnamikil	capable
dugnaskaparprógv	(sjóm.)certificate of competency
dugnaskaparroynd	(sjóm.)merit test
dugnaskapur	competence(t.d.to gain a high level of competence in English; professional / technical competence)¸ proficiency(t.d.a high level of oral proficiency in English; a certificate of language proficiency); (evni) ability, efficiency(t.d.I was impressed by the efficiency with which she handled the crisis), skill, dexterity(t.d.you need manual dexterity to be good at video games); (førleiki) capability
dugni	sídugnaður
duguleiki	sídugur
duguligur	sídugnaligur
dugur	1skill, ability, capability, capacity;fólk sum dugur er íman (, womano.s.fr.)of great ability, competent man, first-rate man, good man;tað er veruligur dugur í honumhe is a very able man2use, good, usefulness,hvat dugur er í tí?what is the use of it?
duk	knock, knocking, hammering; (um hjarta, puls) throbbing; pounding(síduka) blow, stroke, knock, push;hann gav honum eitt duk millum herðarnarhe gave him a push (el.blow) between the shoulders
duka	beat, knock, hammer away;duka á dyrnarhammer(el.pound) at(el.on) the door; (um hjarta, puls) beat(t.d.it sets my heart beating); (kvikari) throb(t.d.my pulse was throbbing; throbbing temples); (hart) pound(t.d.my heart was pounding)
dukan	síduk
dukátur	(gl.)ducat
dukka	1(leika) doll2(í mannastødd) dummy(t.d.a dummy is substituted for the actor in this scene)3(marionettdukka) puppet, marionette;(fl.m.the king was a mere puppet in the hands of his ministers)4(seymigarn) skein5(á dreyibonki) lathe poppet6(pyntidukka) dolly girl
dukkubarn	(baby) doll
dukkudidda	1little girl2(spei.)doll
dukkudrongur	(niðr.)mother's darling, goody-goody, chinless wonder
dukkuhús	doll's house
dukkuklæði(r)	doll's clothes, doll's dresses
dukkuleikhús	toy theatre; (marionettleikhús) marionette theatre
dukkuligur	doll-like
dukkustova	doll's house
duladreymur	inkling(t.d.I had an inkling of the truth); idea,eg havi ikki duladreym um taðI have no idea what it is; notion, suspicion
dulakendur	sluggish, dozy
dularbúni	disguise
dularfullur	(átrúni) mystic(al)(t.d.mystical experiences); mysterious(t.d.his mysterious disappearance); (illgrunasamur) suspicious
dularklæði(r)	disguise
dulbúgvin	in disguise, disguised
duld	1(loyndarmál) secret, (loynd) secrecy(t.d.the secrecy of the ballot; the secrecy of the mails),í duldsecretly, in secret; clandestinely2(sálfr.)complex,Shang-up
duldarfullur	sídularfullur
duldarmál	secret, secrecy, mystery; concealment(t.d.the concealment of crime)
duldi	sídylja
duldur	1(fjaldur)hidden, concealed2disguised3latent(t.d.latent defectsel.disease);(kvæð.) duld eru døpul meingreat sorrows are kept to oneself; covert(t.d.covert operationsel.surveillance)4secret;dult nummarunlisted number;í duldumsecretly; on the quiet
duli	1distraction, frenzy2lethargy3torpid person4(kortsp.)the dummy
dulin	(stb.)sídulin
dulisliga	mysteriously
dulklæði(r)	sídularbúni
dulkornutur	(jarðfr.)cryptocrystalline
dulkrút	idler, slacker, lazybones, lazyboots
dulkrystallutur	(jarðfr.)cryptocrystalline
-dulkutur	síill-
dull	(stb.)slow, tardy, dilatory person
dulla	dulla burtur1conceal, disguise; ignore; pass over in silence2waste away3reduce, dwindle (down), decrease, shrink, diminish
dulleiða	hypnotize, mesmerize(t.d.the patient is mesmerized into believing that he is well)
dulleiðari	hypnotist, mesmerist
dulleiðing	hypnosis;undir dulleiðing(while) under hypnosis
dulleiki	deafness
dulmál	code, cipher,bróta eitt dulmálbreak a cipher;týða til dulmálencrypt;týða dulmál til vanligt máldecode, decipher
dulnevndur	1pseudonymous; anonymous; (um navn) assumed, fictitious;dulnevnd lesarabrøvanonymous readers' letters2hjdulnevntunder a pseudonym
dulnevni	pseudonym, assumed name, nom de plume, pen name
duloyra	í osb: hava duloyra be deaf
dulsmál	secrecy(t.d.the secrecy of the ballot; the secrecy of the mails); mystery(t.d.the mystery was never cleared up); secret(t.d.shall we ever know the secret of Shakespeare's sonnets?)
dultekstur	(teld.)cipher
dulur1	1something secret, concealed, covert,ikki hava dul ella dreym um e-tnot have the slightest idea about something2(fólktr.)the abode of the hidden people
dulur2	1deaf, hard of hearing2confused, bewildered3lethargic, apathetic
dulvit	(sálfr.)subconsciousness, subconscious(t.d.experiences relegated to the subconscious); subconscious mind; (yrkiskøn brúka helst) unconscious(t.d.complexes embedded in the unconscious)
duma	duma
dumb	(gl., stb.)thick haze
dumba	chaff, husks;skilja dumbuna frá korninum (eis. fl.m.)separate the wheat from the chaff;tey spjaddust sum dumba fyri vindithey scattered like chaff before the wind
dumbur	dumb, mute
dummur	1(tlm.)stupid, dull, silly, dense, slow-witted, foolish, obtuse;(tlm.)dim, thick, gormless, daft, dopey2dumb, mute
dumpa	(ikki standa prógv) fail, be ploughed; be flunked;(serl. am.)flunk; bomb (out); (til val) be defeated;dumpa til royndfail a test
dumpari	dumper, dumper truck, dump truck
dumpikandidatur	(til próvtøku) ploughed candidate; candidate who has no chance of passing; (í samb. v.val) defeated candidate; loser; candidate who has no chance of being elected;(tlm.)non-starter
dumpilærugrein	failing subject
dumpimark	minimum (marks), lowest pass mark
dumpiprosent	percentage of failures, failure rate
dumpipróvtal	fail(ing) mark
dums	1heavy fall; thud2(teld.)dump
dumsa	1thud, tumble, fall with a thud2let go with a thud3(teld.)dump
dun	rumble, roaring,dunið frá havinumthe roaring of the sea
duna	rumble, roar(t.d.the sea roars)
dunan	sídun
dundi	sídynja
dundra	thunder, rumble(t.d.thunder rumbling in the distance), boom(t.d.the distant boom of the guns); (um vind og sjógv) bluster(t.d.outside the wind was blustering)
dundran1	sídundur
dundur1	rumble
dundur2	hava ein góðan dundur be half seas over (, pissed, sloshed, sozzled)
dunga	pile up, heap up,kavin dungar niðurit is snowing heavily; accumulate;dunga ríkidømi samanpile up wealth, amass(el.heap up) riches;(tlm.)make one's pile
dungakavi	snow drift
dungarok	heavy snowstorm
dungi	1heap, pile, mound;tveita eitt upp í dungapile sth up; make a heap of sth2(fornfr.)kitchen midden; dunghill, dungheap, manure(el.muck) heap, compost heap
duni	sídun
dunk	síduk
dunka	síduka
dunkraft	sídonkraft
dunkur	can
dunna	(fugl.)(domestic) duck
dunnast	splash
dunnuber	(plfr.)sea purslane(Honckenya)
dunnubilla	(barn.)duck
dunnuegg	duck's egg
dunnuhald	duck-breeding
dunnuhús	duckhouse
dunnuhylur	duck-pond;heimligi dunnuhylurin (fl.m.:svarar til) the parish pump;seta lív í dunnuhylin (fl.m.)cause a stir; set the cat among the pigeons;okkara egni dunnuhylurour own little backwater
dunnupar	pair of ducks
dunnuspæl	bingo
dunnusteggi	drake
dunnuungi	duckling
dunnuveiði	duck-shooting;(am.)duck hunting;fara á dunnuveiðigo duck-shooting
dunsla	drift, idle,dunsla tíðina burturidle the time away;ganga og dunslastdrift around
dupl	sídupul
dupul	buoy
dupultur	double, twofold, dual
durafjórðingur	geva e-m durafjórðingin show sby the door
duragátt	(stb.)dyr,í osb: eg havi ikki verið uttan duragátt í allan dagI have not been out all day
duragekkur	(sj.)door-case, door-frame
durageykn	(sj.)síduragekkur
duragrind	sídurakarmur
durahella	doorstep
durakarmur	(húsasm.)door-case, door-frame
duraklokka	door bell
durasnapsur	welcome dram
durastavur	(húsasm.)door-post
durasteinur	doorstep
duratjald	portière, (door) curtain
duratrepi	threshold,tú fert ikki um duratrepanyou are not crossing the threshold
duratræ	(húsasm.)lintel
duravaktari	síduravørður
duravørður	door-keeper, porter
durian	durian
durum	sídyr
durur	entrance hall
durva	1slumber, be half asleep, doze, drowse2(stb.)be on the point of falling, be within an ace of falling
dusa	dusa sær make oneself comfortable, enjoy oneself;(lækn.) dusandi evnieuphoriant
dusin	(mát)dozen;eitt dusin av blýantuma(el.one) dozen pencils;seks dusin av blýantumsix dozen pencils (men dozens of pencils);hálvt dusinhalf a dozen;eitt heilt dusina full(el.round) dozen
duskur	(til prýðis) tassel
-duskutur	síill-
dusm	dust; a little bit
dusma	raise dust
dusmutur	dusty
-dusputur	síill-
dussur	(sj., stb.)a cup of tea,(el.coffee)
dust	1dust,savna dustcollect dust;fjaldur undir dusticovered with dust, dust-covered;turka dust av innbúgvidust the furniture;geislavirkið dustradioactive(el.atomic) dust, fall-out;her hevur dust lagt segdust has fallen(el.settled) here;tá ið dustið hevði lagt segwhen the dust had settled2a little bit,har er ikki dustið eftirthere isn't the slightest bit left3(plfr.)pollen4(á firvaldsveingjum) scalesflt5(jarðiskar leivdir) dust, ashesflt,mortal clay, mortal remainsflt
dusta	(plfr.)pollinate; raise (the) dust
dustgingin	dusty
dusting	(plfr.)pollination
dustklútur	duster, dustcloth(fltdustcloths)
dustmikil	dusty
dustrikin	dusty
dustslúkur	(sj.)sídustsúgvari
dustsúgva	vacuum-clean(t.d.vacuum-clean a room; have the house vacuum-cleaned); vacuum
dustsúgvari	vacuum cleaner; vacuum
dustutur	dusty
duttu	sídetta
duvaligur	(óregl.)->doðaligur
duvaveður	(óregl.)->doðaveður
dúga	(óregl.)->dúva 2
dúgligur	1diligent, industrious, hard-working, busy, sedulous, assiduous(t.d.an assiduous reader of our magazine);hj-ligaarbeiða dúgliga við e-mapply oneself diligently to sth, work hard at sth;vitja hann dúgligacall on him(el.visit him) frequently;brúka dúgligamake frequent(el.diligent) use of;hann skonkti dúgligahe plied them with wine (, beero.s.fr.)2excellent3often, frequent,hann er dúgliga burturstaddurhe is often away
dúgva	(fugl.)pigeon;(serl. flutt m., m.a. polit.)dove(t.d.the dove of peace; harmless as a dove; the dove with the olive branch); (til kappingar) pigeon;rock dovesíbládúgvaoriental rufous turtle dovesíeystanturtildúgvastock dovesíholudúgvacommon wood pigeonsímánadúgvaeurasian collared dovesíturkadúgvaturtle dovesíturtildúgva
dúgvualing	pigeon-breeding, pigeon-fancying
dúgvubringa	pigeon breast, breast of pigeon
dúgvuflokkur	flight(el.flock) of pigeons
dúgvuhús	pigeon-house, pigeonry, dovecot(e)
dúgvukurran	cooing (of pigeons(el.doves))
dúgvulortur	pigeon droppings; pigeon manure
dúgvureiður	pigeon's nest
dúgvusteggi	cock pigeon, male pigeon
dúgvusteik	roast pigeon;(am.)roast squab
dúgvuungi	(fugl.)young pigeon
dúka	1cover,dúka borðlay the table2seglið dúkarthe sail bellies out
dúkur	1(woven) cloth2(segldúkur) canvas3(table-)cloth,leggja dúk á borðiðspread the4(flaggdúkur) (sheet of) bunting5(kvæði) sail
dún	1(á fugli) down2(plfr.)down3(fínt, ljóst kropshár) vellus hair,peach fuzz4(skegg) fluff, down;við dúnidowny, fluffy
dúna	pluck
dúnast	(um ungael.pisu) become(el.be) covered with down, fluffy
dúndýna	(samsvarar við) down quilt, eiderdown
dúnhærdur	downy; pubescent
dúnlættur	fluffy, light as a feather
dúnmjúkur	downy, fluffy
dúnungapílur	(plfr.)sallow, goat willow(Salix caprea)
dúnungi	1gosling2(plfr.)catkin3(um ungling) greaser
dúnurt	(plfr.)willow-herb(Epilobium)
dúnutur	(um ungael.pisu) downy
dúra	take a nap, slumber, sleep lightly, doze
dúrast	sídúra
dúrk	(skip.)floor
dúrur	nap, snooze, doze, forty winks;fáa sær ein dúrtake a nap, get(el.have) forty winks, have a kip
dús	(sj.)sídúsi
dúsa1	(bát.)sídúsi
dúsa2	slumber, sleep lightly, doze
dúsi	(bát.)[small boat]
dúsur	(bát.)sídúsi
dúva1	(fugl.)sídúgva
dúva2	rely on, depend on
dúvuungi	(fugl.)sídúgvuungi
dvalarviki	(við landsveg) lay-by
dvaldi	sídvølja
dvali	1(dj.)hibernation; (um onnur dýr enn súgdýreis.)winter torpor;leggjast el. falla í dvalabegin to hibernate;(dj) liggja í dvalahibernate;sum liggur í dvalahibernating;(dj.ogfl.m.) vekja úr dvalawake up2lethargy, torpor; (ónatúrligur) trance;leggjast el. falla í dvalabecome torpid; fall into a trance;(fl.m.)dormant, lie dormant(t.d.feelings that had lain dormant for many years);vekja fólkið úr dvalaarouse the people (from its lethargy)
dveylur	(á skipi) (hand) swab
D-vitamin	(evnafr.)vitamin D
dvína	1yield, give way;dvína undan e-myield to someone, give way to someone2(um illveður, sjúkuo.tíl.)subside, abate(t.d.the storm showed no signs of abating), diminish in strength,illveðrið dvínaðithe storm subsided;(lívfr.) dvínandi(um arvaeginleikar) recessive,dvínandi ílegurrecessive genes
dvíning	decrease, fall, abatement,vera í dvíningbe decreasing
dvøl	1tarrying, lingering, dwelling (sídvølja)2delay, tardiness(t.d.the tardiness of the company's response); stay,dvølin var ikki longthe stay was not long; hesitation, respite;uttan dvølwithout hesitation, without respite3(bú.)respite, reprieve,veita skuldara dvølgive a debtor respite
dvølja	1tarry, linger, pause;dvølja við eitt orð (ein tóna)dwell on a word (, a tone); (tala um) dwell on(t.d.the speaker dwelt on the good qualities of the deceased; he likes to dwell on memories of his childhood); dilate on(t.d.I shall not dilate on this subject); (takast við) dwell on(t.d.let one's thoughts dwell on it); (verða verandi) pause by(t.d.he paused long by the grave);lata eyguni dvølja við e-tlet one's glance(el.eye) rest(el.dwell) on sth2delay, detain, keep,dvølja e-nkeep someone3hesitate, wait4stay,hann dvaldi ikki leingi harhe did not stay there long
-dvølja	sídag-
dvørgakongur	dwarf king
dvørgamál	echo, resonance
dvørgamoy	sídvørgamoyggj
dvørgamoyggj	(kvæð.)dwarf maiden
dvørgasteinbrot	(plfr.)[no English name, an arctic Saxifrage species, growing in Greenland for instance(Saxifraga tenuis)]
dvørgasteinur	(fólktr.)[stone where a dwarf is believed to live]
dvørgastrá	(plfr.)EarlyHair-grass (Aira praecox)
dvørgatól	(fólktr.)dwarf's tool,dvørgatólini smíða sjálva dwarf's tools work by themselves
dvørgflogmús	pipistrelle (pipisrellus pipistrellus)
dvørggrælingur	(fugl.)little stint(Calidris minuta)(Leisler, 1812)Calidris minuta ©iStock
dvørghøna	bantam
dvørgkavbátur	midget submarine
dvørgmási	(fugl.)little gull(Hydrocoloeus miniutus)(Pallas, 1776)Hydrocoloeus-miniutus.jpg
dvørgsmetta	baillon's crake
dvørgspannari	(firv.)narrow-winged pug(Eupithecia nanata)
dvørgspurvur	(fugl.)little bunting(Emberiza pusilla)(Pallas, 1776)Emberiza pusilla ©Blake Matheson
dvørgur	(í sirkusi) midget; (í ævintýri) dwarf; (fólk: minkur) gnome; (um dvørgafólk) pygmy;hann er sannur dvørgurhe is a midget of a man; he is dwarfish
dvørgvaksin	dwarfish, dwarf-like
dvørgvøkstur	dwarfishness;(lækn.)dwarfism, nanism
dygd	1virtue; (góður eginleiki við e-m) virtue, merit, advantage, good point(t.d.one of the good points about this system of central heating; one of the merits of his book)2quality,framúr el. frálík dygdsuperior quality, high grade; choice(t.d.tobacco)3strength, force; value, worth
dygdar-	quality, high-quality, excellent, superior
dygdaravrik	workmanship of high quality, high-class(el.high-quality) workmanship
dygdarbátur	superiorel.excellent boat
dygdareftirlit	quality control,hava dygdareftirlit viðquality-test;(í samb. v.plantur,serl.um epli) index
dygdarfar	sídygdarbátur
dygdarfjøl	dygdarbátur
dygdarfólk	excellentel.capital people
dygdargóðska	excellence
dygdargóður	of good quality
dygdarkona	upright (, honourable) wife
dygdarleysur	unfit for use, useless
dygdarlítil	bad, inferior, adverse, poor
dygdarljós	sídygdarfólk
dygdarmaður	upright (, honourable) man
dygdarmerki	quality mark
dygdarmeting	quality appraisal, rating; (flokking) quality grading(el.assessment)
dygdarmikil	virtuous
dygdarmunur	difference in quality
dygdarringur	bad (fyri for), harmful, damaging (fyri to)
dygdarríkur	virtuous
dygdartilvitin	quality-conscious
dygdarveður	fine weather
dygdarverk	workmanship of high quality, high-class(el.high-quality) workmanship
dygdarvindil	choice cigar
dygdarvín	quality wine
dygdarvøra	superior(el.high-class) article
dygdugur	upright, honest, honourable, virtuous;(niðr.)prudish, smug, priggish, holier-than-thou
dygð	sídygd
dygðargóður	quality, high-quality
dygðarleysur	without vigour, without strength, without substance, dygðarleysur mjólkmilk with no goodness
dyggan	emphatically, forcibly
dyggiliga	thoroughly, completely, quite, absolutely; firmly
dyggur	1reliable, dependable, loyal; honest, upright, loyal(t.d.colleague)2sound, solid, strong, durable,dyggur kunnleikisound knowledge;dygt støðisolid foundation3(slago.tíl.)sound,fáa ein dyggan brestget a sound(el.good) beating(el.drubbing)
dygst	close to, close by, near to, jammed up against,dygst í klettinvery close to the shore
dygt	firm, hard,tað tók mær dygtthat hurt me a great deal;hann gav honum tað so dygthe gave him a hiding, he gave him a dressing down
dyl	sídylhøvd
dylhøvd	fool, blockhead, dunce, tawpie, ass
dylhøvur	sídylhøvd
dylin	síhulin
dylja	conceal, hide,dylja fyri e-mconceal (, hide) from someone;dylja nakað inniconceal sth; (hava loyniligt) hide(t.d.I have nothing to hide; hide one's intentions); conceal(t.d. one'sintentions, one's joy, one's defects, one's movements); make a secret of,hann dylur ikki fyri at ...he makes no secret of the fact that; disguise(t.d.I do not want to disguise the gravity of the situation); keep dark(t.d.keep one's intentions dark); make no bones about it,er eitthvørt honum ikki dámar dylur hann tað ikkiif he disapproves of sth, he makes no bones about it; make it abundantly clear,hann duldi ikki fyri at honum dámdi meg ikkihe made it abundantly clear that he disliked me
dylla	milk tub
dymb	1dust, fluff2surf haze
dymba	raise dust, fluff
dymbi	sídymb
dymbildagavika	(kirkj.)Holy Week
dynamiskur	dynamic;dynamiskt ravmagndynamic electricity;sí eis.áræsin
dynamitt	dynamite;spreingja við dynamittidynamite; blast with dynamite;ein stong av dynamittia stick of dynamite
dynamittpatrón	stick of dynamite, dynamite cartridge
dynamittspreinging	dynamiting, blasting with dynamite
dynamo	(tøkn.)dynamo, generator
dyngja1	1heap, pile2(stb.)withered grass
dyngja2	pile sth up, make a heap of sth, accumulate;dyngja e-n undir í e-mload (, burden, encumber, trouble) someone;tey dyngdu hana undir í arbeiðithey heaped work on her, they loaded(el.overwhelmed) her with work
dyngjugosfjall	(jarðfr.)shield volcano
dyngjumosi	(plfr.)grey moss(Grimmia hypnoides)
dyningur	(um sjógv) (ground) swell
dynja	rumble, boom, thunder
dyntil	(upprfr.)->dintil
dynur	(kvæð.)boom, noise, din
dypp	(matur) sauce, dipping, dip
dyppa	1dip, immerse, (brádliga) plunge2dip in cold water, cold plunge
dypping	cold water dipping, cold plunge, cold water immersion
dyppkókari	immersion heater
dyr	dyrnar, bd hvmf durunum)flt1door, doorway2entrance hall3[ísamb.viðfs]avdurunumout of the door;ádurunumto the door;fyridurunumoutside;fara út fyri dyrgo outside;so skjótt hann kom út fyri dyras soon as he got outside;(fl.m.) standa fyri durumbe at hand, be imminent, be just round the corner(t.d.war is imminent; prosperity is just round the corner; winter is at hand);várið stendur fyri durum (eis.)spring will soon be here;(tilt.) sópa tú fyri tínum durumyou mind your own business!, you are living in a glass house; look nearer home!;eg havi ikki verið uttan fyri dyrnar í dagI haven't been out(el.outdoors) today;set ongantíð fótinn ummínar dyr afturdon't set foot in my house again;innanduraindoors, within doors;ídurunumin the doorway;deyðin er í durunum, sídeyði;ganga í dyrremain standing in the doorway; never darken my door again;fylgja e-mtildyrnarsee sby out;rennaupp ádyrnar hjá e-mcamp on sby's doorstep, pester sby (with one's visits), beat a path to sby's door; (í flokki) mob(t.d.he was mobbed by reporters);handlaviðdyrnarsell(el.hawk) from door to door;bidda við dyrnarbeg from door to door4(teld.)gateway
dyrgja	1troll2(fl.m.)fish for(t.d.an invitation, information, compliments);dyrgja eftir atkvøðumtry to attract votes3run after girls
dyrka	1cultivate(t.d.land), till, work2(ala) grow, raise3(útbúgva, menna) cultivate(t.d.the moral sense); improve, develop4(tilbiðja) worship(t.d.a god), idolize(t.d.a hero); (gera burturúr) lionize5(røkja vinskap) cultivate the acquaintance of(t.d.you ought to cultivate his acquaintance a little more)6(lívfr.)culture
dyrkan	1cultivation, tillage2growing, raising3(bakteriur) culture4(bíbl.)worship
dyrkari	grower(t.d.wheat grower); student(t.d.a student of archaeology), devotee(t.d.of music), votary(t.d.of sports); worshipper
dyrkijørð	arable land
dyrkilendi	1piece of arable land2area (, acreage) of cultivation
dyrking	cultivation; tillage; growing, raising; (bakteriur) culture;taka nýtt lendi til dyrkingarbring new land into cultivation(el.under the plough)
dys	(sø.)cairn, dolmen; barrow, burial mound
dysjardólgur	(kvæð.)hill troll
dystaleikur	(spæl) tilt, joust
dystarvenjing	(ítr.)match fitness
dystaskrá	(ítr.)fixture list
dystast	1(í kapping) tilt, joust, compete; go to the mat (with)2combat, fight
dystfýsni	fighting spirit
dystilærdur	sílistilærdur
dystingarleikur	sídystaleikur
dystopia	símarruríki
dystopiskur	sí marrukendur, ófrættakendur, ótýdligur, ræðu-
dystur	1(kapping) tilt, joust2(t.d. fótb.) match, leg,fyrri dysturfirst leg;ásettur dysturfixture3combat, fight, bout
dýggj1	bog, marsh
dýggj2	soaked, wet through, drenched
dýggja	1make dripping wet, make drenched2splash, squirt
dýggjandi	sí í osb: dýggjandi váturdýggjvátur
dýggjvátur	drenched, wringing wet, soaking wet
dýkja	dýkja segl spread sail out to dry
dýna1	(yvirdýna, samsvarar við) duvet, eiderdown, (down) quilt, continental quilt,(am.)comforter; (undirdýna) featherbed;liggja við ongari dýnusleep without an eiderdown;stikað dýna(ribbed) eiderdown, continental quilt;tað er sum at sláa í eina dýnunothing makes any impact on him(o.tíl.);it is like water off a duck's back(el.like hitting a cushion)(GG:it is hopeless to try to bring him to reason; much in his rhetoric must be a whistling in the dark)
dýna2	(fáa dún av fugli) pluck
dýnufrakki	duvet coat
dýnufylla	stuffing for(el.of) an eiderdown (, a featherbed)
dýnujakki	duvet jacket
dýnuvár	sídýnuver
dýnuver	bed-tick, tick (for an eiderdown, for a featherbed), duvet cover, slip (for an eiderdown, for a featherbed); continental quilt cover
dýnuvor	sídýnuver
dýpa	1deepen, make deeper, dredge2become deeper
dýpd	1depth,tað er dýpd í myndinithe picture has depth2(fl.m.)profundity;fara í dýpdina (við málinum)go into(t.d.the matter) in depth; (ógvisligari) plumb(el.sound) the depths;hann fer ikki í dýpdina (eis.)he merely scratches the surface3(tónl.)depth, (low) pitch
dýpdarlinja	(jarðfr.)depth contour line
dýpdarmáling	bathymetry
dýpdarmátari	deep-sea sounder, depth recorder, depth gauge; (í torpedo) depth indicator
dýpi	1deep, deep sea2(mát)depth;(sigl.) dýpið minkarthe water is getting shallower, the depth is decreasing; the bottom shelves upwards;á 10 fóta dýpiat a depth of ten feet;hvat er minsta dýpi tit hava loddað á flóð?what are the least soundings you have had at high water?;lodda dýpiðsound the depths of sth;á lítlum dýpiat a low depth; in shallow water3(skm.)abyss4svartastu dýpi í mannasinninumthe (darkest) depths(el.recesses) of the human soul
dýping	deepening, dredging
dýpshædd	(mát)[a length of 60 to 80 fathoms]
dýr	1animal; (um stór súgdjóreis.)beast; (á garði) livestockflt2(fl.m.) dýrið í menniskjanumthe beast within;sum eitt jagstrað dýrlike a hunted animal;hann er eitt dýrhe is an animal(el.an absolute beast);hann leikaði í sum eitt dýrhe raged like a caged animal3vermin4(gl., bát.)seal
dýra	assert, avow, protest;hann dýraði uppá athe swore that;dýra upp á sakloysiðprotest one's innocence
dýraátin	zoophagous, carnivorous; eis.djóraátin
dýrabarur	precious; (kærur) dear;(speisk.)precious(t.d.I hope she saved her precious canary from the fire);hatta er mær dýrabartit is precious to me;mín dýrabarasta ognmy dearest possession
dýrabiðidagsaftan	[the day beforedýrabiðidagur]
dýrabiðidagsskeið	[the period arounddýrabiðidagur]
dýrabiðidagur	(kirkj.)[a public holiday, falling on the fourth Friday after Easter]
dýrabærur	sídýrabarur
dýradoyð	(illb.)by Jove!
dýraflokkur	(dýr.)species (of animal)
dýragarður	sídjóragarður
dýralæknaeftirlit	veterinary supervision, veterinary inspection;undir djóralæknaeftirlitisubject to veterinary inspection, inspected by a veterinary surgeon, under veterinary supervision
dýralækni	sídjóralækni
dýralæra	(dýr.)zoology; zoological textbook
dýran	truly;leggja e-m dýran viðpromise sby truly; highly, greatly, severely, hard,leggja e-m dýran viðlay down hard conditions, forbid strictly,hann legði dýran við at tað skuldi verða gjørthe (stonily) insisted that it must be done;leggja dýran við at halda eittobserve sth strictly(el.scrupulouslyel.religiously);leggja dýran við at halda lóginaobserve the law to the letter;taka dýran tilcurse and swear, swear, use strong language
dýrandi	í osb: dýrandi fullur el. so dýrandi dead drunk,(tlm.)blind (to the world), plastered
dýrapínsla	sídjórapínsla
dýrasavn	sídjórasavn
dýraveiða	sídjóraveiða
dýrd	1extremely calm; perfectly calm sea2(átr.)glory(t.d.glory to God in the highest); glory(t.d.Solomon in all his glory; the city was spread out beneath us in all its glory), splendour, magnificence; honour
dýrdarfagur	lovely(t.d.landscape, scene, sight)
dýrdarfullur	splendid, magnificent, grand, glorious
dýrdargóður	calm
dýrdargripur	(bíbl.)treasure
dýrdarkyrra	dead calm
dýrdarlogn	sídýrdarkyrra
dýrdarlutur	(bíbl.)treasure
dýrdarmikil	1calm2sídýrdarfullur
dýrdarríkur	sídýrdarfullur
dýrdarsjógvur	dead calm sea
dýrdarslættur	(um sjógv) dead calm
dýrdarstilli	dead calm
dýrdarveður	extremely good weather
dýrdleiki	dýrd(2)
dýrdligur	(bíbl.)sídýrdarfullur
dýrgoldin	dearly paid
dýrgripur	preciousness, treasure, jewel
dýrka	1make dearer, raise the price, increase the cost2become dearer,smørið er dýrkað(the price of) butter has gone up3(bíbl.)worship, honour
dýrkan	1rise in prices, price rise; (brádlig) boom2(bíbl.)worship, glorification
dýrkari	(bíbl.)worshipper
dýrleiki	expensiveness, costliness
dýrligur	(bíbl.)precious; (kærur) dear
dýrlingur	saint
dýrmeta	praise, laud
dýrmetin	precious; (kærur) dear
dýrmettur	(um gimsteinar) precious(t.d.precious topaz); sídýrmetinogdýrmætur
dýrmætur	1precious(t.d.liberty is the most precious thing we have; the precious blood of Christ); dear; noble(t.d.character);(gl.og skaldsk.) gentle(t.d.knight, lady); noble, generous(t.d.nature, spirit); noble-minded, magnanimous2(bíbl.)heavenly, celestial; divine
dýrtíð	(bú.)inflation, high prices, high cost of living, high living costs, time of dearth(el.of scarcity), period of scarcity
dýrtíðarhjálp	(bú.)cost of living allowance
dýrtíðarjavna	[compensate for high cost of living]
dýrtíðarjavning	[compensation for high cost of living]
dýrtíðarviðbót	(bú.)[high cost of living compensation]
dýrur	1expensive, dear, costly, expensive(t.d.an expensive car, hotel, journey, shop); high-priced; pricey(t.d.pubs jazzed up into pricey bars);hava dýrar vanarhave expensive tastes;tað er ov dýrt hjá mærit is too expensive for me, it is beyond my means, I can't afford it, the price does not suit me;í dýrum dómum, í dýra dómi el. í dýra dómaat great expense, at an exorbitant price;gjalda í dýrum dómumpay a lot(el.the earth) (for it); pay through the nose, pay a fancy price; (sum kostar meira enn virðið) dear(t.d.the car cost £200 and was dear at the price)2dear,mín dýrasta ognmy dearest possession; glorious, grand, magnificent;nú eru góð ráð dýrthe situation is desperate, we (,o.s.fr.)are in dire straits(el.in a jamel.in a spotel.in a tight corner);tá ið góð ráð eru dýrwhen the situation is desperate;hann rópti upp á tað dýra navnhe called on that dear name;(tlm.)when the crunch comes3delightful, wonderful; glorious, grand, magnificent4holy, sacred; solemn,svørja ein dýran eiðswear a solemn oath;svørja dýrtswear solemnly5hard, extreme,í dýrastu neyðin extreme distress, in extreme need;dýr tøkgreat exertion, great effort,tað vóru dýr tøk atit took a great effort to;hann er komin til ta dýru tíðhe is on his deathbed, he is at death's door;hon rann tað dýrasta hon orkaðishe ran as quickly as she could;í ein dýran hastin the greatest hurry
dýsa	(tøkn.)nozzle, jet
dýva	dip(el.plunge, immerse) in water
dývátur	sídýggjvátur
dæla	(stb.)leak,tað dælir ikkiit doesn't leak, it is watertight
dællur	sídælur
dælur	1pleasant, courteous, kind, obliging; confidential; amenable;gera sær dælt viðexploit, make the most of;gera sær dælt við e-nside with someone on intimate terms; be free and unstrained with regard to sby;tað er ikki dælt at koma í holt við hannit is not pleasant(el.not an easy matter) to tackle him;tað er ikki dælt at bróta fornan siðit is not advisable to break old customs2accessible,dælt er manni vitandi orð[an intelligent man has no difficulty in following an intelligent speech];(tilt.) tað er ikki so dælt, tað ikki er halt[nothing is flawless]
dæmdur	complexion,væl/illa dæmdurwith good(el.sickly) complexion
dæmi	complexion, appearance
døgarði	(Suð.)dinner
døgg	dew,(t.d.á rúti) steam;hvørva sum døgg fyri sólfade away like morning dew, vanish like smoke;døggin legstthe dew is falling;døggin setur avthe dew evaporates
døgga	gather dew; become misted, steam up;tað døggarthe dew is falling;glasið døggarthe glass is (getting) steamy;(áv.)bedew, dew
døggdropi	dewdrop
døggfalla	í osb: nú fer at døggfalla the dew is beginning to fall
døggfallin	dewy, covered with dew;jørðin er øll døggfallinthe field is covered with dew
døggmark	(alisfr.) dew point
døggpunkt	(alisfr.)dew point
døggsmetta	(fugl.)spotted crake(Porzana porzana)(Linnaeus, 1766)Porzana porzana ©Peter Jacobs
døggvátur	dewy, moist with dew
døglingseyga	half-blind person, weak-sighted person
døglingsregn	sígrimdarregn
døglingur	1(dý.)bottlenose whale(Hyperoodon ampullatus);northern bottlenose whale2(gl.)one-eyed person
døgum	sídagur
-døgur	síjavn-,sam-
døgurðabiti	dinner
døgurðablundur	after-dinner nap
døgurðaborð	dinner table; (máltíðin) dinner;sita við døgurðaborðiðbe at (one's) dinner
døgurðagestur	(t.d. the dinner guests began to arrive)dinner guest(t.d. the dinner guests began to arrive);(eisini sum gjalda) diner;vit hava 8 døgurðagestirwe are having 8 people(el.guests) for dinner
døgurðalúrur	after-dinner nap
døgurðamatur	dinner; (mitt á degieis.)midday meal, lunch
døgurðamál	sídøgurðamál
døgurðamáli	noon, dinner hour,um døgurðamálaabout noon
døgurðasteðgur	lunch hour, lunch(el.midday) break, interval for lunch
døgurðatíð	dinner hour
døgurðatími	noon; dinner hour,um døgurðatímiabout noon
døgurði	1(stb.) døgurð) k1(máltíð) dinner; (á miðjum degi,ofta =)midday meal; lunch2(veitsla) dinner (party)3(almennur) banquet4[íyms.samb.]eta døgurðahave dinner, (hátíðarligari) dine;eta døgurða úti(á matstovu) dine at a restaurant; dine out; (til veitslu) dine out;eta ofta døgurða útibe a great diner-out;hann er farin til døgurðahe has gone to lunch;hvat skulu vit hava til døgurða?what are we having for dinner? what have we got for dinner? what's for dinner?hava høsnarunga til døgurðahave chicken for dinner, dine on chicken;bjóða e-m til døgurðainvite(el.ask) sby to dinner;eta døgurða viðstay for dinner;hvat fekst tú til døgurða?what did you have for dinner?;bjóða e-m døgurðaentertain sby at dinner, dine sby,(tlm.)treat sby to a dinner; (alment) give a banquet in sby's honour;bjóða ein døgurða til heiðurs fyri e-ngive a dinner (, banquet) in sby's honour;eg verði ikki aftur til døgurða í dag (eis.)I shall not be in for dinner tonight;undir døgurðanumat dinner, over the dinner table, at the banquet
døkkast	1become dark; get dark2(um sjón) be dulled
døkkbláur	dark-blue
døkkdæmdur	dark-complexioned
døkkholdaður	(um fólk) dark(-skinned), swarthy;(skaldsk.)dusky
døkki	1dark place, dark spot2silhouette
døkkleittur	sídøkkholdaður
døkkormur	(lækn.)blackhead
døkkoygdur	dark-eyed
døkkur	dim, dark; dull, lustreless
dølgur	sídólgur
døll	dullard
dølla	dølla særel.døllastbe tardy, be dilatory (t.d.they were tardy in filing the application)
døllur	(stb., niðr.)small boat
døllutur	slow, dilatory, tardy (t.d.she was tardy to work)
dølma	be slow (, dilatory, tardy), lag behind, bring up the rear,koma dølmandicome trailing behind;tit hava dølmað henda dagin burturyou have idled the day away
dølmutur	slow, dilatory, tardy
dølski	sídølskni
dølskleiki	sídølskni
dølskni	dullness, lethargy, somnolence, torpor
dølskur	dull, inert, torpid; somnolent; indifferent
dølum	sídalur
døma	1(løgfr., í borgaramáli) judge, deliver judg(e)ment, pass judg(e)ment;døma í e-m málijudge(el.tryel.hear) a case;døma at rinda kostnaðinorder to pay costs;døma at rinda skaðaendurgjaldorder to pay damages(el.compensation);døma e-n at rinda 100 kr.fine sby (døma manni revsing) sentence, pass sentence on; condemn; (døma sekan) convict;døma e-n sekanfind(el.declare) sby guilty; convict sby;fáa e-n dømdan(brotsliga) get sby convicted, obtain a conviction against sby; (borgaraliga) obtain judgment against sby;verða dømdur sekur í e-mbe convicted of sth, be found guilty of sth;døma e-n frá lívinumsentence(el.condemn) sby to death, pass sentence of death on sby;tí verður dømtit is adjudged that;tann dømdi(kann verða endurgivið) the prisoner;dømandi valdjudicial power; judiciary2(ikkiløgfr.)judge(t.d.God will judge all men; it is not for me to judge him); (meta um) judge, form a judgement of;tú eigur ikki at døma onnurone ought not to set oneself up in judgement of(el.sit in judgement upon) others;eg døma hann ikkiI do not set myself up in judgement of him;tað er ikki mín lutur at døma hannit is not for me to judge him;døm hann ikki ov harðligado not judge him too severely; do not be too hard(el.severe) on him;døma frammanundanprejudge3(í fótbólti) referee,(am.)umpire;døma fótfeilcall a foot-fault; foot-fault sby;døma fríspark(o.tíl.)give(el.award) a free kick(o.tíl.);(í nevaleiki) referee; (í baseball, kricket, tennis) umpire; (kapprenning, rógving) act as judge; (í ítrótt)døma skeivtgive an erroneous award4judge(eftirby); estimate; (próvdøma) examine, mark(t.d.his English essay is difficult to mark);(am.)grade; (síannarsmeta um)5condemn(t.d.condemn sby for his conduct); denounce(t.d.he denounced his conduct publicly); censure(t.d.he was severely censured for his mistakes);(átr.)damn (síannarsátala,revsa)6[ísamb. viðfs]døma eftir útsjóndjudge by appearances; go by appearance(s);eftir øllum at dømato(el.by) all appearances(GG:there is every reason to believe that the picture is genuine); (sum frættist) by all accounts;døma vit hann eftir okkara mátiif we judge him by our standards;tú dømir eftir tær sjálvumyou are judging from yourself; you are applying your own standards
dømi	1example, instance (um of), paradigm; (fordømi) precedent; (upplýsandi) illustration;sum dømias an example, by way of example;eitt gott dømia good example; a case in point;eitt vánaligt dømia bad illustration, a poor example;(fl.m.: sum fyrimynd) a bad example;geva dømigive(el.adduce) examples, illustrate by examples;taka fram sum dømiinstance, cite (, quote) as an example;sum dømi kann verða nevntby way of example may be cited (, quoted);ávarandi dømia warning, a deterrent, a lesson, an example(t.d.let this be an example to you);eitt beinrakið dømia striking example;sum dømi um hansara dirvi kann eg nevnaas an instance of his courage I may mention;sum dømi um hvussu orðið verður brúktto illustrate the use of the word; (síannarsfyridømi)2(bókm.)fable(t.d.Aesop's fables)3(kvæð.)event, occurence, incident4[ísamb.viðfs]til dømisfor instance, for(el.by way of) example; like, say(t.d.let me take, say a hundred; any tragic event, say the death of a friend);(ste.g.);eg til dømis komi ikkiI for one am not coming;sum til dømis(such) as(t.d.beasts of prey, such as the tiger); as for example(t.d.large cities, as for example Paris); like(t.d.great writers, like Dickens, often use this effect); such as(t.d."Sometimes you say things that you shouldn't" "Such as?");dømi um eittan instance(el.example) of sth;dømi um tað øvutainstances (, illustrations) to the contrary; counter-examples;dømi eru um, at tílíkt er komið fyrithere are examples of this having occurred; this is known to have occurred;geva dømi um eittgive(el.adduce) examples of sth, exemplify sth(t.d.to exemplify the use of a word), illustrate sth (with examples); instance sth;dømi úr Shakespeareexamples from Shakespeare;lýsa eitt við dømumexemplify sth, illustrate sth with examples
dømileysur	unparalleled, unprecedented, unexampled, nonpareil, unheard-of
døming	1judging2(meting) evaluation, judgment, opinion; assessment(t.d.of candidates);3(verkevni, stílar) examination, marking;(am.)grading;4(ítr.) refereeing5leggja eitt fram til dømingarsubmit sth for decision; submit the question to the committee; approach someone in the matter
dømisøga	1(bíbl.)parable(t.d.the parable of the Buried Talents)2(bókm.)fable(t.d.Aesop's fables)
dønum	sídani
døpul	(kvæð.)double, twofold,í døplum hugain two minds, in doubt
døpur	sídapur
døpurhugi	irresolution,vera í døpurhuga (av e-m)be in two minds (about it)
døsi	sídøsil
døsil	tangled string
døsin	somnolent, torpid
døssasligur	sídeyðsamligur
døttur	fall,(t.d.he was injured by a fall); fall,(t.d.he was injured by a fall)
døtur	sídóttir
døv	(á fólkiel.rossi) haunches, hindquarters; behind, seat, bottom
