u	(málfr.)vowel, /u:/
U-	(ítr., st.)ungdóms-, youth;enska U-16 landsliðiðthe All-England team (up to 16 years);U-18 landslið(up to 18 years);U-21 landslið(up to 21 years)
U-dalur	(jarðfr.)u-shaped valley (glacial trough)
uddi	síyðja
uff	ugh, oof;uff, uff
Uganda	(sern., landafr.)Uganda
ugandabúgvi el.ugandi el.ugandari	Ugandan
ugandari	Ugandan
ugandiskur	Ugandan
ugga	comfort(t.d.she comforted her sobbing child;(bíbl.)comfort all that mourn), console(t.d.the widow was somewhat consoled by the presence of her sister; he consoled himself by the reflection that),(skaldsk.)solace; calm, soothe, cheer up; uggae-ncomfort sby;hann uggaði seg við, at...he took comfort from the fact that...;uggandi orðconsoling/comforting words; words of consolation
uggabein	fish's clavicle
uggabreiður	1(um flaktan fisk, of fishespwhen split) broad-throated2(um mannfólk, of men) broad-shouldered3[íyms.samb.] given to puffing oneself up;hann ger seg so uggabreiðanhe is puffing himself up
uggafiskur	1the thin flesh on the clavicle2(on fish) `topmost piece' (part of the body which is near the breast fins and closest to the head)
uggafjøður	pectoral fin;(tilt.) reisa uggafjaðrarnar/láta við uggafjøðriniget/become angry
uggaleysur	which gives smallorno consolation, comfortless;hesi uggaleysu orðthese words gave no consolation at all
uggan	til ugganar as a comfort;eg væntaði uggan, men onga eg fannI expected to be comforted, but I found no consolation; síuggi2
ugganarát	(uml.)compulsive eating; compensatory eating;(eis.)eating for comfort
ugganarátari	(lækn.)sufferer from (neurotic) bulimia, compulsive eater
ugganarleysur	(bíbl.)síuggaleysur
ugganarorð	orð søgd til ugganar consoling/comforting words; words of consolation
uggari	comforter, consoler,(bíbl.)the Comforter, the Paraclete; uggarimín í lívi og deyðamy Comforter in life and dead
uggastykki	(on fish) `topmost piece' (part of the body which is near the breast fins and closest to the head)
uggi1	[the thin flesh on the clavicle]
uggi2	comfort, consolation;(skaldsk.)solace; soothing, calming;(orðt.) lítil er barnsins uggia child is easily comforted
uggileiki	(stb.)síugguleiki
uggilsi	(tlm.)síuggi2
uggingarsamur	consolatory, consoling, who comforts sby, who brings comfort to sby;vinir vilja vera uggingarsamirone's friends will bring one comfort
ugguleiki	(stb.) til ugguleikaas a means of comfort;hann hevði tað til ugguleikahe used it as a means of comfort;tað er ein ugguleiki at hava barnið hjá særit is a comfort that the child is here;uggi2
ugla	(dýr.)owl(Strigiformes)
ugli	(sj.)síugla
uglubóndi	1(fugl.)short-eared owl(Asio flammeus)(Pontoppidan, 1763)2(kvæð.)male owl© Minette Layne
Ukraina	(sern., landafr.)Ukraine
ukraini el.ukrainari	Ukrainian
ukrainskur	Ukrainian
Ukreina	síUkraina
uks	(stb.)síups
ukulele	(tónl.)ukulele
ulka	(fisk.)bull-rout(Myoxocephalus scorpius)© Wikimedia Commons
ull	wool;leita eftir ullcollect wool in the outfield, sílesull;tann fínara ullin verður kallað rót og tann grovara broddurthe fine inner wool is calledrót(undercoat) and the coarse outer wool of the fleece is calledbroddur (overhair/guard hair/shoddy);ein ullthe fleece of a sheep (after it has been shorn offorshed off)
ullaður	(um seyð, of sheep)væl ullaðurwith good (suitable) wool;illa ullaðurwith little wool and of poor quality
ullarband	woollen rope, woollen collar(t.d.dog collar)
ullarbeiði	wool preparation, woollen clothing manufacture
ullardigla	tuft, wisporscrap of wool
ullarfiti	wool fat, wool grease (lanolin)
ullarfløta	[a field covered with wool which has been spread out to dry];havið var sum ein hvít ullarfløta, brot í brotthe foam-crested sea looked like a field covered with wool, one breaking wave after another
ullarfólk	1(sø.)[people who travelled about the countryside begging for wool]2(sø.)[people who collectlesullin the outfield](lesull= wool that sheep shed in (the) spring)
ullargóður	(um seyð, of sheep) with high-quality wool;ullargott og trivaligt seyðaslaga breed of sheep of tall build and with high-quality wool
ullarhelsi	woollen collar (to which the tether is tied)
ullarhít	bag of wool
ullarklæði	(sj.)woollen clothing;matmóðirin kom við fullum føvningi av ullarklæðumthe mistress of the house came carrying an armful of woollen clothes
ullarknýti	1bundle of wool2carded tuft of wool (rolled into cylindrical form by spinning on the spindle)
ullarkona	1(sø.)[woman who travelled about the countryside begging for wool]2(plfr.)[dandelion after it has withered](Taraxacum)3(plfr.)símýrifípa4(fugl., stb.)downy young one of a puffin
ullarlagdur	tuft, wisporscrap of wool
ullarlíki	material resembling wool(t.d.rayon)
ullarmeis	[net mounted on frame for drying wool];hárið er sum ein ullarmeisthe hair is thick and tousled
ullarnipil	(small) tuft, wisporscrap of wool
ullarnippa	(sj.)síullarnispa
ullarnispa	small tuft, wisp, lumporscrap of wool
ullarnípa	síullarnispa
ullarposi	bag with wool in it
ullarprísur	price of wool
ullarríkur	with much and good wool; ullarríkurseyðursheep with much and good wool
ullarroyting	(stb.)síáseyðaroyting
ullarrúgva	heaporpile of wool(espin the sheepfold)
ullarsaksur	sheep shears(flt)
ullarsekkur	síullarposi
ullarslag	typeorquality of wool
ullarstrýggja	long hair of coarse wool
ullarstúka	woollen shirt
ullartálg	síullarfiti
ullartíggjund	(sø.)tithe of wool
ullartjóvur	(sø.)[someone who collects wool in the outfield without permission]; sílesull
ullartoddi	(stb.)síullarlagdur
ullartógvi	(a tuft of) matted wool felt
ullartóvi	síullartógvi
ullarvág	(measure) onevág(18 kg) of wool
ullarvøttur	woollen mitten
ullast	become fluffy;at dúnnappa er at nappa so fínt, at plaggið ullastpull(nappa)wool so that it becomes as fluffy as down
ullband	1double-ortreble-threaded woollen stringorrope2wollen bandorrope around a cow's neck (strap with which cattle are tied to the cowshed)
ullfakt	(stb.)síullferð
ullferð	growthorquality of wool;neytaslag við lodnari ullferðbreed of cattle with hairy fur
ullfríður	(um seyð, of sheep) with beautiful wool; ullfríðurseyðursheep with beautiful wool;eitt sera ullfrítt lamba lamb with very beautiful wool
ullgarn	woollen yarn, wool
ullhærdur	1(plfr.)villous;ullhært legugrasYorkshire-fog(Holcus lanatus)2(um fólk, of people) woolly-haired
ulling	síullferð;ullingin er óføra tøttthe wool is very thick
ullintur	woollen;ullint klæðwoollen clothing;ullintar hosurwoollen stockings
ullkarði	wool card
ullklæði	woollen clothes;lata seg í ullklæðiput on one's woollen clothes
ullprúður	with good, thick wool; ullprúðurseyðursheep with good, thick wool
ullrísin	(um seyð, of sheep) with ugly and rough wool
ullsjal	woollen shawl;hon hevði eitt lætt ullsjal hangandi um herðarnarshe had thrown a light woollen shawl across her shoulders
ullteppi	blanket
ulltíggjund	(sø.)síullartíggjund
ulltog	woollen band, stringorrope
ulltóvi	tuft of matted wool felt
ulltráður	strand of wool
ulltroyggja	woollen jersey
ullvirki	síspunavirki
ullvirkishús	(sj.)síullvirki
ulnast	(of wool) become fluffy
ulpa	[fleece-lined overcoat with hood]
um1	1about, around(t.d.the garden around the house);runt (um)round(t.d.go round the corner; sit round a table; put a rope round the tree);dansa um jólatræiðdance round the Christmas tree;hava reim um miðjunahave a belt around one's waist;binda um fingurinbandage (up) a finger;runt um borðiðround the table;taka/tríva um e-ttake hold of sth2over, across, via, by, through;nógv fólk ferðast um flogvøllinmany people travel via the airport;leiðin lá um Fútakletttravelling by way of Fútaklettur;inn//út um dyrnarin//out through the door3within the boundaries of sth;ganga (runt) um gólviðwalk up and down the floor;um allar bygdirtravel through all the villages;fara vítt um landiðtravel round the country4across, cross; walk, drive, sail pastetc; sigla um nesiðround the headland;rógva um tanganrow round the point;fara um horniðturn the corner;tað rekur um mánanclouds are drifting acrossorover the moon5over, across; umfjørðinover/across the fiord;um ánnaover the stream;detta um ein steinfall/stumble over a stone;detta um seg sjálvanbe very clumsy;komin um tað ringastabe over the worst6(of a compact group, in close formation);lið um liðside by side;vit fylgdust borð um borð úteftirwe sailed out together side by side7(um tíð, of time, past, farther on, further on, beyond);tað leið út um mikkjalsmessuMichaelmas (29 September) (had) passed;tað var farið um midnáttit was past midnight(eis., t.d.it was after midnight when he came home; just after six o'clock);hon var farin um 90 árshe was past/over ninety8(um tíð, of time, after a certain elapse of time); umein mánaðin a month;um eina løtuin a moment;um nakrar dagarin a few days9about, in the neighbourhood of, round about,(am.)in the area of(t.d.2, 000 dollars); umhundrað mansabout one hundred men;um tíggju ára aldurabout ten years old10as regards; as to(t.d.as to his motive, I cannot say anything at present); regarding, with regard to, concerning; in relation to;tosa um e-ntalk about sby;tað eru nógvar søgur um hannmany stories are told about him;dysturin um fyrsta plássiðthe match (struggle) for the leading place;teir atkvøddu um uppskotiðthey voted on the proposal,(stjm.)motion, (lógaruppskot) Bill;ótti kom á fólk um bátarnarpeople were worried about the boats;hvat veitst tú um tað?can you tell me anything about it?;teir vóru fleiri um arbeiðiðmany men did the job;lata seg úr um beininitake off one's shoes;tað var einki um hannhe was silent (faint-hearted);vera óður um e-tbe furious about sth11(umt.d.likamspart, of parts of the body);vaska sær um eyguniwash one's face;kína e-m um enniðcaress sby's forehead;hvítur um hálsinwhite around the neck12[sumhj]1about, (a)round;fara víða umgo aroundorabout;har er so ringt umit is difficult to walk there;tað er vátt umthe ground is wet, it is wetlands2anew, afresh, again, once more, over again; (tíðum verður skrivaðel.sagt) re(-)(t.d.re-establish a system, retry a criminal case, repopulate a country); rewrite, redo, rebuild,etc); skriva e-t umrewrite sth;gera e-t um afturredo sth13(um tíð, of time, duration); umnáttinaat night(t.d.he works at night; late at night); by night(t.d.travel by night);um daginby day, during the day, in the daytime;um kvøldiðin the evening, at night;um summariðin (the) summer, during (the) summer, in (the) summer time;um jóliniat Christmas; during Christmas;um somu tíðat the same time;1000 kr. um mánaðin daginonce a day;tvær tablettir um dagintwo tablets a day;dag um dagday by(el.after) day14[ísamb.viðhj]framum,sífram;niðanumfurther up than;niðan um bøgarðarnarfarther up than the village fence (out into the outfield);omanumfurther down than;oman um húsinidown below the house(s);yvirum hann fór yvir um ánnahe crossed the stream;yvir um fjørðoveroracross the fiord15[fs/hjsaman viðs] t.d.:biðja um; brýggja seg um; bøta um; galda um; halda um; hálsa um; hugsa um; kenna um; leggja um; reika um; ríva um; røða um; spyrja um; tala um; vera um(sísagnorðsumleitorð)
um2	1on condition that; on the understanding that; provided that;eg komi, um eg sleppiI'll come provided the sevice isn't cancelled, provided I'm not hindered by a matter of urgency;um so er, at...in the case that;um enn/(eis.)umenn (kvæð.)even though, even if2(sum inngangsorð í óbeinleiðis spurnarsetningum, as initial word in indirect interrogative sentences) if, whether;spyr hann, um hann veit taðask him if he knows something about it;vitago and look; vita um tú sært nakaðgo and look whether you can see something;hann spurdi, um eg tímdihe asked me whether I would do it3though, in spite of the fact that;minnið livir, um maður doyrthe memory of a man outlives him
umaftur-	anew, afresh(t.d.start afresh), again, once more, over again, (tíðum verður nýtt) re(-)(t.d.re-establish a system; retry a criminal case; repopulate a country)
umafturteljing	recount
umbera	1make allowances for; bear with; be indulgent towards; forgive;vit eiga at umbera næsta okkarawe should forgive our neighbours2decline, refuse (to); excuse oneself (from)(t.d.excuse oneself from coming);teir umbóru seg ikki fyri øllum tí starvi, ið her varthey did not decline doing all the work which was/lay before them;teir tóku allir at umbera segthey all began to excuse themselves from3make excuses, explain away; umberaseg við e-mmake sth a pretext (for doing//not doing sth);vit kunnu ikki umbera okkum við tí, at..we cannot explain it away by saying...4[-'b-] íosb.sumtað umber seg ikkiel.tað umberst ikkiit is unavoidable, it cannot be avoided;tað kundi ikki umberast, at hann fekk at hoyra allar hesar søgurthat these stories reached him was unavoidable
umbering	1forgiveness;biðja um umbering (fyri e-t)ask (sby's) forgiveness (for sth)2excuse;hava sum umberingas an excuse; excuse oneself on the score/plea that(t.d.one is busy); plead that(GG:on the score of illness; on the plea of being too busy)
umbermis	in circumference, in perimeter
umbersla	forgiveness
umbiðin	in demand, in request, popular; reserved, ordered, engaged;hann var so umbiðinhe was in great demand, he was very popular
umbiðing	order, requisition; application, petition
umbiðjari	(sj.)applicant, petitioner (for)
umbinding	1tying up2bandage, dressing(t.d.of a wound), ligature
umbjálving	packing, wrapping
umboð	1authority, power of attorney;kongur gav honum umboð at koyra prestar úr embætithe King gave him authority to defrock clergymen;hann fær honum í umboð at geva enska konginum skipiðhe gives him authority to hand over the ship to the King of England2representative, deputy, member, delegate, (fyri felageis.)agent;felagið sendir eitt umboð á fundinthe firm is going to send a representative to the meeting;umboð fyri politisku flokkarnarrepresentatives for the (Faroese) political parties;føroysku umboðini í Norðurlandaráðnumthe Faroese delegates at the meetings of the Nordic Council3(handilsm.)agent, dealer, representative; umboðfyri Ford í FøroyumFord's representative in the Faroes
umboða	represent, act for; umboðaeina bilverksmiðjurepresent a repair shop/garage;hon umboðar flokkin í stýrinumshe is the party's member of the board;ríkisumboðsmaðurin umboðar donsku stjórnina í Føroyumthe High Commissioner represents the Danish Government in the Faroes
umboðan	representation
umboðanarendurgjald	(handilsm.)entertainment allowance
umboðanarkonta	(handilsm.)entertainment account, (tíðum) expense account
umboðanarskylda	(handilsm.)obligation to entertain
umboðanarútreiðslur	(handilsm.)etertainment expenses/costs(flt),business entertainment costs(flt)
umboðanarviðbót	(handilsm.)entertainment allowance
umboðari	representative
umboðsbræv	(sø.)written authority
umboðsfulltrú	(handilsm.)authority to bind the company, the firmetc
umboðsfulltrúi	(handilsm.)sby who signs for the firm
umboðsgevi	mandator, principal
umboðshandil	1(handilsm.)(einstakur) commission transaction2commission business
umboðsjørð	administered land which is owned by someone else
umboðsmaður	1representative, deputy, member, delegate, (fyri yrkisfelag) official;felagið sendir ein umboðsmann á fundinthe firm is going to send a representative to the meeting;umboðsmaður fyri donsku stjórninaa representative for the Danish Government;ríkisumboðsmaðurthe Danish High Commissioner in the Faroes2agent, representative3(stjm.um Norðurlond) Ombudsman, (íBretl.)Parliamentary Commissioner4(gl.)man who administers land for others; administrator
umboðsmannafundur	meeting of delegates
umboðsmannagjald	(sigl.)agency fee
umboðsmannating	(stjm.) umboðsmannatingið(í USA) the House of Representatives; (í ymsum londum) Chamber of Deputies
umboðsnevnd	síumboðsráð
umboðsráð	(í enskum partafeløgum samsvarar taðuml.við) shareholders' committee; board of representatives; committee of representatives; assembly of delegates; (yrkisfelag) representative assembly
umboðsstjórn	(gl., stjm.)the central administration
umboðsstova	representation, mission (abroad)
umboðssøla	(sales) agency; representation
umboðsvald	1authority to bind the company, the firmetc.2(í ríki) the executive power;lóg um umboðsvald FøroyaFaroese Executive Power Act; eis.útinnandi vald
umborð	on board;vera umborðbe on board;fara umborðcome on board, embark;umborð á Norrønuon boardthe Norrøna(a ferry)
umbót	improvement, reform
umbótamaður	reformist, reformer
umbótastevna	reformism
umbrot	(prent.)make-up
umbroyta	1change, alter, transform, modify2(bíbl.)transfigure
umbroyting	1change, alteration, transformation, modification2(bíbl.)transfiguration(t.d.the Transfiguration of Jesus)
umbróting	(prent.)making up
umbundin	tied up, bandaged;við umbundnum høvdiwith bandaged head
umburðarlyndi	tolerance, toleration, permissiveness
umburðarsamur	tolerant (to), easy-going;hann er umburðarsamur og roynir at fata tey, ið hugsa øðrvísi enn hann sjálvurhe is tolerant and tries to understand those who think differently
umbúnaður	síumbúni
umbúni	preparation, planning, intending to; with the intention of -ing; meaning to; for the purpose of -ing;tað er í umbúnait is being contemplated;hava e-t í umbúnaentertain/harbour/revolve schemes of sth; plan something
umbúningur	1preparation2(handv.)architrave; backband
umbygdir	villages on the outskirts of a town;úr umbygdunum inn í býinfrom the neighbouring villages into the town
umbygging	rebuilding(t.d.a house); conversion(t.d.an old building converted into a house);(gera út við nýggjari útgerð) recondition(t.d.a yacht)
umbýtandi	transferable, negotiable
umbýti	exchange, replacement, (sínámillum) interchange; (handilsm.) swaps;eg fekk tað í umbýtiI got it in exchange (for sth);um ikki til støðugt brúk, so til umbýtisif not for permanent use then to be used from time to time
umbýtingar-	transfereable, negotiable
umbýting	(handilsm.) transfereable
umbýtisrættur	(bú., handilsm.)conversion privilege
umbæri	patience, tolerance, the ability to control oneself;hann hevur ikki umbæri at bíða longurhe is too impatient to wait any longer;eg havi ikki umbæri til at liggja í seingini longurI can't bear to stay in bed any longer;eg havi havt umbæri við tykkum til henda dagI have been patient with you up to now
umbæriligur	tolerant (to), easy-going;hann var umbæriligur og manngóður kongurhe was a tolerant and loving king
umbærisleysur	intolerant (of)
umbøn	application, petition; order, commission;hann hevur tveir bátar í umbøn í løtuni(um bátasmið, of a boat builder) he has two boats in commission at present
umbøting	improvement, reparation, reformation, (um tekst) emendation;bókin varð prentað við nøkrum umbøtingumthe book was printed with some emendations
umdystur	(ítr., framhalda av dysti)extra time; (nýggjur dystur) replay, play-off;spæla umdystplay off
umdømi	1sphere, field of activity; sphere (of authority), competence(t.dit is not within his competence)2reputation;gott//vánaligt umdømigood//bad reputation
umdømisvaldur	(stjm.)seat in the Faroese Parliament (Løgting) obtained by election in a multi-member constituency;nú eru 27 umdømisvaldir løgtingsmennthere are now 27 constituency seats in the Faroese Parliament (the Løgting); síeis.eykavaldur
umenn	even ifel.even though
umfar	1round, row, revolution, (um rennibreyt) lap, (í boksing) round, (íítr.)leg2(í binding) roundorrow of stitches in knitting3(bát., sigl.)a row of boards round a boat;umfar av plankum//plátum (uml.) eftir miðjuni á skipisheer strake4row of stones in a wall;tað niðasta umfarið var 20-24 tummar á breidd; tað ovasta 14 tummarthe width of the bottom row was 20 to 24 inches, the topmost row was 14 inches5attempt, try, occasion;eg skuldi bent hann niður í fyrsta umfariI should have bent him down at the first attempt;í fyrsta//øðrum umfarion the first//second occasion;í fyrsta umfari vunnu teir sakina/máliðthe first time (round) they won the case6epidemic;eitt umfar tók seg uppan epidemic broke out7circulation;silvur var tá eisini í umfariat the time silver was in circulation too8(stfr.)periphery9(ítr.)heat(fótb. eis.)round
umfaraskjal	(løgfr.)negotiableel.transferable document
umfaraskuldarbræv	(løgfr.)negotiable bond
umfarast	walk, goel.sail past each other without meeting; miss each other;bátarnir høvdu umfarist á vegnumthe boats had missed one another on their way (on the route)
umfarsljóð	(nýggjy.) surround sound
umfarssjúka	(lækn.)epidemic, infectiousorcontagious illness; eis.umfarssótt, farsótt
umfarsskriv	circular;umfarsskriv frá landsstýrismanni Government circular, departmental circular;senda limunum umfarsskriv (eis.)circularize the members
umfarssótt	(lækn.)epidemic; eis.umfarssjúka, farsótt
umfarsvinkul	(stfr.)peripheral angle
umfata	include(t.d.each district includes several parishes; this obligation does not include the duty of keeping the road in order); comprise(t.d.the book comprises more than 500 short biographies; the district comprises many places of interest); cover(t.d.the period covered by these statistics; the book covers the whole subject; cover a wide field); embrace(t.d.his studies embraced many subjects; the book embraces the whole history of the 18th century); comprehend(t.d.these subjects are not comprehended by the Treaty); take in(t.d.the catalogue takes in all books published after 1900)
umfatandi	sívíðfevndur,víðfatandi,víðfarin,víðlendur,djúptøkin
umferð	1cycle, rotation; umferðmánans um jørðinathe moon's rotation round the earth;seta fylgisvein í umferðorbit a satellite, bring/put a satellite into orbit, insert a space craft in orbit;í umferðin orbit;í umferð um mánanlunar orbit2visitation;prestur var á umferðthe clergyman was on visitation3(t.d.blóði, pengumviðv.)circulation;falskur peningur er í umferðcounterfeit money is in circulation;í umferðin circulation4(ravm.)circuit5(handilsm.)turnover, rate of turnover;last year the company had a turnover of £100,000í fjør hevði felagið £100.000 í umferð; velocity of circulation
umferðarogn	(handilsm.)current assets
umferðartíð	(stjfr.)time of rotation
umferma	(sigl.)reload(t.d.the cargo)
umferming	(sigl.)reloading(t.d.of the cargo)
umfermingarfarmur	(sigl.)goods for transshipment, transships(flt)
umfermingarhavn	(sigl.)port of transshipment
umfermingarkostnaður	transshipment charges
umfermingarstøð	transshipping station
umfermingarútreiðslur	transshipment charges(flt)
umfígging	(handilsm.)provision of new capital, refinancing, rescheduling(t.d. of payment periods)
umfíggja	(handilsm.)provide new capital for, refinance, reschedule(t.d.payments);umfíggja lánreschedule the payment periods
umformari	(ravm., tlm.)converter
umframt	1[sumfs] besides, in addition to, apart from; umframtalt hettain addition to all this; apart from to all this;umframt maðkar etur hann mýsit eats mice beside earthworms2[sumhj] in additon, besides, moreover, thrown in
umfylking	(herm.)regrouping, re-arrangement, redeployment
umgangari	candidate who presents himself for an examination a second time; (í skúlao.tíl.)repeater
umgangast	1associate with, consort with, frequent the company of, keep company with, mix with;fólk, sum hann umgongstpeople with whom he keeps company2be evadedoravoided;tað umgongst ikkiit is unavoidable3síumfarast;vit umgingustwe walked past each other without meeting4(stb.)treat badly, maltreat
umgangslærari	(gl.)peripatetic teacher; síferðalærari
umgangur	1(tlm.)beating, thrashing, hammering, drubbing;hann fekk ein ordans umganghe got a sound beating2(tlm.)dressing-down, telling-off; ticking-off3(gl.)in rotation, by turns;skúlin varð hildin upp á umgang í teimum ymsu húsunumthe houses (of the village) made room for the teaching in rotation;summi fóru upp á umgang í kommununisome poor people were taken on by turns by families of the parish
umgerð	1(húsasm.)covering; (á tekju) flashing;(t.dlens) mounting,(t.d.spectacle) frame;stór rundbogað vindeygu við gulari umgerðlarge round window with yellow covering2transformation, change, metamorphosis;lívrunnin evni, sum eru í umgerðorganic matter which are in a state of transformation3(jarðfr.)diagenesis
umgirdur	fenced in, enclosed, surrounded (withorby sth), encircled;húsini vóru umgird við garðithe house was surrounded with/by a wall/fence; síeis.umgyrdur
umgjørð	(bíbl.)síumgerð2
umgonga	1walk around sth;hann gjørdi eina umgongu runt um alla oynnahe walked round the entire island2síumgangur3;hann gekk til umgonguhe was taken on by turns by different families
umgrein	outline, contour;hann tekti í hálvamyrkrinum umgreinina av henniin the semi-darkness he could vaguely discern the outlines of her body
umgreining	outline, contour;umgreiningin av Sandoynni ók seg fram úr myrkrinumgradually (the island of) Sandoy stood out/was outlined in the darkness
umgyrdur	girded, strapped, buckled; síeis.umgirdur
umhang	hangings(flt),curtain
umheimur	surroundings(flt),outer world, surrounding world, outside world(t.d.cut off from the outside world); external environment;samband Føroya við umheiminthe Faroese commercial (trade/business) relations/connections/dealings/intercourse with foreign countries; (ferðasamband) communication(s)(t.d.communications between the Faroes and foreign countries);umheimurin fær ein myrkan og kargan dámthe surroundings become dark and bleak
umhildin	1popular;nógv//lítið umhildinpopular//unpopular2(stb.)miserable, wretched;hann sær so umhildin úthe looks miserable/wretched
umhugi	(sj.)síumhugsan
umhugsan	consideration, reflection, thoughtfulness, thought, contemplation; care, attention, caution;arbeiði, ið krevur góða umhugsanwork that requires consideration;hann hevði umhugsan fyri bátinumhe took well care of his boat;velja við umhugsanchoose cautiously;hava ein spurning til umhugsanartake up a problem for consideration
umhugsanarfreist	time to think it over, time for reflection, respite, cooling-off period(t.d.give him twenty-four hours to think it overel. t.d.he has till Monday to consider the offer)
umhugsin	1thoughtful, considerate2careful, attentive, prudent;hon var ikki umhugsin við børnunumshe neglected her children;hann var stórur og raskur, men umhugsin og røkjutur var hann ikkihe was strong and capable but he was neither prudent nor careful3intent, aware, observant
umhugsni	consideration, thoughtfulness
umhvarv	outline, contour, profile, silhouette;umhvarvið á fjøllunum stendur niður í fjørðinthe contours/the outline of the mountains are reflected in the waters of the fiord;hon sá bara umhvarvið av tekjunishe could only see the outline of the roof
umhvørvi	environment
umhvørvis	1in circumference, in perimeter;eitt hjól er umhvørvis 3 ma wheel which is 3 metres in perimeter2(a)round, about;her umhvørvisin the vincinity3on the outskirts of, on the fringe(s) of;fáa jørð umhvørvis Havninaget a plot of land on the outskirts of Tórshavn
umhvørvis-	environmental(t.d.environmental tax); environment(t.d.environment control); sít.d.: umhvørvisfelagsskapur, umhvørvisflokkur, umhvørvislógo.s.fr.
umhvørvisavgjald	environmental tax
umhvørvisávirkan	environmental impact(t.d.assess the environmental impact of a product); exposure
umhvørvisbólkur	environmental group
umhvørvisbrotsverk	environmental offence(s)
umhvørvisbúskaparfrøði	environmental economics
umhvørvisbúskaparfrøðiligur	umhvørvisbúskaparfrøðiligur vøksturenvironmentally sustainable economic growth
umhvørvisbúskaparfrøðingur	environmental economist
umhvørvisdálking	environmental pollution
umhvørvisdeild	environmental department
umhvørviseftirlit	environment control
umhvørviseitran	environmental poison
umhvørvisfelagsskapur	environmental movement
umhvørvisflokkur	green party, environmental party
umhvørvisflóttafólk	environmental refugee(t.d.environmental refugees in Africa)
umhvørvisfrøði	environmental studies(flt)
umhvørvisfyrilit	environmental considerations(flt)
umhvørvisgóður	environmentally friendlyel.soundel.correct
umhvørvisgranskari	environmentalist
umhvørvisjarðfrøði	environmental geology
umhvørviskrav	environmental requirements
umhvørvisligur	environmental
umhvørvislívfrøði	ecobiology
umhvørvislívfrøðiligur	ecobiological
umhvørvislívfrøðingur	ecobiologist
umhvørvislóggáva	environmental legislation, legislation concerning the environment
umhvørvislæra	(skúlam.)environmental education, environmental studies(flt)
umhvørvisma	environmentalism
umhvørvismálaráð	(stjm.)ministry of the environment, environment ministry; (íOngl.)Department of the Environment
umhvørvismálaráðharri	(stjm.)minister for the environment, environment minister; (íOngl.)Secretary of State for the Environment
umhvørvismeting	environmental appraisal
umhvørvispolitikkur	environmental policy
umhvørvisráðstevna	conference on the environment
umhvørvisreglur	environmental regulations(flt)
umhvørvisrøkt	environmental management
umhvørvisrørsla	environmental movement
umhvørvisskaddur	(sálfr.)maladjusted
umhvørvisskaði	environmental harmel.damage
umhvørvisskaðiligur	damaging to the environment
umhvørvisspiltur	(sálfr.)maladjusted
Umhvørvisstovan	The Environment Agency
umhvørvisstríðsfólk	environmentalist
umhvørvisstýring	environmental management
umhvørvistilvit	environmental consciousness, consciousness of the environment; ecoconsciousness
umhvørvistilvitandi	environmentally consciousel.aware; environment conscious, ecoconscious
umhvørvistreytaður	environmental (t.d. changes)
umhvørvistur	environmentalist
umhvørvistøkningur	environmental engineer
umhvørvisvanlukka	environmental disaster
umhvørvisvernd	environmental protection, protection of the environment
umhvørvisverndarfólk	environmentalist
umhvørvisvinaligur	environmentally friendly, environment friendly
umhyggin	careful, cautious;hann var umhyggin um tey fátækuhe took good care of the poor;teir skulu vera umhygnir um handilsvørurnarthey have been ordered to be careful with the merchandise
umhygni	carefulness, care, caution, attentiveness
umkast	1(fótb.)foul throw-in2(málfr.)metathesis;dømi um umkast er "høvla" til "hølva"an instance/example of metathesis is"høvla"becoming"hølva"
umkasting	(handarb.)sewing over the edge of a seam, oversewing
umkendur	(løgfr.)accused of sth, charged with sth
umkenning	(løgfr.)accusation, charge, imputation, allegation(t.d.allegations were made against him)
umkenningarsamur	(sj.)inclined to blame others;hon er so umkenningarsom
umkoma	(sj.)kill;umkoma e-mkill sby;umkomast1die, be killedorbe lost (by accident,espat sea)umkomast á sjónumbe lost at sea2(sj.,of a boat) overturn, capsize;teir umkomust við støðna, men allir bjargaðustthe boat capsized near the landing place but they were all saved
umkoyring	temporary detour due to road repairs(flt)
umkring	1(a)round, about;sita umkring eitt borðsit round a table2far and wide(t.d.travel far and wide); far around;ferðast umkringtravel widely;strúka umkringgad/knock about;eg gekk umkringI was walking about
umkringur	1(stb.) hygg, hvussu hatta gongur umkringurwhy is he//she gadding about in that way; síumkring2down, over;koyra umkringurthrow over, knock down
umlagari	(ravm.)converter
umland	(of a town) surrounding area, hinterland;har var einki umlandthere was no surrounding area; (um bý)umlandið er stórtserve a large area/hinterland
umlegging	re-laying; change, alteration, re-adjustment; rearrangement; reorganization; reorientation(t.d.a reorientation of our foreign trade)
umleið1	detour;eg gekk eina umleið fyri at sleppa fráI made a detour in order to avoid(t.d.doing sth)
umleið2	1about(t.d.about 2 o'clock; about a mile; about as high as...); (framman fyri tølumeis.)some(t.d.some 20 miles//persons//tons); in the neighbourhood of(t.d.a thousand tons); roughly(t.d.roughly half (of) the population are French-speaking)2(næstan, heldur minni enn) nearly(t.d.nearly succeeded); almost, approximately(t.d.approximately correct; approximately what I want); more or less(t.d.this is more or less what might be expected); síeis.næstan
umleiðis	síumvegis
umlendi	síumland
umlestur	(t.d. framman undan próvtøku)revision, re-reading
umleypandi	(veðurfr.)changeable, variable, unsettled;veðrið var umleypandichangeable/variable weather;hann er so umleypandi í veðrinumthe weather is changeable/variable/unsettled
umliðin	passed, elapsed, gone by;tá ið ein løta var umliðinwhen a moment had passed;tá ið árið var umliðiðwhen the year was out/had gone by/had passed
umljóð	(málfr.)mutation(t.d.i-mutation); umlaut;fáa umljóðbe mutated
umljóða	(málfr.)mutate;" e" í " menn" er eitt umljóðað sjálvljóðthe"e"in"menn"is a mutated vowel
umlopin	1passed over, omitted, left out;eitt navn er umlopið á kortinumone name has been omitted on the map2síumliðin;tá ið eitt ár var umlopiðwhen a year had passed
umlopsgerð	(nýggjy.) procrastination, displacement activity
umloysur	1fringe benefit, perquisite;Sperks(flt)2minorel.petty expenses;farmagjald og aðrar umloysurfreight charges and other expenses;alt fór í umloysurwhat money which was left was spent on paying petty expenses (hjá felagi ið fór á húsagang, of a firm which had gone bust)3extra work;hann hevur so nógvar umloysur at gerahe has much extra work4small areas in the infield where the hay harvest is difficult
umlætting	respite care
umlættingarbrunnur	(oljuv.)relief well
umlættingarheim	respite care home
ummast	(tlm.) ummast at tað vísir seg at...if it turns out that; síum2
ummál	(stfr.)perimeter, circumference;ummálið á rørinum var 16 sentimetrar og tvørmálið 5 sentimetrarthe perimeter of the pipe was 16 cm and its diameter was 5 cm
ummáls	ummáls/í ummálsperimenter, area, extent, size;trøðin var 600 metrar ummálsthe perimeter of the allotment was 600 metres;bygdin er vaksin skjótt í ummálsthe village has expanded fast;býlingurin er lítil í ummálsthe part of the town is small in size
ummynda	transform (into), turn (into), change
ummyndan	transformation, change
ummyndanarmálfrøði	(málfr.)transformational grammar
ummæla	(t.d.bók, framsýningo.tíl.)review
ummælari	(bøkur, fløgur, framsýningaro.tíl.)reviewer, critic
ummæli	1reference, testimonial;ummæli frá serkønumexpert opinion, according to expert opinion;fáa//senda eitt mál til ummælistake sby's opinion//submit the case to sby2review3(skúlam.)(terminal) report4reputation, standing, status, name;hon hevur ringt ummælishe has a bad reputation/a bad name;ymist hevur ummælið verið um hana í seinni tíðopinions of her have differed lately
ummælisbók	(skúlam.)mark book, (tíðum) report,(am.)grade book, report card
ummæliseintak	review copy
umnevndur	above-mentioned
umorða	rewrite
umráð	1(veðurfr.)change; umráðí veðrinum (ættini, vindinum)changeable/variable weather;tað er umráð í luftinithere is a change of/in the weather;(fl.m.)change;tað størsta umráð í lívi mínumthe most important change in my entire life;eitt umráð í býarmyndinithe look of the town has changed2planning; programming; (skipan) organizing3(sj.)consideration, reflection, deliberation, contemplation, thought
umráða	think over(t.d.I must think it over first), reflect on(t.d.give me time to reflect on the matter);fáa umrátt seghave time to reflect on(t.d.the matter);nevningarnir umráddu seg (løgfr.)the jurors were considering their verdict
umráðadagur	(veðurfr.)(dead) calm day (calm day between different wind directions)
umráðandi	important, significant, meaningful;tað er umráðandi at sleppa av við fiskin, meðan hann er feskurit is of vital importance to be able to sell the fish while it is still fresh
umráðatíð	time of fermentation, time of unrest and upheaval, time of crisis
umráðaveður	changeableel.variable weather, unsettled weather;frálíkt veður, men umráðaveðurfine weather but chageable weather
umráði	area, open space; síøki
umráðing	1consideration, reflection, deliberation, contemplation, thought2changeable, variableel.unsettled weather;tað er umráðing í veðrinumthe weather is changing3(løgfr.)[consideration of judgment by the judges]
umráðingartíð	time to think sth over, time to reflect on sth; break(t.d.I need a break), pause for thought; pause for thinking things over
umrenda	(stb.)síumrinda1
umrenning	(løgfr.)vagrancy
umrenningur	(løgfr.)vagrant
umrinda	1avoid, evade, escape;hann umrindar ikki at fara í skansanhe can't avoid going to jail2tað umrindaðist ikkiit never fails, it does not fail, it never fails; it is certain; it is beyond dispute
umringa	surround, encircle, envelop(t.d.an army); close in on(t.d.the enemy was closing in on us);umringa ein skansainvest/surround a fortress; síeis.kringseta
umripiligur	assertive, not diffident, noisy, furiously busy
umripingarsamur	síumripiligur
umrivin	(um saltfisk, of salt(ed) fish) síríva(um)
umríving	the act ofríva um (q.v.)
umrokning	recalculation
umrokningarkursur	rate of exchange, rate of conversion
umrokningartalva	conversion table; ready reckoner
umroynd	(skúlam.)reexamination;hann slapp at taka royndina umafturhe was allowed to resit his exam
umrøddur	mentioned; discussed(t.d.the most discussed film in London); talked-about;bók, ið er nógv umrødda much discussed book;nógv umrødd hendinga much publicised affair;B sum á sinni var nógv umrøddurB., who at one time caused so much comment (in the press)
umrøða1	discussion, debate, consideration, reading;taka e-t til nýggja umrøðutake up again, take up for renewed consideration;leggja seg út í umrøðunaenter into the discussion with
umrøða2	discuss, debate
umrøðuevni	debatingel.talking point, topicel.subject of discussion;umrøðuevnið var skaldskapurthe topic of the day was literature
umsagnarliður	(málfr.)predicative, predicate, subjective//objective complement
umsagnarsamsvar	(málfr.)verbal correspondenceel.identity
umseta	translate(t.d.sth from Latin into English),(t.d.siga á føroyskum) render(t.d.how would you render that word in French?);umsettar bøkurtranslated books
umsetari	translator
umseting	1translation, translating;leylig umsetingroughel.draft translation2(sjálvt verkið) translation, version; (orðrætt umseting av klassikarum nýtt av næmingum) crib
umsetingar-	sítýðingar-
umsetningur	1(tlm., handilsm.) turnover;í fjør var umsetningurin hjá virkinum DKK900.000last year the company had a turnover of £100,0002(tlm., handilsm.) sale;stígur er komin í søluna/umsetningin the sales are stagnating3(tlm.,í roknskapi) revenue;umsetningurin hjá virkinum hækkaði við 10% tað áriðthe revenue of the company increased with 10% that year4(tlm., handilsm.) business;umsetningurin verður frægari, lækka vit virksemið/virkseminaBusiness will be better if we downsize5(tlm., handilsm.) trade;umsetningurin var vánaligur í fjørtrade was bad last year
umseyma	(handarb.)alter, remake;umseymaður kjólian altered/remade dress; síeis.seyma(um)
umseyming	alteration, remaking, renovation(t.d.garments received for renovation)
umsita	1keep in repair, maintain;húsini vóru væl umsitinthe house was kept in perfect condition;synd var at siga, at jørðin var væl umsitinI would have been lying if I said that the land was kept in perfect condititon2administer, administrate;hesi embæti kunnu verða umsitin av føroyingumthese government posts can be administrated by Faroemen; síeis.fyrisita
umsitari	administrator
umsiting	1administration;fyritøkan varð sett undir umsitingthe firm was put under administration(el.was deprived of the control of its estateel.property);tekniska umsitingin (uml.)the Highways Department; síeis.fyrisiting2maintenance, keeping up, (um hús) upkeep(t.d.it costs a lot in upkeep)
umsitingarkostnaður	(costs of) maintenance; expensesel.costs of upkeep
umsitingarligur	concerning administration
umsitingarskylda	(løgfr.)duty of maintenance; duty to repair(t.d.a house);leigumál har leigarin hevur umsitingarskyldurepairing lease
umsitingartænasta	maintenance service
umsíðir	at (long) last, at length, eventually, finally
umsjón	supervision, superintendence, inspection;hava umsjón við e-mwatch over sth, look after sth, take care of sth, be in charge of sth;vera undir umsjón (av e-m)be under the supervision of sby, be supervised by sby, be watched by sby
umsjónar-	supervisory
umsjónarferð	1tour of inspection;tá gjørdi amtmaðurin eina umsjónarferð til Føroyathen the prefect did a tour of inspection to the Faroes2visitation(t.d.bishops hold periodical visitations)
umsjónarmaður	supervisor, superintendent
umsjónarráð	board of supervision, board of control, supervisory committee; umsjónarráðsparikassans
umskapa	change, alter, transform
umskapaður	transformed, changed;umskapað grótslag (jarðfr.)metamorphic mineral
umskapan	1change, alteration, transformation2(jarðfr.)metamorphism3(dýr.)metamorphosis
umskaping	síumskapan
umskarast	overlap;jarnpláturnar umskaraðust so lítið, at tað lak um tærthe overlapping of the iron plates was so slight that there was a leakage;umskaraðuroverlapping
umskaring	1overlapping2(jarðfr.)fault; (lítil) spring;San Andreas umskaringinthe San Andreas fault3(sálfr.)displacement
umskaringarfella	(oljuv.)fault trap
umskera	circumcise;øll nýfødd dreingjabørn verða umskorin hjá rætttrúnum jødumorthodox Jews circumcise all new-born boys
umskering	circumcision; (umskering av konufólki) female circumcision, clitoridectomy
umskiftan	síumskifti;ein knapplig umskiftana sudden change
umskiftari	(ravm.)change-over switch
umskifti	1change(t.d.change from day to night, change from fear to hope, the change from wartime to peacetime production), alteration, transition, change-over(t.d.the change-over to a national hospital service); umskiftifrá ísfiskaveiðu til saltfiskaveiðua change (changing) from ice fishing to salt(ed) fishing2vicissitude, ups and downs(t.d.the ups and downs of life)
umskiftiligur	changeable
umskifting	síumskifti
umskiftisáseting	(løgfr., serst. viðv. skeyti)deed of conveyance; (um partabræv) share
umskiftisrevsing	(løgfr.; bót, sum kemur í staðin fyri hefti)alternative sentence (t.d. `he got £100 or
umskiftur	1exchanged, which is got in exchange (for sth)2changed, completely altered;maður hennara var, sum var hann umskifturher husband was completely changed;nú var alt umskifteverything had changed, nothing was the same
umskipa	1change, remodel(t.d.the whole system of education); reshape(t.d.the system), reorganize(t.d.the Government); transform(t.d.an institution into a school), reconstruct;nógv er umskipaðmuch has changed/is different;hann vildi umskipa alt og hava tað øðrvísihe wanted to alter everything2(sigl.)transship3(jarðfr.) transform
umskipan	1change, alteration2(sigl.)transhipment3(herm.)regrouping, rearrangement, redeployment4(jarðfr.) transformation
umskiping	síumskipan
umskipla	do differently, change, alter;viðurskiftini kunnu vit ikki umskipla nógvwe cannot change the condition under which we live;sum alt var umskiplað!how everything had changed
umskipling	change, alteration;samfelagsligar umskiplingarsocial changes
umskorin	circumcised
umskotin	(stb.)íosb. við umskotnum eygumwith upturned eyes
umskriva	1(skriva av nýggjum) rewrite, (skriva øðrvísi) paraphrase;(ljóðfr.)transcribe; (úr øðrum stavraði) transcribe, transliterate; umskrivaalla søgunarewrite the entire story;umskriva skaldsøgu til sjónleikmake a novel into a play2(stfr.) umskrivaður sirkulcircumcircle
umskriviligur	(stfr.)circumscribable
umskriving	rewriting
umskurður	circumcision; síumskering
umskúla	re-educate; retrain; (óarbeiðsfør fólk) rehabilitate
umslag	1cover; (til plátu) sleeve; (leyst bókarumslag) (dust) jacket, wrapper, dust cover2(lækn.)pack(t.d.a cold pack); compress; fomentation;heitt umslagpoultice
umsorg	síumsorgan
umsorgan	care;hava umsorgan fyri (e-m)take care of sth, look after sth, see/attend to sth;umsorgan fyri barnakonumpregnancy care (eis.barnakonuumsorgan);stóra umsorgan hevur hon havt fyri okkum og børnum okkarashe has taken great care of us and our children;stóra umsorgan vístu tey honumtheir solicitude for him was fantastic
umsorganararbeiði	work with (mentally) handicapped persons; (tíðum) welfare work
umsorganartørvur	need of care
umsorgarfullur	careful, painstaking, full of thought(t.d.the nurse was full of thought for her patients)
umsoymdur	(bát.)re-nailed;báturin er umsoymdurthe boat has been re-nailed; sísoyma
umsókn	1application, petition2(brævið) application, petition;senda umsókn inn um okkurtsend in/file an application;handskrivað umsóknhand-written application
umsóknarblað	application form
umsóknarbræv	application
umsóknarfreist	deadline for application
umsóknarmaður	(sj.)applicant, petitioner (for)
umstakking	re-stacking (salted fish)
umstempla	re-stamp
umstilling	1transfer,putting through, switching through, (staðið) exchange2switchboard
umstýring	(bát., tøkn.)reverse gear, reversal, reversing
umstøður	circumstances(flt),conditions(flt); í góðum//ringum umstøðumin good//poor circumstances//conditions;umstøðurnar at íðka ítrótt eru góðarconditions for sporting activities are good;kanna umstøðurnarexamine the conditions;linnandi umstøður (løgfr.)extenuating/mitigating circumstances;tú verður noyddur at laga teg eftir umstøðunumwhen at Rome (you must) do as the Romans do;herðandi/skerpandi umstøður (løgfr.)aggravating circumstances
umsvermaður	(tlm.)fêted, surrounded by a crowd of admirers, much courted
umsøgn	(málfr.)predicative, predicate, subjective//objective complement
umsøkjari	applicant, petitioner, (til starveis.)candidate;tveir umsøkjarar vóru til starviðthere were two candidates for the position
umtak	síhugtak
umtal	síumtala;vera til umtalsbe discussed
umtala1	mention, comment, reference, discussion;filmurin fekk góða umtaluthe film was favourably mentioned
umtala2	speak about, mention; umtalae-n við virðingmention sby with veneration
umtalaður	síumrøddur
umtalsevni	subjectortopic of discussion, debatingel.talking point;umtalsevnið á fundinum var avvápnaðurthe topic of the meeting was disarmament
umtonktur	resourceful, quick-witted
umtosa	(gl.) oddamenninir skulu umtosast rósandithe top people are to be spoken of in high terms; síumrøða2,umtala2
umtóktur	popular;væl//illa umtókturpopular//unpopular;hon var nógv umtóktshe was very popular
umvaksin	made larger, enlarged, magnified; sívaksa
umval	second ballot, deciding ballot
umvarðandi	urgent, important;tey mest umvarðandi amboðinithe most important tools;tað er sera umvarðandiit is urgent
umvarp	landslide (which has markedly altered the area);har er eitt slíkt umvarp komiða landslide has markedly changed the area
umvav	(lækn.)bandage, compress, wrapping
umvavdur	bandaged, woundel.wrapped up, tied up;við umvavdum høvdiwith bandaged head; sívevja
umvegis	indirectly, by a roundabout route;bæði beinleiðis og umvegisboth directly and indirectly;tey fingu tað at vita umvegisthey learnt it indirectly;umvegis prógv (løgfr.)(piece of) circumstantial evidence
umvegur	detour;ganga umvegmake a detour
umveldi	(stjm.)territory; dependency
umveldismark	(løgfr.) territorial boundary
umvenda	convert; umvendaheidningar til kristindóminconvert heathens to Christianity;umvenda seg/umvendastbe converted, convert(tilto);hann er vorðin umvendurhe has been converted, he is a born-again Christian
umvending	conversion; umvendingheidninga til kristindóminthe conversion of heathens to Christianity
umvendingararbeiði	missionary work, proselytizing (work)
umvendingardópur	(bíbl.)baptism of repentance;Jóhannes doyparin prædikaði umvendingardóp til fyrigevingar syndannaSt John the Baptist preached baptism of repentance for the remission/forgiveness of sins
umvera	(tlm.)do without(t.d.can you do without tobacco for a week?); dispense with(t.d.dispense with sby's services); go without(t.d.when I am busy I go without my lunch); spare(t.d.a public servant of a kind that can ill be spared); ([ikki] hava tøkar) spare(t.d.we could not spare any troops for this campaign);eg kann ikki umvera hana//taðI cannot do without her//it
umverð	(sj.)síumheimur
umvirdur	1expensive, precious;umvirdar vørurexpensive commodities2greatly prized, cherished, highly esteemed, much appreciated;umvirdur starvsbróðira valued colleague
umvæla	repair(t.d.clothes; a house; road; roof; car; ship; watch; hole), mend(t.d.a garment//puncture//hole), fix up(t.d.an engine), (skógvar) repair, mend, cobble,(sigl., eis.)refit; umvælabátarrepair boats
umvælari	repairer(t.d.bicycle repairer), mender, repairman, service mechanic
umvæling	1(fáa í rættlag) repair, repairs(t.d.road repairs; repairs to the roof; the ship has docked for repairs)2(stórar umvælingar) reconditioning, overhaul; (um skipeis.)refit, refitment3renovation (t.d.this property is in need of complete renovation; older churches underwent major renovations)4(um smáar umvælingar,t.d.av plaggi, súkkluslangu) mending5(lapping) mending, patching6(at stoppa) mending, darning7(av listaverki) restoration8(hol ið er umvælt) repaired place, mend; (lappi) patch; (stopping) darn(ing);umfatandi umvælingthorough repair(s), (thorough) overhaul, reconditioning;leigarin ger sjálvur tær umvælingar, ið krevjastall repairs to be performed by the tenant;gera umvælingardo repair work, make/undertake/carry out repairs;(sigl., eis.)refit, be refitting9[ísamb.viðfn]umvælingavthe repair of;bilinum tørvar umvælingthe car is in need of repair;veratilumvælingarbe under repair, be undergoing repairs
umvælingarkostnaður	cost of repair(s)
umvøling	(sj.)síumvæling
umyrking	rewriting, recasting;hetta er meira ein umyrking enn umsetingit is more like a rewriting than a mere translation
undan	1skipini sigla heim undan Íslandithe fishing ships sail home from the fishing grounds off Iceland;hann kreyp fram undan borðinumhe crept out from (a position) under the table;undan fótunum á e-mfrom under someone's feet;sópa undan neytummuck out the manure channel2from under sth;turka burtur undan skónumclean the underside of a shoe;fáa mjólk undan kúnniobtain milk from the cow3be descended from, descend from4appear, come into sight, emerge;báturin kom undan nesinumthe boat came into sight round the headland;koma undan sýniniappear on the ridge of a hill;koma undan kaviemerge(t.d. from the sea)5along with, in the same direction asorparallel to;undan vindinumwith the wind;venda bátinum undan veðrinumrun the boat with the wind;ganga undan veðrinumhave the wind behind one, have the wind in one's back;undan ljósinumaway from the light;undan sóliniaway from the sun6downwards; undanbrekku(ni)down the hill7(of time, before something happens) before; undanjólumbefore Christmas;ár undan áriyear after year;hann var undan mærhe was before me;hvør undan øðrumone after another8appear above the surface of the water;skerið er undan á fjøruthe skerry is emerged at low tide;høvdið var undanthe head was above the surface9[sumhj] (in the same direction);vindurin er undanhaving down wind/following wind/having tail wind;vit høvdu/fingu undan allan veginwe had down wind all the way10[fs/hjsaman viðs] t.d.arbeiða undan; bera seg/berast undan; bregða sær undan; draga undan; fara undan (e-m); flýggja undan (e-m); ganga undan (e-m); hava (seg) undan; hóra undan; koma undan; leggja undan; renna undan (e-m); skáka sær undan; springa undan; sleppa undan; taka undan(sísagnorðinisumleitorð)
undanbering	excuse; evasion, evasive answer, prevarication, equivocation;eg taki ikki við undanberingum longurI do not accept evasive answers any longer
undanbersla	síundanbering;viðganga synd sína uttan undanberslu og viðburðirconfess one's sin without offering an excuse
undanbrekka	downhill walk;tá ið komið var á skarðið, var alt undanbrekkaafter having reached the pass the rest of the way was downhill
undanburður	1(sigl.,yrkisheiti) wake2(um før, of ships) leeway, lee drift, driftage3(sigl.)variation;hvussu stórur er undanburðurin?what is the variation?4(stb.)dissuade sby from doing sth;kona mín hevði undanburð í fyrstunimy wife was doubtful to begin with
undanbært	1íosb. tað er undanbærtwith the wind coming from astern, with a following wind2(um hart rák, of strong current)tað er undanbærtwind and current move in the same direction3downhill;gott er at ganga har, ið undanbært erto walk downhill is easy4(um stað, of locality) sheltered from the wind;hetta stykkið er undanbærtthis plot of land is sheltered from the wind
undandrag	1lead, head start, goingel.being in front, leading the way, taking the lead;Brandur og Sjóvarmoyggin kappaðust, men tó hevði Brandur altíð gott undandragthe Brandur and the Sjóvarmoyggin were competing, but Brandur always took the lead;lat nú hin gamla fáa undandragiðallow the old man to have a head start2the bestormost resourceful man;hann er undandragið í slagnumhe is most outstanding person of his family3(ítr.,golf) handicap
undandráttarmál	embezzlementel.defalcation case; (við almennum pengum) malversation case
undandráttartrygging	(trygg.)embezzlement insurance; eis.fíggjarundandráttartrygging
undandráttur	1(sj.)refusal, excusing oneself (from), declining (to do sth)2quiet interval, lull (before the wind blows from a new direction)3(løgfr.)embezzlement (t.d.charges of fraud andembezzlement)
undandystur	(t.d.í fótb.)initial match,qualifying match
undandøttur	1omen, auspice, sign, indication, presage, portent, warning2[stonesetcwhich fall down before a landslide]
undanfarin	1previous, preceding, past; undanfarinárprevious years;í undanfarnum árumduring the past years2gone ahead, left before; sífara(undan)
undanfírin	resigned, inclined to give up, despairing, of despair(t.d.with a gesture of despair); compliant, accommondating, amendable, yielding
undanfírur	(sj.)spineless person
undanforrita	(teld.)program in advance
undanførin	síundanfírin
undanførligur	síundanfírin;hon var hvørvin og undanførligshe was shy and resigned;tað er einki smoykið við honum longur, einki undanførligthe's neither sheepish nor resigned any longer
undanførsla	1excuse; evasion, evasive answer, prevarication, equivocation;øll eru full av umberingum ella undanførslumthey were either all apologies or making up excuses;koma við undanførslummake up/manufacture an excuse;tað eru tær beru undanførslurit is nothing but a poor/lame excuse;hava sum undanførsluexcuse oneself on the score/plea that(t.d.one is busy); plead that(GG:on the score of illness; on the plea of being too busy)2(gl.)purification of one's sins; demonstration of one's innocence, attempt at proving one's innocence3(gl.)giving wayoryielding to difficulties
undangangsmaður	(stb., bjarg.)síundangongumaður2
undangingin	out of stock, no longer in stock; run out of sth(t.d.I have run out of petrol)(GG:I am out of whisky);næstan undanginginshort of(t.d.I am short of tobacco); síganga(undan)
undangjald	payment in advance, prepayment;aftur fyri undangjaldon payment in advance, on prepayment
undangjørdur	over, through, finished, having got sth off one's hands;váringin var undangjørdthe agricultural spring task was over
undangonga	sailing before the wind, wind that blows from astern;hava beina undangongurun dead before the wind, (um sjógv) following sea;sigla í undangongu (eis.)run with the wind, scud;báturin er góður í undangonguthe boat runs well well before the wind;hann hevði onga undangongu í lívinum (fl.m.)his life was full of adversity; his life was not a bed of roses
undangongubyrur	fair wind
undangongufólk	pioneer
undangonguland	pioneerel.leading country; undangongulandí fiskiídnaðia leading country when it comes to fish(ing) industry
undangongumaður	1pioneer, advocate, champion(t.d.a champion of the cause of civil rights); protagonist (for, of); spokesman2(bjarg.)foreman for a party of bird catchers (on a bird cliff)
undangonguvindur	fair wind
undangoymdur	covert, hidden, concealed;við undangoymdum smíliwith a covert smile
undangruni	have a feeling, an ideael.a hunch that(t.d.I have a feeling that there is sth wrong; I have an idea that we must have met before), instinctive feeling;hava ein undangruna um okkurthave a hunch,(eis.)feel it in one's bones that;hann fekk rætt í undangruna sínumhis gut reaction proved to be right
undanhald	withdrawal, rearward movement, retreat
undankanning	preliminary survey
undankapping	(ítr.)qualifying tournament;dystur í undankappingini til heimsmeistaraskap í fótbóltiqualifying match for the World Cup
undankoma	(sj.)rescue, saving; síkoma(undan)
undankomin	1sprouted up, come up;bløðkurnar eru undankomnarthe first tiny leaves of the potato plants have come up2has risen;enn er sólin ikki undankominthe sun has not risen yet3grown up and independent;børnini vóru undankominthe children were grown up; síkoma(st) (undan)
undanlagstur	> árin var undanløgst the oar had become warped; síleggjast(undan)
undanlát	(løgfr.)omission, failure(t.d.his failure to keep his promise); síóvirkni
undanlátsbrotsverk	(løgfr.)[offence consisting in an omission]
undanlátsdómur	(løgfr.)(prohibitory) injunction
undanleggiligur	síundanleggin
undanleggin	1(sj.)dispirited, dejected, downhearted, dismayed2weak, feeble, yielding(t.d.disposition); nerveless, spineless
undanmaður	predecessor; undanmaðurhansara í stjórasessinumhis predecessor as managing director
undanmeting	1preliminary assessment2(trygg.)survey
undannevndur	above-mentioned, mentioned above, above
undanrennari	(ítr.)pacer
undanrenning	1running away (from sby)2(ítr.)pacing
undanromantikari	pre-Romanticist
undanromantiskur	pre-Romantic
undanromatikk el.undanromantikkur	pre-Romanticism
undanroynd	pretest; (próvtøka;gl.)preliminary examination;(evnafr.)preliminary test
undanrýming	flight, running away from sby//sth, fleeing from sby//sth
undansetningur	(málfr.)antecedent
undanskipa	(ítr.)seed
undanskipaður	(ítr.)seeded;skipaður millum teir fremstutop seeded
undanskiping	(ítr.)seeding
undanskurður	1[thin piece of meat included when an oblong piece of blubber is cut from the whale]2serial (story);søgan stendur sum undanskurður í Dimmalættingthe story is serialized in the Dimmalætting (a newspaper)
undanslag	(tónl.)grace note; (langt) appoggiatura; (stutt) acciaccatura
undansleipin	1slippery and steep;tey stúrdu fyri skalvalopi, tí har var so undansleipiðthey were apprehensive of snowslides as the terrain was slippery and steep2having parallel wind and current, having wind and current moving in the same direction
undansloppin	1the worst is over;tá ið seglið var komið á, var undansloppiðthe worst was over when the sail had been set;tey(t.e.foreldrini,the parents)eru undansloppintheir children are grown up2escaped(t.d.prisoner), runaway(t.d.slave);hin undanslopni revurinthe escaped fox; sísleppa(undan)
undanstaddur	(lækn.) undanstaddur fitilókurplacenta praevia
undanstandandi	(í teksti) preceding, above-mentioned, above(t.d.the above facts)
undanstarvsnæmingur	[preliminary apprenticeel.trainee]
undanstarvsvenjing	preliminary training
undanstreymur	(sigl.)wake
undanstøkkingur	1stunted animal(esplamb)2turncoat, weathercock, trimmer3the black sheep of the family
undansúkklari	(ítr.)pacer
undansýning	preview; (um filmeis.)pre-release
undantak	exception;vera undantakbe/constitute an exception;undantak frá málfrøðiregluan exception to a grammatical rule;undantakið prógvar reglunathe exception proves the rule
undantaksatgerð	exceptionalel.emergency measure
undantaksføri	exceptional case(t.d.in exceptional cases); special case;bara í undantaksførisave in exceptional circumstances;bara í undantaksføri kann hetta verða gjørtit can only be done in exceptional circumstances
undantaksgrein	exemption clause, escape clause
undantaksloyvi	dispensation
undantaksmaður	outstanding, exceptionalel.brilliant man
undantaksregla	exemption clause, escape clause
undantaksstandur	síundantaksstøða
undantaksstøða	state of emergency(t.d.declare a state of emergency); state of exception;lýsa hernaðarliga undantaksstøðudeclare martial law;forsetin setti landið í undantaksstøðuthe president declared a state of emergency
undantikin	not counting, exclusive of, except, leave out of consideration;vinningurin er undantikin inntøkuskattithe prize is not subject to tax
undantilvera	pre-existence
undantøka	(gl.)síundantak
undanval	(stjm.)primary, primary election (í USA)
undanveð	(løgfr.)prior security
undanveltur	completely cultivatedortilled;nú er undanvelt hjá honum
undanvera	pre-existence
undanvindur	down wind, following wind, tail wind,(sigl.)fair wind
undarligur	1strange, unusual, peculiar, odd, curious, odd, queer, quaint, singular;Ábal varð hildin at vera undarligurpeople thought that Ábal was an odd character;hetta tókti teimum undarligt;tað er ikki undarligt íthat isn't strange, there is nothing extraordinary about that2[sumhj]undarliga;verða undarliga viðbe embarrassed, be/feel awkward
undir-	(eis. jarðfr.) sub-
undir	1under(neath), below;kettan fór undir borðiðthe cat moved under the table;kettan liggur undir borðinumthe cat is lying under the table;er nógv undir?(of a potato field) does it come up?;nógv er undirthere is much fish under the keel2on the underside of;hava ilt undir ilinifeel pain on the sole of one's foot;hava runu undir skónumhave shoes clogged with dirt;báturin hevur jarn undir kjølinumthe boat's keel is ironclad3under (water), in (water);hann koyrdi høvdið undirhe put his head under the water;hann fór undir allur sum hann varhe went under the surface of the sea4at the footorbottom of sth;teir sigldu inn undir landthey sailed close to the shore;teir lógu undir landithey were lying close to land;slíta upp undir landsucceed in reaching the landing place;undir Íslandioff Iceland;undir heygnumat the foot of the hill;undir fjallinumat the foot of the mountain;(uppi) undir húsunumjust below the house5close to (sth);sita undir liðini á e-msit beside someone6aftur undirbehind, concealedorhidden;hann fór aftur undir ein steinhe went behind a boulder;hann sat aftur undir heygnumhe sat behind the hill7protected by or hidden behind; undirfølskum navniunder a false/an assumed name8(um tignarstøðu, um virði: minni enn, of rank; of value: less than); undireina milliónless than a million; under(t.d.a colonel is under a general in rank; nobody under a captain/nobody under the rank of captain was admitted); below(t.d.below me in station)9belong under, be a matter for;málið lá undir løgmálaráðnumthe case was a matter for the Ministry of Justice;hon hevur 30 fólk undir særshe has 30 persons under her;undir norsku krúnuniunder the Norwegian Crown;leggja undir segsubjugate, subdue, conquer;standa undir e-mbe dependent on someone; rank under sby10(um tíð, of time)fram undirtowards, just before;fram undir jóltowards Christmas11during; undirkrígnumduring the war12[sumhj]kópurin er undirthe seal has submerged;mánin er farin undirthe moon is down;bøurin stendur undir í vatnithe field is flooded13[fs//hjsaman viðs] t.d. búgva undir; díkja undir; ganga undir; geva seg undir; koma undir; liggja undir; rísa undir; røra undir; sita undir; skumpa undir; spæla undir; taka undir(sísagnorðinisumleitorð)
undirbit	underhungel.undershot jawel.bite(t.d.he has an undershot jaw)
undirbjóðing	(handilsm.)undercutting, underselling
undirborin	overtaxed, burdened with;lærarar úti á bygdunum vóru ofta undirbornir við almenn álitisstørvvillage teachers were often burdened with various honorary offices
undirbólkur	1subgroup2(handilsm.)secondary group
undirbrotligheit	1(eyðmýkt) humility, humbleness2(sleiskni) servility, cringing, obsequiousness
undirbrotligur	1(eyðmjúkur) humble2(sleiskur) servile, cringing, obsequious;so undirbrotligir vóru føroyingar, at amtmaðurin kundi gera tað, honum lysti at the timeFaroemen were so servile that the Danish Prefect could do whatever he wished;(sj.) vera undirbrotligur e-m (eis.)grovel/cringe before sby
undirbrotni	(sj.)síundirbrotligheit
undirbrøkur	síundirbuksur
undirbuksur	pants, underpants; (til konufólk) knickers; (stuttar) panties; (trussur) briefs; (stuttar, til menn) trunks, briefs;(am.)shorts, undershorts; (langar) long underpants;Slong johns, John Sullivans;føroyskar undirbuksurlong woollen underpants
undirbyrjaður	loaded, filled, stuffed;ovnurin stóð undirbyrjaður av øsku og tómum pappírskistlum
undirdeild	1subdivision2(í flokkingarskipan, in a system of classification) subdivision, subsection, subclass, subgroup3(handilsm., viðv.virkio.tíl.)sub-branch4(løgfr.;í lógargrein) subsection5(dý.ogplfr.)subclass, subtype
undirdekk	(sigl.)lower deck
undirdíktur	be pelted with; be heapedorshowered with; be besieged(t.d.the teacher was besieged with questions); (um arbeiði) overloaded, overburdened, overwhelmed with work, up to the eyes in work; sprayed, sprinkled; undirdíkturí ókvæmisorðumbe pelted with insults; síeis.díkja(undir)
undirdjúp	(bíbl.)bottomless pit
undirdongdur	síundirdíktur; síeis.deingja(undir)
undirdýna	featherbed
undirdýpi	(bíbl.)bottomless pit
undirentreprenørur	subcontractor; síundirveitari,undirverktakari
undirentreprisa	(handilsm.)subcontract
undirfalshjól	undershot (water) wheel
undirfarin	passed out of sightorview; sífara(undir)
undirfígging	(handilsm.)underfunding
undirflái	[slightly shelving sea bottom near land];millum flesina og ein undirfláa við landiðbetween the skerry and the shelving sea bottom near land
undirfløddur	flooded during high tide;sandurin er undirfløddurthe sand is flooded; sífløða
undirforrit	(teld.)subprogram, subroutine;opið undirforritopen subroutine
undirfólk	1servants, subordinates, underlings; subjects2(sigl.)sailors, seamen, crew, hands
undirføddur	(lækn., sj.)undernourished
undirgangsdámur	senseel.atmosphere of doom; apocalyptic atmosphere
undirgangur	ruin(t.d.such a course will mean certain ruin); destruction, death(t.d.the death of civilization); fall(t.d.the fall of the Roman Empire)
undirger	(evnafr.)bottom yeast
undirgeraður	(evnafr.) undirgerað ølbottom fermentation beer
undirgeving	submission;hennara stórlátna sinni bardist móti undirgevingher self-respect tried to prevent submission
undirgingin	1passed out of sightorview;nú eru húsini undirginginthe houses have now disappeared(t.d.behind a hill)2overgrown, overrunel.rank with(t.d. weeds)3(gl.)gone underordown, sunk; perished, destroyed, lost
undirgivin	submissive, subservient, obedient;kvinnan eigur at vera manninum undirgivin
undirgivni	submissiveness; subservience; (eyðmýkt) humility, humbleness; (sleiskni) servility, cringing, obsequiousness;í allari undirgivniYour Majesty's most humble and loyal subject
undirgjørdur	equipped, fitted out, supplied, provided;væl//illa undirgjørdurwell//badly equipped;handilin var illa undirgjørdurthe shop was in short supply
undirglasing	underglaze
undirgonga	síundirgangur
undirgongd	síundirgangur
undirgrein	1footnote2síundirbólkurogundirdeild
undirgrind	(húsasm.)footing [the lowest layer of beams, joined under the floor of a building]
undirgrivin	buried, dug in; undirgriviní arbeiðiburied in work;smb.sígrava
undirgrógvin	síavvaksin
undirgrund	1underground;olja verður vunnin úr undirgrundinioil is being extracted from the underground2foundation(s), basis;undirgrundin undir skaldskapi hansarathe foundation under his writing;undirgrundin undir einum lærdum skúlathe foundation on which a university builds
undirgrundarbókmentir	underground literature
undirgrundarbreyt	underground (railway);Stube(t.d.I came by tube);(am.)subway
undirgrundarlóg	Subsoil Act
undirgrundarmentan	underground culture
undirgrundarrørsla	underground (movement), resistance (movement);undirgrundarrørslan (eis.)the Resistance
undirgrýttur	síundirdíktur; síeis.grýta2
undirgudur	inferior divinity
undirhagi	[low-lying part of the outfield also used as winter pasture];um summarið liggur seyðurin ovarlaga á haganum, men undan illveðri leitar hann sær oman á undirhaganin the summer the pasture is high up in the mountains, but before a storm breaks the sheep seek shelter in the low-lying part of the outfield;í kavaroki koma harurnar niður á undirhaganhares seek shelter in the low-lying part of the outfield when snowstorms are raging; síeis.ervahagi,yvirhagi
undirhald	(tlm.)entertainment
undirhalda	(tlm.)entertain(t.d.a conjurer entertained the company); amuse, divert;hann undirhelt gestunumhe entertained the guests
undirhaldsbókmentir	síundirhaldslesnaður
undirhaldsfilmur	entertainment film
undirhaldsídnaðurin	the entertainment business
undirhaldslesnaður	light reading, light literature
undirhaldsorkestur	light orchestra
undirhaldsrithøvundur	writer of light literature
undirhaldsskaldsøga	light novel, entertainment
undirhaldstáttur	(útv.)light programme
undirhaldstónleikur	light music
undirhár	(á fólki, on people) the short hairs on the lower neck
undirheimur	underworld, lower world, nether world, kingdomel.land of the dead; infernal regions(flt)
undirhella	1[lower part of a flat rocky beach];ein flá undirhellaa flat rocky beach2[flat rocks at the foot of bird cliffs]
undirhelling	(jarðfr.)[the sea floor between the continental slope and the deep sea bottom]
undirhiti	bottom heat
undirhópur	(plfr., dý.)suborder
undirhugtak	(málfr.)minor term
undirhúð	(likam.)subcutis
undirhúðar-	(likam.)subcutaneous, hypodermic
undirhús	1(stjm.)Lower House; (undirhúsið í Onglandi) the House of Commons, the Commons(flt)2(ným.)hang-out (haunt where elderly men spend time in Tórshavn)
undirhøka	double chin
undirjarðiskur	underground(t.d.dwelling; fire; gallery; surface and underground surveys); subterranean
undirkantur	lower edge
undirkast	snack between meals
undirkavaður	completely covered inorwith snow, snow-covered, snowed under, snowed up(t.d.road), snowed over; snowbound;seyðurin var undirkavaðurthe sheep were snowed over
undirkjaftur	(á dýrum, of animals) lower jaw;(fakl.)mandible;við undirkjafti sum stendur framúr (fakl.)prognathous
undirkjóli	slip, petticoat
undirklakaður	covered with ice and snow;í myrkrinum komu teir aftur, undirklakaðir av kavaafter nightfall they returned covered with snow
undirkleksaður	loaded down, overburdened;hann kom so undirkleksaður av Tvøroyri við einum kaggahe returned from (the town of) Tvøroyri loaded down by a keg of schnapps
undirklektur	síundirkleksaður
undirklokka	(gl.)woollen petticoat
undirklæði	underclothes, underwear
undirkongur	(bíbl.)vassal king
undirkoyggja	(sigl.)lower bunk, lower berth
undirkoyring	1(jarnb.)subway;(am.)underpass2(um veg) underpass
undirkæti	quiet amusement
undirkøla	(alisfr.)supercool, undercool; undirkølaløgsupercool a liquid
undirkøling	supercooling
undirlag	1dish mat, doily;hon legði eitt undirlag á borðið at seta grýtuna áshe placed a dish mat under the pot2(fl.m.)basis, grounding, foundation;ritið er gjørt sum undirlag fyri nakrar røðurthe paper was written to constitute a basis for some speeches3(stuðul, støði) support, base, foundation, bed(t.d.a bed of masonryel.of gravel), substructure;(sigl.,til lossingar) dunnage; (sum maskina stendur á) bedplate;(prent.,til plátur, klisjeiro.tíl.)riser, mount;(tøkn.,virki) abutment4(bleytt undirlag at forða fyri trýstio.tíl.)pad, mat; (undir gólvteppi) underlay, underfelt; (skriviundirlag) blotting pad5(lag sum liggur niðari) substratum(fltsubstrata), underlying layer;(jarðfr.)substratum(t.d.a substratum of rock);(landb.)subsoil; (av máling) undercoating
undirlagdur	1undirløgd mjólkmilk with rennet;undirlagda mjólk kallaðu tey dralvamilk in which rennet had been mixed was calleddralvi2(horse) which has been harnessed for the first time;rossið er ikki undirlagt ennthe horse has not yet been harnessed3covered (um veitir, of ditches);nú er alt undirlagtall the ditches have been covered
undirlast	(sigl.)lower hold
undirleður	underleather
undirleikari	(tónl.)accompanist
undirleikur	(tónl.)accompaniment
undirlen	(sø.)arriere fief, subfief
undirlendi	1[foreshore below steep or precipitous bird cliffs]2lowland(s) at the foot of mountains;fyrr var undirlendið í Kirkjubø rættiliga stórtformerly the village of Kirkjubøur had a fairly large lowland3[the spot on which hayorpeat is spread out for drying];tað er so vátt undirlendithe ground on which to spray the hay//the peat is rather wet
undirliður	(málfr.)adjunct, secondary
undirlippa	lower lip, underlip; (hjá skordýrum) labium;undirlippan læt á henniher lower lip was quivering
undirlív	1(likam.)abdomen;hon er sjúk í undirlívínumshe has some feminine trouble2(gl.)camisole, bodice
undirlívssjúka	(lækn.)abdominal disease, abdominal disorder
undirljóðs-	(flogm.)subsonic(t.d.airliner)
undirljós	(á flakavirki, in a filetting station) light from below the table top;skeriborðini skulu hava undirljósthe filleting tables have to be equipped with lights from below the table top; sískeriborð
undirlutakensla	inferiority complex, feeling of inferiority
undirluti	1inferiority, being inferior to sby, being sby's inferior;vera við undirlutansuffer a defeat, lose (the game, the matcho.tíl.)2lower part, under part, bottom (part)
undirlutur	(gl.) teir vóru við undirlutinthey lost; síundirluti1
undirlyftustong	(tøkn.)tappet
undirlýður	(stb.)weak-willed person, compliant person
undirlýsa	(lmynd.)underexpose
undirlýsi	1good visibility at sea (so that the coastline can be seen), although the fog is thick elsewhere2(lmynd.)underexposure
undirlýsing	(lmynd.)underexposure
undirløga	1rennet2(niðr.)insignificant person, a nonentity
undirløgugras	(plfr.)butterwort(Pinguicula); vanligt undirløgugrascommon butterwort(P. vulgaris)©iStock
undirløgukjaftur	(stb.)síbiðiskinskjaftur
undirløguskinn	(stb.)síkveikamagi
undirmaður	1subordinate,(niðr.)underling, inferior, junior;góðseigarin kundi gera við sínar undirmenn, hvat honum líkaðithe squire could treat his subordinates as he chose2loser
undirmannaður	undermanned, understaffed, short-staffed, shorthanded
undirmáls-	undersized
undirmálsfiskur	undersized fish
undirmálslaksur	undersized salmon
undirmeldur	eddying undercurrent
undirmenniskja	person of inferior race
undirmeta	underestimate(t.d.sby's abilities; a distance; the cost of sth); undervalue, underrate(t.d.do not underrate the danger; underrate an opponent); misprize(t.d.it would not do to misprize their work); minimize(t.d.he did not minimize the difficulties);hann undirmetir ikki seg sjálvanhe thinks a lot of himself
undirmeting	1underestimation, undervaluation, underrating, misprision, minimization; (meira ítøkiligt) underestimate(t.d.£500 would be an underestimate)2contempt, disdain, scorn
undirmígur	1bed-wetter2(in stone wall) [slanting, wrongly placed stone which results in water running into the house along its underside]
undirmógvur	the bottom layer of peat soil
undirmuður	síundirmunnur
undirmunnur	1lower part of the mouth;tenninar í undirmunninumthe teeth in the lower part of the mouth2(forlornar tenn) lower denture
undirnavn	(sj.)síundirtittul
undirnet	(sigl., á troli)underbell
undirnev	(dýr.)underbeak,(fakl.)under mandible
undirnevnd	sub-commission
undirniðan	down below
undirniðri	under the boat;nú er fiskur undirniðrifish are now under the boat
undiroka	(bíbl.)cow, subdue, oppress
undiroystur	síundirdíktur;oysa2
undirpartur	lowerel.bottom part, underpart
undirpissur	síundirmígur1
undirprísur	cut, reduced, dumping, knockdownel.bargain price;søla til undirpríssale at cut prices; undercutting; underselling;selja vørur til undirpríssell goods at a loss; undercut; dump; undersell; sell at cut prices
undirrita	(t.d. bræv)sign, putel.affix one's signature to, put, set, subscribeel.sign one's name to; set one's hand to; (samundirrita) countersign
undirritaður	the undersigned;undirritaði/a váttar við hesum at allar upplýsingar eru rættarthe undersigned hereby certifies that all information is correct; (ofta) I, We, the undersigned (t.d.I, the undersigned, hereby certify that all information is correct; (gerandismál) yours truly;hann skrivaði bókina og undirritaði myndprýddi hanathe book was written by him and illustrated by yours truly
undirrokin	buried in(t.d.sandetc);sírúka
undirrómi	thin cream on skimmed milk
undirrættardómari	(løgfr.)[judge of an inferior court]
undirrættardómur	(løgfr.)judgmentel.sentence of an inferior court; sídómur
undirrættarmál	(løgfr.)case tried by an inferior court
undirrættur	(løgfr.)lower court, inferior court
undirsetningur	(heimsp.)minor premiseel.term
undirsetumaður	(bjarg.)síundirsitingarmaður
undirsitari	(bjarg.)síundirsitingarmaður
undirsitingarmaður	(bjarg.)[a man who is responsible for the top end of the rope (while the bird catcher is on the cliffs)]
undirsíða	under side, underside;(plfr., eis.)ventral side
undirsjóarkaðal	submarine cable
undirsjóvarbrunnhøvd	(oljuv.)sub-sea wellhead
undirsjóvarleiðing	subsea cable
undirsjóvarsmoga	sub-sea tunnel, submarine tunnel; eis.undirsjóvartunnil
undirsjóvartunnil	submarine tunnel, underwater tunnel; eis.undirsjóvarsmoga
undirsjóvarútbúnaður	(oljuv.)underwater installations(flt)
undirskegg	goatee
undirskelvtur	covered with iceorsnow;húsini vóru undirskelvt í kavathe house//houses was//were covered with snow
undirskeyti	(bát.)[oak sheathing protecting underside of oar from wear]
undirskildur	understated, understood(t.d.when she wrote "somebody, " Smith was understood); implied(t.d.an implied reservation); implicit(t.d.an implicit reservation)
undirskipaður	1(um haga, of outfield) [having a smaller flock of sheep than the pasture can support]2(málfr.)hypotactic, subordinate; undirskipaðursetningursubordinate clause
undirskipan	(málfr.)subordination, hypotaxis
undirskjal	(løgfr.)secondary document of a case
undirskjúrt	underskirt, petticoat
undirskot	deficit, deficiency(t.d.a deficiency of two pounds); shortfall(t.d.our dollar balance shows a shortfall); (á gjaldsjavnvágini) deficit, gap(t.d.the dollar gap);tiltakið gav undirskotthe enterprise resulted in a deficit/a loss; síhall
undirskógur	(plfr.)underwood, underbrush, undergrowth
undirskrift	signature;talgild undirskriftdigital signature,(eis.)electronic signature
undirskriva	(t.d. bræv)sign, putel.affix one's signature to, put, set, subscribeel.sign one's name to; set one's hand to; (samundirrita) countersign; sískriva(undir)
undirskriving	signature, signing
undirslag	1(húsasm.)one of the crossbeams which supports the floor of a house, sleeper2(dýr.)subspecies
undirspæl	(tónl.)accompaniment
undirspæla	(sjónl.)underplay, underact
undirstaddur	(plfr.)hypogynous;undirstødd blómahypogynous flower
undirstanda	1íosb. undirstanda segdare, venture, be so bold as to, risk;tú skalt ikki undirstanda teg at gera taðyou just try!2(gl.)understand, comprehend;undirstóð hann dvørgamálhe understood the language of the dwarfs
undirsteinur	(grinder) under-orlower stone
undirstinga	(gl.)símutra
undirstjóri	assistant director, deputy director, deputy chief executive
undirstreymur	undercurrent;(fl.m.) gjøgnum brøvini gongur ein heitur undirstreymur av heimkensluhis letters reflect a warm undercurrent of love for his native town
undirstúka	(gl.)sístúka
undirstúrsin	(stb., sj.)brusque, gruff, blunt
undirstætt	the lower classes(flt); munurin millum undirstættina og borgarastættinathe difference between working-class people and middle-class people
undirstøða	1foundation, basis;(fl.m.) undirstøðan undir Hammershaimbs stavsetingthe foundation on which Hammershaimb based the orthography of the Faroese written language;tær bestu uppskriftirnar eru havdar til undirstøðu í hesi útgávunithis edition is based in the most reliable texts2low-lying part of terrain by the sea;tað var tjúkt í erva, so bert undirstøðan sástthe fog was lowering over the mountains so that only the lower part of the landscape was visible
undirstøði	1(eis. fl.m.) foundation(s), base2(jarðfr.) basement;undirstøðið undir basaltháslættanumthe basement under the basalt plateau
undirstøðubúskapur	primitive economy, barter economy
undirstøðukervi	infrastructure
undirstøðuligur	sístøðisligur
undirsundurbýti	subdivision
undirsyll	(húsasm.)sill, supporting beam
undirtak	(ítr.)(í glímu, in wrestling) underhold
undirtekstur	(til filmar) subtitle; (til lýsingar) caption
undirtittul	subtitle;hava sum undirtittulhave as a subtitle
undirtóni	1(tónl.,um sveiggingar) sub-harmonic2(fl.m.)undertone(t.d.of bitterness);politiskir undirtónarpolitical undertones
undirtráður	(í seymimaskinu) under thread; shuttle thread
undirtrom	(húsasm.)the lowest floor or storey
undirtroyggja	vest;(am.)undershirt
undirtrútsligur	(stb.)reserved, reticent, silent, quiet, of few words
undirtrygging	(trygg.)under-insurance
undirtryggja	(trygg.)under-insure
undirtryggjaður	under-insured
undirtrýst	(alisfr.)partial vacuum, low pressure, underpressure
undirtvingsla	subjugation, (ógvisligari) enslavement;har var eingin undirtvingslano enslavement took place
undirtøka	1response, sympathy, approval, acceptance; meet with approval, find favour;fáa undirtøkuevoke a response(t.d.his eloquence evoked no response from his audience); meet with sympathy(t.d.the idea met with sympathy)2(løgfr.) accession
undirtøkuløgskjal	(løgfr.) instrument of accession
undirvaksin	overgrown;undirvaksin íoverrun/rank with(t.d.weeds)
undirvatnsbátur	síkavbátur
undirveð	(løgfr.)mortgage;undirveð í fastognmortgage on real property
undirveitari	subsupplier, (tíðum) subcontractor
undirveiting	subsupply, subcontract
undirvekt	underweight;(viðv.vørumo.tíl.)short weight(t.d.give short weight in bread)
undirverktakari	subcontractor
undirverktøka	subcontract
undirvirðing	(gl.)contempt(t.d.show one's contempt for sth; he had nothing but contempt for it); disdain, scorn; undirvirðingav góðum siðumcontempt for old traditions
undirvirðiskensla	(sj.)inferiority complex;hon hevði bart undirvirðiskensluna av sær, sum leingi hevði pínt hanashe had shaken off the feeling of inferiority which had crippled her for so long; síundirlutakensla
undirvirðissøla	(bú.)dumping price(t.d.sell goods at a dumping price)
undirvitska	(sálfr.)subconsciousness, subconscious(t.d.experiences relegated to the subconscious); subconscious mind;(fakl.verður nú tíðari nýtt) unconscious(t.d.complexes embedded in the unconscious); eis.dulvit, loynivitska
undirvísa	teach(t.d.teach children); instruct;(óáv)teach(t.d.the school where she taught); give lessons; (í skúla:am.)teach school;undirvísa e-m í enskumteach (sby) English, give instruction (to sby) in English, give lessons (to sby) in English, give (sby) English lessons;hann hevur flokkin í enskum (eis.)he takes the class in English
undirvísing	1(sum verður veitt) teaching(t.dtake up teaching as a career); instruction(t.d.religious instruction); tuition; lessons(flt)2(sum ein fær) training, education(t.d.he got next to no education); instruction(t.d.the instruction provided by these schools); tuition(t.d.tuition is free); lessons(flt);(skúlaundirvísingeis.)schooling(t.d.he did not get much schooling);teldustuðlað undirvísingcomputer-assisted instruction;fáa undirvísing(í skúla) attend classes; (á fróðskaparsetrio.tíl.)attend lectures;felags undirvísingco-education
undirvísingar-	educational, instructional; teaching
undirvísingaramboð	educational material, teaching aids
undirvísingarár	educational year
undirvísingarendamál	languageel.medium of instruction
undirvísingarfrælsi	freedom in the choice of teaching methods
undirvísingarførleiki	teaching ability
undirvísingarháttur	teaching method, method of instruction
undirvísingarhøli	classroom
undirvísingarlærugrein	subject taughtel.studied
undirvísingarmál	1languageel. medium of instruction2educational matters(flt)
undirvísingarskipan	educational system; (skúlaskipan) school system
undirvísingarskylda	(hjá næmingi) compulsory education; (um skúlabørn) subject to compulsory school attendance;lektorar hava fýra tíma undirvísingarskyldulecturers must teach a minimum of four weekly periods
undirvísingarstovnur	institute of education, educational establishment, school, college
undirvísingartilboð	educational facility; educational option
undirvísingartilfar	educationalel.teaching material, instructional material(s);(teld.)courseware
undirvísingartíð	1(skúlatíð) class hours(flt),class time2(øvut frítíð) term (time)
undirvísingartími	(skúlam.)lesson, period(t.d.English is taught for four periods a week);(lækn.)tutorial
undirvísingarvegleiðing	1(ráðgeving) study guidance2(leiðreglur) study guidelinesel.directions
undirvísingarverk	education(t.d.the authorities in charge of education); educational matters(flt),education service(t.d.the national education service)
Undirvísingar-, Vísinda- og	
undirvísingarætlan	curriculum(fltcurricula); (skrá) syllabus
undirvørr	1lower lip, underlip; (á skordýrum) labium2(plfr.)lower part of a bilabiate corolla
undra	astonish, surprise, be surprisedel.astonished at, wonder at;tað undraði meg stórliga at hann kundi gera taðI was surprised that he could do it;tað er ikki at undrathere is nothing extraordinary about it, it is quite natural;undra seg/undrastbe surprised/astonished, (ógvisligari) be astounded/amazed/marvel at, wonder at(t.d.I don't wonder at his anxiety);undrast á (e-t)be surprised at sth, wonder that, be astonished/surprised that
undran	wonder; astonishment, surprise;vekja undran(cause) surprise;tá fyltist eg av undranI was filled with wonder
undranarhávirðing	admiration;hava undranarhávirðing fyri e-madmire sby greatly,(GG: eis. t.d.:I have (a) great admiration for him)
undranarsamur	strange, wonderful, singular, odd;hitt loyndarfulla, undranarsama haviðthe mysterious and wonderful sea
undranarverdur	admirable, worthy of admiration; síeis.undranarsamur
undrunar-	síundranar-
undulátur	(fugl.)budgerigar,(tlm.)budgie(Melopsittacus undulatus)©iStock
undur	wonder, marvel, prodigy; miracle(t.d.believe in miracles);ei undur íthere is nothing extraordinary about it, it is quite natural
undurbarn	infant prodigy, infant phenomenon, child genius,(serst. am. eis.)wonder child; (skemt um vaksin) whizzkid, wunderkind;Mozart var eitt undurbarn, ið skrivaði tónleik longu fimm ára gamalMozart was a child genius who wrote music already when he was five years old
undurfagur	of wonderful, exquisiteel.matchless beauty, divinely beautiful, lovely(t.d.a lovely lady); exquisite
undurfullur	wonderful(t.d.sight); marvellous;(skaldsk.)wondrous; (frálíkur) wonderful(t.d.dinner, dress), magic;Aladdins undurfulla lampaAladdin's wonderful(el.magic) lamp;á undurfullan háttwonderfully, marvellously
undurgerandi	wonder-working, miraculous;tann undurgerandi myndin av halgu moynnithe wonder-working picture of the Holy/Blessed Virgin
undurgerð	wonder, miracle;ein sjónlig Guds undurgerðone of God's visible miracles
undurgerningur	síundur
undurkurur	miracle cure
undurleikur	miracle (play)
undurmikil	síundursamur
undurríkur	síundurfullur
undursamligur	síundursamur
undursamur	síundurfullur;hin undursama rósanthe wonderful rose;ein undursom megia miraculous power
undursemi	wonderfulness, marvellousness
undursjón	wonderful sightel.spectacle;útsýnið var ein undursjónthe view was wonderful/breathtaking
undurtrúgv	belief in miracles
undurvakur	síundurfagur
undurverdur	síundurfullur;á undurverdan háttwonderfully, marvellously, in a marvelous way
undurverk	wonder(t.d.the seven wonders of the world); marvel, miracle;gera undurverkwork/perform miracles;(fl.m. eis.)do wonders(t.d.this medicine has done wonders);heimsins áttanda undurverkthe eighth wonder of the world
undurvænur	síundurfagur
unga	íosb. unga úthatch out (eggs), incubate;ein lundi ungaði út í hasum holinuma puffin hatched out its young in that hole;eggið er ungaðthe egg is fertilized
ungaegg	1a young hen's first egg2chicken's egg
ungagás	goose with young
ungaligur	little and sweet (of a little child)
ungamamma	henorduck with young, mother henorduck;(fl.m.) hatta er ein sovorðin ungamammashe loves children
ungapipp	(stb., barnam.)littleel.small birds
ungari el.ungarari el.ungverji	Hungarian
Ungarn	(sern., landafr.)Hungary
ungarskur	Hungarian
ungast	1be faint-hearted, be modest, be shy;hvørjum gongur tú her og ungast eftir?stop fiddling about and tell me what you want2be fiddling about, be pottering about;hvat ungast tú við har?what are you fiddling about with
ungdóms-	of (one's) youth(t.d.the ideals of my youth); youthful(t.d.at a youthful stage);ungdómsár,ungdómsblómi,ungdómsdølskleikio.s.fr.
ungdómsarbeiði	1(avrikað tá ið ein var ungur) early work, juvenile work, work of one's youth;ungdómsarbeiði hansara (eis.)his juvenilia2(millum tey ungu) work among young people
ungdómsarbeiðsloysi	youth unemployment, juvenile unemployment
ungdómsár	síunglingaár
ungdómsblómi	in the first flush of youth
ungdómsbókmentir	juvenile books, books for the youngel.for youthful readers
ungdómsbrotsverk	juvenile crimeel.delinquency
ungdómsdeild	youth section; (á bókasavni) juvenile department
ungdómsdreymur	youthful dream;tað var ungdómsdreymur mínit was the dream of my youth
ungdómsdyrkan	cult of youth
ungdómsdølskleiki	(lækn.)dementia praecox
ungdómsfongsul	youthel.juvenile prison, detention centre;verða dømdur at sita í ungdómsfongslibe sent to a detention centre
ungdómsklubbur	youth club
ungdómskæti	joy of youth
ungdómslega	youth camp
ungdómsleiðari	youth leader
ungdómsligur	youthful(t.d.appearance; bride; clothes; dress; face; mother; smile)
ungdómslív	youth
ungdómsmegi	youthful vigour
ungdómsminni	a memory from(el.of) one's youth; youthful memory(t.d.I have youthful memories of her in a red dress);ungdómsminni mínithe memories of my youth
ungdómsmynd	a pictureel.portrait of her when young, a pictureel.portrait of her as a young woman
ungdómsrørsla	youth movement
ungdómsskúli	síunglingaskúli
ungdómsuppreistur	youthful revolutionel.rebellion, adolescent revolt;ungdómsuppreisturin(í 60-árunum) the youth revolution, the youth revolt
ungdómsvanlukkutrygging	(trygg.)insurance for young people
ungdómsvinur	companion of one's youth;ungdómsvinur mín//hansara o.s.fr.a friend of my//hisetcyouth
ungdómur	1youth, adolescence2years of (one's) youth, early years, adolescence;í mínum ungdómi3the young, young people; youth(t.d.youth today; modern youth)
ungdýr	young animal
ungfiskur	(fisk.)young fish (of all sorts before they are sexually mature);friða ungfiskpreserve young fish
ungfoli	young horse, colt
ungfólk	youth, young people;(løgfr.)juveniles;bókin er ætlað ungfólki og børnumthe book is intended for young people and children
ungfrú	Miss, Ms (t.d. Miss/Ms Smith)
ungfrúgv	(sø.)young unmarried womanorlady, young lady
ungfuglur	1young guillemot2(fugl., samn.)young birds
unghestur	young horse, colt
ungi	(offspring of some birds and some animals) young;(tilt.) nú skal antin verða egg ella ungi,síegg2;eggið er í ungathe egg is ferilized; with the chick formed inside; sípisa
unglaksur	(fisk.)smolt
ungligur	youthful (appearance; bride; clothes; dress; face; mother; smileo.tíl.),young-looking; of youth(t.d.errors of youth; the gracefulness of youth); juvenile
unglinga-	early, youthful, of youth
unglingaár	youth, years of (one's) youth, early years, adolescence
unglingablað	youth magazine
unglingafjøld	the young, young people; youth(t.d.youth today; modern youth)
unglingalið	(ítr.)youth team;leikari á unglingaliði skal ikki verða fyltur 19 ár fyri 1. januar í kappingarárinuma player of the youth team must not have reached his 19thyear before the 1stof January of the year of the tournament
unglingasinni	youthfulness
unglingaskúli	continuation school; (iOngl. eis.)County College
unglingi	youth, lad, young person
unglingur	síunglingi
ungljón	(bíbl.)young lion
unglomvigi	(stb., fugl.)young guillemot
unglundi	(dýr.)young puffin
ungmaður	1young man;tað eru vána ungmenn, ið vilja liggja heimayoung men who prefer to spend their time at home in stead of going fishing are in a bad way2(sigl.)navigating apprentice (with 1 year's seagoing experience)
ungmanna-	youthful, of youth
ungmannaarbeiði	work among young people
ungmannaár	síunglingaár
ungmannafelag	1youth association2(sø.)Faroese Youth Organization (which was inspired by the Faroese National Movement)
ungmannafelags-	-fundur, -lív, -samkoma, -tíð
ungmannafelagsrørsla	the youth movement (whose roots were the Faroese National Movement);ungmannafelagsrørslan tók seg upp tíðliga í 20. øldthe Youth Movement came into being in the early 20th century
ungmannafjøld	síunglingafjøld
ungmannafylking	youth movement
ungmenni	young man
ungmoy	(skaldsk.)young unmarried woman
ungmoyggj	(skaldsk.)síungmoy
ungneyt	young cattle
ungross	young horse, colt (millum 1 og 3-4 ár)
ungsintur	youthful (in mind), young at heart
ungskógur	(plfr.)young growth
ungur	1young;maður deyður í ungum áruma man who died young;tá ið eg var ungurwhen I was young; in my younger days;frá ungum hevði hon varðveitt dreyminshe had preserved the dream from her early youth;mest var ungt, ið fleygmostly young birds (young guillemots) were flying2young compared with others;hon er ov ungur at fara í skúlashe is too young to be sent to school;hann er ov ungur at koyra bilhe is too young to drive a car;eg havi ung bein at standa á(you take the seat, said to an elderly person whom one offers a seate.g.in a bus)3ungurí sinniyouthful(t.d.in mind), young at heart4new, fresh, modern;okkara unga skriftmálour recently constructed written/literary language;ung vísindagreinnew branch of science, (í hugvísindum) a new branch of scholarship5(um tíð, not far advanced in time);árið er ungt ennthe year is still young;dagurin er ungurthe day is young;náttin er enn ungthe night is still young
ungverji	Hungarian
ungverskur	Hungarian
universitet	university; síeis.fróðskaparsetur
universitetsadjunktur	(íOngl.samsvarar tað við) fellow
universitetsár	academic year
universitetsbókasavn	university library
universitetsbókavørður	university librarian
universitetsbygningur	university building(s)
universitetsbýur	university town
universitetsfólk	university people
universitetsheimur	the university world, the academic world
universitetslektari	university lecturer, reader
universitetslív	university life
universitetslærari	university teacher
universitetsprofessari	university professor
universitetsrektari	vice-chancellor;(am.)president; (um onnur ikkiensk viðurskiftieis.)university rector
universitetssjúkrahús	(lækn.)university hospital
universitetstíð	time spent at the university, undergraduate days; period of study (at a university)
universitetsundirvísing	university teaching, university instruction
universitetsútbúgvin	university-educated, with a university education; (tíðum) with a degree;hon hevur universitetsútbúgvin (eis.)she is a graduate
universitetsútbúgving	university training, university education
unna	1not grudge(t.d.I do not grudge her success); giveel.allow oneself sth(t.d.he did not allow himself a moment's rest);hatta unni eg tæryou are welcome to it;hon er øvundsjúk og unnir ikki Karini henda góða drongshe is jealous of Karin and begrudges her her fiancé;eg unti teimum sigurinI think they deserved to win;tey unna sær einkithey are mean/stingy/miserly/niggardly/close-fisted;tey unnaðu sær ikki at livathey were too miserly to live as decent life;tú mást unna tær svøvnyou must sleep;hann unti sær ikki hvíldhe did not allow himself a moment's rest;tað er tær væl untyou are welcome to it;(speis.)much good may it do you2(gl.)love, be fond of, like;unna e-n/e-mlove sby, be fond of sby, like sby;unna e-m vælbe fond of;mær unti Brynhild Buðladóttir (kvæð.)Brynhild Buðladóttir loved me;at tú unnar mannin tannthat you love that man3unnast1get an opportunity of doing/to do sth; get a chance to do/of doing sth, be permitted (by fate);unnast mær ein hundsaldur (kvæð.)if I am spared to live for dark, feel confident;unnast væl//illafeel safe//feel apprehensive;ikki unnast inni í myrkribe frightened of going into the dark
unnasta	(skaldsk.)síunnusta
unnasti	(skaldsk.)síunnusti
unnileiki	freedom from fear; comfort, consolation;tað er ein unnileiki í honumit is a comfort that he is here
unniligur	1handsome, beautiful, absorbing, captivating;eitt unniligt landslaga breathtaking scenery2who deserves to be loved, lovable3comforting; íosb.sumtað er so unniligt at ganga, tá ið onkur er viðit is a comfort to have company
unnusta	(skaldsk.)beloved, who is beloved, fiancée; unnustahansarahis fiancée
unnusti	(skaldsk.)beloved, who is beloved, fiancé; unnustihennaraher fiancé
upp	1up;upp undir miðju//knæup to the waist//the knee;fáa upp í skógvarnarget wet feet;aldurnar draga upp og niður við klettinthe waves lap upon the stones;byggja uppbuild, build up;fara upp á takiðgo up on the roof;ganga uppgo up;koma uppreach the top;lesa seg uppclimb up on a line;lyfta upplift up;prísurin fer uppthe price is rising/is going up;reisa seg uppget up(t.d.get up when I address you!); rise, rise to one's feet(t.d.when he appeared we rose to our feet); get on one's feet(t.d.the boxer got on his feet again); stand up(t.d.the whole class stood up);rísa uppbe rising;beint upp og niðurperpendicular, vertical, straight up and down;raksturin (t.d.hjá virki)stendur upp og niður (fl.m.)receipts and expenditure balance (out)2(úr seingini, out of bed);fara uppget up(t.d.it is time to get up); rise(t.d.rise with the sun); get out of bed3in towards land (from the sea); uppundir land4(um tíð, of time) towards; uppat jólumtowards Christmas;heilt upp at okkara døgumdown to our own time; up to the present5into the light, throw light on;grava uppdig out;alt snoddaði hann upphe dug out everything;tað kemur eina ferð upp, sum hann hevur gjørtwhat he has done will one day be unravelled6fáa ein knút uppuntie/undo a knot;lata uppopen;læsa uppunlock;skera uppcut up, cut into pieces (a whale)7up (in a certain orderorsuccession);rokna uppcount;seta roknskap uppprepare an account; draw up a balance sheet;skriva uppwrite down, put down;telja uppcount8up to a greater size;bólgna uppswell/puff up9until everything has been spent;eta uppfinish one's food, clean up one's plate;fiska uppfish out, fish up;høgga uppunstock, draw, deplete;torna uppdry up/out10(completely);hann rodnaði upphe blushed;hita uppheat, (ikki so heitt) warm11[ísamb.viðfs]uppaftur:sigla upp aftursail to the same position once more(t.d.to the buoy);uppafturá:leggja seg upp afturálie down (to rest);uppat:upp at fiskimarkinumclose to the fishery limit(s);uppá:lat einki koma upp á taðdon't damage it;hon er vøkur upp á kroppshe has a good figure;læra upp á e-n,sílæra2;stingast upp á e-non a whim, fancy(t.d.whenever the fancy takes one), caprice, a sudden impulse;upp á `seg(við herðing á seg, with stress onseg) in the circumstances, considering, fairly well;í norðaru helvt skarst væl upp á segthe slaughter weight was fairly good in the southern part of thehagicompared with the northern part;uppeftir:upp eftir e-mclimb up sth;uppfrá:flogfarið lætti sær upp frá breytinithe aeroplane took off from the runway;uppfyri:upp fyri egginaupp over the edge of a cliff;uppí 1skeinkja e-m upp í glasiðpour out a glass of whisky to sby;upp í dansinenter the Faroese folk dance2(of change especially for the worse)koma upp í einkicome to nothing(t.d.the project came to nothing); peter out(t.d.the reform movement petered out); run into the sand; be abortive(t.d.an abortive scheme); fizzle out (like a damp squib);brenna upp í kolbe charred;koma upp í møsnit was all nonsense (síkomaupp í einki); traðka upp í nakkafull of holes, all holes;koma upp í rakgrow thin, lose weight; (ógvisligari) waste away;upp í røkuragain and again;upp í samanagain and again;koma upp í varg(of sheep) become wild;uppum:fletta upp um seg,sífletta;uppundan:upp undan vatnskorpuniemerge from the surface of the water;uppundir:hon er full upp undir hendur(of pregnancy) she is heavily pregnant;gera upp undir tráðuattach the trolling-line to the fishing rod;uppúr:mjólkin skvampar upp úr spanninithe milk is splashing out of the milk pail12[ísamb.viðs] t.d.ala upp; bólgna upp; eta upp; fáa upp; fletta upp; flotna upp; ganga upp; gera upp; geva upp; hita upp; klára upp; kalla upp; koma upp; lata upp; leita upp; leggja upp; rokna upp; skjóta upp; skriva upp; rekja upp; renna upp; seta upp; siga upp; taka upp; telja upp; torna upp; vaksa upp; vaska upp; yngjast upp(sísagnorðinisumleitorð)
uppaftur	1again, once more, one more time;hetta verður ikki gjørt uppafturthis is the last time;giftast uppafturmarryorbe married again;ganga uppaftur(um kúgv, of a cow) not become pregnat the first time2even, still; uppafturbetri//størri//verrieven better//larger//worse
uppaftur-	smst. t.d. -bygdur,doyptur, -latin, -livnaður, -prentaður, -tikin
uppafturbygdur	1rebuilt(t.d.a town); reconstructed, built up again, re-erected2(lívfr.)regenerated(t.d.the tissues)3(fl.m.)reconstructed, built up again(t.d.an organization)
uppafturbygging	rebuilding, reconstruction, re-erection
uppafturdoyptur	rebaptized
uppafturgiftur	remarried
uppafturgrivin	dug up again;síggja út sum eitt uppafturgriviðlook like nothing on earth, look like death (warmed up)
uppafturkomin	on one's feet again, on one's legs again; uppafturkominav sjúkuleguni,síkoma(upp aftur)
uppafturkyknaður	1(um eld, of fire) reflamed, reblazed, refired2(um kenslureis.)rekindled, flared up again, revived, resurgent
uppafturkyknan	fresh outbreak(t.d.of the fire; of hostilities); recrudescence(t.d.of the disease); revival(t.d.of interest)
uppafturlatin	re-opened
uppafturlivnaður	revived, emerged again, re-emerged, resurrected
uppafturprentaður	reprinted
uppafturprenting	reprint
uppafturróptur	(stb., sj.)íosb.sumvera sum eitt, ið er uppafturróptbe somnolent, lethargic, torpid (based on the notion that a dying person can come back to life if there is not complete quiet round him: if this happens he doesn't become normal again)
uppafturtikin	1resumed, reassumed, taken up again(t.d.of work; payment; the debate; the fighting; the negotiations); reopened(t.d.of the negotiations)2revived (a custom, a tradition, a play, a film)3reopened(t.d.a case)
uppafturtos	repetition;tað, sum blaðið sigur um hvalaveiðina er nógv uppafturtosmuch of what the paper writes about whale hunting is repetition
uppafturtøka	1resumption(t.d.of work//payment//the debate//the fighting//the negotiations); reopening(t.d.of the negotiations)2revival(t.d.of a play//a film/a custom)3(um lim í felagi) readmittance4(løgfr.)retrial, new trial; resumptionel.reopening of a case, new hearing
uppafturveking	(um fólk) revival, resuscitation
uppafturvenjing	rehabilitation(t.d.physical and vocational rehabilitation)
uppafturyngdur	rejuvenated, restored to youth;vinabond vórðu knýtt ella uppafturyngdnew friendships were tied or old bonds of friendship tightened
uppalari	educationalist, educationist; teacher
uppaldur	reared, brought up
uppalin	síuppaldur
uppaling	1upbringing2(um fuglar og dýr, of birds and animals) breeding, rearing;við uppalingini ber til at nøra um fitinøgdina í mjólkiniby means of breeding it is possible to increase the fat content in milk
uppalingarháttur	method of upbringing; child-rearing method
uppalingarligur	educational
uppargaður	enraged, infuriated
uppat	íosb.sumgeva/halda uppat (við e-m)stoporabandon doing sth, give up; leave off(t.d.ever leaves off talking; you could not tell where bosom began and draperies left off); lay off;geva uppat at siglastop going to sea;halt uppat við hasum!stop that!
uppatgevingartíð	time to stop (playing; working)
uppav	(t.d..)(blow) off sth
uppá	on sth;kasta uppá(í binding, of knitting) cast the first stitches on to the knitting needles;lesa uppádo one's homework;spæla uppáplay an instrument;tað er tíð uppá at tú gert taðit is about time/it is high time you get it done;koma uppátake place, occur;hjúnalagið var komið heldur óvart uppáthe marriage took place rather suddenly
uppábót	repair, repairs(t.d.road repairs; repairs to the roof; the ship has docked for repairs); síumvæling
uppábundin	síbinda(uppá)
uppábøttur	repaired(t.d.clothes; a house; road; roof; car; ship; watch; hole); mended(t.d.a garment; puncture; hole); fixed up(t.d.can you fix up that engine?); fixed;(sigl., eis.)refitted; (lappaður) mended, patched(t.d.a garment); (stoppaður) mended, darned(t.d.stockings); (skóbúni, shoes) repaired, mended, cobbled; (listaverk, work of art) repaired, restored
uppáhald	statement, assertion, claim, profession, allegation
uppákasting	(í binding) cast-on stitches
uppákomin	síkoma(uppá);tað er nýliga uppákomiðit occurred/happened recently
uppámynstraður	(sigl.)signed on, enrolled, enlisted
uppás	(stfr.)y-axis, ordinate
uppáskotraður	sískotra
uppástaðini	shortly, soon, before long, in the near future
uppátrúgv	(sj.)superstition; sípátrúgv
uppátøka	(í binding) picking up of stitches
uppbakað	síbaka(upp); uppbakaðsóssauce thickened with roux
uppbaking	roux;ein uppbaking av margarini, mjøli og mjólka roux consisting of margarine, flour, and milk
uppbirtningur	(stb., sjónavn)smoke
uppblásin	1swollen, tumefied;beinið á honum var so uppblásiðhis leg was swollen2(fl.m.)haughty, arrogant, bumptious;hann er so uppblásinhe is such an arrogant prick
uppblástur	1inflated, blown up; uppblásturbólturinflated ball;hann hevur altíð verið sum ein uppblástur kíkurhe has always been very fat2síuppblásin1;beinið og lærið var alt uppblásthis//her leg and thigh were swollen
uppbloyttur	soaked, soggy, sodden(t.d.a sodden field); síbloyta(upp)
uppboð	auction;keypa á uppboðibuy at an auction;selja á uppboðisell by auction
uppboðshaldari	auctioneer
uppboðssøla	auction;selja fisk á uppboðssølusell fish by auction
uppbólgnaður	swollen, tumefied;fingrarnir vóru uppbólgnaðirthe fingers were swollen; síbólgna(upp)
uppbrettur	rolled-up(t.d.sleeves), turned-up(t.d.trousers); síbretta(upp)
uppbrot	(á buksum) turn-up;(am. eis.)(trouser) cuff; (á ermu) cuff; (á jakka) lapel, facing
uppbrotin	rolled-up(t.d.sleeves), turned-up(t.d.trousers);við uppbrotnum skjúrtuermumwith rolled-up sleeves
uppburður	1up(-)current (wind hitting the steep slopes and then rushing upwards)uppburður, so at rokið stóð av hvørjum tindi2(sj.)fame, renown, fame, success
uppbyggandi	síuppbyggiligur
uppbyggiligur	edifying, edificatory, elevating; (prædikukendur) homiletic;uppbyggiligar bøkur(bókmentir) devotional/homiletic books/literature
uppbygging	1building (up), construction2(av listaverki) structure, composition;uppbyggingin av søgunithe structure of the story3edification;okkum til uppbyggingarfor our edification
uppbyggingarfundur	(átr.)devotional meeting
uppbýti	(í talv, in chess) exchange
uppdaga	1find out, discover2catch sight of sth; become aware of sth; perceive sth; see sth, notice sth; spot sth;tjóvurin varð uppdagaður og tikinthe burglar was detected and apprehended
uppdagan	(sj.)síuppdaging
uppdagari	discoverer
uppdaging	1discovery(t.d.of a country//of radium)2(a) discovery
uppdagingarferð	expedition, exploration,(sigl.)voyage of discovery;fara á uppdagingarferð í landiexplore a country;senda ein á uppdagingarferð (sigl.)send sby out on a voyage of discovery
uppdráttur	1pulling a boat up from the sea2line connecting buoy and long line3map4draft(t.dfor a machine), design(t.d.a design for a house)
uppdrift	1(tlm., tøkn., flogm.)lift2buoyancy3(um luftskip, ballón, of airship, balloon) buoyancy
uppdyrking	cultivation, tillage, tilling(t.d.of the soil)
uppeftir	1up, upwards;(tilt.) eg mundi dottið uppeftir, tá ið eg hoyrdi taðyou could have knocked me down with a feather/I was completely bowled over when I heard it2(um tíð, of time);frá 1906 og uppeftirfrom 1906 and forward3(um nøgd, of amount);teir fingu úr tíggju túsund pundum og uppeftir í partthe weight of the catch was from 10, 000 lbs and up for each of them4(um virði, of value)prísurin kvinkar uppeftirthe prices are rising/going up slowly
upperring	stimulation
upperringarevni	(lækn.)stimulant(t.d.coffee and tea are mild stimulants)
uppetin	1eaten up, consumed;hoyggið var uppetiðthe hay had been used up2(um sjúkling, of a patient) wasted, withered;hann var uppetin av krabbameinihe was wasted by cancer
uppevjaður	soaked, soggy, sodden(t.d.a sodden field);vegirnir vóru uppevjaðirthe roads were soggy; síevja2
uppfarin	1(from a lower to a higher place) gone upstairs, gone up in the attic2up, out of bed3(of prices) risen, gone up, climbed;prísirnir eru uppfarnirprices have risen
uppfaring	1[climbing up a bird cliff]2getting up; getting out of bed
uppfaringartíð	getting-up time;fyriuppfaringartíð at an unearthly hour
uppfatan	1perception, understanding;mín persónliga uppfatanit is my opinion that, I think that, in my opinion2(heimsp.)apprehension(t.d.direct apprehension of mental life)3perception(t.d.our perception of sounds)4view(t.d.my view of the matter), opinion; conception(t.d.we have the same conception of justice); notion(t.dour notion of right and wrong); impression(t.d.I received another/a different impression of his conduct)5interpretation, reading, construction(t.d.their construction of the treaty)
uppfattur	bent upwards, turned up;uppføtt nøsturned-up nose, pug-nose, snub nose
uppfesti	(sj.)bill, poster; (fráboðan) notice;fundurin skal verða lýstur viku frammanundan við uppfestumthe meeting is to be announced with notices one week before the meeting takes place
uppfestur	fastened up;uppfest lýsingposted announcement, posted proclamation, posted notice
uppfinna	invent(t.d.a machine); devise(t.d.a system); contrive(t.d.at last we contrived a defence against magnetic mines);Graham Bell uppfann telefoninaGraham Bell invented the telephone
uppfinnari	inventor
uppfinning	invention
uppfinningarsamur	inventive, ingenious; creative; innovative; (tíðum) fertile(t.d.his fertile mind); (skjótteinkin) resourceful
uppfinnsamur	síuppfinningarsamur
uppfiskaður	1fished out, empty of fish;er longan uppfiskað, verður leingi, áðrenn hon kemur afturif the ling stock is depleted, it will take a long time before it recovers2(of sunken pilot whales) fished up (after the killing of a shoal of pilot whales)
uppfisking	1fishing up (sunken whales after the killing of a shoal of pilot whales)2(oljuv.)fishing (fáa aftur útgerð, ið er mist niður í borihol, the recovering of tool(s) which has//have accidentally been dropped into a borehole)
uppfiskingarløn	payment for fishing up sunken pilot whales (after the killing of a shoal of pilot whales)
uppfitnaður	who has put on much fat
uppflotnaður	which has come to the surface (from the bottom)
uppflutningur	(í starvi) promotion
uppflyting	1(skúlam.)remove2(ítr.)promotion, going up; uppflytingúr triðju í aðru deildgoing up to the second division
uppflytingarroynd	(skúlam.)qualifying examination; end-of-term examination
uppflytingarrættur	(løgfr.)[the right of a mortgage to advance into the position vacated by the repayment of prior mortgages]
uppfostran	1rearing, bringing up, upbringing2fostering, bringing up (taking care of a child who is not one's own)
uppfrá	up from the ground/the flooretc; lyfta e-n uppfrálift up sth//sby
uppfylla	1(bíbl.)fill (up);uppfyllið jørðinareplenish the earth2(nøkta) fulfil(t.d.sby's expectations//hopes);hann uppfyllir ynski teirrahe fulfils their wish3(skylduro.tíl.)fulfil(t.d.one's promise//obligations); meet(t.d.requirements; conditions; demands), honour(t.d.our commitments)4(laga seg eftir) comply with(t.d.all the formalities); conform to/with(t.d.every detail of the regulations); satisfy(t.d.the requirements); síeis.lúka
uppfyltur	full(t.d.full of bitterness; full of admiration for him; he was full of the project for the new bridge); (feel, be) overloaded (having overloaded one's stomach); filled(t.d.with envy; bitterness; admiration); absorbed(t.d.in his work); taken up(t.d.with other thoughts)
uppfyri	[something which looms, projects, rises, stands up, towers in front of one];tað var høgt uppfyrithe cliff was precipitous;tað var fjøruti favna berg at draga hann uppfyrithey had to pull him up more than 40favnar(sífavnur:app82 yards);bera uppfyriobstruct the view
uppføðing	síuppfostran
uppgangur	1heavy surforbreakers2(fl.m.)wigging, dressing-down, ticking-off, telling-off; violent quarrel
uppgataður	perforated, holed
uppgáva	1task, duty, assignment;hann fekk í uppgávu at gera myndirnarhe was given the assignment to take/make/paint the pictures;tað er ein stór uppgáva at fara undirit is a hard task to take upon oneself2task; assignment; exercise; (stílur) paper, essay, composition;(stfr.)problem;uppgávur til próvtøkunaexamination paper; question paper3(sø.)[conveyanceortransfer of one's property to another person (often a rich farmer) in return for being supported by him when old]
uppgávudintil	(sj.)[person who is inclined to give up a job half-way]
uppgávuhugaður	servile, slave-minded, defeatist
uppgávuhugur	resignation; defaitism
uppgávujørð	(sø.)[land which has been handed over in return for old-age support]
uppgávukona	(sø.)[old, childless woman who has handed over her property in return for old-age support]
uppgávulyndi	defeatism, defeatist attitude, servile spirit; base mind, spirit of bondage
uppgávumaður	(gl.)[old, childless man who has handed over her property in return for old-age support]
uppgávupolitikkur	policy of concessions, (policy of) appeasement; síeftirlætispolitikkur
uppgávurødd	íosb. við uppgávurøddin a despairing voice
uppgávusíða	item page
uppgerð	1making up(t.d.of the accounts);goymsluuppgerðstock-taking;sambært niðanfyri tilskilaðu uppgerðas per statement at foot;kostnaðaruppgerðstatement of expenses;sundurgreinað uppgerðitemized account, specification;hagfrøðilig uppgerðstatistical survey, (statistical) returns;uppgerð av sjóskaðaaverage adjustment2statement (of account); account rendered3settling (of accounts), (skrivlig) account; billel.statement of account4showdown, confrontation, clash; (um hjún á almennum stað) scene(t.d.they had a scene in public);tey høvdu uppgerð í nevndiniit came to a showdown between the contending parties of the committee5affectation, showing-off
uppgessaður	stirred up(t.d.feelings; sby's anger against sby); stimulated, roused(t.d.to action); incited(t.d.incite them to rebel), inflamed, inspired, fired(t.d.fired with patriotic zeal), whipped up, worked up
uppgjald	(sj.)compensation, payment, consideration, return;hann fekk uppgjald afturfyrihe was compensated
uppgjørdur	1(um togo.tíl.,of ropeetc)coiled, wound up;snørið er uppgjørtthe handline has been wound up (on a súla1)2(of male lamb) selected as breeder;veðurlombini vórðu uppgjørd3unnatural, artificial, affected, feigned(t.d.with feigned cordiality); simulated, sham;uppgjørdi eldhugifeigned enthusiasm;við uppgjørdum gongulagwith an affected walk;hasin uppgjørdi gorlakkurinthat stuck-up clown4(of hay) stacked5(of bed) made;uppgjørd songa made bed6fictitious, assumed, invented;uppgjørd nøvnfictitious names7[íyms.samb.]búgvið er uppgjørtthe estate is now wound up; sígera(upp)
uppgløddur	enthusiastic, keen, eager;verða ógvuliga uppgløddur umgo into raptures over; be completely carried away by;flokkurin var uppgløddur fyri at fremja tað, ið kundi menna føroyingar tjóðskaparligathe party was anxious to do everything in its power for the advancement of Faroese national culture
uppgonga	1ascent;føroyingarnir bóltaðu grót oman á írarnar at forða teimum uppgonguthe Faroemen tried to prevent the Irishmen's ascent by rolling stones down at them2(sigl., herm)going alongside, boarding;gera uppgongu á skipboard a ship3road or path up to an island; steep ascent from the sea;uppgongan í Skúvoythe ascent to the village of Skúvoy;uppgongan er góð at verjathe ascent from the sea is easy to defend4extraoradditional sheep drive (when all the sheep have not been rounded up the first time)
uppgongd	1síuppgonga32(sj.)rise, increase;fiskaprísurin er í uppgongdthe prices of fish are rising3(sj.)progress, advance;henda uppgongd vardi í umleið 50 árthis period of prosperity lasted for about 50 years4(sj.)heavy surforbreakers
uppgongdur	passable;stíggjurin er uppgongdurthe path is passable;har er uppgongtone can walk up from there
uppgongukrókur	(sigl., herm)grappling iron/hook
uppgongulið	(sigl., herm)boarding party, boarders
uppgongumaður	(sigl., herm)boarder
uppgongustigi	(herm.)scaling ladder
uppgongutíð	time of prosperity, boom (period)
uppgreiðing	explanation (of)(t.d.the explanation of the phenomenon);ein natúrlig uppgreiðing mundi fara at koma av hesum undarliga tilburðia natural explanation of this strange incidence was likely to be offered
uppgressaður	(sj.)angry, furious, cross
uppgrevstur	digging-up, unearthing
uppguvan	(alisfr.)evaporation, vaporization;nógv av regninum fer fyri einki við uppguvanmuch of the rain does no good due to evaporation
upphald	[(loose) snow which blows up from the mountain tops (betokens windy weather)]; upphaldá fjøllunum(loose) snow blows up from the mountains
upphav	1origin (of sth), beginning, genesis, birth(t.d.the birth of Greek civilization);frá upphavi at endafrom beginning to end, from start to finish;(bíbl.) í upphavi skapti Gud himmal og jørðin the beginning God created the Heaven and the Earth;upphavið at ríki hansarathe birth/the beginning of his empire2large amount of food;eitt upphav av grinda large amount of whale meat and blubber3(sj., stb.)síupphald
upphavligur	original;orðið man ikki vera upphavligt á norrønari grundthe word is hardly of Norse origin
upphavsformur	1(málfr.)the primordial form(t.d.of a religion);Øravík hevur havt upphavsformin Hørðavíkthe primordial name for Øravík was Hørðavík2(lívfr.)the primordial cell(t.d.from which life developed)
upphavsmaður	promoter, originator(t.d.of a project), initiator, author(t.d.of a scheme); instigator (of); architect; (fyri uppreistri) ringleader; upphavsmaðurat e-mthe architect of sth
upphavsrættur	1intellectual property right; patent rights2(hjá rithøvundio.tíl.) copyright
upphavsstaður	place of origin
upphavsøld	(jarðfr.)the Precambrian/Pre-Cambrian (Era) (tíðin frammanundan 600 mill árum síðan)
uppheinging	hanging (up), suspension
uppheitaður	(t.d. of food)warmed up, heated
uppheittur	síuppheitaður
upphevjaður	honoured, venerated, revered, esteemed highly, glorified; síhevja(upp)
upphevjan	glorification
upphitaður	síuppheitaður
upphiting	1heating(t.d.the heating and ventilation of buildings; electric heating); (ikki so ógvisligt) warming(t.d.in Italy, charcoal braziers are used for warming a room)2(ítr.ogfl.m.)warm up;(fótb., eis.)(pre-match) kick-about; (í frælsari ítrótt og fimleikieis.)limber-up
upphitingarbólkur	(tónl.)warm-up band
upphitingardystur	(ítr.)warm-up match
upphitingarkostnaður	cost(s) of heating
upphitingarvenjing	warm-up exercise
upphongdur	hung (up)(espfor wind-drying of fish and meat); síheingja(upp)
upphovnaður	swollen, tumefied;andlitið var upphovnað av grátithe face was swollen with crying/tears
upphóp	(jarðfr.) accumulation
upphugsa	think uporout, devise, invent;hann upphugsaði onnur brøgdhe thought up other tricks;upphugsaðurinvented, devised
upphædd	amount(t.d.of money);allar upphæddir í DDKall amounts in DKK
upphæddartrygging	(trygg.)insurance on the basis of valued policies
upphærdur	receding (hairline)
upphøgging	breaking up;skipið varð sent til upphøggingarthe ship was sent to the breaker's yard;seldur til upphøggingar (eis.)sold for scrap
uppi	1up (in a higher place); uppiá takinum(up) on the roof;uppi á aldunion the (wave) crest;uppi í sjónumjust below the surface;boðin er uppisíbróta10;bæði uppi og niðrieverywhere2in an upright position;standa uppistand up;húsini standa uppi ennthe house is still standing;vera uppistill up, not in bed yet;(orðt.) ilt er at læra gamlan hund uppi at sita,síhundur3used up, consumed, run out of sth(t.d.I have run out of petrol;GG:I am out of whisky); (næstan uppi) short of(t.d.I am short of tobacco);etið nú til uppi ereat now until nothing is left;maturin er uppiwe have run out of food;tá ið hann kom til Sands, var dagurin uppiit was dark when he arrived at the village of Sandur;dagarnir vóru uppi hjá honumhis days were numbered;mín tíð var ikki uppimy days were not numbered4sit for an examination;eg havi verið uppi í føroyskum í dagI sat for an examination in Faroese today5[ísamb.viðfs]uppiá:hava knív uppi á særcarry a knife;passa klædning uppi á e-mbe fitted for a new suit;uppi á floti,síflot;uppi á gosi,sígos;uppií:vera uppi í e-mtake part in sth, participate in sth, be in on sth;eiga uppi í e-mown a share in sth;standa uppi í ljósinumshade sby;uppiundir:sita uppi undir særsit up in bed;uppiyvir:hjúkla uppi yvir e-m,síhjúkla;gleða seg uppi yvir e-m,sígleða;sita uppi yvir e-m,sísita6[ísamb.viðs]dansa uppi; drepa uppi; fjara uppi; hava uppi; leggja uppi; sita uppi; standa uppi(sísagnorðinisumleitorð)
uppiá	on(t.d.I had no money//no papers on me; have you a match on you?); above;búgva uppiálive above(t.d.the family living in the flat above);hava uppiá(um seyð, of sheep) have the prescribed stock of sheep in a single pasture
uppiborin	(um fólk) (well-)deserving; (um ting) well-deserved, well-earned;ein uppiborin sigura well-deserved victory;hava/eiga e-t uppiboriðbe worthy of, deserve;tú hevur ikki annað uppiboriðit serves you right
uppifjaraður	1left high and dry at ebb tide;báturin lá uppifjaraðurthe boat was stranded2(fl.m.)helpless;hann liggur uppifjaraðurhe is in a helpless state of condition;verða uppifjaraðurbe exposed, uncovered, found out(t.d.at last he was found out)
uppihald	1keep(t.d.earn one's keep); living, livelihood(t.d.assure sby a livelihood)hon virkaði við hondunum til lívsins uppihaldshe earned her keep by making manufacture2(bráðfeingis) place of sojourn, whereabouts; (fast) (permanent) residence, home
uppihalda	1support(t.d.he has to support his old parents); maintain(t.d.maintain a wife and family); provide for, keep;sonurin, sum var sjómaður, uppihelt húsinumthe son who was a fisherman supported his parents and brothers and sisters;Harrin uppihelt fólkinum í oyðimørkini2preserve, keep, conserve(t.d.conserve the order and safety of the state); uppihaldata skipan, sum nú erpreserve the present system
uppihaldari	breadwinner, supporter, provider;tey sum hann syrgir fyrihis dependents;einsamallur uppihaldarisingle parent; (ógift ikkihúsarhaldspliktað fólk sum rindar í minsta lagi 50% av útreiðslunum, sum kann draga part av útreiðslunum frá í skatti) head of household
uppihaldshjálp	alimony, maintenance; síuppihaldspeningur
uppihaldsloyvi	residence permit; (við arbeiðsloyvi) work permit;bráðfeingis uppihaldsloyviprovisional residence permit
uppihaldspeningur	1[compulsory contribution to the maintenance of (illegitimate) children];(uml.)payment under an affiliation order;gjalda uppihaldspeningpay maintenance(t.d.unmarried fathers should pay maintenance)2(við skilnað til konu og barn/børn) maintenance3(við skilnað bara til konu) alimony(t.d.women living on alimony)
uppihaldsskylda	obligation to support sby;vanlig fyrisett uppihaldsskyldastandard allowance, statutory allowance
uppihaldsskyldugur	liable to pay maintenance/alimony; síuppihaldspeningur
uppihaldsstova	common room(t.d.á studentagarði)
uppií	(included) in (sth), taken into account, counted (in);stuttleiki skal vera uppiífun must be part of it;nógv fólk var hjástatt, og uppií vóru brøður hansaramany people were present his brothers among them;nógv ómarkað var uppiíseveral unmarked lambs were in the flock of sheep;duga uppií[know parts of a long ballad by heart and thus be able to participate in the singing when sby else leads];tosa uppií(of children) cut in with a remark
uppikastaður	(fl.m.)unable to get any further with sthorsucceed in sth;hann stendur ikki uppikastaðurhe can give tit for tat; he can give as good as he gets
uppikipping	subjectel.topic of conversation whose purpose it is to make fun of sby;hava e-t til uppikippingaralways talk about sth
uppikipsan	síuppikipping
uppilagstur	(sigl.)retired from fishing; uppilagsturskipariretired skipper
uppiløga	[state of being unable to go out fishing due to bad weather]
uppiløgudagur	[day when one doesn't go out fishing due to bad weather]
uppiseta	staying up, sitting up
uppisetur	íosb. vera í uppisetri við e-m/e-t1run out of sth, out of stock, be empty, bare, lacking in, used up, consumed;handilin var í uppisetri við vørurthe shop had run out of merchandise;ein dagin var hon í uppisetri við teone day she had run out of tea2báturin er í uppisetrithe boat is unuseable (old)
uppistøða	síuppstøða
uppivið	íosb.sumhar hongur annað uppiviðthere is sth at the bottom of this; (okkurt lúnskt) there is a catch in it somewhere
uppiyvir	above, over;ein pottur hekk uppiyvira pot was hanging over the fire
uppí	1(until sth is full);fáa uppíget a full load of fish;lata sær uppítake a fill (of tobacco);skalt tú ikki hava uppí aftur?shall I pour you some more(t.d.tea//coffee)?2in addition, add to this that, moreover, furthermore, besides, in addition;uttan forføll koma uppíthat is, if there is no unavoidable absence;byggja uppímake additions; (tíðum) add/build a new wing;rokna uppícount (in), include, take into account;skoyta uppímake longer, extend, lengthen; add3fara uppíjoin the ring of dancers;nú komu øll tey vaksnu uppíthen all the grown ups joined the ring of dancers4broach to;leggja bát uppíbroach to;halda bátin uppídraw the boat ahead against the wind
uppíblanding	intervention;(niðr.)meddling, interference
uppíbygging	addition, extension;gera uppíbygging til eini húsbuild an extension to a house
uppídráttur	1gathering of storm2continuous (bad) weather
uppílegging	1intervention;(niðr.)meddling, interference2(sj.)contribution (to a debateordiscussion)
uppíløga	uppíløgaí dagsins kjaka contribution to today's issue; síuppílegging2
uppímillum	1(intervene, interpose between two parties, between two combatants) in between;tú mátti lagt uppímillumyou should intervene;koma uppímillumget in between two combatants2occasionally, sometimes, now and then, from time to time;ein lítil linni var uppímillumoccasionally there was a pause/break/rest
uppímóti	into the windorwaves, head the sea, breast the waves;leggja bátin uppímótibroach to
uppíroknaður	included, including, inclusive of
uppískoyti	addition, supplement; insertion; uppískoytitil ensku-føroysku orðabókinasupplement to the English-Faroese dictionary
uppítaldur	included, including, inclusive of
uppítøka	inclusion
uppkallaður	called, named;drongurin er uppkallaður eftir abbanumthe boy is named after his gradfather
uppkallari	caller
uppkalling	calling, naming(eftir e-mafter sby);siðurin við uppkalling er gamalit is an old family traditions to name sby after sby
uppkarvaður	cut into pieces; síkarva(upp)
uppkast	1(ítr.)drop ball, [ball dropped by the referee]2(rough) draft(t.d.of a book//of a document//of a novel); sketch(t.d.of a picture//of a plan); (rough) outline(t.d.of a plan); (rough) design(t.d.for a dress//a building//a piece of furniture);gera uppkast til e-tprepare/make a draft of sth
uppkastaður	1síuppikastaður2(um garð, of stone wall) made in a hurry
uppkiptur	short-necked
uppkláring	(eis. fl.m.)settling (of accounts); (skrivlig) account, bill, statement (of account); síklára(upp)
uppkleyraður	trampled down; miry, muddy, slushy;teir fóru eftir uppkleyraðari gøtuthey went along a muddy path
uppkneptur	unbuttoned;í uppkneptum frakkain unbuttoned overcoat
uppkolaður	burned down, charred(t.d.the charred remains; the charred bodies of the victims)
uppkoma	1beginning, rise;uppkoman av føroyskum handilsskapithe beginning of Faroese commerce2the beginning of the flow of the tide (sísjóvarfall)3source(t.d.of a spring)4sunriseormoonrise
uppkomandi	accessible;einasta stað, har ið uppkomandi er í Oknadalithe only accessible place is in Oknadalur
uppkomin	síkoma(upp)
uppkók	parboiling, parboil;lat mjølbollarnar í og lat teir fáa eitt uppkókput in the dumplings/doughballs and parboil them
uppkyknaður	síkykna(upp)
uppkynding	firing, stoking
uppkyndur	síkynda(upp)
upplaðing	[the act of building a stone wall]
upplag	(um bók) print run, (um blað) circulation;stórt upplag(um bók) large print run/ impression; (um blað) wide/large circulation;fyrsta/annað upplaga first/initial/second print run
upplagdur	1washed ashore;inn móti helluni, har hin fíni, hvíti sandurin var upplagdurin towards the flat rocky shore on which the fine, white sand had been washed ashore2(of fish) landed;nógvur fiskur verður upplagdur í Klaksvíkmuch fish is being landed in Klaksvík3væl//illa upplagdurin high spirits/in good humour/cheerful/in a cheerful mood//in low spirits/depressed4schemed, plotted, hatched (plots);uppløgd ráðscheming, schemes, wiles, plot(t.d.defeat sby's plot)
upplatandi	which can be opened
upplatari	1corkscrew2tin-opener;(am.)can opener
upplatin	opened; sílata(upp)
upplating	opening
upplatingardagur	opening day
upplatingarhátíð	opening ceremony, inauguration (ceremony)
upplatingarsýning	(sjónl.)opening performance
upplatingartíð	(tá ið upp verður latið) opening time; (meðan upplatið er) hours(t.d.we don't do business after hours)
upplegg	1things washed ashore2plan;uppleggið hjá føroyska liðinum var at verjathe Faroese team planned to stress the defence3discussion paper, consultation document; uppleggtil orðaskifti
uppleitandi	investigative (t.d.reporting), outreach (t.d.staff, worker), itinerant (t.d.theatre)
upplesari	reciter;(sjónv, útv.)newsreader, newscaster; upplesarií útvarpinumradio newsreader
upplestur	reading (aloud), recitation(t.d.he gave readings from Shakespeare)
upplimur	(likam.)arm(flt fakl. eis.upper extremities)
upplit	look, appearance, expression;hann hevur gott//ringt upplithis appearance is attractive//unattractive
uppliva	experience, meet with(t.d.many adventures); live through(t.d.we have lived through five depressing years), go through, be through(t.d.he has been through a good deal);vit upplivdu nógv á ferðiniwe saw many things on our journey;hann upplivdi eina sanna gleðihe experienced true joy;aldri havi eg upplivað so yðjandi lívnever have I experieced such teeming life
upplivan	(sj.)síuppliving
upplivilsi	(tlm.)síuppliving
uppliving	1(royndir) experience2(ævintýr) adventure3(gleðiligt, áhugavert) treat(t.d.it was a treat to see him//to listen to him)4(spennandi) thrill(t.d.I got a certain thrill out of it)
upplivingarbúskapur	experience economy (t.d. she says that we are living in an experience economy)leisure economy (t.d.the country has a thriving leisure economy)
upplíva	encourage, enliven
upplívandi	cheering, heartening, enlivening, exhilarating; (ressandi) stimulating, bracing, encouraging; upplívandiorðheartening words
upplívgan	encouragement
upplop	1short-lived enterprise, momentary movementorcommotion;felagið hevur higartil vaksið seg javnt, so tað vísir seg ikki bert at vera eitt upplopthe society has had a steady growth so it would be wrong to label it a flash in the pan;hatta tíðarritið er bara eitt upplopthat magazine is here today and gone tomorrow2(viðv.arbeiði, performance) person who jumps up like a lion and falls down like a lamb3splashing, lapping; upplopí sjónum (av streyminum)the sea has become rough (caused by the current)
upploysa	upployst evni solute; síloysa(upp)
upploysing	1(tilgongdin, the process) dissolving, dissolution(t.d.on dissolution in water alkalis turn red litmus blue)2(úrslitið, blandingin) solution(t.d.a strong solution of salt; acidel.alkaline solution)3(rot) decomposition(t.d.the body was in an advanced state of decomposition), decay4disintegration(t.d.the disintegration of matter under the influence of radiation)5(at detta sundur) disintegration(t.d.disintegration of the Roman Empire);kreppa og upploysing er í samfelag okkaraour country is in a state of crisis and disintegration6dissolution(t.d.the dissolution of an association); (tingið verður heimsent) dissolution; (strikaðel.avtikið) liquidation, winding up, dissolution7(sjónv,myndaupploysing) picture resolution, picture definition
upploysingarevni	1solvent2(sigl., viðv.radara, radar) discrimination
upploystur	dissolved
upplyftur	1raised, lifted;mínar upplyftu hendurmy raised hands2in high spirits, in good humour, cheerful, in a cheerful mood; elated;hon var so glað og upplyftshe was delighted and elated
upplýsa	1throwel.shed light on, elucidate(t.d.a matter; a question); enlighten(t.d.in order to enlighten the public on this point); inform(t.d.the public)2explain, clarify, account for;síðan upplýsti brúðgómurin alt fyri konginumthen the bridegroom clarified the situation for the King;upplýsa e-n um e-texplain sth to sby;upplýst fólkeducated people;(sø.) upplýst einavaldenlightened despotism
upplýsing	information;fáael.geva upplýsingargive/supply information;til upplýsingar um Føroya miðøldto the elucidation of the Faroes during the Middle Ages;upplýsingar um felagið (handilsm.)general information;skeivar upplýsingarincorrect statements;villleiðandi upplýsingarmisleading statements
upplýsingarátak	informational campaign
upplýsingardobling	(kortsp.)take-out double, informatory double
upplýsingarmeld	(kortsp.)approaching bid
upplýsingarsamband	data connection
upplýsingarskylda	(tá ið trygging verður teknað) duty to disclose all material facts
upplýsingartíðin	the (Age of) Enlightenment
upplýsingartænasta	information service
upplæra	sílæra(upp)
upplærdur	trained, educated
upplæring	education, training, upbringing
uppløga	síuppiløga
uppløgutíð	síuppiløga
uppmálaður	depicted, painted
uppmáldur	measured, sureveyed
uppmáling	measuring, survey(t.d.the survey was started in 1895); (uppmálingarhátturin) surveying(t.d.various applications of mapping and surveying); (av rúmd) gauging;gera uppmáling(make a) survey
uppmáting	síuppmáling
uppmerking	1marking-out2note, (í dagbók) entry;uppmerkingar í dagbókinientries in the diary
uppmikil	large in the upper part of the body
uppmýldur	toothless,uppmýld kellingtoothless old woman
uppnevna	(løgfr.)appoint;umboðsmaður kongs uppnevndi løgrættunathe King's representative appointed theløgrætta
uppnos	1sudden roughorchoppy sea;tað er eitt sovorðið uppnosthe sea has suddenly become choppy2íosb.sumikki fáa uppnos1not get a word in edgeways;hon tosaði so nógv, at eg fekk ikki uppnos fyri hennishe spoke so much that I could not get a word in edgeways;teir vóru so illir, at vit fingu ikki uppnosthey were so furious that we were not able to interpose/put in a remark2rest, repose;hon gevur sær ikki uppnosshe never gives herself a moment's rest;eg havi so nógv at gera, at eg fái ikki uppnosI am up to the eyes in work that I can't rest for a minute;hann fær ikki uppnos, sum hann leikar í
uppnýggja	repair(t.d.a house; road; roof; car; ship); renovate(t.d.the house has been completely renovated); recondition(t.d.the central heating system); remodel(t.d.a house; a flat); refurbish(t.d.old furniture)
uppnýggjaður	renewed, reconditioned; síeis.endurnýggjaður
uppnýggjan	renewal, renovation, reconditioning, remodelling, refurbishing; síeis.endurnýggjan
uppogniðurvask	spring-cleaning
uppraktur	unravelled; síeis.rekja(upp)
uppráddur	having run out of; uppráddurfyri pengarhaving run out of money
uppreiddur	(of bed) made;uppreidd songa bed that is made; síreiða2(upp)
uppreiðing	making of a bed
uppreising	síuppreisn
uppreisn	1(átr.)resurrection; uppreisnlikamsinsthe resurrection of the body2(fyri tort) reparation, satisfaction(t.d.demand satisfaction for an insult); redress, amends; (hevnd) revenge;teir fingu uppreisn fyri ósigurin/tapið í fyrra dystinumthey got even in the return match
uppreisnarloyvi	(løgfr.)leave to appeal
uppreist	(sj.)síuppreistur
uppreistrarandi	disaffection; rebelliousness
uppreistrarfelagsskapur	revolutionary organization
uppreistrarherur	rebel army
uppreistrarleiðari	rebel leader, revolutionary leader
uppreistrarmaður	rebel
uppreistrarrørsla	insurrectionaryel.revolutionary movement
uppreistrarstjórn	rebel government
uppreistur	rebellion, revolt, uprising;fólkið gjørdi uppreistur móti einræðisharranumthe people rose in arms against the dictator
uppreittur	irritated, exasperated, provoked, teased, baited; síreita
uppreksan	rattling off, reeling off, enumeration;(niðr.)rigmarole, screed
upprendur	1(bát.)sheer fore and aft;báturin er nógv upprendur (til endarnar)the boat is sheer fore and aft2turned-up;hava upprenda nøshave a turned-up nose/a pug-nose/a snub-nose
uppringing	(telephone) call;eg fekk eina uppringingI got a (telephone) call
uppris	1surf, breakers; upprisí sjónumthe sea is rough2(fl.m.)disturbance;øll skúlastovan kom í uppristhe classroom was in an upheaval
upprisin	risen from the dead
upprit	1note;eg gjørdi nøkur upprit undir fyrilestrinumI took some notes during the lecture2minute, memorandum, record3account, report, (stytt) summary; uppritav orðaskiftinuma summary of the debate
uppritsbók	notebook
uppriv	(sj.)showdown, confrontation, clash;hann gjørdi uppriv um máliðhe provoked a showdown concerning the matter
uppríkaður	who has made a fortune, rich, wealthy
upprodnaður	blushing, flushed, deep red
upprokning	reeling off, rattling off, enumeration
upproyndur	having swept the fishing grounds clean (of fish);longumiðið varð upproynt og longan uppfiskaðthe fishing ground for ling has been fished out
uppróp	(sj.)declaration, statement;teir sendu eitt uppróp út til fólkthey sent out a statement to people
upprunafella	(oljuv.)original trap
upprunafólk	the original inhabitants; (um frumstadd fólk,eis.)the aborigines;upprunafólkið í Nýsælandi eru maoriarthe Maoris are the original inhabitants of New Zealand
upprunafrøði	(málfr.)etymology
upprunafrøðiligur	(málfr.)etymological;upprunafrøðilig orðabóketymological dictionary;upprunafrøðilig stavsetingetymological spelling
upprunafrøðingur	etymologist
upprunagreina	(málfr.)etymologize; upprunagreinaorðetymologize a word
upprunahandrit	original manuscript
upprunakykna	(lækn., lívfr.)stem cell
upprunaland	country of origin
upprunaligur	1original(t.d.aim; idea; meaning; plan; text); (fyrstur av sínum slag) original, earliest, first, primeval, primordial(t.d.the primordial form of a religion; the primordial cell from which life developed), aboriginal(t.d.the aboriginal population); (óspiltur, ónomin) pristine;tann upprunaliga ætlanin er sleptthe original plan has been abandonded;tann upprunaliga orðingin er broyttthe original wording (text) has been changed;hjupprunaliga2(jarðfr.) primary;upprunalig steinsløgel.grótsløgprimary minerals or rocks
upprunamál	1original (language);úr//á upprunamálinumfrom//in the original;skaldskapur á upprunamálinumliterature in the original2nativeel.indigenous language
upprunamerking	(málfr.)the original meaning of a word
upprunaorðabók	etymological dictionary
upprunarit	(løgfr.)script
upprunaskapur	originality; primitive character
upprunaskjal	(løgfr.)script
upprunaslag	primitiveel.primeval form, original form, form from which sth stems
upprunastaður	place of origin
upprunatilfar	(the) original(s)(t.d.use photocopies - we cannot accept responsibility for the originals)
upprunatýdningur	(málfr.)síupprunamerking
upprunaváttan	(handilsm.)certificate of origin
upprunaverk	(bókm.)work, bookel.literature in the original
uppruni	origin(t.d.the origin of this scheme; the origin of all our misfortunes); origins(t.d.his humble origins); (um framleiðslustað) origin(t.d.goods of British origin); source(t.d.the original source of this belief); (føðing) genesis, birth(t.d.the birth of Greek civilization); (á orði) derivation; av útlendskum uppruna (um vørur, siðiro.tíl.)of foreign origin; (um ætt) of foreign extraction;(lívfr.)exogenous, allogenous;av innlendskum uppruna(um vørur, siðiro.tíl.)of domestic origin;(lívfr.)endogenous;orð av sama upprunacognate words;av ivasomum upprunaof doubtful origin
upprunnin	arisen, stemmed from, come from, originated in;søgan tykist verða upprunnin í gomlum døgumthe story is most likely of ancient origin
upprúgvaður	accumulated, piled up
upprúm	(likam.)auricle, atrium (í hjarta)
upprúmsflákran	(lækn.)auricular flutter
upprætnaður	(um króko.tíl,of hook or the like) straightened outorup;krókurin var upprætnaðurthe hook had been straightened out/up
upprættur	1upright, on end, raised, erected; straight, erect;eg kundi standa upprættur undir tekjuniI could stand upright under the roof2við upprættum hondumwith raised arms3(plfr.)(um grein, legg, of branch, stem) erect
uppsagdur	dismissed, discharged; (um embætismanneis.)removed;(herm, eis.)dismissed from the service; fired, sacked, got the sack, got one's cards
uppsagnaráseting	(í sáttmála) denunciation clause
uppsagnardagur	1term of notice2(sigl.)cancelling day,(st.)c.d.;vera ov seinur til uppsagnardaginmiss the cancelling day (ísamb.við leigusáttmála;c.d.er allar síðsti dagur, skipið skal vera búgvið at ferma)
uppsagnarfráboðan	term of notice
uppsagnarfreist	term of notice
uppsagnarløn	severance pay, redundancy payment
uppsagnartíð	term of notice
uppsagnarumsókn	letter of resignation;lata inn uppsagnarumsókngive in/tender/send in one's resignation
uppseldur	sold out(t.d.the edition is sold out; all the tickets for the theatre were sold out);bókin er uppseld (eis.)the book is out of print;(sjónl., eis.)full house
uppsending	(teld) upload
uppseting	1(sjónl.)production, staging;bæði uppseting og spæl eiga rósboth the staging and the acting have been laudably executed2wording, text;teir vildu broyta uppsetingina, sum nevndin hevði gjørtthey intended to change the committee's wording3layout(t.d.the layout of an advertisement//a page)4(tele.)configuration, edit
uppsettur	1tucked up, set up;genturnar stóðu við uppsettum skjúrti í ánnithe girls were standing in the stream with tucked up skirts2(of boat in stormy weather) having sought shelter (in another village or place)3(sjónl.)produced, staged
uppsiða	(sj.)educate sby in good manners;hon uppsiðar okkum til at avnokta gudloysishe educates us to renounce atheism
uppsiðing	1(sj.)teaching of good manners2good manners, good form
uppsikt	look, appearance, expression;hann hevur góða//ringa uppsikthis carriage is errect//slack
uppsitarahús	tenant's house, (garður) tenant's farm
uppsitari	tenant, lessee of land
uppsíða	top side
uppsjóvarfiskur	(fisk.)pelagic fish
uppskakaður	terrified(t.d.he was terrified to hear what had happened), appalled, dismayed, horrified(t.d.he was horrified at the murder of his friend), horror-struck; (einans sum umsagnarliður) aghast(t.d.he was aghast);(serst.moralskt) shocked(t.d.I am shocked at his conduct)
uppskakandi	terrifying, awful, terrible, horrible, dreadful, frightening, horrifying, shocking, scary; uppskakanditíðindidreadful news
uppskering	[the act of cutting up a pilot whale]
uppskerptur	(of air-dried fish and meat) which has become too hard and dry
uppskipaður	(sigl.)unloaded, unshipped, landed, discharged, disembarked;farmurin verður uppskipaður í Havnthe cargo is to be unshipped in Tórshavn
uppskipan	(sigl.)unloading, discharging, discharge, landing
uppskipanarpláss	1(sigl.;har uppskipað verður) discharging berth2(atkomustaður) place of discharge
uppskiping	síuppskipan
uppskjørkaður	wild, shy, timid;ærin er uppskjørkaðthe ewe is wild
uppskorin	1(of sheep's carcass) [cut into pieces for division between the owners]2(of pilot whale) cut up;hvalurin er uppskorinthe whale has been cut up3(um torvheiðar, of peat bogs) dug up;nógv uppskornir torvheiðarmuch exploited peat bogs4(um haga, of outfield) with ditches for drainage; uppskorinhagian outfield with many drainage ditches
uppskorpnaður	hard and dried up
uppskot	1proposal;samtykkja uppskotaccept a proposal;vraka uppskotreject(el.turn down) a proposal;uppskot til samtyktar (stjm.)Proposal for Parliamentary Resolution2(tilráðing) suggestion3(stjm.)motion; reject a motion;uppskotið varð einmælt samtyktthe motion was carried unanimously;uppskotið varð samtykt við stórum meirilutathe motion was adopted by an overwhelming majority;uppskotið er samtyktthe motion is carried;uppskotið er falliðthe motion is lost;atkvøða fyri uppskotivote for a motion;atkvøða um uppskotvote on a motion;taka undir við uppskotiendorse a motion4(lógaruppskot) Bill;leggja uppskot fyri tingiðintroduce a bill, bring in a bill;vraka (lógar)uppskotreject/throw out a Bill;uppskotið varð vrakað (eis.)the Bill was defeated5(serst.hjá nevnd) recommendation(s)6[íyms.samb.]vera í uppskotibe recommended for a post, be put forward as a candidate for a post;hann er í uppskoti til fundarformannhe is proposed as chairman
uppskotin	1turned-up;nøsin var reyð og uppskotinthe nose was red and upturned2síuppskot6ogskjóta(upp)
uppskotssetari	proposer, mover
uppskrift	1text, recording, notes, manuscript;uppskriftir av kvæðumearly recordings of ballads2recipe (for);baka kaku/køku eftir uppskriftmake a cake from a recipe
uppskriftabók	notebook
uppskrivaður	written down, noted, recorded;søgurnar eru uppskrivaðar eftir manna munnithe stories are based on oral tradition
uppskrivari	recorder(t.da recorder of oral tradition)
uppskriving	1writing down; registration, recording;kvæðauppskrivingrecording of ballads2(bú., handilsm.)revaluation,(am.)revalorization
uppskrýddur	rigged out, dressed up to the nines, smartlyel.sprucely dressed;(niðr.)bedizened, tarted up, flashy;býurin var uppskrýddur við fløggumthe town was beflagged/full of flags
uppskræddur	torn, cut up
uppslag	1bill, poster, (kunngerðartalva) notice2(t.d.á brókum/buksum) turn-up,(am. eis.)(trouser) cuff; (á ermu) cuff3(tónl.)up-beat
uppslagsorð	síleitorð
uppslagstalva	notice board; (hjá virkio.tíl. eis.)bulletin board
uppsleptur	sísleppa(upp)
uppslitin	worn out
uppsloppin	(skúlam.)removed
uppsmoygdur	rolled, tuckedorturned up(t.d.trousers);við uppsmoygdum ermumwith rolled-up sleeves
uppsnákaður	smartenedorspruced up, tidy, clean and smart;hon var uppsnákað í stuttum skjúrti og silkisokkumshe was spruced up in short skirt and silk stockings
uppsneiddur	bent upwards, turned up;við uppsneiddari nøswith a turned-up nose, pug-nosed, snub-nosed
uppsnissaður	sly, wily, crafty; cunning; síbesnissaður
uppsnollaður	smartenedorspruced up;hon var so uppsnollaðshe had smartened herself up
uppsnúgvin	(plfr.; um legg)ascending
uppsókn	tracking (down), tracing; investigation, enquiry (into), research (into);gera uppsókn um brótsmannthe tracking down of/the search for the criminal;gera uppsókn um hannfind out where he has been, trace his movements
uppsparing	sísamansparing
uppspentur	stretched, strained to breaking point; wide-opened;hon stardi upp á hann við uppspentum eygumshe was staring wide-eyed at him
uppspretta	síuppkoma3
uppsprotnaður	come unsewnel.unstitched; come apart at the seams;kjólin er uppsprotnaðurthe dress is coming apart at the seams
uppspuni	invention, fabrication, made-up story;ein blandingur av uppspuna og veruleikaa mixture of fabrication and facts
uppspunnin	fictitious, imaginary(t.d.person, name); made-up; síspinna(upp)
uppspurdur	come to light, turned up, disclosed; found out, learned
uppspurn	hon vildi hava uppspurn um, hvør ið hevði dripið hannshe insisted on being told as to who had killed him; síuppspurningur
uppspurningur	íosb. fáa uppspurning um e-tfind out (sth), discover the whereabout of sby//sth, get to know sth
uppspurt	íosb. fáa (e-t) uppspurtfind out (sth), discover the whereabout of sby//sth, get to know sth;nú var tað uppspurt, hvaðan hann var ættaðurnow they had found out from where he came
uppspæl	(ítr.)forward play;hann var góður í uppspælinum og tetti væl í verjunihe was excellent in the forward play and was a good defender too
uppstand	(sigl.)bulwark;uppstandið fór alt fyri borð, tá ið brotasjógvurin legði seg yvir skipiðthe bulwark was swept away when the breaker washed across the deck
uppstandandi	(sigl.)bulwark;alt uppstandandi soraðistall the bullwark was swept away
uppstandari	stanchion, upright, standard;espline connecting buoy and landline
uppstandilsi	(tlm.)excitement, stir, fuss, outcry;tað var eitt uppstandilsi, hin gamli var í luftinithe house was turned upside-down, the old man (the father) was in a rage
uppstásaður	síuppskrýdduroguppsnákaður
uppstig	1heavy surforbreakers;tað var eitt øgiligt uppstigthe surf was vicious2nausea, sickness;eg havi sovorðið uppstig í dagI feel like vomiting3disturbance, noise, din, commotion, excitement;gera uppstigkick up a row, make trouble
uppstiga	(teld) upgrade
uppstiging	(teld) upgrade
uppstilling	nomination, putting up, (valevni) candidature;(serst. am.)candidacy
uppstillingarfundur	selection meeting
uppstillingarval	(am.)primary (election)
uppstígingar	síuppstig2
uppstrammari	(tlm., drykkur)bracer, stiffener, pick-me-up; tonic(t.d.it acted like a tonic)
uppstrekki	(stfr.)ordinate
uppstrika	(skúlam., í bókstavi)upstroke;í bókstavinum "i" er ein uppstrika og ein niðurstrika(í skrift, in writing) the letter "i" has one upstroke and one downstroke
uppstríddur	exhausted, tired out, worn-out, all in(t.d.I am all in), dog-tired, dead tired, tired to death, dead beat;hann var uppstríddurhe was worn out
uppstrok	(tónl., við violinboga)up-bow
uppstrokin	well dressed and presentable;hon er altíð so uppstrokinshe's always well-dressed
uppstøða	1beginning, start; uppstøðaog niðurløgaalpha and omega, beginning and end;tað var uppstøða og niðurløga hjá pápanum: " Tú verður aldri konfirmeraður"time and time again my father filled mye ears with warning about my never being confirmed;har var mín uppstøðathat was my beginning, that's where I began2sticks to support forms3[(loose) snow which blows up from the mountain tops (betokens windy weather)]
uppsvølpaður	swollen, puffed up, puffy, tumefied; uppsvølpaðurí andlitia puffed-up face;hendurnar á monnunum eru uppsvølpaðar av salti og kuldathe men's hands are swollen from salt and cold
uppsøgn	(frá arbeiðsgeva) notice of dischargeel.dismissal, notice, discharge; (frá arbeiðstakara) (notice of) resignation;fáa uppsøgnbe discharged, receive a notice of discharge
upptak	1clearing (up); difficulty in clearing (up);tað er stórt upptak aftan á slíka veitsluthere will be a lot of clearing up to do after such a party2(oljuv.)cleanup3(stb.)surf, breakers4quick perception, understanding
upptaking	lifting (of potatoes, turnipsetc)
upptakingartíð	lifting season (of potatoes, turnipsetc)
upptaksútgerð	(oljuv.)cleaning up equipment
upptakt	(tónl.)upbeat
upptaldur	sítelja(upp)
upptandur	síúttandur
uppteljing	counting, count;(hagfr.)census;(sigl.)tallying;uppteljing av bókumbook census;goymsluuppteljingstock-taking
upptikin	1(one's share in a catch of pilot whale hunt) brought to the house and salted (down);ikki alt varð upptikið, tí lítið var fólkið2included;vísan er upptikin í Føroya kvæðithe ballad has been included in Corpus Carminum Faeroensium3recorded, taped4(of boat) pulled up on dry land5(um epli, røtur, of potatoes, turnips) lifted, harvested;eplini eru upptikinthe potatoes have been lifted/harvested6(from the sea) hauled in;línan er upptikinthe fishing line has been hauled in7(um seyð, of sheep) brought in, caught (strange sheep);eitt hvítt veðurlamb er upptikið í Norðskála hagaa white male lamb has been (caught) brought in from the outfield of (the village of) Norðskáli
upptil	on the upper part of the body;hann er breiður upptilthe upper part of his body is big
upptjúknaður	having put on much fat, grown very stout
upptornaður	dried-up(t.d.pond; stream); dry(t.d.river bed; pond); (um plantulut) dry(t.d.branch); withered, sapless
upptrekkjari	corkscrew
upptrungin	distended, bloated;kúgvin er upptrunginthe cow's belly is distended;eg eri so upptrungin av matiI've had so much to eat I feel absolutely bloated
upptrútnaður	swollen, puffed up, tumefied
uppturkaður	1(with a dish cloth) wiped up, mopped up2dried-up(t.d.pond; stream); dry(t.d.river bed; pond);ein uppturkaður hylurdried-up pond
uppturking	1wiping up, mopping up(t.d.of water)2drying up, draining, drainage
uppturkingarlappi	dish cloth
upptúsnaður	swollen, puffed up, tumefied; upptúsnaðurí andliti,sítúsna
upptúsning	swelling; (umt.d.neyt, of cattle) distension
upptústur	(stb.)síupptúsnaður
upptýsnaður	(sj.)síupptúsnaður
upptærdur	wasted(t.d.wasted hands; he is terribly wasted); emaciated, worn to a shadow, worn away, haggard, gaunt
upptøka	1admission(t.d.of a new member; admission to a school; to the UN)2nøkur tespilig upptøka verður tað ikkiit won't be a pleasant job to clean it up; síupptak13[what is taken up at one time,espwhen fishing with line]4the catch(espon a fishing line)5síupptak26(í frímúraralosju) initiation7publication (of newspaper material)8(lmynd.)taking (of photographs), exposure(t.d.I have taken three exposures of it);(viðv.filmi) shooting(t.d.the shooting took place in Klaksvík); frame(t.d.there are 12 frames per spool);(viðv.filmi: útgáva) version(t.d.I only know the old version of the film); (stakupptøka) shot(t.d.there are some good shots of the boatrace); scene, sequence, take9recording(t.d.tape recording); (útvarpssending) recorded programme10lifting(t.d.of potatoes)11(um dýr ið ganga inniá hjá øðrum) impounding(t.d.of cattle)
upptøkualdur	age of admission
upptøkugjald	1(løgfr.)[fee paid on submission of a case for judgment]2(í felagio.tíl.)admission fee
upptøkuhøli	recording room
upptøkumaður	recorder
upptøkunevnd	admission board
upptøkuorð	(málfr., sj.)sítøkuorð
upptøkuroynd	(skúlam.)entrance exam, entranceel.admission examination
upptøkurúm	recording room
upptøkusiður	initiation rite
upptøkutal	(av studentum) intake(t.d.a yearly intake of intake)
upptøkutól	(lmynd.)camera; (til ljóð) recorder
upptøkutreyt	terms of admission
upptøkuumsókn	application for admission
upptøkuætlan	(filmiviðv.)shooting script
upptøvdur	much fulledormilled
uppum	1over;leypa uppum, har garðurin er lægstur (eis. fl.m.)jump over where the fence is the lowest2wear out, go into holes;slíta/traðka uppumwear out;hosurnar eru uppumthe socks are in holesskógvarnir vóru traðkaðir heilt uppumthe shoes were worn out/down at heel
uppumslitin	worn out;í uppumslitnum skómin worn-out shoes
uppundan	1up, peep through(t.d.green shoots peeping through the soil);eplabløðkurnar koma uppundanthe sprouting leaves (of the potato plant) are coming up;standa uppundanproject over the sea2manage, come out all right;hesir pengar høvdu hjálpt teimum uppundanthis money would have helped them to get on their feet again;hann kemur ikki uppundan afturhe won't survive financially on his own
uppundir	1(supported) from below2[ísamb.viðs]styðja uppundir; bera uppundir; birta uppundir; eggja uppundir; leggja uppundir; taka uppundir(sísagnorðinisumleitorð)
uppundirris	[sudden surf in calm weather which betokens strong wind from the opposite direction]
uppundirsveising	overhead weld, overhead welding
uppúr	out of sth, up from sth;hyggja/kveita uppúrlook up while working;hann arbeiddi sum fyri lívinum og kveitti ikki uppúrhe was working very hard and did not look up;standa uppúrrise, stand up, tower (over sby//sth);leggja uppúrtake the food out of the pot and put it on the table
uppúrlagdur	taken out of the potorsaucepan(t.e.the food is on the table);nú er uppúrlagtdinner is ready
uppvaking	resurrection
uppvaknaður	awakened
uppvaknan	awakening
uppvaksin	grown-up, bred;hon er uppvaksin á bygdshe is country-bred
uppvakstrartíð	(childhood and) adolescence, youth
uppvandur	sívenja(upp)
uppvarpaður	beel.ride at anchor;vit lógu uppvarpaðir væl norðari og nærri landiwe were riding at anchor much farther north and closer to the shore
uppvask	1(tað at) washing-up2(tað ið verður uppvaskað) dishes;uppvaskið var fingið frá hondinithe dished had been washed up
uppvaskari	dishwasher
uppvaskibakki	draining tray
uppvaskibust	washing-up brush
uppvaskievni	detergent; washing-up liquid
uppvaskifat	washing-up bowl,(am.)dishpan
uppvaskimaskina	automatic dishwasher
uppvaskirúm	scullery
uppvaskistativ	dish drainer
uppvaskivatn	1dishwater, slops2(skemt.)very thin soup
uppvenjari	(pedagokur) educationalist, educationist; (lærari) teacher
uppvenjing	upbringing; (útbúgving, skúlagongd,o.tíl.)education;sum snýr seg um uppvenjingeducational;geva henni góða uppvenjinggive her a good upbringing/a good education;hava uppvenjinghave manners/breeding;hvørja uppvenjing hevur hon fingið?what sort of an upbringing/education has she had?;hann hevur onga uppvenjinghe has no manners; he lacks breeding;harða/stranga uppvenjinga strict upbringing
uppvenjingarháttur	method of upbringing; child-rearing method
uppvið	(the child) can stand up when leaning on sth;barnið dugdi at taka seg uppviðthe child was able to stand up (when leaning againste.g.a wall)
uppvikaður	receding (hairline);hann er nakað uppvikaðurhe has a receding hairline; he is receding
uppvísing	sísýning,framsýning
uppvísingar-	sísýningar-
uppvøkstur	childhood and) adolescence, youth;í uppvøkstri hansaraduring his adolescence(el.youth);tarnaður í uppvøkstrinumstunted (in one's growth)
uppvørpa	(tøkn.)overhead projector
uppyngdur	rejuvenated, restored to youth;hann kom aftur so uppyngdur, spelkin og mjáurhe returned rejuvenated, agile and slender
uppyvir	over the fire;heingja pottin uppyvirhang the pot over the fire
uppøsandi	exciting; inciting, inflammatory
uppøsari	agitator, demagogue
uppøsing	excitement, agitation; exasperation;til stóra uppøsing fyri onnurto the exasperation of others
uppøstur	1excited, agitated, whipped up; exasperated;alt fólkið var uppøstthe people was in a state of agitation2wind-swept;uppøst havwind-swept sea
ups	[slope ending in the cliff edge]
upsa	(sj.)síups
-upsaður	sítvør-
upsastovnur	coalfish stock
upsastræti	(kvæð., kenn.)sea
upsatorva	shoal of coalfish
upsaveiða	coalfish fishing, coalfish fishery
upsi	(fisk.)large, mature coalfish (seiður)(Pollachius virens)
ur	watch;armbandsurwrist watch;lummaur(pocket) watch
uran	(evnafr.)uranium;ríkað uranenriched uranium
Uranus	(stjfr.)Uranus
uratkvøða	sífrumatkvøða
urð	scree, talus (pile of largish stonesorboulders as a result of a landslide)
urðargeypa	(dýr.)desert lynx, caracal(Lynx caracal)©iStock
urðarglopur	spaceorgaps between boulders;í urðargloprum eigur fuglurbirds build/make nests in the gaps between boulders
urðargrell	(sj.)young children; urðargrelleru smábørnurðargrell are young children
urðargrót	large boulders in a scree
urðarhúsagras	(plfr.)wood-meadow grass(Poa nemoralis)
urðarkálvi	síurðarkálvur
urðarkálvur	1small scree2spur of a scree
urðarketta	(bíbl.)wild cat
urðarkoma	(gl.)large amount, large quantity
urðarkona	(fugl., sj.)síurðnakona1
urðarkovi	(sj.)síurðarkálvur1;(tilt.) sum í einum urðarkova[very untidy, littered, covered with litter, in a mess]
urðarkumli	síurðarkálvur1;(tilt.) sum í einum urðarkumla(very untidy, littered, covered with litter, in a mess)
urðarlag	síurðarkálvur1
urðarlendi	terrain with many boulders, terrain with many screes
urðarseiður	(kvæð., kenn.)dragon, wivern, wyvern
urðarseyður	(dýr.)[sheep which graze in a scree]
urðarskrápur	(fugl.)scopoli's shearwater(Calonectris diomedea)(Scopoli, 1769)© Wikimedia Commons
urðarsmog	narrow passage in a scree
urðarsteinur	large boulder in a scree
urðartrøstur	(fugl.)common rock thrush(Monticola saxatilis)(Linnaeus, 1766)Monticola saxatilis ©iStock
urðarveðrur	(dýr.)ram which grazes in a scree
urðnakona	1(fugl.)one-year-old puffin;(tilt.) hatta sær út sum ein urðnakona(of a big and clumsy woman)2(stb.)young razor-bill in its first year3(stb.)young guillemot
urðut	(stb.)(terrain) with many screes
urga	1(tónl.)organ;spæla á urguplay the organ;spæla á urguniplay on the organ;urga við 4 manualumfour-manual organ2(niðr.)organ;DagblaðiðurgaFólkafloksinsthe Dagblaðið the organ of the Faroese People's Party (the Fólkaflokkur)
urgan	(kvæð.)síurga
urgansleikari	síurguleikari
urgansleikur	síurguspæl
urganspípa	(kvæð.)síurgupípa
urgansspæl	síurguspæl
urgubrús	(organ) peal, pealing, swell
urgukorall	(tónl.)voluntary, choral prelude
urguleikari	organ player, organist
urguleikur	organ playing
urguljóð	organ tone
urgupípa	(tónl.)organ pipe;opin//afturlatin urgupípaopen//closed organ pipe
urgurødd	organ stop
urgusmiður	organ builder
urguspæl	(á urgu) organ playing; (tónsett til urgu) organ music
urguspælari	organ player, organist
urgutal	(sj.)íosb. í urgutaliinnumerable, numberless, countless(t.d.books; people; times); without number(t.d.times without number); untold(t.d.during untold centuries)
urketa	watch chain
urn	(sj.)low humming or buzzing noise(t.d.frá æðum, from eider ducks)
urna	1(um kettu, of cat) purr;kettan urnarthe cat is purring2hum;mamman urnar yvir barninum3urnast1(um smábarn, of baby) be restless, whimper, cry;barnið liggur og urnastthe baby is whimpering2(stb.)be busy3(stb.)live, settle, try to hold one's own
urni	(fisk., sj.)small halibut
urnikvæði	growling, muttering(expr.of bad moodorhumour)
urniljómari	(fugl.)common grasshopper warbler(Locustella naevia)(Boldaert, 1783)©Sergey Yeliseev
urnisongur	síurnikvæði
urpt	(dýr.)brood; (um akurhønu) covey; (um egg) clutch;fyrra//seinna urptthe first//the second brood;tá var loyvt at taka fyrru urpt av eggjumat the time it was allowed to pick the first brood;missa urptina(um hønu, of hen) stop laying eggs;tapa urpt(umt.d.gás, of goose due to cold weather) stop laying eggs;rapla urpt,sírapla; síeis.løga
urreim	watch strap
urs	(said to a bull when a cow is being served),urs, urs!
ursa	1(stb.,um tarv, of bull) serving a cow;tarvurin ursaði kúnnithe cow was served by the bull2(stb.)fidget(t.d.sit still and don't fidget!); wriggle(t.d.the little boy wriggled in his seat);ursastwork in a clumsy manner
ursi	1old bull2tall, stout and clumsy man
urskiva	dial, face of a clockora watch
ursmiður	watchmaker, clockmaker
ursur	(stb.)bull
urt1	(plfr.)plant, herb, growth (not ligneous);grøðandi urtirmedicinal plants, herbal remedies,(gl.)simples
urt2	wort, infusion of malt
urt3	síurpt
urtaføði	(sj.)sígrønmeti
urtagarðabýur	garden city;urtagarðaforstaðurgarden suburb
urtagarðafelag	1association of allotment owners; (garðsetursfelag, kolonihavafelag) allotment garden society2horticultural society
urtagarðsamboð	gardenel.gardening implement, garden tool
urtagarðsarbeiði	gardening, garden work
urtagarðsblóma	garden flower
urtagarðsbonkur	garden seat
urtagarðsbrúk	gardening, horticulture
urtagarðsfrøði	horticultural science
urtagarðsfrøðingur	horticultural graduate
urtagarðsgarður	garden wall; garden fence
urtagarðsgøta	garden walk, garden path
urtagarðshús	(stuttleikahús) summer-house; garden shed
urtagarðslið	garden gate
urtagarðslæra	síurtagarðsfrøði
urtagarðsmaður	gardener
urtagarðsmøplar	garden furniture
urtagarðsplanta	(plfr.)garden plant
urtagarðsportur	garden gate
urtagarðsskúli	horticultural school
urtagarðsslanga	garden hose
urtagarðsveitsla	garden party
urtagarðsvinna	horticulture, gardening
urtagarðsyrki	gardening, horticulture
urtagarður	garden; (til kryddurtir) herb garden; (til grønmeti) kitchen garden; (lítil) vegetable patch
urtagóður	lush;her er so urtagottanything will grow in this soil;tann bøurin er urtabetrithe soil of that field is better
urtakervil	(plfr.) søtur urtakervilsweet cicely(M. odorata)
urtapílur	(plfr.)dwarf willow(Salix herbacea)©Richard Droker
urtapottafjalari	flowerpot bowl, ornamental flowerpot, cache-pot, planter
urtapottaskál	flowerpot saucer
urtapottur	flowerpot, pot;seta í urtapottpot(t.d.a plant);taka upp úr urtapottiunpot
urtasuppa	vegetable soup
urtate	herbal tea
Uruguai	(sern., landafr.)Uruguay
uruguaibúgvi	Uruguayan
uruguaiskur	Uruguayan
Uruguei	síUruguai
USA	(st.) (sern. landafr.)the USA, the US
usbeki el.usbekari	Uzbek
usbekiskur	Uzbek
Usbekistan	(sern., landafr.)Uzbekistan
utopiskur framtíðarskaldskapur	utopian fiction [sum lýsir umstøðurnar hjá fólki í hugsaðari eydnugóðari samfelagsskipan, soleiðis sum rithøvundurin kanska kundi hugsað sær hana]; sídystopiskur framtíðarskaldskapur
uttan1	1from outside (inwards); uttanav havifrom the open sea;uttan úr heimifrom abroad2from, from the outer side of sth; on the outside, externally;bæði uttan og innanboth without and within3(gl.)what else, except;hvat er uttan stórur kalvi!what else but a large halibut!4[ísamb.viðfs]uttanáon the outside of, over(t.d.he wore two shirts, one over the other); uttaná klæðunumover one's clothes;hon kastar eitt bundnaturriklæði uttan á segshe throws a woollen shawl across her shoulders;uttanfyri/(el. gl.)fyriuttanoutside;uttan fyri húsinioutside the house;búgva uttan fyri býinlive outside the town;eiga barn uttan fyri hjúnalaghave an illegitimate child;vera uttan fyri ESnot be a member of the EU;uttanumaround, round;krákan vappar uttan um ungarnarthe crow walks round its young;teir trunkaðust uttan um hannthey crowded(el.pressed) round him;uttanyvir:hon tók eitt sjal uttan yvir segshe put a woollen shawl across her shoulders5[sumfs]1on the other side;uttan duraoutside the house;(stn.) uttan Á(on the other side of the river)2without; uttanmat og klæðiwithout food and clothes;uttan ivano doubt;uttan vitunconscious;eingin uttan egI only;eg sá ongan uttan tegI saw no one but you;øll vóru har uttan egthey were all there except I/me
uttan2	1unless;eg fari ikki, uttan at tú kemur viðI'm not going unless you come with me;eg fái einki gjørt, uttan (at) tú hjálpir mærI can do nothing unless you help me;eg komi ikki, uttan so er, at ...I won't come unless...2but;hann kom ikki higar, uttan fór beina leið heimhe did not come here but went straight home;uttan eg sigibut then I say
uttanat	by heart(t.d.I know it by heart; learn sth by heart); (heldurniðr.)by rote(t.d.learn//say sth by rote; he knows it by rote)
uttanatlæra	cramming, gettingel.learning by rote; rote learning;(tlm.)parrot-learning, learning parrot-fashion
uttanav	remove from the outside (of);hann koyrdi pappírið uttanav pakkanumhe removed the paper from the parcel
uttaná	outside, on the outside;teirra góðska var mest uttanátheir friendliness was mostly pretence
uttanáskrift	(t.d. á brævi, on a letter)address
uttanbíggjar-	from another village, extra-parochial; non-resident(t.d.voters); non-local(t.d.mail; members)
uttanbíggjarfólk	people from another village
uttanbíggjargenta	girl from another village
uttanbíggjarjørð	[land which is not owned by the people of the village]
uttanbíggjarmaður	man from another village
uttanborða	síuttanborðs
uttanborðaður	síuttanborðs1
uttanborðs	1(sigl.,uttan fyri skips-el.bátssíðu) outboard, outside the ship, on her outside;skipsbáturin hongur uttanborðsthe ship's boat is hanging on her outside2(fyri borð) overboard(t.d.fall overboard; throw sth overboard);hann fór uttanborðshe fell overboard3(sigl.;út fyri lúnningo.tíl.)overside(t.d.haul sth overside);fríholtslisti uttanborðsrubbing strake
uttanbredda	(jarðfr.)extramarginal
uttanbygdar-	síuttanbíggjar-
uttandura	1out-of-door, outdoor(t.dgames, life, work)2[sumhj] outdoors(t.d.live//sit//sleep outdoors); out-of-doors; out(t.d.sleep out);barnið skuldi ikki uttandura, áðrenn tað var doyptthe child was not allowed to be out-of-doors until it had been christened
uttanduraður	outdoor, out-of-door, out, outside;so títt og knapt útklykt var, var hann uttanduraðurthe church bell had hardly struck the last stroke before he was out
uttanduraklæði	t h24outdoor clothes(flt),outdoor things(flt)
uttanduraupptøka	(lmynd.)outdoor shot; (um filmeis.)exterior shot
uttaneftir	from withoutoroutside, from abroad, from places further out along a fiord;tíðindi uttaneftirforeign news
uttanfelagsmaður	non-member;blaðið kostar 15 kr. fyri limir og 20 kr. fyri uttanfelagsmennthe newspaper costs 15 kroner for members and 20 kroners for non-members
uttanflokka	(stjm.)outside the parties;(stjm. eis.)be an Independent;hann stillaði upp uttanflokkahe ran (for election) as an Independent, he stood for Parliament as an Independent
uttanflokkamaður	(stjm.)independent, outside the parties;(serst. am.)mugwump
uttanfóta	(r)hj on the outer side of the foot;jarkin er uttanfótathejarkiis the outer side of the foot
uttanfyri	outside;hann stóð uttanfyri og bíðaðihe was waiting outside (the house)
uttangarða	síuttangarðs
uttangarðaður	(stb.)outsid the infield, in the outfield
uttangarðs	in the outfield;tað, ið er innangarðs kalla vit bø, tað, sum er uttangarðs, kalla vit hagathe infield is calledbøur,the outfield is calledhagi
uttangarðsjørð	outfield
uttangarðsmørk	(stb., gl.)sheep marks
uttangátta	(r)hj(sj.)out of the house, outside
uttanhanda	íosb. tað er so uttanhandait is inconvenient/awkward;tað var so uttanhanda onga mjólk at hava í húsinumit was awkward that we never had any milk in the house(i.e.that we had no cow);tað var so uttanhanda fyri lærararnar, at teir ongar orðabøkur høvdu at halda seg tilthe teachers felt it awkward that they had no dictionaries at their disposal
uttanheimur	abroad, foreign countries or parts (the World outside the Faroes)
uttanhjarta	(tøkn.)eccentric
uttanhjartaður	(tøkn.)eccentric(t.d.bearing; bush(ing); motion; press; shaft)
uttanhýsis	outside the door; externally
uttanhýsisarbeiði	outdoor work
uttanhýsisfólk	[perons who are not part of the householdorthe family]
uttanhýsismeting	external evaluation
uttanhýsispróvdómari	(skúlam.) external examiner
uttanífrá	from outside, from abroad, from another village;ein maður uttanífráa stranger;ljóðið kom uttanífráthe noise came from the outside;vit mugu fáa hjálp uttanífráwe must ask for help from outsiders (from another village//from abroad)
uttankirkjufólk	nonconformist
uttanklædna	regarding outer garments
uttanklæða	síuttanklædna
uttanlands	abroad; foreign, overseas;ferðast uttanlandstravel abroad
uttanlandsferð	journey abroad;uttanlandsferðir (eis.)travel abroad, foreign travel;júst heimkomin av uttanlandsferðjust back from abroad
uttanlandshandil	foreign trade
uttanlandsmál	foreign affairs
uttanlandsnevnd	(stjm.) uttanlandsnevndinthe Foreign Affairs Committee
uttanlandspostur	post from abroad
uttanlandssigling	foreign trade;skip i uttanlandssiglingship (engaged) in foreign trade, foreign-going vessel
uttanlandsskuld	(bú.)foreignel.external debt
uttanlandstíðindi	foreign news
uttanleggja	[on the outer side of the calforlower leg]
uttanleiðarbrunnur	(oljuv.)step-out well, outstep well
uttanlendis	síuttanlands
uttanliða	íosb. tað liggur uttanliðathe cow has a prolapsed uterus
uttanlíkindi	external condition
uttanlæra	(sj.)síuttanlærs
uttanlærs	[on the outer side of the thigh]
uttanmaður	1stranger, man from another village2man from a village further out along a fiord
uttanoyggja	1goingorsailing round an island;fórt tú ikki uttanoyggja, so varð farið gjøgnum Sundalagiðif one did not sail round the island one sailed through theSundalag(the sound between Streymoy and Eysturoy)2abroad;hann eygleiddi alt, sum fór fram uttanoyggjahe kept himself well-informed as to what happened abroad
uttanpartastøða	neutrality
uttanríkis	foreign
uttanríkisfarstøð	(flogm.)international air terminalel.air station
uttanríkishandil	(bú.)foreign trade
uttanríkismál	(stjm.)foreignel.external affairs
uttanríkismálaráð	(stjm.)síuttanríkisráð
uttanríkispolitikkur	1foreignel.external politics (, policy); (tíðum) foreign affairs(t.d.interested in foreign affairs)2policy;ein nýggj støða í bretskum uttanríkispolitikkia new situation in British foreign policy
uttanríkispolitiskur	(stjm.)relating to foreignel.external politics, policy; foreign-policy(t.d.adviser; decisions); (tíðum) foreign(t.d.affairs); external(t.d.the external situation);uttanríkispolitiskt tíðindafólka writer on foreign affairs
uttanríkisráð	(stjm.)Ministry for/of Foreign/External Affairs; Foreign Ministry; (í Bretlandi) Foreign and Commonwealth Office; (í USA) State Department(GG:tíðum verður staðarnavnið nýtt, t.d.the Quai d'Orsay, París;(sø.)(the) Wilhelmstrasse, Berlin)
uttanríkisráðharri	(stjm.)Minister for/of Foreign/External Affairs, Foreign Minister; (í Bretlandi) Secretary of State for Foreign and Commonwealth Affairs; Foreign Secretary; (í USA) Secretary of State
uttanríkisruta	international route
uttanríkistíðindafólk	foreign correspondent
uttanríkistænasta	foreign service
uttanroyndarligur	metaphysical
uttanroyndarvísindi	metaphysics
uttanrætta	íosb.sumtaka seyð uttanrættacatch sheep without driving them into a sheepfold by overtaking them and rounding them up with the help of a dog
uttanrættar-	1(løgfr.)(done) out of court, extrajudicial2[sumhj] out of court, extrajudicially
uttanrættarbót	(løgfr.)out-of-court fine, extrajudicial fine
uttansníkur	(dý.) ectoparasite
uttansóknar	extra-parochial
uttanstokka	(bát.)síuttanborðs1
uttanstrok	(nýy.)outsider; síeis.outsiderí ensk-føroysku orðabókini
uttansyndis	outside the fiords and sounds, outside the islands
uttantil	externally, on the outside; uttantilá húsunumon the outside of the house
uttantings	(stjm.)extraparliamentary, extraparliamentarian
uttanum	round
uttanumtos	irrelevant talk;latið okkum tosa um málið, og latið alt uttanumtos liggjalet's talk about the case in hand and stop beating about the bush
uttanumvik	(løgfr.)evasion
uttanvegaakfar	off-road vehicle, off-roader; eis.lendisakfar
uttanveggja	out, outside, out of the house
uttanvelta-	neutral
uttanveltaður	1neutral;Svøríki er uttanveltað landSweden is neutral,(stjm. eis.)uninvolved; non-aligned(t.d.states)2impartial, unprejudiced, unbiassed, disinterested, detached(t.d.a detached observer)
uttanveltapolitikkur	policy of neutrality
uttanveltastøða	policy of neutrality, neutralism;brot á uttanveltastøðuinfringement/violation of sby's neutrality;yvirlýsing um uttanveltastøðudeclaration of neutrality; proclamation of neutrality
uttanvert	right on the outside of;teir vóru uttanvert við hannthey were (situated) right on the outside of him;teir halda seg uttanvert við streingin suðureftiron the way south they kept right on the outside of the narrow, strong tide race
uttanvirknaður	(handilsm.) externality; smb.innanvirknaður
uttanyvir	over;hann hevði frakka uttanyvirhe was wearing coat;ert tú í ongum uttanyvir?you are not wearing any outer garments?; are you in your shirt sleeves?
uttar	farther out (seen from the centre of the house); uttarí dyrout in the entrance;far uttar í forstovunago out into the hall;deknurin fer uttar eftir gólvinumthe parish clerk walks along the (centre) aisle towards the entrance
uttareftir	farther out (in the building);hann hevði reist seg og fór uttareftirhe had got up and was walking in the direction of the(t.d.entrance)
uttari	1[l]which is farther out or away;Uttara Dalsáthe Outer Dalsá2[sumhj] farther out or away;uttari við dyrnar(out) in the entrance;uttari í durunum(out) in the doorway;konan stákaðist uttari í stovunihis wife was busy preparing(t.d.for a party) in the drawing room
uttarlaga	1fairly far outordistant;grindin lá uttarlaga áthe school of pilot whales was farily far out at sea;teir vóru uttarlaga staddirthey were fairly far out at sea2near the entrance
uttarumegin	on the outside of something
uttastur	1farthest outoraway, most distant2[sumhj]uttast,uttast við vaks vælon the fringe the vegetation was lush;hann mátti skifta øll klæðini frá uttast til innasthe had to change all his clothes
-utur	(eftirfesti), sít.d.át-, bekl-, berskøll-, blik-, bøll-, fesj-, flekk-, fræn-, gjørð-, gróm-, grugg-, kløtr-, krill-, lubb-, omm-, pesj-, pink-, pokn-, rond-, skrøgg-, skør ð-, sokk-, túgv-, vingl-, vørm-, ørg-
