á1	1river(t.d.the Murray is the largest river of(el.in) Australia; a swift(-flowing) river), stream, brook,(am. eis)creek,(skotskt eis.)burn;Tigris áthe (river) Tigris;Jordan áthe (river) Jordan;áin tekur seg upp í Alpunumthe river takes its rise(el.the river rises) in the Alps;áin rennur ígjøgnum fruktbart lendithe river runs through fertile country;áin rennur út í Miðjarðarhaviðthe river falls(el.flows) into the Mediterranean;við eina áby(el.near) a river; (um by, húso.a.)on a river(t.d.the town stands on the River Avon);eini hús við ánna (eis.)a riverside house;fossandi áa torrent, a torrential river2(sigl.) brúka ánnaprofit by the tide;(sigl.) hava ánna við særcome up with(el.be carried on by) the tide;(sigl.) hava ánna ímóti særhave the tide against one, come up against the tide;niðan eftir ánniup the river, upriver, upstream;oman eftir ánnidown the river, downriver, downstream3í osb: fara yvir um ánna eftir vatnicross the river in search of water; take unnecessary trouble;mangir løkir smáir gera stórar áirmany a little makes a mickle; every little helps;tað gekk sum eftir ánniit went very smoothly
á2	1(um flatael.linju) on, upon(t.d.on the beach, on the ceiling, on the chair, on the coast, on deck, on this earth, on the floor, on the ground, on the line, on page four, on the river, on the seas, on the table, hang on the wall, spots on the sun)(GG:upon merkir tað sama sum on, men verður sjáldan brúkt í talumáli);legg bókina á borðiðput the book on the table;fara umborð á skipiðgo on board the ship;skriva e-t á talvunawrite something on the blackboard2(um pláss hugsað sum eitt punkt) at(t.d.at the corner, at a place, at the top);(viðv.bygningiserl.tá ið hugsað verður um virksemi knýtt at honum) at(t.d.at the consulate, at the custom house, at the office, at the school, at the station, at the theatre, at the university)3(= innan fyri eitt økiel.rúm) in(t.d.in a café, in the country (á bygd), in the field(GG:on the football field, on the battlefield)); in the meadow, in the picture, in the pulpit, in a restaurant, in the sky, in the w.c., in the toilet); (um stórar oyggjar) in(t.d.in the Isle of Wight, in New Guinea, in Sicily; live in Malta); (um smáar oyggjar) on4(viðv.likamsparti) on(t.d.on one's knees, on one's toes, have a ring on one's finger, put gloves on one's hands; she wore a crown on her head);fóturin (beinini, armurin) á mærmy foot (legs, arm)5(um málel.endapunkt á rørslu) on to(t.d.climb on to the roof);(am.ofta skrivað onto); on(t.d.drop it on the floor); into(t.d. lata tað á fløskurput it into a bottle;fara út á bygdgo out into the country); to(t.d. eg fari á posthúsiðI am going to the post office)6(um tað ið hoyrir saman ofta samanseting við) of(t.d.the captain of the ship; the roof of the house; the leaves of the trees)7(ymsar tíðarfestingar) in,seint á kvøldilate in the evening;á morgniin the morning (at four in the morning);á sumriin (the) summer (, winter));seint á árilate in the year;tað var liðið á veturinlate in (the) winter(o.tíl.);at(t.d. á jólumat Christmas; á middegi at noon);á fjøruat low water(t.d.you cannot cross the bar at low water); ofbesta tíð á árinumthe best time of the year;langt út á náttinafar into the night, well into the small hours;nú á døgumnowadays8(viðv.aldri)á fimmti ára aldriat the age of fifty;á mínum aldriat my time of life, at my age;á ungum aldriearly (in life), at an early age;hann er á mínum aldrihe is my age9(um hátt) in(t.d.in this way(el.manner))10(um tungumál) in(t.d.in English; in any language);á føroyskum eftir ABtranslated (from the Englisho.s.fr.)by AB; Faroese translation by AB11(um eginleika, eyðkenni) byeg kenni hann á málinumI know him by his voice;fimur á fót(un)umswiftel.light on one's feet;fastur á hondinimiserly, stingy, tight-fisted;tungur á hondiniheavy-handed;hásur á málinumhoarse;lættur á særagile; light(el.quick) on one's feet12(um mát)á støddbe the size of(t.d.it is the size of an egg; he is about my size); be as big as13(nøvn á býarpørtum, gøtumo.ø.)in (, on)(t.d.he lives in the Market Square; in (, on) Oxford Street);(am.)on(t.d.he lives on Harvard Square, on Fifth Avenue)14(í smb. við ávís bygdarnøvn, staðanøvno.tíl.), in, at,á Eiðiat Eiði; (um vág, fjørð, havno.tíl.) skipið kom á Vestmannathe ship called(el.touched) at Vestmanna15(viðv.sinni, kenslum, kærleikao.tíl.) hava hug á e-mbe taken by sby;leggja ást á e-nhave a crush on sby;hon hevði álit á honumshe had confidence in him;vita á særhave a feeling that, have a hunch that;tá kom illgruni á teirthen they became suspicious16(í smb. við vindætt)á norðriwhen the wind is northerly17(fyri hvønn) of(t.d.2 cases of 25 bottles (each)); each containing(t.d.2 boxes, each containing 25 bottles); (um prís) at(t.d.5 bottles at 70 p. each)18í osb: á kroppisoaked, rain-soaked, drenched;á lívialive;ganga á oddago in front, lead the way;á tremurchock-full, chock-a-block, cram-full, crammed, packed;maður á manni el. kropp á kroppone after the other;nevna ánavni call(el.mention) by name;bíta á kampiswallow(t.d.one's resentment); control(t.d.one's temper);ganga á illumrutting, on heat,(am.)in heat;gevast á hendurthrow up the sponde, give up;hava á orði el. munnimention, make mention of;hava barn á bróstibe breastfeeding a child;á blikibleaching;standa á berum;sita eftir á berumhigh and dry;(vera) á fótumbe up19(saman við hjáorði)aftan á:after, in succession to(t.d.James II reigned after(el.in succession to) Charles II);aftur á:mala aftur á blóðiðreturn, go back;fram á:stumble across(el.upon);inn á:skipið kom inn á Havninathe ship called at, touched at Tórshavn;gera seg inn á e-nannoy, intrude upon;niðan á:ganga niðan á heygginwalk up the hill;oman á:on top of; above;og oman á altand into the bargain;hvat skulu vit hava oman á døgurða?what are we having for afters?upp á1for each, per2upp á seg hava nógv/lítið upp á segsignificant, insignificant;upp á segproportionally, proportionately3í osb: bera upp á e-tbe, fall on(t.d.the 13th of May is(el.falls on) a Sunday);bera upp á rímrhyme4bjóða e-m upp á málengage in conversation with sby; engage sby in conversation;taka e-t upp á tungunaspeak of, mention;læra el. rætta upp á e-nreprove, rebuke, reprimand, censure, take to task;upp á sítt besta el. tað bestain the prime of life;lættur upp á sporiðswiftel.light on one's feet;uppi á:hava e-t uppi á særon(t.d.I had no money (, papers) on me; have you a match on you?);vera uppi á gosibe stirred up;út á:gera út áthicken;úti á:úti á opnum havion the open sea;yvir á:hann kveitir yvir á hanahe glances at her20hj: tað er áthere is a rise!21av ogánow and then, now and again, occasionally, off and on, at intervals, from time to time
á3	(til at vísa m.a. iva, ovfarni, spurningo.tíl.)oh;á, heldur tú tað?oh, do you think so?
á4	síeiga2
áar-	(jarðfr.)fluvial
áararvi	(plfr.)Bog Stitchwort(Stellaria uliginosa)
áarbakki	river bank, riverside
áarbotnur	river bottom, river-bed
áarbugur	(landafr.) meander
áarbýur	riverine town
áardalur	river valley
áardampari	river steamer
áardun	roar of a river
áarduni	síáardun
áardúnurt	(plfr.)Chichweed Willowherb(Epilobium alsinifolium)
áarerla	(fugl.)grey wagtail(Motacilla cinerea)(Tunstall, 1771)©Alessandro Laporta
áareyrgrýti	(jarðfr.) fluvial conglomerate
áarfossur	waterfall,(skald.)cataract,(serl.lítil) cascade, (ikki loddrættur) rapidsflt,(stórur) fallsflt (t.d.the Victoria Falls)
áarføri	1swelling of a river2downpour, pouring rain, heavy rain, (ógvisligari) torrential rain;rættiligt áarføria regular downpour
áarførisdagur	rain(y) day
áargarður	embankment of a river,(am.)levee
áargil	gully
áargrein	branch of a river
áargrugg	river mud
áarhestur	(dj., sj.)síáarross
áarkallur	(fugl.)white-throated dipper(Cinclus cinclus)(Linnaeus, 1758)©iStock
áarkoppur	(plfr.)coltsfoot(Tussilago farfara)
áarlega	river bed
áarleið	riverway
áarljómari	river warbler
áarlop	flooded river; flood; (stórt) deluge
áarløka	(stb.)síáarløkur
áarløkur	brook
áarmaður	(Vágar) angler
áarmarra	river mud
áarmeldur	eddy, whirlpool
áarmerki	high-water mark, floodmark
áarmunni	síáarósi
áarmylla	síáarmylna
áarmylna	water mill
áarneliksrót	(plfr.)Water Avens(Geum rivale)© Wikimedia Commons
áaroyri,áraoyra	(jarðfr.)alluvial plain;(jarðfr.)floodplain
áarósi	mouth of a river, (breiður) estuary
áarprámur	(river) barge
áarross	(dýr.)hippopotamus(Hippopotamus amphibius)© Wikimedia Commons
áarsandur	river sand
áarsigling	river navigation
áarsíl	(fisk.)river trout© Wikimedia Commons
áarskrubba	(fisk.,stb.)dab(Limanda limanda)
áarsteinbrot	(plfr.)slag av steinbroti(Saxifraga rivularis)© Wikimeda Commons
áarstoytingur	síáarføri(2)
áarstreymur	tide in a river
áarsuð	rushing sound of a river
áarsvala	(fugl.)sand martin(Riparia riparia)(Linnaeus, 1758)©iStock
áartutl	purl, murmur
áartúsundblað	(plfr.)Alternate Water-milfoil(Myriophyllum alterniflorum)
áarurð	alluvial cone
áarvegur	(stn.)vegur fram við á
áarvøkstur	swelling (of a river)áarføri(1)
ábart	(óregl.)->ábært
ábati	yield, gain, profit
ábeint	straight, direct; right against
ábeking	endorsement
ábekja	endorse, back
ábekjari	endorser
ábending	1hint, indication, tip,hann gav honum eina ábending um taðhe gave him a hint about it;(oljuv.)show;(teld.)indication2(løgfr.)(piece of) circumstantial evidence;týðiligar ábendingara strong presumption(t.d.there is a strong presumption that he is guilty); weighty evidence(t.d.Counsel produced weighty evidence that he was innocent);døma e-n grundað á ábendingarconvict sby on circumstantial evidence
áberandi	accidental
áberi	(løgfr.)counsel for the prosecution, prosecuting counsel
ábersla	tinge, touch (of colour),hann hevði hvítt hár við gulari ábersluhe had white hair with a touch of yellow
ábindingarknútur	(sjóm.)sheet bend
ábindisknútur	síábindingarknútur
ábit	1breakfast2(stb.)snack
ábitaleysur	on an empty stomach
áblástur	(málfr.)aspiration
áborin	væl áborin well supplied; well equipped; portly, in good condition
áborist	síberast á
ábót	1improvement, repair, mending, patching2(á tekst) emendation3(gl.)addition, increase
ábreiða	(sj.)cover, covering, blanket
ábreiðsla	1reproach, reproof, reprimand, rebuke,geva e-m ábreiðslu (tlm.)talk to(t.d.I shall have to talk to him about his laziness), have a few words with; have (sby) on the carpet(el.mat); tick sby off;fáa eina ábreiðslu fyri at hava gjørt e-tbe reprimanded by sby for having done(el.for doing) sth;fáa eina ábreiðslu (tlm.)be on the carpet, be on the mat2manure
ábrek	(skaði) damage, (løstur) injury
ábreyt	(gl.)river bank
ábundin	síbinda á
áburra	(fisk.)perch(Perca fluviatilis)© Wikimedia Commons
ábúgvi	sííbúgvi
ábyrgd	1responsibility;frákannasær alla ábyrgddisclaim responsibility for it, wash one's hands of it;eg frákanni mær alla ábyrgdI refuse to accept any responsibility, I wash my hands of the matter;gera ábyrgd galdandimóti e-m fyri e-thold sby responsible for sth;leggja ábyrgdina á hannplace the responsibility on his shoulders, throw the responsibility on him; blame him for it;hannhevurábyrgdina av tíhe is responsible for it, the responsibility is his;ábyrgdinhvílirá honumthe responsibility rests with him;ábyrgdliggur á(t.d., responsibility for the Faroese economic policy resides with the Faroese government);taka áseg ábyrgdina av e-mtake(el.shoulder) the responsibility for sth; claim responsibility for;taka á seg sín part av ábyrgdinishare the responsibility, shoulder one's share of the responsibility;eintungábyrgda heavy responsibility;frælsiundirábyrgd[freedom with responsibility]; (samsvarandi ensk orðing er:) freedom subject to the consequences of the law;virka undir ábyrgdbe prepared to accept the responsibility for one's actions; be accountable for one's actions;við ongariábyrgd fyri okkumwithout responsibility on our part2(viðv.endurgjaldskravi) liability,avmarkaðábyrgdlimited liability;gera ábyrgdgaldandimóti e-m fyri e-t(krevja endurgjald) hold sby liable in damages for sth, claim damages from sby;(trygg.) ábyrgdsambærtlóginilegal responsibility, third party liability, public liability;sáttmálabundinábyrgdcontractual liability3(umt.d.politikara) responsibility, liability, accountability(t.d.a Minister's accountability to Parliament)4(skyld) blame(t.d.the blame for it lies at his door(el.rests with him))5(løgfr.)(kautión) surety6(løgfr.)guarantee, guaranty,(serl. í samb. v.lán) security;(am. eis.)collateral; (í sølusáttmála: fyri breki) guarantee, warranty;tað er 5 ára ábyrgd fyri hesum strúkijørnunumthese irons are guaranteed for five years; there is a five-year guarantee on these irons;full ábyrgda full guarantee;ábyrgd fyriguarantee for(t.d.quality);taka á seg ábyrgd fyri e-mundertake a guarantee for sth; guarantee sth; underwrite sth
ábyrgdaravkanning	exemption of liability
ábyrgdaravmarkandi	ábyrgdaravmarkandi klausul clause limiting liability
ábyrgdarblaðstjóri	editor responsible under the press law
ábyrgdarbræv	(postm.)letter of recommendation
ábyrgdarfrátøka	(løgfr.)indemnity,fráboðan um ábyrgdarfrátøkuletter of indemnity
ábyrgdarfullur	responsible;eitt ábyrgdarfult starva highly responsible task
ábyrgdari	(bú.)guarantor, surety, security, guarantee; (fyri virðisbrævaútgávu) underwriter;vera ábyrgdari fyriguarantee, stand surety for
ábyrgdarkensla	sense of responsibility
ábyrgdarleysur	irresponsible, wanton(t.d.the wanton destruction of animal life)
ábyrgdarloysi	irresponsibility, wantonness
ábyrgdarloysingur	wanton person
ábyrgdarmaður	(løgfr.)guarantor, surety, security, guarantee
ábyrgdarmikil	responsible;ábyrgdarmikið starva highly responsible task
ábyrgdarpeningur	(bú.)security capital; subordinate loan capital
ábyrgdarprógv	(bú.)warehouse receipt; (fyri vørugóðsku) written guarantee
ábyrgdartilvitin	responsible, alive to one's responsibilities; (samvitskufullur) conscientious
ábyrgdartrygging	(trygg.)public liability insurance; (um bilar,o.a.)third party (liability) insurance
ábyrgdartryggja	insure against third party risks
ábyrgdartryggjaður	third-party insured
ábyrgdarvandi	(trygg.)third-party risk
ábyrgdarváði	third-party risk
ábyrgdarvitska	sense of responsibility
ábyrgdarøki	field of responsibility; (hjá einstaklingieis.)purview;hava eitt sum ábyrgdarøkibe responsible for sth
ábyrging	responsibility, liability, accountability(t.d.a Minister's accountability to Parliament)
ábyrgingarfrælsi	freedom from responsibility
ábyrgingarfrælsur	free from responsibility
ábyrgjast	be (held) responsible for sth, answer for sth, be answerable for sth;hann skal ábyrgjast fyri taðhe is to be held responsible, he'll be called to account(tlm.)he is to be brought to book;hann kann ikki ábyrgjast fyri taðhe cannot be blamed for it; no blame attaches to him for it;hann ábyrgist fyri peninginhe is answerable for the money;felagið ábyrgist ikki fyri upphædd oman fyri £500the company is not liable for sums exceeding £500;(løgfr.) ábyrgjast at annar maður lýkur gjaldstreytirdel credere(t.d.the agent acts del credere(el.takes over the del credere)
ábyrgsla	1responsibility2hava í ábyrgslube in charge of
ábyrgur	responsible, liable, accountable, liable to be called to account (fyri for; mótvegis to, before);ábyrgt íognarfelagpartnership with personal liability of partners;navngivið íognarfelagpartnership in which the names of the partners are made public
ábæri	an exposed place, an exposed position
ábært	open to(t.d.it was open to every wind), exposed(t.d.in an exposed position)
ábærur	síábært
ábøting	improvement, repair, mending
Ádam	(sernavn)gamli Ádam kom upp í hann the old Adam came out in him;Ádam og Eva(eis.) our first parents
ádamsbúni	í ádamsbúnain my (, his, her, etc.) birthday suit, in the altogether
ádamsskógvar	í ádamsskóm barefooted, barefoot
ádeinging	hard ride
ádú	(til at vísa undrano.tíl.)really?, indeed?, is that so?; good heavens!, good lord!, good gracious!
áðni	recently, a little while ago
áðrenn	1sbbefore(t.d.I must see you before you leave); by the time that(t.d.by the time that you read this);áðrenn ár er umliðiðbefore a year has passed, within a year2fs (tlm.)before, prior to, previous to(t.d.before(el.prior toel.previous to) the King's arrival)
áður	1hjbefore, earlier, formerly(t.d.Namibia, formerly known as South West Africa); of old, in former days,áður í fyrndiniin the very earliest times2sbbefore
áðurnevndur	above-mentioned,áðurnevndi harra Xthe above-mentioned Mr X; previously mentioned; (hátíðarliga) aforementioned
áeggjan	prompting, impulse
áfall	(kvæð.)breaker
áfallin	1be unfair; have favourites(t.d.a teacher ought not to have favourites)2(um metal) oxidized(t.d.silver)3(um turt kjøt) moulded
áfalslitur	temper colour
áfast	fixed to
áfastur	1fixed to; continuous, unbroken2fighting; (í glímu) locked together3(um hund og tík ið makast) mating
áfatt	vera áfatt be the matter, be wrong, be amiss
áfesti	(alisfr.)adhesion
áfesting	(oljuv.) latch on
áflatur	slightly flattened
áfløði	(jarðfr.)transgression
áfok	(jarðfr.)wind deposit
áfram	further, further on, farther,halda áframcontinue
áfyllingarkrani	inlet
áfýsn	desire, craving; (kynslig) concupiscence
ágangandi	1aggressive, pushing; hard-hitting(t.d.advertising campaign, aid programme);(GG:adopt an aggressive stance)2lh nút: koma ágangandipass by chance
ágangin	síágangandi
ágangsmaður	aggressor, terrorist
ágangur	1pressure,vit vóru fyri hørðum ágangiwe were exposed to great(el.severe) pressure; strain(t.d.the mental and physical strain he had undergone); rough handling; push, shove, shake2pain, ache, pang,ringur ágangursharp(el.violentel.keen) pain;tá ið ágangurin var harðasturwhen the pain was at its worst
ágarnarbruni	(lækn.)appendicitis
ágáva	1fee;(í samb. v.kekkar, kontuavrit, fremmant gjaldoyrao.tíl.)(service) charge; perquisite;leggja ágávu ácharge a fee2(sø.)[tax which the king's farmers were to pay every three years]
ágeingin	(upprfr.) ->ágangin
ágerð	(alisfr.)action,ágerð og andgerðaction and reaction
ágirnd	desire, craving,ágirnd ið mettast ikkian insatiable craving
ágiti	fame, renown
ágonga	síágangur
ágongd	síágangur(1)
ágongdur	1síágangandi 22síárendur
ágonguseyður	(stb.)síáseyður
ágóði	profit,fáa ágóðan avderive profit from; gain,nettoágóðinet gain; benefit(t.d.the benefits of democracy)
ágrýtin	energetic, persistent, persevering, eager, keen(t.d.teacher), anxious,ágrýtin at fáa e-t gjørtanxious (, keen) to have sth done;ágrýtin forsprákari fyrifervent(el.zealous) advocate of;ágrýtin í tænastuassiduous, zealous, a person with a can-do attitude
ágrýtni	energy, persistence, perseverance, eagerness, zeal, tenacity of purpose
ágørn	1ágarnarcaecum2(lívfr.)appendix;fáa ágørnina tiknahave one's appendix out(el.removed)
áh	oh!, ah!, alas!
áhald	síáhaldni
áhaldandi	1undaunted, steady, persevering, indefatigable, untiring, dogged, undismayed;áhaldandi fólksticker;vera áhaldandi (eis.)persevere(t.d.persevere with(el.in) one's work), be capable of sustained effort2continued(t.d.continued bombing; the continued existence of the race); constant(t.d.fog, rain, pressure); sustained(t.d.applause, eloquence, high speed); prolonged(t.d.cheering, drought, spell of fine weather); persistent, unremitting, continuous(t.d.efforts); lasting(t.d.improvement); incessant(t.d.movement); unbroken(t.d.luck); unceasing, unintermitting, unintermittent, continual, continuous(t.d.gale, progress, showers); ongoing(t.d.negotiations)3(teld.)persistent4hj-ly(t.d.work doggedly; he is steadily at work on it); constantly, continuously, incessantly, persistently, unceasingly, unintermittently
áhaldin	síáhaldandi(1)
áhaldingarblað	síáhaldsblað
áhaldni	persistence(t.d.he admired her dogged persistence in pursuing the job; his persistence in asking for a raise was finally rewarded)
áhaldsi	handy implement
áhaldsin	1stumble, take a false step, trip2miss
áheitan	request(umfor)(t.d.my request for respite); (innilig) appeal (um for)(t.d.an urgent appeal for help); entreaty, plea; (skrivlig) petition, suit;eftir áheitanby request; as requested; (tá ið tað verður kravt) on request(t.d.the bus stops on request); upon request;eftir áheitan fráby request of, at the request of, at the instance of;eftir áheitan almannakunngera vitwe have been asked to publish;eftir hansara áheitanat his request;fylgja eini áheitancomply with a request;seta fram áheitan (um)make a request (for);gera eftir áheitangrant a request; (ESeis.)grant an application;innilig áheitanurgent request;senda hinum áheitan um atrequest him to;skrivlig áheitanapplication in writing;áheitan um úttalilsi(ES) request for an opinion;áheitan verður ikki tikin til eftirtektar(ES)(løgfr. uml. =)refuse the application
áherðing	1síáherðsla 22(málfr.)stress(t.d.the stress falls on the last syllable)
áherðsla	emphasis, stress,leggja áherðslu ámake a point of sth(t.d.of accuracy); stress sth, lay stress on sth, set great store by sth, attach (great) importance(el.weight) to sth(t.d.we attach great importance to this treaty)
áhildin	síáhaldandi
áhittin	inventive, ingenious
áhoyrari	hearer, listener
áhoyriligur	worth listening to
áhugabólkur1	interest group(t.d.the agricultural interest group);(viðv.frítíðarvirksemi) hobby group
áhugabólkur2	interest group(t.d.the agricultural interest group);(viðv.ítrivum) hobby group
áhugaður	interested, concerned;tey beinleiðis áhugaðuthose immediately concerned;áhugaðu partarnirthe interested parties, the parties concerned;vera áhugaður í el. fyri e-mbe interested in sth, take an interest in sth;(GG:SI'm not into that); (fíggjarliga) be interested in(t.d.a firm);vera áhugaður í at (t.e.síggja sínar fyrimunir við at) be interested in -ing(t.d.he is interested in increasing the profits); be anxious that(t.d.he is anxious that I should pass the exam); take an interest in -ing(t.d.he takes an interest in our doing well)
áhugafelag	interest group(t.d.the agricultural interest group); (í samb. við ítriveis.)hobby group
áhugafelagsskapur	community of interests
áhugaleikari	amateur actor
áhugaleysur	without interests, apathetic, dull
áhugaloysi	lack of interests, apathy, dullness
áhugamál	interest,andligáhugamál intellectual interests;vit havafelagsáhugamálwe have common interests; we have interests(el.tastes) in common;privatáhugamálprivate interests;hevði hannserligáhugamál ?had he any special interests? (handilspolitiskt) interest(t.d.British interests; our interests in China)
áhugasamur	interested, concerned
áhugaskriv	letter of interest
áhugavarpari	radio amateur
áhugaverdur	interesting, of interest
áhugi	1interest;tað hevur ongan áhugait is of no interest;hava eins áhugabe of interest to (el.for) sby;spurningurin hevur áhuga millum fólkthe question is of general interest;vantandi áhugilack of interest; (ofta =) incuriosity2[í samb.viðs]fáaáhuga fyri tí(begin to) take an interest in it, become interested in it;hevurtað áhuga?(tilboð) could I interest you in that?alt hevur áhuga(tá ið ein søkir sær arbeiði) anything considered;(ofta =)do anything, go anywhere;hava áhuga í politikkitake an interest in politics;tað hevur ongan áhugano interest attaches to it, it is uninteresting;hvønn áhuga skuldi eg havt í tí?what interest can I have in that?, what good is that to me?eg;missaáhugan (fyri) (tlm.)go cold (over), lose interest (in);skapaáhuga fyriarouse an interest in;varðveitaáhuganhold the attention;vekjahansara áhugaarouse his interest; interest him;tað vekir ongan serligan áhugait presents no (points of) particular interest; no particular interest attaches to it; it is not particularly interesting;taðøkir umáhuganit enhances(el.adds to) the interest, it gives it an added interest3[í samb.viðl] tað hevuronganáhuga fyri mítt viðkomandiit has no interest for me; it is of no interest to me; I am not interested (in it);havalivandiáhuga fyritake a keen(el.lively) interest in;havasøguliganáhugabe of historical (o.s.fr.)interest; present a historical (o.s.fr.)interest;einaferð tá ið tað ikki hevðistórvegisáhuga longur (eis.)at a time when it no longer greatly mattered;tað hevurserliganáhugait presents a special interest;tvørrandiáhugilack of interest4gera eittaváhuga fyri málinumdo sth for the sake of (el.out of interest for) the cause;stórur áhugi erfyritígreat interest attaches to it;hansara áhugiímálinumthe interest he took (, takes) in the cause;eg havi lisið bókinaviðáhugaI have read the book with interest
ája	ah!; well (well)!; certainly;ája, kom so meðniall right, come on then
ájavnt	1at the same height, on the same level;(fl.m.)be on a level with(t.d.he is on a level with the rest of the pupils); be up to the standard of(t.d.their cars are up to the standard of the British makes); be equal to(t.d.he is equal to the best American boxers); come up to(t.d.their results do not come up to ours); be abreast of; be on a par with(t.d.our air strength will soon be on a par with that of any other country2(sj.)parallel to
ájátta	consent (to)(t.d.consent to a wage reduction); (ofta um eitthvørt minni týdningarmikið) assent (to)(t.d.he assented to my opening the windows);(tlm. eis.)give one's nod, give sby the nod
ájáttanarsøk	(løgfr.)[trial in which the accused pleads guilty]
ájáttilsi	consent(t.d.he proposed to her and her parents gave their consent); approval, approbation; sanction;biðja um e-s ájáttilsiask sby's consent;fáa e-s ájáttilsiobtain sby's consent (til to);geva sítt e-s ájáttilsiconsent, assent (til to)
ájátting	síájáttilsi
áje	oh God!
ájú	certainly, of course, (speisk) indeed!
ákall	1(forml., teld.)invocation;(átr.eyðmjúkliga) supplication(t.d.she knelt in supplication)2(kensluliga) entreaty(t.d.despite her entreaties, he left; she held up her arms in entreaty)
ákalla	1(kalla á) invoke, call upon(t.d.the Muse, the saints)2(biðja um) beseech, entreat;(átr.)supplicate
ákallan	síákall
ákenn	feeling, instinctive feeling, sense, sensation
ákenning	síákenn
áklæði	(gl.)counterpane, coverlet, bedspread; bedcover
ákomandi	1l óbcommon, of common occurrence2l óbbeginning
ákomin	happened, occurred, taken place, come off, brought about
ákoyring	scolding,hann fekk ákoyringarnarhe got a dressing-down
ákoyrsla	prompting, impulse, urge, spur, incentive
ákrav	(løgfr.)claim, demand;eftir ákravion demand
ákæra1	1(løgfr.)accusation (of), charge (of), indictment (for), arraignment;ákæran var umhe (, she,o.s.fr.)was accused of(t.d.theft); the charge was(t.d.manslaughter);leggja fram ákæru ímótilay(el.prefer) a charge against;reisa ákæru ímótiaccuse sby (of), bring an accusation against sby (of); charge sby(fyriwith);seta undir ákæru fyricharge with, accuse of; (fyri rættin) prosecute for, put on trial for;vera undir ákæru fyri brotsverkbe charged with a crime;vera undir ákæru (eis.)be on trial2(skuldseting) accusation;(eis.) hann setti fram ógvisligar ákærur móti stjórninihe denounced the government violently;(fl.m.) vit eru øll undir ákæruwe all stand accused
ákæra2	1(løgfr.)accuse (of), charge (with);hann var ákærdur fyri stuldurhe was arrested on a charge of stealing;hann verður ákærdur fyri manndrápthe charge against him will be manslaughter;ákæra ein fyribring a charge(el.an accusation) against sby., indict sby. (for)2(skuldseta) accuse (of), charge (with);vera ákærdur fyribe(el.stand) accused of, be charged with
ákærdur	accused;(tann) ákærdi(í brotsmáli) the accused, the prisoner; (í borgaraligum máli) the defendant;sakførari ákærda(í brotsmáli) (the) counsel for the defence; (í borgaraligum máli) (the) counsel for the defendant
ákæri	(løgfr.)accuser; counsel for the prosecution, prosecuting counsel;almennur ákæriDirector of Public Prosecutions, Public Prosecutor;(am.)District Attorney, DA; (ES) procurator fiscal
ákæruaðalregla	[the principle that the burden of proof lies with the prosecution]
ákæruboð	order directing a prosecution
ákærubonkur	sita á ákærubonkinum be in the dock;seta á ákærubonkinput on trial
ákærufrágangur	(løgfr.)withdrawal of the charge(GG:the Attorney General entered a nolle prosequi)
ákærumál	(bill of) indictment
ákærumyndugleiki	síákæruvald
ákærunevningar	grand jury (nú avtikið í Ongl.)
ákærupunkt	count (of an indictment);hann varð fríkendur í sambandi við annað ákærupunkthe was acquitted on the second count
ákærurit	(løgfr.)indictment;skriva ákæruritdraft an indictment
ákærurøða	(ikki-løgfr.)denunciation;(løgfr.)speech for the prosecution
ákærutilfar	evidence;tað er nógv ákærutilfar ímóti honum (eis.)there is a strong case against him
ákæruvald	(løgfr.)(rætturin at reisa ákæru) the power to institute prosecution; (myndugleikin sjálvur) prosecution; (í Ongl.eis.)Crown Prosecution Service;umboða ákærumyndugleikanappear for the prosecution(el.the Crown);vitnisfrágreiðing fyri ákærumyndugleikanum (am.)state's evidence
ál	strap, belt, narrow strip;(orðt.) gott er at rista álir av annans mans húðum[this is easy to do at other people's expense]
ál-	síal-
ála	eis.ála sundurtear (in strips)
álagdur	ordered,honum varð álagthe was ordered to; laid down, imposed;álagdar skyldurimposed(el.laid down)
álakálvur	(fisk.)small eel
álaljómari	lanceolated warbler
Áland	the Aland Islands
álandsvindur	onshore wind
álaroðsla	eel-slime
álasipa	1whipping2bad scolding
álating	filling (bottling, casking)
álát	síálating
álegging	1laying-on; imposition2laying on of hands, touch,(t.d.cure by one's touch; touch a patient for a disease)
áleggja	1impose, order, prescribe, dictate;áleggja e-m at gera eittorder(el.enjoinel.directel.call upon) sby to do sth;honum varð álagt athe was ordered to;áleggja e-m eitt arbeiðiset sby a task, assign a task to sby; prescribe sby a task; order sby to perform a task; (um myndugleika ofta) direct(t.d.the Minister may direct any of the staff to perform any service required);áleggja e-m skyldu(r)impose(el.lay) obligations on sby; impose(el.lay) a duty on sby2(um greðing) serve,ryssan varð áløgd av hestinumthe mare was served by the stallion
áleiðis	1in progress; in process; in motion2fs (sj.)just opposite
áleikandi	topical, of current interest, of immediate importance, existing, very popular; (sum tosað verður um í løtuni) current(t.d.a discussion of current problems); ongoing(t.d.the ongoing discussion of incomes)
álendingur	inhabitant of the Aland Islands
álendskur	of (, from) the Aland Islands
áleypandi	1brash, aggressive; overbearing(t.d.an overbearing manner, she found him rude and overbearing)2(um lit, mynsturo.a.)garish(t.d.it's a little too garish for my taste), gaudy(t.d.gaudy clothes, gaudy colour), loud; glaring(t.d.a glaring omission / inconsistency / injustice)
áleypari	(fótb.)striker, forward (t.s.s.framherji)
áliðin	late
álinju-	(teld.)on-line
álinjusamband	(teld.)online
álit1	confidence, faith (in), trust, reliance (in, on),(t.d.the study programme concentrates more on group work and places less reliance on (= depends less on) lectures; I wouldn't place too much reliance on (= trust) these figures); have confidence in(t.d.the future, one's own abilities);blint álitblind(el.implicit) faith(el.confidence);fult álitcomplete confidence;hava álit áhave confidence in(t.d.the future, one's own abilities), place confidence in(t.d. sby'shonesty); put(el.repose) trust in, have faith in, put(el.place) reliance in, rely upon, trust (in);sum e-n kann hava álit ácredible;ikki at hava álit á (eis.)distrust;hava blint álit á e-m (eis.)trust sby implicitly;hava stórt álit áhave every confidence in;hava álit á e-mhave confidence in sby; trust sby;sum hevur álit uppiboriðdeserving of confidence, trustworthy, reliable(GG:she's a very steady friend and deserves my trust);eg havi einki serligt álit á honum íhaven't much confidence in him;hava álit á framtíðiniface the future with confidence;í aliti árelying on, trusting to(t.d.his promises); confident of(t.d.one's strength, the future); (okkurt frammanundan,eis.)on the strength of(t.d.a promise);vekja álitinspire confidence;tvørrandi álitwant(el.lack) of confidence, distrust;misbrúka e-s álitabuse sby's confidence;missa álitið álose confidence in, lose one's faith in;eg havi hansara álitI enjoy his confidence, he trusts me;eg seti álitið á hannI place confidence in sby;treytaleyst álitabsolute confidence, implicit confidence;hava treytaleyst álit átil trust implicitly, place implicit(el.every) confidence in;sýna álitshow confidence;sýna e-m álitshow sby confidence, trust sby,place confidence in sby;vekja álitinspire confidence
álit2	(committee's) report(t.d.the report of the committee is now before the public; the committee will report to the House; the report will be introduced in Parliament next week);minnilutaálitminority report;skriva álitprepare a report;uppkast til álit(ES) draft report;(endaliga) góðkenna eitt álit(finally) adopt a report;skriva álit um(um nevnd) report on, submit a report on; (um yrkiskøn) give an opinion on;endaligt álitfinal report;leggja álit fyri tingiðintroduce a report in Parliament
álitis-	dependable, reliable
álitisatkvøða	vote of confidence;krevja álitisatkvøðuask for a vote of confidence;vinna álitisatkvøðureceive a vote of confidence
álitisástøði	(løgfr.)[the theory that the rights created by a promise are determined by the reasonable expectations of the promisee]
álitisbrot	breach of confidence(el.trust)
álitisfólk	1(á arbeiðsplássi) shop steward (t.d.several shop stewards met yesterday to approve a strike ballot)2(í sendinevnd) delegate, deputy3(umboð) representative4(í trotabúgvi) assignee
álitisfulltrú	authority to bind the company (, the firmo.tíl.); veita harra A. álitisfulltrúentitle Mr A. to sign for the firm(o.tíl.);authorize Mr A. to sign by procuration;harra A. hevur álitisfulltrú í virkinumMr A. signs for the firm;taka aftur ta álitisfulltrú sum varð veitt honumrevoke(el.cancel) his power of attorney(el.his authority);tann álitisfulltrú sum varð veitt honum er tikin aftur frá í dag at roknaas from today, Mr X (o.s.fr.)no longer has authority to sign(el.to enter into commitments) on behalf of our company(o.tíl.); skriva undir fyri virki sambært álitisfulltrúsign for our firm (by procuration);sambært álitisfulltrúper procuration, per pro, pp.
álitisfulltrúi	confidential clerk, chief(el.managing) clerk, assistant general manager
álitiskvinna	1reliable woman2shop steward; (umboð) representative, deputy
álitismaður	1reliable man2mandatory, agent
álitismannafundur	meeting of shop stewards
álitismál	matter of confidence
álitismikil	trusting, trustful
álitismisbrúk	abuse of trust
álitisprógv	(sj.)síálitisváttan
álitissamband	relationship of trust;(løgfr.)fiduciary relationship
álitisskapandi	confidence-building
álitisstarv	honorary office; position of trust
álitisumboð	shop steward
álitisváttan	vote of confidence; declaration of confidence
álitisvekjandi	confidence-inspiring;vera álitisvekjandiinspire confidence
álits-	(sj.)síálitis-
álíkna	álíkna skatt assess taxes;álíkna e-m skattassess sby'staxes;skattur álíknaður teimum (eis.)the tax chargeable on them; the amount at which they are assessed
álíkning	assessment (of taxes);endalig álíkningfinal tax
álíkur	(kvæð.)be like, look like, resemble, be similar to
álítandi	1reliable, dependable, trustworthy(t.d.cashier, firm, people, person, worker); true, staunch(t.d.friend)2(eftirfarandi) reliable, truthful(t.d.person)3(um tíðindi) reliable, authentic, hard(t.d.hard news (, information));frá álítandi kelduon good authority(t.d.I have it on good authority); from a reliable source(GG:we are credibly informed that)4(um endurgávu) faithful(t.d.rendering, translation)5(um lutir) reliable(t.d.a reliable watch); dependable, safe(t.d.the rope is safe)6[íyms. samb.]geva álítandi mynd avgive a faithful picture of;álítandi minnireliable memory;álítandi háttalagsafe method;álítandi evni el. miðalan effective remedy;álítandi veðurreliable weather
áljóðandi	(tlm.)áljóðandi virðiface value, nominal value, sínavnvirði
áljósur	síalljósur
álka	(fugl.)razorbill(Alca torda)(Brehm, CL, 1831)©iStock
álkubøli	colony of razorbills
álkuligur	(sk.) í osb: nú fer tað álkuliga at síggjast hjá okkumwe are greying at the temples
álkupisa	(fugl.)young razorbill
álkusteffa	(fugl.)one-year-old puffin
álli	síállur
állur	(fisk.)eel,elektriskur állurelectric eel;hálur sum állur(as) slippery as an eel
álm	síálma
álma	eye of a fish-hook
álmanakkaár	calendar-year
álmanakki	calendar, almanac
álmunakkavís	(sk.)í álmunakkavís in large quantities
álmunakki	(tlm.)síálmanakki
álmur	(plfr.)elm(Ulmus)© Wikimedia Commons
álmussa	síolmussa
álmviður	elmwood
áloðin	síalloðin
álogandi	síallogandi
álop	1attack,álop er besta verjaattack is the best form of defence;gera álop álaunch an attack against; (brádligt) assault; (stormálop) charge, onslaught,blása til álopssound the charge; (skjótt) dash, rush(t.d.the Germans made a dash for Paris); (reiðálop) charge; (innrás) invasion; (flogálop) raid; (øði) aggression; (í bóltspæli) attack,offence, offense2(í orðum) attack; (ógvisligt) diatribe
álops-	offensive, attacking
álopsbylgja	(herm.)assault wave
álopsfylgi	attacking body(el.column)
álopskendur	offensive, attacking
álopskríggj	war of aggression
álopsleikari	(ítr.)(í fótbólti) forward; (í nýggjari uppstilling) striker; (eis.framherji)
álopsmál	objective
álopsmegi	attacking force
álopsmót	front (of attack)
álopsrað	(í fótbólti) forward line
álopsskipan	(herm.)order of attack, assault formation
álopsspæl	(ítr.)offensive play
álopsstyrki	attacking force
álopstyrla	(herm.)attack helicopter
álopsvápn	weapons of offence, offensive weapons
álur1	síállur
álur2	síál
álutur	(sj.)striped
álv1	síálma
álv2	síálvur2
álva1	(gl.) síalvi
álva2	síálvamoy
álvadansur	fairy dance, elf-dance
álvafljóð	(kvæð.)síálvamoy
álvagenta	
álvakendur	elfish, fairy-like, elfin
álvakerta	(jarðfr.)belemnite;(tlm.)thunderstone
álvakongur	king of the elves; the Fairy king
álvaland1	elfland; fairyland; Faerie
álvaland2	(skaldsk.)fairy land
álvaleikur	(kvæð.)fairy play, fairy game
álvalættur	light as a thistledown, gossamer(y)
álvamoy	(kvæð.)fairy woman, elf girl
álvara	1seriousness; (sterkari) gravity(t.d.the gravity of the situation); earnestness2[íyms.samb.]eitt er skemt annað álvarajoking apart;varðveita álvarapreserve one's gravity, keep a straight face;nú gjørdist tað álvaranow it was becoming serious, now it was getting past a joke;tað er mítt (ramasta) álvaraI am in (dead) earnest; I was never more serious in my life;í ramasta álvaraquite seriously(t.d.he quite seriously suggested that I should make him a present of it); in real(el.deadel.good) earnest; quite seriously, in real(el.deadel.good) earnest;nú er tað álvara !I mean what I say!(ofta =)you heard me!;(am.)and I don't mean maybe!;av álvaraseriously(t.d.I am seriously thinking of going away; do you seriously mean that?); in earnest;(tlm.)for real(t.d.this time it is for real); with a vengeance(t.d.this time he succeeded with a vengeance); really(t.d.this time it is really dangerous; I shall be really angry if you do that); (í langa tíð) for good;(tlm.)for keeps;gera álvara av (e-m)carry out; realize(t.d.the plan);gera álvara av at vitja teycarry out one's intention of visiting them (, us,o.tíl.); gera álvara av lyftinummake good one's promise;gera álvara av ætlaninicarry out one's scheme;gera álvara av hóttaninicarry out one's threat;nei álvara !no really
álvaramikil	síálvarsamur
álvarann	(kvæð.)elf's home
álvaratos	1serious talk2hjhonestly(t.d.honestly, don't you think we have been unjust to him?); frankly(t.d.frankly, he does not seem to be very reliable); (viðgangandi) to be quite frank(el.honest)(t.d.to be quite frank, I think it was a mistake); to tell the truth(t.d.to tell the truth, I don't feel much like going)3mðlv álvaratos !what is the point? (illur)(tlm.)what's the (big) idea?(t.d.what's the idea (of) talking like that to me?); what's that in aid of;(t.e.hvat er tað tú gert?) what on earth are you doing(el.trying to do)
álvareldur	(lækn.)(extreme degree of) shingles
álvarhús	(kvæð.)elf's house
álvari	síálvara
álvaringur	(plfr.)fairy ring
álvarligur	síálvarsamur;hj-liga
álvarsamur	1(móts.skemtiligur) serious(t.d.a serious book, face, talk, writer; a serious affair);vera álvarsamurkeep serious(t.d.I do wish you would keep serious for a moment); keep a straight face(t.d.it was difficult for me to keep a straight face); (av lyndi) serious(t.d.a serious young man); (heldurniðr.)portentous(t.d.his portentous manner of speech); (ógvuliga álvarsamur, strangur) grave(t.d.a grave air, demeanour, face, smile; put on a grave face; the judge looked very grave)2(ærligur, sannur) earnest(t.d.an earnest desire, endeavour, wish; a frank and earnest face); serious(t.d.a serious attempt, effort, intention, offer; a serious reprimand); sober-sided(t.d.he was a very sober-sided young man)3(hátíðarligur) solemn(t.d.a solemn tune)4(hættisligur) serious(t.d.a serious condition, crisis, illness, matter, menace, situation, step, wound); severe(t.d.illness); grave(t.d.a grave danger); critical5(týðandi, stórur) grave(t.d.a grave error, mistake, responsibility); serious(t.d.a serious crime, offence); (ógvuliga týðandieis.)grievous(t.d.mistake)
álvarsemi	síálvara
álvarsligur	síálvarsamur
álvarsmaður	solemn person
álvarsmál	serious business
álvarsmikil	earnest, grave, serious, solemn
álvarsorð	lat meg siga eitt álvarsorð við teg I am going to give you a piece of my mind
álvarstala	pápi helt eina álvarstalu fyri mær my father gave me a piece of his mind
álvarstungur	fateful, solemn
álvarstyngdur	fraught;(tlm.)doomy
álvheyggjur	(stn., fólktr.)hill of the elves, fairy mound(el.hill); (í ævintýrum H.C. Andersens) the Elf-Hill, the Elfin-Hillock
álvinda	(fisk.)small eel
álvindi	(stb.)síálvinda
álvindur	(stb.)síálvinda
álvuligur	1(stb.)strong, fierce2ikki álvuligur1 nervous, edgy, ill at ease 2 anything but comfortableel.pleasant
álvur	1(fólktr., kvæð.)elf, male fairy2(stb.)illegitimate child
álýðari	síáhoyrari
áløg	taka ein í áløgunum calm sby down
áløga	1á áløgumon heat,ryssan er á áløgumthe mare is on heat2deposit3(jarðfr.)sedimentation, consolidation (soil), settlement
áløgd	síáleggja
áløguglopp	hiatus
áløgulægd	(jarðfr.)sedimentary basin
ámannafatt	síáfatt
-ámillum	sísín-
ámin	(gl.) síamen
áminna	1(leggja í sinni) admonish,áminna e-n um at gera eitthvørtadmonish(el.enjoin) sby to do sth; enjoin2(minna) remind (á of)3(ávara) warn4(átala) reprimand, warn, caution(t.d.he was cautioned not to touch the wires)
áminni	til áminnis in memory (of)
áminniligur	worth remembering, memorable,ein áminniligur dagur (eis.)a day to remember, a red-letter day
áminnilsi	síáminning
áminning	1remembrance(t.d.the cenotaph stands as a remembrance of those killed during the war)2admonition, warning3reminder(t.d.the sheer size of the cathedral is a constant reminder to the tourist of the power of religion; if an invoice is not paid within seven days, we automatically send out a reminder)4recollection, memory, remembrance, reminiscence(t.d.recollections of a long life; happy and sad memories)
áminningarbræv	dun, reminder, dunning letter
áminningarskriv	(í bókasavni) overdue notice
ámmin	í osb: ámmin og júgv eftir may it come true
ámót	hindrance, impediment
ámæla	slander, calumniate, defame, malign, traduce, run down, speak ill of
ámæli	1slander, calumny, aspersion, defamation, maligning, backbiting2reputation(t.d.he has not got the best of reputations)
ámælisorð	reproaches, accusations, charges
án	just a little bit (, drop, spot), the least little bit (, drop); just a trifle
ána	1suspect, guess; (um eitthvørt ódámligt, formligt mál) have a foreboding(el.a presentiment) of; (hava kensl av) sense(t.d.that she is wrong); (hóma) see faintly(GG:we could just make out the coast);eg ánaði taðI had a feeling (that), I felt it in my bones (that);(tlm.)I had a hunch (that)2[íyms.samb.]áðrenn eg ánaði nakað (eis.)before I knew where I was;áni tað ikki (tlm.)no idea, haven't the remotest (, slightest) idea, haven't the foggiest (notion), haven't a clue; search me!, ask me another! don't ask me!tey ána ikki hvør eg eri (eis.)they don't know me from Adam;eg ánaði ikki at hann var brotsmaðurI little thought(el.little did I suspect) that he was a criminal;eg ánaði at hann fór at komasth told me he would come;ána ilt, ána óráðsuspect mischief;(tlm.)smell a rat
ánaraskifti	change of owner, transfer
ánari	owner(t.d.be the owner of, own, possess, have),rætti eigarinthe rightful owner;skifta eigarachange hands, pass into sby else's possession; proprietor(t.d.newspaper proprietors)
ánám	í osb: sumfáa ánám áget hold of, catch, get at
ánámi	síánám
áneyðir	(compelling) reason,tú hevur ongar áneyðir at gera taðyou have no need to do that
ánilsi	1(undandøttur, varhugi) presentiment(t.d.of danger); premonition, foreboding(t.d.a foreboding of evil);(tlm.)hunch;eg havi eitt ánilsi av atI have a feeling that, sth tells me that; I have a hunch that, I have a gut feeling that...2(ógreið hugmynd) inkling(t.d.I had an inkling of the truth); idea(t.d.I have no idea what it is); notion, suspicion;tað havi eg ikki ánilsi avI have not the slightest idea;(tlm.)I haven't the foggiest (notion); I haven't a clue3(eitt sindur, dism) touch(t.d.a touch of garlic; a touch of frost in the air); (formligt mál, skemt) suspicion(t.d.a suspicion of pepper, a suspicion of triumph in her voice);(forml.)intimation; touch, hint, flavour
áning	síánilsi
áningarsamur	(stb.)who has forebodings
ánir	(sj.)prospects(t.d.his prospects are poor)
áogn	1(bú.)outstanding account(el.debt); account;mín áogn hjá tærmy account against you; the amount you owe me;hava áogn hjá virkinum áljóðandi £50have an outstanding account against the firm amounting to £50;heinta inn áogncollect a debt;2(bú.)balance(el.amount) owing(el.due) to sby; balance in sby's favour;mín konta vísir áogn áljóðandi £50my account shows a balance of £50 (in my favour);áogn í bankabank deposit;innifryst áognfrozen balances (, assets);útistandandi áognreceiveable(s)3fáa sína áogn rindaðabe repaid;(serl.við rættarhjálp) recover a debt
áognari	creditor;allir áognarar (eis.)the accounts payable;fráboðaður áognaricreditor who has filed his claim;vanligur áognariordinary creditor;áognari við framíhjárættipreferential creditor
áognarkonta	(bú.)clearing account
áognarseðil	(bú.)credit note, credit memo
áotan	(málfr.) imposition
ápok	(sj., stb.)apogee
ápostlasøga	(bíbl.)the Acts (of the Apostles)
ápostolskur	(kirkj.)apostolic;ápostolsku fedrarnirthe Apostolic Fathers;tann ápostolska kirkjanthe Apostolic Church;tann ápostolska trúarjáttaninthe Apostles' Creed,ápostolska signinginthe Apostles' blessing;hjapostolically
ápostul	1k21(bíbl.)apostle,Paulus ápostulSt Paul the Apostle2(sk.) brúka ápostlarnargo (, come) on Shanks's mare(el.pony)
ár1	(bát.)oar,toga í árarnarpull at the oars, ply the oars;hvíla seg niður á árarnarrest on one's oars;leggja árar í sjógvput out the oars;(fl.m.) leggja allar árar í sjógv el. útexert oneself;leggja árarnar innship the oars,(fl.m.)stop working;(fl.m.)die
ár2	1year,árini gangathe years go by(el.pass);tað kann taka ár at umvæla skaðanit could take years to repair the damage;sniðið í árthis year's model;sjey rak árseven lean years,alt áriðall the year round;hvørt árevery year; annually;annaðhvørt árevery second(el.other) year;míni bestu árthe best years of my life;hetta Harrans árthis year of grace;ár og dagurlong, ages(t.d.it is ages since he left);fleiri ára royndirmany years of experience; the experience of many years;ársins gongdthe course of the year;langt sum eitt ilt áras long as a month of Sundays;fylla 20 árreach twenty, be twenty(t.d.I shall be twenty next Wednesday); (hátíðarligari) complete one's twentieth year;ár 44 f.Kr. doyði CæsarCaesar died in 44 B.C.;sum árini eru liðinin the course of time, gradually, throughout(el.down) the years, as the years go (, went) by;tey seinastu áriniin recent years;eitt fýra ára gamalt barna child of four, a four-year-old child;ein tvey ára gamal hestura two-year-old2[ísamb.viðfs]ta tíð á árinumat that time of the year;á fyrsta sinni í mong árfor the first time in many years;hann er sjúkur á fimta árihe has been ill for over four years;eftirárið eftirthe year after, the following year;ár eftir áryear after year;íí bestu árumin the prime of life, in one's prime;í árthis year, at present, these days;í árinum 1815in (the year) 1815;í mong árfor many years;í mong Harrans árfor ages;í dag um eitt árthis day next year, in a year's time from now, twelve months today;fyrst(, síðst) í árinumearly (, late) in the year; at the beginning (, end) of the year;millummillum ár og dagin the course of time;umár um áryear by year, annually, yearly; with every year(t.d.with every year he grew more ambitious);um áriða year, per annum, annually;um eitt árin a year; in a year's time;tilkoma til ársbe getting on (in years(el.in life));til ársadvanced(el.well on)(el. skaldsk.:stricken) in years;undireitt barn undir tvey ára child under two;viðvið árunumwith (the) years, in the course of time, gradually;útárið útthe rest of the year, till the end of the year;ár út (og) ár innyear in (and) year out
árabátur	(bát.)rowboat, rowing boat
árabil	sequence(el.number) of years;eitt árabilfor many years, for a number of years
áragamal	several years old; of several years' standing(t.d.an enmity of several years' standing)
áraka	just opposite, just in line with; abreast of, on level with;(sigl.) vit vóru áraka Lissabonwe were abreast of Lisbon
áralag	stroke,hava áralagkeep stroke;hava títt áralagrow a fast stroke
áralangur	agelong, lasting several years, of several years; long-standing(t.d.friendship);áralangt arbeiðithe labour of years, years of labour;eftir áralanga búsetu í Londonhaving stayed in London for several years
áraleysur	(á báti) without oars
áramál	term of years;ávíst áramálfor a term of years;hann leigaði húsini út í eitt langt áramálhe let the house on a long lease
áramót	turn of the year
árarblað	(bát.)(oar) blade, blade of an oar
árarleggur	(bát.)loom (of an oar)
árarlongd	(bát.)(oar) length
árarlummur	(bát.)oar handle, handle of an oar
árarskeyti	(bát.)[piece of oak on the oar where it rubs against the gunwhale and the tholepin]
áraslag	stroke (of the oars)
áratak	stroke (of the oars);við longum áratøkumwith long strokes; row with even strokes; lengthen the stroke(s)
áratal	space (of time), period (of time), span of years
áratíggju	decade, decennium
áratúsund	millennium
áráðin	(gl.)decided
árás	attack
árásin	impetuous, rash
árborin	(sj.)new-born
árbók	yearbook, annual (publication);(sø.)annalsflt,chronicle
árdegis	early
árdømi	patina;(fl.m. eis.)mellowness;sum hevur árdømipatinated, mellow
árend	1(av sjúku), attack(t.d.of cholera, dysentery, influenza, meningitis, nerves); (brádligt, stutt) fit(t.d.of apoplexy, coughing); access(t.d.an access of pain); bout(t.d.of fever)2attack, assault, charge3storm
árendur	1exposed2(bíbl.)attacked, assaulted3run(el.knocked) down
árfesta	date
árgangur	1(um bløð og tíðarrit) volume,gamlir árgangir av The Economistold volumes of The Economist(eis.)back volumes of The Economist2(um ársrit) (annual) volume3(aldursflokkur) those of a particular year(t.d.the students of my year); class; (í skúla) year group; (um hermenn) class(t.d.the 1965 class);mín árgangurthe men of my year; my year;teir stóru árgangirnir(í samb v. burðartal) the baby boom(ers)4(um vín) vintage, year;teir stóru árgangirnir(um vín) the great vintage years5(um ávísan fiskastovn) year class,góður (ringur, miðal) árgangurgood (bad, average) year class
árhundrað	century;í árhundraðfor centuries;19. og 20. árhundraðthe nineteenth and twentieth centuries(GG:seytjanhundraðtalið (osfr.) má verða endurgivið: the eighteenth (osfr.) century)
ári	(í)morgin ári tomorrow morning
árin1	influence; action(t.d.exposed to the action of the air);ógvisligt árinstrong influence; effect(t.d.the effect of light on the organism); (umhvørvi) exposure, impact;sínámillum árinmutual influence; interaction
árin2	(kvæð.)fireplace
árin3	tomorrow morning
árinamikil	effective(t.d.argument, method, protection, speech); effectual; efficacious(t.d.an efficacious remedy); telling(t.d.a telling argument; make a telling entrance); impressive(t.d.an impressive ceremonial)
árini	tomorrow morning
árinsfráleiki	impact distance
árinskanning	impact assessment
árinsvaldur	impact factor
árit	1visa; attestation, certificate; signature2(við forstavum) initial3((frá)merki) mark(t.d.parcels should be marked "Parcel Post")4(viðmælandi árit) endorsement, (marginal) recommendation
árínandi	áríniligur
áríniligur	1(um sirm) penetrating2(fl.m.)impressionable, susceptible (to influence); (kensluborin) sensitive;lættliga áríniligurhighly susceptible (to); highly sensitive (to); very impressionable, easily influenced(avby), pliable
áríning1	síárin
árla	early;árla morgunthe early morning;árla á fótumup early
árlaður	hann er so árlaður he is up early
árlangt	year-long, lasting a whole year, lasting throughout the year
árliðið	late in the year,enn er so lítið árliðiðthe year is so little advanced
árliga	per annum(t.d.he gets £15, 000 per annum); annually(t.d.he visits London annually);tríggjar ferðir árligathree times a year(el.annually);árliga afturvendandiannual, annually recurrent
árligur	1yearly, annual(t.d.my annual income, his annual visits);árligur haldaragjaldannual subscription;ein árligur renta áljóðandian annual interest of(t.d.5%)2seasonable3beautiful, nice; delightful; cosy4sprightly, hale (and hearty)(t.d.a hale old man)
árna	(stb.)árna seg adjust itself(t.d.all this will adjust itself in (the course of) time); settle down(t.d.the financial situation is sure to settle down); turn out all right, come right, be all right, work out (right);tað árnaði seg av sær sjálvumit adjusted itself, it worked itself out;tað man fara at árna seg!that will be all right!, don't you worry!, it'll all work out!
árnast	(um grøði og fenað) succeed, thrive
árnur	(gl.)fireplace
árrisin	síárlaður
ársaðalfundur	annual general meeting
ársarbeiði	a year's work
ársavlop	(bú.)annual surplus, the year's profits
ársbil	a year's time
ársbók	yearbook, annual (publication);(sø.)annalsflt,chronicle
ársbrúk	annual consumption
ársbyrjan	beginning of the year
ársdagur	anniversary (of); birthday
ársendi	the close of the year
ársfjórðingur	quarter (of a year)
ársframleiðsla	annual production(el.output)
ársfrágreiðing	annual report
ársfundur	annual meeting
ársgamal	1year-old, a year old, of one year2a yearling
ársgildi	annual festival, anniversary; (í skúla) prize day, speech day; (á fróðskaparsetri) commemoration
ársgjald	1subscription,(tlm.)sub2(kvota) quota, allocation(t.d.bilateral quota)3(herm.)contingent
ársgróður	(plfr., sj.)annual (plant); ephemeral
ársgrøði	year's harvest, year's crop
árshelmingur	half year
árshúsagras	(plfr.)annual meadow grass(Poa annua)
ársinnløga	a year's earnings
ársinntøka	(einstaklings) annual income; (ríki, kommuna) annual revenue
árskringur	(sj.)(í viði) graining
ársleiga	annual rent
árslok	the close of the year
ársløn	yearly wages (, salary osfr.)síløn
ársmet	(skúlam.)marks for the year's work
ársmót	same point in time the next year
árspeningur	appanage, civil list annuity
ársplanta	(plfr.)one-year seedling
ársrit	annual, year-book
ársroknskaparlóg	the accounts act
ársroknskapur	(bú.)annual report, annual accounts;gera upp ársroknskapwind up the year's accounts, balance the(el.my, our,o.s.fr.)books;ársroknskapurin verður lagdur fram fyri partaeigararnarthe annual accounts are made available for the inspection of shareholders
ársroynd	(skúlam.)annual examination
ársskeið	(skúlam.)one-year course
ársskifti	(commencement of a) new year;um ársskiftiðat the turn of the year
ársskurður	(bún.)a year's harvest
ársspring	(stb.)annual consumption
árstal	date, year
árstíð	season, time of the year;alt grønmeti ið fæst hesa árstíðall the vegetables in season;hetta er árstíð til ferskurpeaches are in season;hesa árstíðat this season, at this time of the year;sum er heft at ávísari árstíð, sum hoyrir til ávísa árstíðseasonal(t.d.seasonal variations in unemployment)
árstíðarbundin	seasonal
árstriðingur	a third (el.one) third of a year
ársungi	yearling;(fl.m.) hon er eingin ársungishe is no (spring) chicken
ársuppgerð	yearly(el.annual) settlement(el.statement)
ársurt	(plfr.)one-year seedling
ársúrslit	1(handilsm.)net profit for the year;stjórn felagsins/virkisins mælir til, at ársúrslitið verður flutt til næsta árthe management recommends the profits of the financial year to be carried forward to the next year2final result, result for the year
ársúrtøka	(framleiðsla) annual yield(el.output); (dividenda) annual dividend
ársveitsla	(stór) annual festival, anniversary; (í skúla) prize day, speech day; (á fróðskaparsetri) commemoration
ársverk	1a year's work2[one person's work in one year]
ársvikarur	(skúlam.)[one-year appointee]
ársvinna	a year's work
ársvinningur	1annual income2annual surplus, the year's profits
ársvøkstur	(í samb. v. skógarvøkstur o.a.) annual increment
ártíggju	decade, decennium
ártímiligur	1(um veður) seasonal2annually recurrent3(stb.)cosy, delightful;hj-liga
ártúsund	millennium
árundaður	rounded off
árundur	síárundaður
árunt	round, about, around,alt árið áruntall the year around
árvakin	1early awake2alert, watchful, vigilant
árvissur	annually occurring
áræði	courage,(tlm.)pluck,Sguts;geva e-m nýtt áræðihearten sby, put new heart into sby, put some fight into sby;tað fer at geva tær nýtt áræði (tlm.)that will buck you up;hava áræðicourage, be courageous;samla sær áræðipluck up (el. summon (up) one's) courage, take heart;taka áræði frá e-mdiscourage(el.dishearten) sby; put sby off
áræðin	courageous, brave, bold, audacious; stouthearted;(tlm.)plucky; with push, with drive, with go
áræðismikil	síáræðin
áræsin	1persistent(t.d.how do you deal with persistent salesmen who won't take no for an answer?), persevering(t.d.a few persevering climbers finally reached the top), pushing2energetic, industrious, dynamic,ein áræsin maðura dynamic personality; a fireball
áræsni	persistence, perseverance; industry(t.d.we were impressed by their industry)
ás	1(á hjólio.tíl.)shaft, axle2(stfr.)co-ordinator3(jarðfr.)esker; os4(byggl.)purlin (= ryggás)5[beam in storehouse on which motton is hung up for drying]
ásaka	accuse, charge
ásalæra	Norse mythology
ásamt	agree with, come to an agreement
ásanna	admit(t.d.he would not admit that he had been in trouble); acknowledge, own,(tlm.)own up to(t.d.he would not own up to his crimes) confess; acknowledge;eg ásanni (eg má ásanna) atI admit that;eg ásanni eg havi ávísar veikleikar (eis.)I confess to certain weaknesses;eg má ásanna at býttur er hann ikki (eis.)I will say that for him that he is no fool; to do him justice, he is no fool;ásannast má at býttur er hann ikki (eis.)admittedly, he is no fool;ásanna at hava gjørt eitthvørt skeivtadmit that one has made a mistake, acknowledge(el.confess to) a mistake;ásanna sína skyldconfess one's guilt;ásanna síni brek one'sfaults; recognize(t.d.the justice of sby's claim)
ásannan	admission, acknowledg(e)ment, confession
ásanning	síásannan
ásarveldi	(sø.)axis power;Ásarveldinithe Axis Powers
ásatrúgv	belief in the ases
áseta	1(tíð) appoint, fix,áseta eina freistfix a time-limit;ásett freista deadline;ein ásettan dagon an appointed day;til ásetta tíðat the appointed time(el.hour); within the prescribed time; set aside(t.d.a day for this business);á ásettum staðat the appointed place; set; time,dysturin varð ásettur at verða ein sunnudagthe match was timed for a Sunday);áseta ein dag til fundinfix a date for the meeting;áseta ein dag til dómsviðgerðassign a day for trial;tá ið hoyringin er ásettwhen the day for (the holding of) the inquiry has been fixed;til ásettu tíðat the appointed time2(prís, løn, renta) fix;áseta lønina tilfix the wages at;áseta mánaðarligafix monthly;áseta ein prísset a price; (um tryggingargjald) fix;ásettur prísura fixed price;fyri ásettan prís (eis.)at the stipulated price;prísurin er ásettur at verathe price is fixed at(t.d.£35);skatturin er ásettur til 10%the tax is (fixed at) 10 per cent;rentan fyri 2006 er ásett at vera tann samathe rate of interest for 2006 is stipulated to be the same3(treyta sær) stipulate(t.d.it was stipulated in the contract that);áseta gjølligari treytirspecify the conditions, lay down the conditions in detail4(reglur) fix, establish, lay down; determine;ásettu reglurnarthe (stipulated) rules;tær í §3 ásettu reglurthe rules(el.provisions) laid down in Section 3, the provisions of Section 3;lógin ásetir atthe law provides(el.lays down) that;sum ásett í lóginias laid down in the law; as required by law;revsing sum er ásett fyri hettathe punishment provided by law;áseta revsingfix the penalty;nærri ásettspecified;nærri ásett tala specified number;í ásettu skipanin the stipulated order, in the order arranged beforehand;(ítr.)ásetturdysturfixture
ásetan	síáseting
áseting	1appointment(t.d.of a day for the meeting)2(lógaráseting) provision(t.d.according to the provisions of this Act); (í sáttmála) stipulation, condition(t.d.the conditions laid down in the contract); (í reglugerðo.tíl.)rule, regulation3fixing, establishment,assessment,áseting av inntøku(ES) establishment of revenue;áseting av avlamisstigiassessment of the degree of disablement
ásettur	1síáseta2síseta á
áseyðaroyting	sheep shearing
áseyma	(handarb.)apply, attach, appliqué (to)
áseyming	(handarb.)appliqué (work)
Ásia1	Asia1eAsia
ásia2	(plfr.)large (seeded and pickled) cucumber
ásigldur	run into, run foul of, foul(t.d.the cutter was fouled by a gunboat); collide with, come into collision with;tað ásiglda skipiðthe ship (that was) run into;ásiglandi skipiðthe colliding ship
ásigling	collision
ásin	(dýr.)ass, donkey,(tlm.)moke; (ókvæmisorð) jackass, ass;treiskur sum eitt ásinstubborn as a mule
ásíggiligur	worth looking at, beautiful, lovely
ásjón	1countenance(t.d.the Lord lift up his countenance upon thee and give thee peace);fyri Guds ásjónin the sight of God, before God2appearance,í ásjónin appearance(t.d.in appearance he is insignificant)
ásjónd	síásjón
ásjónligur	beautiful, handsome; easy on the eye
áskoðan	view(t.d.a man of conservative views; hold extreme views; I share his views on(el.about) the Homeric question); opinion(t.d.religious opinions; he always respected the opinions of others);hava ta áskoðanat be of (the) opinion that, hold that, take the view that(t.d.he took the view that I had broken my promise);hann hevði aðra áskoðanhe took a different view of the matter;nevndin hevði ta áskoðan atthe committee considered(el.took the view) that;sambært míni áskoðanin my opinion;vit hava ymsar áskoðanir (eis.)we differ;gera vart við eina áskoðanexpress(el.give expression to) a view
áskoðari	spectator, onlooker; (tilvildarliga hjástaddur) bystander; (vitni) eyewitness, witness; (í leikhúsi) member of the audience;áskoðarar(í leikhúso.ø. eis.)audience, house(t.d.the whole audience(el.house) applauded);áskoðararnir(til ítróttardystir o.a.ofta =)the crowd;tal á áskoðarum (eis.)the attendance(t.d.the attendance was 37, 000);vera áskoðari tilwitness(t.d.a football match, an accident);lata sær lynda at vera áskoðaristand passively aside, remain a mere spectator, look on(t.d.we cannot look on while Europe is being ruined)
áskot	covering soil
áskrift	1(á brævio.tl.)address2inscription; (á gravsteini) inscription, epitaph;seta sum áskrift áinscribe on(t.d.the motto inscribed on his statue)3(fram við rondini á myntit.d.)legend
áskriva	(bú.)endorse, back
áslag	(handv.)(metal) furnishing(s)(t.d.the metal furnishing(s) of a chest of drawers), fittings, mount(ing); (á hurðum, vindeygum) furniture; hardware(t.d.window hardware)
ásókn	(løgfr.)contestation
ást	love, affection, passion(t.d.his passion for her made him blind to everything else);binda el. leggja ást viðfall in love with;(orðt.) ást fjalir lýtilove is blind
ástaðarfundur	(løgfr.)inspection of the ground, local inquiry, on-the-spot investigation
ástaðarmál	case involving an inspection of the ground, local inquiry
ástaðis	present, there
ástaðna	(sj., stb.)in the afternoon
ástaður	(løgfr.)scene of the crime, place where (the bodyo.s.fr.)was found;(fl.m.)place in question;á ástaðnumon the spot
ástandur	situation, circumstancesflt,occasion, state of things
ástarblóma	(plfr.)passion flower(Passiflora)
ástarbragd	(kvæð., skaldsk.)(declaration of) love
ástarbrek	(gl.)heartbreak
ástarbræv	love letter
ástardrykkur,ástarløgur	love philtre, love potion
ástarfrukt	passion fruit
ástarfullur	loving; (girndarliga) amorous
ástarfundur	assignation
ástargaman	joy of love
ástargerð	love-making
ástargudinna	(gudal.)goddess of love
ástargudur	god of love, Cupid
ástarhugi	síástarhugur
ástarhugur	feeling of love
ástarkensla	loving feeling
ástarkossur	love kiss
ástarkvæði1	love poem
ástarkvæði2	love song
ástarleikur1	dalliance
ástarleikur2	game of love
ástarlív	love life
ástarljóð	love poem
ástarsamband	love affair; liaison
ástarskaldsøga	(bókm.)love story, romance
ástarsøga	love story
ástartokki	love, affection
ástartrá	desire
ástarvina	lover, fiancée; sweetheart;(tlm.)(best) girl, girlfriend
ástarvinur	lover, fiancé, sweetheart;(tlm.)young man, boyfriend
ástaryrking	love poem
ástarøvund	jealousy
ástatt	ábærur
ástig	pedal; (á orgli) pedal board;brúka ástiginipedal
ástkærur	loving
ástmoy	(skaldsk.)fiancée; sweetheart;(tlm.)(best) girl, girlfriend
ástoytingarsteinur	stumbling-block
ástoytur	offence;vera til ástoytgive(el.cause) offence
ástríki	(bíbl.)love
ástríkur	(bíbl.)loving
ásttikin	in love
ástvinur	síástarvinur
ástøðar	(on the) spot(t.d.market, price)
ástøði	theory (of, about),(t.d.it may be all very well in theory, but how will it work (out) in practice?);gera sær eitt ástøði umform(el.frameel.construct) a theory about;seta fram eitt ástøðiadvance(el.put forward) a theory;sum ástøðiin theory, theoretically;sambært hesum ástøðion(el.according to) this theory;seta upp eitt ástøðiadvance(el.propoundel.postulate) a theory;sum ástøði og í verkiin theory and (in) practice;út frá hesum ástøðion(el.according to) the theory
ástøðiligur	1theoretic(al);stovnur fyri ástøðiliga alisfrøðiinstitute of theoretical physics;ein heilt ástøðiligur spurningura purely academic question, a question of (purely) academic interest2hj-ally;heilt ástøðiligafrom a purely theoretical point of view
ástøðingur	theorist
ástøðumaður	(løgfr.)arbitrator; (í ítrótto.ø.)umpire
ástøtt	(stb.)síábært
ástøvund	síástarøvund
ásur1	As(fltAsesel.Aesir)
ásur2	1(eis.: stjfr., støddfr., plfr., pol.)axis(fltaxes);fyrri ásur (støddfr.)axis of abscissas (el. abscissae), x-axis;(likam.)line of action(t.d.the line of action of the hand, the foot);snara um sín egna ásturn on its axis;ásur jarðarthe axis of the earth;lítli ásur(í ellipsu) minor axis;seinni ásurordinate axis;veruligur ásur (stfr.)real axis;Berlin-Rome ásinthe Berlin-Rome Axis2beam3shaft, axle4(gl., sj.)(mountain) ridge
ásynja	(átr.)goddess
ásýnd	(bíbl., sj.)appearance, shape
ásýni	(sj.)appearance
ásýniligur	1síásjónligur 22visible, perceptible, noticeable3hj-liga:visibly, perceptibly, noticeably
ásýnligur	síásýniligur;hj-liga
ásýnur	síásýniligur(2)
ásøkiligur	(løgfr.)contestable
át1	eating; stuffing; food,tað er einki át í hasumthere's not much food in that
át2	síeta
áta	(Suð.)síæti
átak	1(við ár) powerful grip, stroke, pull; exertion; (um veður, sjógv) roughness2flt hon lá við átøkumshe felt sick3(ným.)campaign (advertising) campaign, (advertising) drive(t.d.an anti-waste campaign); crusade(t.d.a crusade against anti-Semitism); drive(t.d.China's modernization drive)
átaka	(e-t)átaka sær (yvirtaka, taka á seg) undertake(t.d.undertake the defence of the accused; undertake the management; undertake(el.take on) a task);átaka sær ov nógvundertake too much; take too much upon oneself; take on too much;átaka sær skyldunatake the blame;átaka sær ábyrgdarfult starvaccept(el.take on) a responsible post; take (sth) upon oneself(t.d.he took it upon himself to bring him to reason);hatta skal eg átaka mær!I'll attend(el.see) to that!; take on(t.d.a job, a piece of work); assume(t.d.assume a guarantee for sth; assume(el.takeel.undertakeel.accept) (the) responsibility for sth; assume(el.shoulder) a burden); engage(t.d.I will engage to do it in a month); (í sáttmála) contract(t.d.contract to build the bridge for £50, 000)
átaksleiðari	incident commander
átaksleiðsla	incident command
átaksøki	incident area
átala1	reprimand(t.d.he received a severe reprimand for his behaviour), rebuke, reproof(t.d.she received a mild reproof from the teacher), reproach, censure
átala2	criticize, protest against(t.d.I must protest against the tone adopted by my opponent); complain of(t.d.I had to complain of the slowness of the service); call to order,formaðurin átalaði orð hansarahe was called to order by the chairman; censure, reproach,ráðið átalaði hann fyri at leka upplýsingar til fjølmiðlarnarhe was censured(el.reproached) by the council for leaking information to the press; reprimand,verða átalaður fyri at hava gjørt eittbe reprimanded by sby for having done(el.for doing) sth; rebuke(t.d.the company was publicly rebuked for having neglected safety procedures)
átalurættur	right to take proceedings
átarabragd	gluttony
átarahít	coarse eater
átaravætti	glutton, gourmand
átari	glutton
átbærur	(sj.)edible, eatable(t.d.the food at the hotel was barely edible; edible fungi (snails))
átekna	(løgfr.)(vátta) attest, certify; (skriva undir) sign; (myndugleikieis.)stamp,átekna eitt eintak(ES) stamp a copy;fáa koyrikortið áteknaðhave one's licence endorsed
átekning	(løgfr.)attestation, certificate; signature; endorsement
átfrekur	síátufrekur
átfundur	(skaldsk.)síátgildi
átgildi	enormous feast, blow-out, spread
átigur	greedy, voracious(t.d.a voracious eater; to have a voracious appetite), gluttonous
átikið	sítaka á
átjan	(tlm.)eighteen
átjandi	(tlm.)eighteenth
átrokan	pressure
átrokandi	urgent, pressing, requisite
átrokin	síátrokandi
átrú	(gl.)belief(t.d.belief in God; reason and belief)
átrúgvandi	credible, believable; (líkt til) likely, probable
átrúgvin	(gl.)faithful (, loyal, true) to; faithful(t.d.servant); loyal(t.d.subject); faithful, staunch, true(t.d.friend)
átrúnaðarligur	religious(t.d.ecstasy, emotion, life); sacred(t.d.poetry)
átrúnaðarsøga	history of religion;(ofta =)comparative religion, comparative study of religions
átrúnaður	belief; faith(t.d.the Christian faith; he belongs to another faith), religion
átrúnaligur	síátrúnaðarligur;hj-liga
átrúni	1síátrúnaður2confidence, trust, faith (in), reliance (in, on)
átta	(tlm.)eight;um einar átta dagarin a week or so, about a week from now, about a week hence
áttafletingur	octahedron
áttalitla-	(lívfr., nýggjy.) octoploid
áttamannafar	(bát.)eight-oar; (um kappróðrarbát) an eight
áttandi	(tlm.)eighth
áttandipartur	eighth (part);tríggir áttandapartarthree eighths;(tónl.)quaver, eighth; (um takt) three-eight time
áttatal	(figure) eight, figure of eight;liggjandi áttatalhorizontal eight, infinity (sign)
áttatalsknútur	(sigl.)Flemish knot, figure eight knot, figure 8 knot, figure of eight loop knot
áttati	eighty
áttatiár	í áttatiárunum (árstal) in the eighties; (aldur) in one's eighties
áttatiundi	(tlm.)the eightieth
áttermdur	eight-armed; (um høgguslokk) octopus
áttfarin	exhausted
átthyrningur	octagon
átthyrntur	(um lutir, bygningaro.tíl.)octagonal
átti	síeiga
áttingur	1eighth (part);tríggir áttingarthree eighths2(tónl.)quaver, eighth
áttlitla	octoploid
áttstrentur	(bókm., sj.)octagonal
áttund	1(tónl.) octave2(teld, sj.)bit
áttundi	(tlm.)eighth
áttu(r)	(kortsp.)eight(t.d.the eight of spades)
átufiskur	edible fish
átufrekur	greedy, voracious
átufressa	glutton, gourmand
átufressur	(stb., sj.)síátufressa
átukykna	(lívfr.)phagocyte
átuligur	(um mat) delicious, delectable, tasty, toothsome;(tlm.)yummy
áturoppa	glutton, gourmand
átusoppur	(plfr.)mushroom, edible fungus
átutari	edible seaweed
átutur	síátufrekur
átuvomb	(kvæð., niðr.)síátari
átuvøkstur	edible plant
átveitsla	(niðr.)enormous feast, spread, blow-out
átyngd	load, weight
átøkkur	síátøkur
átøkur	have a (strong, faint) resemblance to
áum1	síá
áum2	síávum
ávara	warn,ávara umwarn of;ávara um atwarn that;ávara harðligawarn in the strongest terms;ávara hann ímóti tíwarn him against it;ávara hann ímóti at gera taðwarn him not to do it, warn him against doing it, point out to him the danger of doing it;hann læt seg ikki ávarahe refused to be warned, he would not take a warning;ávarað verður ímóti eftirgerðbeware of imitations; (í ítrótt) caution(t.d.he was cautioned several times by the referee for hitting below the belt); admonish(t.d.a warning voice admonished him not to let this happen)
ávaran	(sj.)síávaring
ávaring	1warning, caution; (í ítrótt) caution; (leiðbeinandi) admonition;hann fekk eina ávaring frá løgreglunihe was warned by the police; (í rættinum) he was dismissed with a caution; (í ítrótt) he was cautioned (by the referee); (um at vera varino.tíl.)he was given a warning (to be carefulo.tíl.); geva e-m eina ávaringwarn sby;lurta eftir ávaring frá e-mheed sby's warning;ávaring ímótiwarning against;sleppa við eini ávaringbe let off with a caution;lata hann sleppa við eini ávaringdismiss him(el.let him off) with a caution;vera (tæna sum) ávaringserve as a warning, be a warning2(freist) respite, delay, grace, time, time-limit; deadline
ávaringarmerki	(á matvørum) label of warning
ávaringarskelti	warning sign
ávaringarskipan	alarm system
ávegis	be in the process of, be on the way, be on one's way
áverk	1(stb.)start, commencement,gera áverk áput the work in hand, commence(el.start) work(el.operations), set to work on a job2(bíbl.)violence, brute force;(løgfr.)assault and battery
áverka	begin work, put the work in hand, commence(el.start) work(el.operations), lay the foundations of(t.d.a house); make a start on
áverkaður	1just started, just begun2slightly battered
ávik	góður í ávikum helpful, ready(el.willing) to help, willing to oblige, friendly, obliging
ávikavist	(í upprokning) respectively(t.d.they received sentences of one year and eight months respectively)
ávildum	(sj.)í osb: av sínum ávildum of one's own accord; of one's own free will
ávinningur	profit(s), gain
ávirka	influence(t.d.Shaw is influenced by Ibsen; you must not try to influence the witness); have(el.exert) an influence on(el.over); get at(t.d.that politician is likely to be got at by business tycoons); affect(t.d.the war has affected the price of iron; the climate affects their health; affect unfavourably);ikki ávirka (ikki lata seg ávirka)be(el.remain) unaffected by(t.d.her charms); not be susceptible to; have an effect on; act on(t.d.the words acted on him like a powerful stimulant);(tøkn.:flyta) actuate;ávirka hvørt annaðinteract
ávirkaður	1influenced; affected;ávirkaður av e-minfluenced by sby(t.d.he is strongly influenced by Carlyle); under the influence of sby; (ofta =) a disciple(el.follower) of2(av brennivíni) under the influence of liquor(el.alcoholel.drink);(tlm.)under the influence; obviously under the influence of liquor; obviously the worse for liquor;eitt sindur ávirkaðurslightly intoxicated(el.drunk)
ávirkan	1influence,hava ávirkan áan influence on, influence;brúka sína ávirkan á e-nuse one's influence with sby;gera sína ávirkan galdandimake one's influence felt; bring one's influence to bear;undir ávirkan avunder the influence of, influenced by;vera undir e-s ávirkanbe under sby's influence, be influenced by sby;hava góða ávirkan á e-nhave a good influence on sby,influence sby for good;orsøkir eg ikki havi ávirkan ácauses beyond my control;um eg havi nakra ávirkan á hannif I have any influence with him;hava stóra ávirkan (tlm.)swing much weight; have an important bearing upon;hava størri ávirkan hjá (eis.)prevail more with;fremja ávirkan áexert an influence on sby,influence sby;undir ávirkan avunder the influence of, influenced by2say(t.d.the European Parliament's say was increased);(tlm.)pull (with)3action(t.d.exposed to the action of the air); effect(t.d.the effect of light on the organism);(alisfr.: um tilfar sum er fyri eini kraft) stress;(alisfr.: um likam) affection(t.d.the reciprocal affection of moving bodies); (á kropp) affect; (umhvørvi) exposure, impact;ávirkan frá atmosferuniatmospheric effect(s);beinleiðis (, óbeinleiðis) ávirkandirect (, indirect) influence;sínámillum ávirkanmutual influence;(tøkn.)interaction;sterk ávirkanstrong influence;(tøkn.) loyvd ávirkanpermissible load;ytri ávirkanexternal influence (, action)
ávirkandi	(málfr.)transitive
ávirkari	influencer
ávirki	1(málfr.)object2(teld.)argument
ávirkiligur	impressionable, susceptible (to influence); (kensluligur) sensitive;lættliga ávirkiligurhighly susceptible (to); highly sensitive (to); very impressionable, easily influenced (by), pliable
ávirking	síávirkan
ávíkiligur	helpful, ready(el.willing) to help, willing to oblige, friendly, obliging
ávíkin	síávíkiligur
ávíkindi	request (for)(t.d.my request for respite); appeal (for)(t.d.an urgent appeal for help)
ávísa	1point out, draw attention to, show2(gera eyðsýnt) prove,ávísa við vissu atprove conclusively that;ávísti skaðithe proved damage; show(t.d.this disease has been shown by X to be hereditary), demonstrate(t.d.demonstrate(el.prove) the existence of an Aryan family of languages), establish(t.d.the law of gravity was established by Newton)3(evnfr.)detect, prove(el.showel.demonstrateel.establish) the presence of(t.d.arsenic in the body)4(pening)ávísa eina upphædd tilassign a sum for;ávísa eina upphædd til útgjaldingarorder an amount to be paid out; (arbeiði)ávísa e-m arbeiðifind work for sby,offer sby work
ávísan	síávísing
ávísandi	demonstrating, showing, pointing out;(málfr.) ávísandi fornavndemonstrative (pronoun)
ávísi	indicator, sign-post;(lækn.)predicator
ávísiligur	demonstrable, provable, traceable;við ongari ávísiligari grundfor no apparent(el.assignableel.demonstrable) reason; for some unaccountable reason
ávísing	1(leiðbeining) direction, instructions;eftir hansara ávísingaccording to his instructions;fylgja e-s ávísingfollow sby's instructions;fáa ávísing at gera taðbe instructed to do it2(tillutan) assignment, allotment3(peningaávísing) (money) order; (kekk) cheque;(am.)check;taka ávísing útcash a cheque;ávísing til gjaldingar(ES) authorization of payments4(lækn.) prescription
ávísingarfornavn	(málfr.)demonstrative pronoun
ávísingarskjal	cheque (form)
ávísur	a certain(t.d.a certain friend of yours has called; women of a certain age);(t.e.onkur) a certain, some(t.d.a town of a certain(el.some) importance; there is a certain coolness between them; he spoke with a certain(el.with some) hesitation); a certain degree(el.measure) of(t.d.skill)(GG:the prisoners enjoyed a measure of freedom);ein ávísur harra Smitha certain(el.oneel.a) Mr Smith(GG:at the instance of one Blackstone); ávísflt (t.e.nøkur) certain(t.d.there are certain things that I refuse to do; under certain circumstances); some(t.d.there are some people who think that; it would not be possible to replace some volumes)
ávum	í osb: av mínum ávum on my initiative, with my help
ávøkstur	1fruit, crop; yield(t.d.a high crop yield)geva ávøksturyield a crop;samlaði ávøksturinthe total yield2(pening) yield(t.d.this will give a yield of 10% on your investment), proceeds, output
