í1	
í2	1(um stað í víðastu merking) in(t.d.in the army, in a box, in another chapter, in England, in a hole, in the house, in the newspapers, in the sea, in the wood; the wind is in the North)2(um stað/umstøður)í dagslýsiby daylight, in daylight;í kavain snow;í loyndumin secret;í mjørkain a fog;í myrkriin darkness;í óveðriin foul weather;í vandain danger; at risk3(framman fyri nøvn á stórum býum) in(GG:kortini: I have never been to London; he is on a visit to Paris)4(framman fyri nøvn á smáum býum) at(t.d.we stopped at Lincoln); (= ,,inni í" tó) in(t.d.old houses in Lincoln; the King was besieged in Lincoln)5(um umfevnandi viðurskiftio.s.fr.)in(t.d.in a dangerous situation)6(um støðu) in(t.d.in chains, in despair, in a violent rage);vera í neyðbe in peril; be in distress, be in want;liggja í óvitibe unconscious;mær stendur íI've been offered;hann stendur í vøkstrihe is growing;koma í skuldrun into debt, incur debts;vera í døpurhugabe in two minds;vera í ørvitibe confused;vera í gildibe valid (, current; present)7(um klædnabúnao.s.fr.)in(t.d.a man in a black coat, in evening dress, in rags, in slippers)8(soleiðis sum eitt er skipaðo.s.fr.)in(t.d.a play in 5 acts; a poem in 5 cantos; in groups of five; in packets of ten; in rows)9(inn (, niður, úto.s.fr.)í) into(t.d.jump into the water); in(t.d.put the key in the lock)10(hvussu leingi eitt varar) for(t.d.I have lived in London for 5 years); during(t.d.I was in India during the hot season);(am. eis:)in(t.d.I haven't seen him in years)11(um klokku) to(t.d.it is 5 minutes to 8)(GG:,,í hálvgum" má verða endurgivið við minuttum eftir seinasta heila tíma,t.d. 5 minuttir í hálvgum 812(um mánað) in(t.d.in June)13(ávísar tíðarásetingar:í morgunthis morning;í gjárkvøldiðlast night;í gjáryesterday)14(um samhoyring) of(t.d.the professor of German; the capital of the country; the University of Oxford; the wars of the Middle Ages; the events of 1914; he is a teacher of English); (í einstøkum førum) in(t.d.a commercial traveller in cotton; a speculator in railway shares); on(t.d.an expert on that question)15(støddfr.: um potens, veldi) to the... power(t.d.ten to the fifth power)16(um gjaldsslag) in(t.d.pay in gold, in pounds sterling); by means of(t.d.the fee is payable by means of stamps)17(sum) as, by way of(t.d.as a reward; by way of reward); in(t.d.pay £200 in taxes; in reward, in compensation); for(t.d.she gave him £100 for a wedding present)18(um evnið, sum eitt er gjørt úro.s.fr.)in(t.d.paint in oils; a statue in bronze; carved in wood)19(viðvíkjandi) in(t.d.his equal in strength)20[íyms.samb.]. í og fyri segin itself(t.d.it is not so bad in itself); per se; as far as it goes(t.d.the system is satisfactory as far as it goes); properly speaking; in a way;hava ein flokk í fronskumhave (, take) a form for(el.in) French;í og við ateo ipso(t.d.being King, he was eo ipso Commander-in-Chief of the army);í hesum mánaðithis month; during this month;tað er okkurt í títhere is sth in that;nóg gott í sjálvum særgood enough in itself21[ísamb.viðhj]burtur í:fara burtur í hagago out into the outfield;skorpna burtur í einkishrink to nothing;fram í:koma fram í ljósið (fl.m)appear, come to the fore;draga fram í ljósiðbring to light, reveal; (brotsverko.tl.)bring to light, expose;inn í:inn í húsiðinto the house;inn í náttinainto the night;inni í:inni í húsinumin(side) the house;niðan í:teir fóru niðan í gerðiðthey went up into the field;niðri í:niðri í fjørunidown on the beach;oman í:oman í fjørunadown to the beach;upp í:skeinkja upp í glasiðpour out(t.d.he poured himself (out) another glass of wine);klintra upp íclimb(t.d.a tree); scale;uppi í:uppi í seinginiin bed;út í:koma út í orðbecome the object of rumour;sukur út í tesugar in the tea;yvir í:e-m tykir yvir í, sítykja22[samb.viðfs/hjsaman viðs]t.d.anda í;festa í;helma í;klára í;koma í;leika í;leggja í;ríkja í;seta í;skjóta í;slíta í;spinna í;taka í;vita í;sísagnorðið
ía	(barn.)dress,ía segdress
ían	(óregl.)->íðan
íbeiskur	embittered
íbindi	(stb.)síbindindi
íbinding	1(bjarg.)harness2connection, (til vatn, ravmagno.s.fr.á tjaldingarplássi) hook-up
íbinviður	ebony (wood)(Ebenus)
íbirta	síbirta í
íbirtari	1entrepreneur, promoter, originator (originator to...)2instigator; (til uppreisturo.s.fr.)ringleader, agent provocateur
íbland1	admixture,har er málið enn óspilt av fremmandum íblandithere the language is uncontaminated by any foreign admixture;men eisini tær løturnar vóru fyltar við beiskum íblandibut these moments were filled with a bitter strain too
íbland2	(stb.)among others; including(t.d.including the following)
íblástur1	inspiration;geva e-m íblásturinspire sby;tað var hesin tilburður sum gav honum íblástur til kendu yrkinginait was this event which inspired him to write his famous poem
íblástur2	inspired;ein íblást grein (eis. fl.m.)an inspired article
íbláur	bluish
íbogin	slightly bent (, bowed, curved, crooked)
íborin	hereditary, congenital(t.d.criminal tendencies; hereditary diseases); innate(t.d.innate ideas; her innate sense of beauty), inborn, native(t.d.her native good sense, tact), inbred(t.d.her inborn grace and courtesy), natural(t.d.natural abilities, capacity, charm, gifts, rights, talent);íbornir eginleikar (lívfr.)inherited(el.hereditary) characteristics;tað er honum (henni, mær o.s.fr.) íboriðhe (, she, Io.s.fr.)was born with it
íbregðiligur	(um eginleika) hereditary(t.d.character);íbregðiligt hjáhereditary in
íbundin	síbinda í
íbúð	flat(t.d.we live in a three-room flat);(am.)apartment; (hjá støkum fólkumeis.)rooms;íbúð við innbúgvia furnished flat,(am.)apartment;leiga íbúðtake a flat;(am.)rent an apartment;íbúð í tveimum hæddumduplex
íbúðahús	block of flats;(am.)apartment house
íbúðarhús	residential property; dwelling house; (í fleiri hæddum) block of flats;(am.)apartment house; tenement house;sísethús
íbúðarvognur	caravan;(am.)trailer; recreational vehicle; (til alt árið) residential caravan; (stórur) mobile home
íbúgvalandafrøði	human geography; eis.mannlandafrøði
íbúgvanavn	(málfr.)residential appellation
íbúgvandi	immanent
íbúgvatal	population, number of inhabitants;íbúgvataliðthe population figure
íbúgvi	inhabitant(t.d.of a town; of a country);upprunaligu íbúgvarnir(um náttúrufólko.s.fr.)the aborigines
íbygdur	1(fólktr.)[populated by supernatural beings]2(um reiður) built, made3(sk.) har man vera íbygtshe is in the family way
ídna	industrialize
ídnaðar-	industrial
ídnaðarbanki	industrial bank
ídnaðarbarónur	captain of industry
ídnaðarbýur	manufacturing town, industrial town
ídnaðardepil	manufacturing centre, industrial centre
ídnaðarfelag	industrial association
ídnaðarfiskur	trash fish
ídnaðarframleiðsla	industrial product, manufactured product
ídnaðarframsýning	industries fair(t.d.The British Industries Fair), industrial fair(el.exhibition)
ídnaðarfyritøka	industrial undertaking, industrial enterprise
ídnaðargering	industrialization
ídnaðargransking	industrial research
ídnaðargrein	branch of industry
ídnaðargrund	industrial property
ídnaðargrunnur	Industrialization Fund
ídnaðarharri	industrial magnate, captain of industry
ídnaðarhavn	commercial harbour
ídnaðarkollveltingin	ídnaðarkollveltinginthe industrial revolution
ídnaðarland	industrial(el.industrialized) country;nýggju ídnaðarlondini(ES) the newly industrialized countries(stNICs)
ídnaðarligur	industrial,til ídnaðarligt brúkfor industrial use
ídnaðarmaður	industrialist
ídnaðarmálaráð	industry ministry, ministry of industry
ídnaðarmálaráðharri	minister of industry
ídnaðarnjósning	industrial espionage
ídnaðarrakstur	industrialism, industrialized working
ídnaðarsamfelag	industrialized society
ídnaðarsild	trash herring
ídnaðarstevna	industries fair(t.d.The British Industries Fair), industrial fair(el.exhibition)
ídnaðartólmenni	industrial robot
ídnaðarváði	industrial risk
ídnaðarvirki	industrial enterprise, industrial firm
ídnaðarvirksemi	industrial activity; industrial activities, industry
ídnaðarøki	industrial district(el.area), manufacturing district; (við býeis.)industrial estate; (øki) industrial region;ídnaðarøkini í Onglandi (eis.)the industrial parts of England
ídnaður	industry, manufacturing industry (, industries), manufacture(s);handil og ídnaðurtrade(el.commerce) and industry; the crafts and industries; the manual and manufacturing industries;innlendis ídnaðurdomestic(el.home) industry;evnafrøðiligur ídnaðurchemical industry;lættur ídnaðurlight industry;tungur ídnaðurthe heavy industries
-ídnaður	industry(t.d.the furniture industry)
ídnan	industrialization
ídnast	í osb: ídnast ikki not manage to do sth;tað ídnast ikkiit is useless, it is futile, it is of no avail
ídni	industry(t.d.we have a great asset in the skill and industry of our workmen), diligence; (treiskur) assiduity; hard work(t.d.he achieved it by means of hard work); effort(t.d.the effort he put into it paid off); (um andsarbeiðieis.)application zeal, eagerness;ídni og avrikeffort and performance
ídning	industrialization
íða	1eddy, vortex, whirlpool2counter current
íðan	íðanwell then, well(t.d.well, how did you get on?);íðan, so noyðist eg at fara meðniwell then I'll have to go;íðan, íðanwell then;íðan, hvat vilt tú, eg skal gera?well then what do you want me to do?;íðan, íðan!then what!
íðin	diligent(t.d.pupil), industrious, hard-working, busy, sedulous, assiduous(t.d.an assiduous reader of our magazine);(viðv.andsarbeiðieis.)studious; ardent(t.d.student; supporter)
íðinskapur	síídni
íðka	1engage in;(tlm.)go in for(t.d.games, sport)2train, exercise(t.d. one'smemory, one's voice); practise(t.d.he practises every day for several hours)3read again, re-read aftur, brush up; (pensum) revise; review; recapitulate4íðkastaccelerate, increase speed
íðkanarbann	(ítr.) ban
íðkari	devotee, practitioner, performer
íðukálvi	(sj.)sííðukálvur
íðukálvur	small eddy
íðukendur	(um sjógv), with eddies
íðuliga	frequently, often, always, perpetually, continually;íðuliga taka upp í samankeep repeating.
íðuligur	frequent; continual, perpetual (t.d.his perpetual interruptions)
íelvi	instinct(t.d.do sth by instinct; an unerring instinct for)
ífaring	sííferð
íferð	(á skógvi)í osb: skógvurin er ov trongur um ífaringinathe shoe is tight to put on
ífesti	(alisfr.)centre of suspension; (at snara) hinge point
ífesting	ignition, kindling
ífrá	(kvæð.)sífrá
ífylla	stuffing, padding(eis.um bløð)
ífylling	filling up, filling in
ífyllufóður	bulky feed
íganga	admit(t.d.he would not admit that he had been in trouble); acknowledge, confess
ígangur	1breeding lamb2fry, spawn3(sk.)brood(t.d.with his brood around him); offspring(t.d.his numerous offspring); progeny
ígða	(fugl.)finch(Fringillidae);common rosefinchsíroðaígða
ígða3	(fugl.)finch;Eurasian siskinsíbarrígðacommon chaffinchsíbókígðaEuropean goldfinchsífagurígðabramblingsífjallígðaEuropean greenfinchsígrønígðacommon linnetsílínígðaEurasian bullfinchsíprýðisígða
ígegn	towards; against;(kvæð.) ganga e-m ígegngo towards sby,go to meet sby
ígera	(lækn.)infect
ígerð	(lækn.)infection
ígerðarsjúka	(lækn.)infectious disease
ígildis	of the same amount (, value) as
ígildiskoma	sígildiskoma
ígjøgn	síígjøgnum
ígjøgnum	1fsthrough2hj gata e-n ígjøgnumpierce sby;alt summarið ígjøgnumthe whole summer through (, long)3all the way, right, straight;fara inn ígjøgnumgo right in;niður ígjøgnumright down;prísirnir vóru roknir upp ígjøgnumthe prices were soaring;tey eru suður ígjøgnumthey are as far south as possible4soaked, rain-soaked, drenched, sodden, dripping wet, sopping wet, wet to the skin, wet through
ígjørdur	(lækn.)infected
ígonga	1stock of sheep2(um ílat) capacity
ígongdsetari	entrepreneur;eis.íverksetari
ígongdur	common
ígrivin	engraved, incised, cut
ígrípiligur	concrete; tangible; eis.ítøkiligur
ígrønur	greenish
ígulur	yellowish
íhald	1stop(t.d.ten minutes' stop); stopping, stoppage, halt; (fyribils) pause; interruption, break; (steðgur) cessation; pause; (í ferðslu) stop(page), hold-up(t.d.there was a two-minute hold-up of traffic)2lull(t.d.a brief lull in the rain)3(stjm.) conservatism
íhaldsflokkur	(stjm.)Conservatives; (í Ongl.eis.)Tories
íhaldsmaður	a Conservative; (í Ongl.eis.)a Tory
íhaldssamur	conservative
íhaldssemi	conservatism; (politiskt) Conservatism; (í Ongl.eis.)Toryism
íhampaður	dressed decently
íhav	síínnihald
íhava	síínnihalda
íheimiligur	sííheimligur
íheimligur	agreeable, pleasant, attractive; comfortable, homelike(t.d.a homelike atmosphere), cosy,har var nossligt og íheimligtit was nice and cosy there;"friður á jørð" - hesi orðini eru okkum so íheimlig at hoyra"peace on earth" these words sound so agreeable to us
íhelmingur	stop, pause, break,har var eingin íhelmingurthere was no break
íhjá	(kvæð.)síhjá
íholdan	(átr.)incarnation,ein íholdan av øllum óndskapievil incarnate;hann líktist eini íholdan av øvundhe looked the very picture of envy
íholdast	(átr.)incarnate,ein íholdaður fania devil incarnate; inveterate(t.d.an inveterate bachelor); out-and-out
íholding	(átr.)sííholdan
íhylkja	1(lækn.) encapsulate2(sálarfr.)encase(t.d.encased in habits)3(teld) enclose
íkast	contribution(t.d.give sth as one's contribution); share;lata eitt íkast tilcontribute to, make one's contribution to;eg havi givið mítt íkastI have contributed my share;(tlm.)I have done my bit
íkensla	empathy
íkervi	(teld)embedded system
íkleiv	(alisfr.)cathode
íklæðast	(bíbl.)array(el.attire) in, dress in
íkoma	1beginning; founding,tað hevur flokkurin sagt alt síðan íkomu sínaour party has said so ever since its beginning;nakað soleiðis mundi íkoman vera hjá teimumthat is likely how their talk began2síígangur
íkomin	1síkoma(í)2(jarðfr.) íkominemergent
íkorni	(dýr.)(red) squirrel(Sciurus vulgaris)Sciurus vulgaris ©iStock
íkoyring	(stb.)í osb: kúgvin krevur stórar íkoyringar the cow requires much forage
íkring	about, round, round about, around(t.d.he looked around at the huge crowd; the villages around Oxford);líta seg íkringlook around, have a look round
ílaband	síílatog
ílag	(teld.)input
ílagað	predetermine, preordain, foreordain
ílagdur	(umt.d.líggja) inlaid,við íløgdum stáliwith inlaid steel
ílasteinurk	[stone used as an anchor]
ílat	1container, vessel;2(flutt m., bíbl.)vessel, instrument,hesin maður er mær eitt útvalt ílat(amboð) this man is a chosen vessel unto me; this man is a chosen instrument of mine
ílatin	1dressed,vera ílatinbe (fully) dressed;illa ílatinbadly dressed;ófantaliga ílatinuntidily dressed, untidy, slovenly (in one's dress);vera væl ílatinbe well dressed; be warmly clad2dressed up
ílating	dressing
ílatog	cable
ílát	síílat
ílega	(lívfr.)gene
ílegg	insole
íleggin	commited, dedicated, engaged, involved(t.d.heavily involved);(serl.politiskt) committed;(skaldsk. eis.)engagé
ílegging	(handilsm.)investment
íleggingargrunnur	(bú.)investment fund
íleggingartørvur	(bú.)sííløgutørvur
íleggjari	investor
íleguarvur	(lívfr.) genetic inheritance
ílegugranskari	geneticist
íleguhópur	(lívfr.) genome
íleguskoyting	(lívfr.)gene splicing, genetic engineering, genetic modification; (støk) gene splice
ílegutilfeingi	(lívfr.) genetic resources (flt)
ílegutillagaður	(lívfr.) genetically modified;ílegutillagað lívvera/veragenetically modified organism
ílegustýring	(lívfr.) genetic engineering, genetic splicing
ílegutøkni	genetic technology
íleidningur	sííleiðing
íleiðing	occasion, cause, ground(s), reason,geva el. vera íleiðing tilbe the occasion of(t.d.his funeral was the occasion(el.cause) of demonstrations); give occasion for, give rise to(t.d.anxiety, criticism, suspicion, scandal); result in, cause, occasion(t.d.the incident occasioned riots); spawn(t.d.their affair spawned much scandal); afford grounds for(t.d.a protest)(GG:give them no subject for complaint); motivate(t.d.there is nothing that can motivate interference);tað gav honum íleiðing at fara av fundinumit caused him to leave the meeting;hetta gav mær íleiðing at viðmerkjathis caused me to remark; this occasioned me to remark; this gave me occasion to remark
íleik	1fuss, to-do, commotion, row2agitator; rioter
ílendis	(just) opposite, in line with; abreast of, on a level with
ílendur	síinnlendskur
íli	[stone used as an anchor],liggja fyri ílabe anchored
íligin	pickled(t.d.pickled herring)
ílíki	symbol
ílop	(stb.)(um arbeiði, veiðuo.tíl.)extra(el.spare, additional) income (, stock, catcho.s.fr.)
ílýsing	clearing up, lull(t.d.in the rain)
ílýst	í osb: tað er ílýst the rain is over, it has stopped raining
ílættur	sílætta í
íløga	(handilsm., bú.)investment;aðrar íløguralternative investments
íløgubanki	(bú.)investment bank;Evropiski íløgubankin(the) European Investment Bank(stEIB)
íløgufelag	(bú.)hedge fund; investment trust; unit trust;(am.)mutual fund;innlendsk íløgufeløgdomestic hedge funds;útlendsk íløgufeløgforeign hedge funds
íløgufrádráttur	(handilsm.) investment tax credit
íløgufrágreiðing	(handilsm.) investment report
íløgugrunnur	(bú.)investment fund
íløguhugur	propensity to invest
íløgukapitalur	(handilsm.) invested capital;miðal íløgukapitaluraverage (avg.) invested capital
íløgumøguleikar	openings for investment
íløgustjóri	(bú.)fund(el.assetel.portfolio) manager
íløgustuðul	investment aid
íløgutørvur	(bú.)investment requirement, investment need
íløguútreiðsla	investment expenditure;almennar íløguútreiðslur(ES) government investment expenditure
íløguvørur	(handilsm.) investment products;aðrar íløguvørurother investment products
ím	(undir pottum, ketlum, komfýrsringumo.ø.)soot
íma	soot, blacken with soot
ímeðan	sísímeðan
ímergjaður	(stb.)(umt.d.seyð, kalva), fat enough
ímerki	stamp; (mynd) effigy(t.d.a coin bearing the effigy of the King)
ímerking	striking
ímerkja	(um mynt) strike
ímgráur	dark, obscure, sooty,himmalin er ímgráurthe sky is sooty
ímillum	1(avmarkað við tveimum punktum, linjumo.s.fr.)between(t.d.a district between two rivers; the river flows between wooded banks; he turned the letter between his fingers; the distance (, railway) between London and Oxford; the train does not stop between London and Oxford; there are only 5 years between us; relations between France and England; between hope and fear; between life and death2(millum fleiri) among(t.d.among the passengers there were several Faroese; the money was divided among the crew)3(um tíð)mánaðir ganga ímillum at eg síggi hannsometimes I don't see him for months; I only see him at intervals of several months; I don't see him for months on end;náttin ímillum 18. og 19.on the night of the 18th to the 19th;ímillum ár og dagin the course of time4(um mun)ja, nógv er ímillumthat makes all the difference; what a difference it makes5(um tað sum røtt verður um)hvør liggur ímillum nú?who is the victim of your gossip?6[íyms.samb.]ímillumárog dagin the course of time;vera ímillumbeggja, síbáðir;dettaburtur ímillum1vanish in the crowd; be deflated2hann datt burtur ímillumit knocked the stuffing out of him;gangaímillumintervene;tað ganga mánaðir ímillum at eg síggi hannsometimes I don't see him for months; I only see him at intervals of several months; I don't see him for months on end;onkuntíðinnímillumnow and then, occasionally, off and on, sometimes, now and again, once in a while;inn ímillum(in) between(t.d.in between the woods white houses stood out; he placed the letter between the pages of a book);komaupp ímillum (fl.m.)intervene, interpose;koyraímillumcommute, shuttle;taliðliggurímillum 40 og 50the figure is (somewhere) between 40 and 50;náttinímillum tann 18. og 19.on the night of the 18th to the 19th;tað er einki ímillumokkum(eis.)she is nothing to me;lat tað vera ímillum okkumlet it go no further;ímillum okkumbetween you and me; between ourselves;setaeitt ímillum tveir lutirplace(el.interpose) sth between two things
ímillumat	sometimes, now and then, once in a while
ímillumgjørt	í osb: tað er ímillumgjørt, at. it is far between, it is seldom that
íminnin	vindictive
íminning	memory, recollection
ímintur	sííminnin
ímót	(kvæð.)síímóti
ímóti	1(um stuðul, bakgrund) against(t.d.the woman was leaning against the wall; the trees stood out against the dark background)2(um mótstøðu, samanbresto.s.fr.)against(t.d.he fought against the enemy; he walked against the wind; he was against the plan); be against sth(t.d.I am against the idea);vera ímótibe opposed to sth(t.d.I am opposed to the plan); be averse to sth(t.d.I am averse to doing anything in a hurry); (um ítróttardyst og rættarmáleis.)versus(stv.)(t.d.Portsmouth versus Newcastle United; Jarndyce versus Jarndyce)3(um kós) to(wards)(t.d.he walked towards the house; there were black clouds to(el.towards) the east);hann kom yvir ímóti gentunumhe approached the girls4(um tíð) towards(t.d.towards evening); (um tað at nærkast) (um tíð) towards,ímóti kvølditowards evening;ímóti jólumtowards Christmas,ímóti ársendatowards the end of the year;út ímóti einum árifor almost a year; (um tal) about, nearly(t.d.about 50, for nearly two hours);klokkan var farin at ganga ímóti 8it was about(el.it was getting on for) eight o'clock; approximately(t.d.approximately ten dozen); (um aldur) about, getting on for,hann gongur ímóti teimum 80he is getting on for 80; approach,tað leið ímóti jólumChristmas was approaching5(um virkishátto.s.fr.)to, towards(t.d.he is kind to children; his duty to his parents); with(t.d.he has an unpleasant manner with his patients)6(tvørt av) against(t.d.against his wishes, his orders); contrary to(t.d.contrary to expectation);ganga ímóti síganga7(samanborin við) (as) compared with(el.to)(t.d.the price is 50p as compared with 40p last year); to(t.d.that is nothing (compared) to what I saw);tað er einki aftur ímóti tí ið mær hevur verið fyriit is nothing to what I have suffered; (um møguleikar, veddimál) to(t.d.the chances are ten to one; I will bet you ten to one);hon er ímóti fimm (sjey)she does the work of five (seven) people8(aftur fyri) in return for(t.d.he gave her daughter lessons in return for board and lodging; he said he would do it in return for a small fee); in consideration of; against, for(t.d.against(el.for) cash); for(t.d.do sth for a consideration)91(um rørslu øvutan veg) against(t.d.the wind, the current)2(um andstøðu)tað nýggja fær tað altíð nógv ímóti særnew things always meet with resistance3(um ósamsvar) against,gera e-t ímóti lóginido sth against the law;tað er ímóti náttúruniit is against nature4(um ólýdni) he spoke against the proposal; disobey,hann gjørdi ímóti boðunumhe disobeyed the orders10(við mótvindiel.mótráki)vit høvdu ímóti allan veginwe had the wind against us all the way; we were wind-bound all the way11(ímóti brekku),nú fór at vera ímótiwe were going uphill now12[ísamb.viðhj]aftur ímótiManchester er einki aftur ímóti LondonManchester is nothing compared to London; Manchester cannot hold a candle to London; Manchester simply isn't in it with London;tað er einki aftur ímóti tí mær hevur verið fyriit is nothing to what I have suffered;fram ímóti:fram ímóti jólumtoward Christmas;inn ímóti:inn ímóti bryggjuniin toward the wharf (, quay);niðan ímóti:niðan ímóti húsinumup towards the house;oman ímóti:oman ímóti árabakkanumdown towards the bank;upp ímóti:seta seg upp ímóti e-mrevolt against, rise against(t.d.a tyrant); challenge(t.d.his power);Sbuck(t.d.the authorities);koma upp ímóti e-mcompare; be competetive;halda tað upp ímóti ljósinumhold it to the light13[ísamb.viðfs/hjsaman við sagnorði]t.d. bera ímóti;halda ímóti;leggja ímóti;mussa ímóti;standa ímóti;stoyta ímóti;taka ímóti;vera ímóti;øva (sær) ímóti(sísagnorð)
ímótitøka	símóttøka
ímótur	(tlm.)síímóti
ímpottur	1sooty pot, sooty saucepan2(um veður)himmalin er sum ein ímpotturthe sky is as black as the grate
ímutur	sooty
ímynd	1symbol(t.d.chemical symbol, mathematical symbol);vera ímyndin avbe a symbol of, be symbolic of, symbolize, stand for(t.d.a heart symbolizes(el.stands for) courage)2(heild) sum(t.d.the sum of human knowledge); total3(fullkomin ímynd) essence, quintessence(t.d.this poem represents to me the quintessence of beauty); epitome(t.d.he is the epitome of all the manly virtues);hann er ímyndin av heiðurligheithe is honesty itself; he is the soul of honour.
ímynda	1symbolize, stand for,hvítt ímyndar sakloysiwhite symbolizes innosence2ímynda særimagine
ímyndan	symbolization
ímyndarligur	symbolic
ímyndingarevni(r)	imagination(t.d.he has no imagination)
ímyndingargáva	síímyndingarevni
ínæst	(kvæð.)sínæst
íognarfelag	(handilsm.)partnership;navngivið íognarfelagpartnership in which the names of the partners are made public
íognari	(handilsm.)partner, interested party;virkin íognariactive partner;óvirkin íognarisleeping(el.dormant) partner;ábyrgur íognarigeneral partner
ípot	(plfr.)grafting
írahópur	rabble, riff-raff, scum
írapakk	síírareppur
írareppur	(sa.)scoundrel
írasáð	1scoundrel, villain2a good-for-nothing, a ne'er-do-well;(tlm.)a dud
írast	(stb.)be wild (, unruly, unmanageable, ungovernable)
írevl	(sj.)sííriv
íreyður	reddish, ruddy
íri	Irishman; (S,niðr.)mack;írar(tjóðin) the Irish;(tilt.) hann rann sum undan írumhe rann as though the devil was after him
íriskur	(fugl.)twite(Linaria flavirostris)(Linnaeus, 1758)Linaria flavirostris © Mike Lane
íriv	(um veður) bright interval, spell, clearing up
írivin	cultivated
Írland	(landafr.)Ireland;(skaldm. eis.)Eire
íroknaður	included,(t.d.meals are included in the price; 50p postage included; these names have not been included in the list);frá 1. februar til 20. mars, báðir dagar íroknaðirfrom 1 Feb. to account of);báðir dagar íroknaðirboth days inclusive; (stytt) b.d.i;allar útreiðslur íroknaðarincluding(el.inclusive of) all expenses
írskur	Irish;írska havthe Irish Sea;írska lýðveldið(the Republic of) Ireland; (frammanundan) Eire;írska máliðIrish, Erse;írski republikanski herurinthe Irish Republican Army(stIRA);írskur stúvningurIrish stew
ís-	(jarðfr.) glacial-
ísa	1cover with ice; put on ice, put in cold storage2freeze
ísaður	covered with ice, ice-covered, sheeted over with ice
ísagleraður	síísakaldur
ísaglerakaldur	(stb.)síísakaldur
ísakaldahor	(stb.)emaciated, wasted, gaunt
ísakaldarak	ísakaldahor
ísakaldur	1cold as ice, icy(t.d.an icy wind, the room was icy), ice-cold(t.d.the beer should be served ice-cold); (um eitt ið eigur at vera heitt) stone cold(t.d.my tea is stone cold; the food (, the stove) is stone cold; a stony reception)2(fl.m.)icy(t.d.an icy glance, manner), frigid(t.d.frigid politeness; a frigid style), glacial3insensitive(t.d.to the miseries of others), blunted, callous(t.d.to the suffering of others)3with no means (of subsistence)4(stb.) ísakaldur í látrisplitting one's sides with laughter
Ísakur	í osb:blindi ÍsakurBlind Isaac
ísandi	í osb: ísandi kaldur icy (cold); biting, cutting; nipping(t.d.a cutting(el.bitingel.icy) wind
ísarak	skinny, bony, scraggy, scrawny
ísari	(sjóm.)[man who covers the fish with ice]
ísastirdur	stiff(el.numb) with cold;(tlm.)frozen stiff
ísáa	inseminate
ísáari	inseminator
ísáð	insemination
ísáða	inseminate
ísáing	(lívfr.)(artificial) insemination
ísálaður	animate, inspired
ísár	year with much drift-ice
ísbarr	ice-cream parlour
ísbjørn	(dýr.)polar bear(Ursus maritimus)Thalarctos maritimus ©iStock
ísblóma	(á rúti) frostwork, ice fern, ice(el.frost) pattern
ísborin	(jarðfr.) ice transported;ísborið grótglacially erratic rocks;ísborið legugrýtiglacially deposited sediments
ísbrótari	(skip.)ice-breaker
ísbrúgv	ice front, ice fringe
ísbrýndur	(jarðfr.) glacially scraped
ísbræðing	(jarðfr.) ice melting
ísedikur	(evnafr.)glacial acetic acid
íseting	1putting in;(lmynd.:av filmi) loading2(lækn.)implantation3(teld.)installation
ísettur	put in
íseymaður	síseyma í
íseyming	(handarb.)embroidery, fancywork
ÍSF	(st.)Ítróttasamband Føroya The Faroese Sports Federation
ísfiskatrolari	fresher
ísfiskur	iced fish
ísfjall	iceberg
ísflaki	(ice) floe
ísfløta	ice sheet, ice field
ísfoyra	(jarðfr.) glacial groove
ísfríur	ice-free(t.d.an ice-free port); open
ísfrøði	glaciology
ísfrøðiligur	glaciological
ísfrøðingur	glaciologist
ísføri	(stb.)sííshálka
ísgongd	(jarðfr.) glacial movement
íshavskrutt	(Arctic) sea scorpion(Icelus bicornis)
íshavsskøta	(fisk.)sílógvaskøta
íshálka	slipperiness
íshús	(sø.)icehouse
ísing	icing
ískaldur	síísakaldur
ískaptur	sííborin
ískápa	(jarðfr.) ice sheet, ice mantle
ískorin	carved(t.d.a carved figure; carved wood; carved in stone); sculptured(t.d.a sculptured pillar)
ískoyti	(til bók, blaðo.s.fr.)supplement; appendix; annex(e); addendum(fltaddenda); (størri) supplement; (til lóg: við broyting) amendment(t.d.revsilógarískoyti Criminal Law Amendment Act); (til lóg: reglur sum hoyra til) schedule(t.d.the schedule annexed to the Act);(trygg.:til tryggingarskjal) endorsement (on a policy)
ískoytisforrit	(teld)plugin program
ískoytisskattur	additional tax
ískubbi	ice cube
ískurður	(lækn.)sískurðviðgerð
ískøddur	(sj.)sískøddur
íslagdur	ice-covered
Ísland	Iceland;í Íslandiin Iceland
íslandsfiskur	[fish caught in Icelandic waters]
íslandsgás	(fugl.)Pink-Footed Goose(Anser brachyrhynchus)(Baillon, 1834)©iStock
íslandsgrælingur	(fugl.)red knot(Calidris canutus)(Linnaeus, 1758)© Hans Hillewaert
íslandslomvigi	(fugl.)Brunnich's guillemot(Uria lomvia)(Linnaeus, 1758)©Wikimedia Commons
íslandsmaður	sííslendingur
íslandsmási	sílítil valmási
íslandsrennari	(fisk.)sííslandstoskur
íslandsrúgva	(stb.)[small oblong haycock]
íslandstoskur	(fisk.)[cod from Icelandic waters]
íslandstroyggja	(sj.)Iceland sweater
íslendingasøga	(bókm.)saga
íslendingur	Icelander
íslendsk súgont	(fugl.)common goldeneye(Bucephala islandica)(Gmelin, JF, 1789)© Dick Daniels
íslendskur	Iceland, Icelandic;íslendskur seyðurIceland sheep;íslendskt rossIceland pony;íslendskt rossIceland lamb(el.mutton);íslendsktIcelandic
ísligin	sísláa í
íslit	1pause, interval2break, stop
íslitin	síslíta í
ísmalagørn	(stb.)síísmannagørn
ísmannagørn	[intestines in large cattle]
ísmark	(jarðfr.) ice shed
ísmási	(fugl.)ivory gull(Pagophila eburnea)(Phipps, 1774)© Wikimedia Commons
ísmikil	with much drift-ice
ísmoli	ice cube
ísna	(skaldsk.)freeze
ísnám	ice fringe
ísoga	(evnafr.)absorption
ísoppur	(plfr.)sífísibjølgur
íspegil	fool, jester, buffoon
íspinnari	instigator, ringleader
íspinnur	ice-cream; (sodavtnsísur) ice-lolly; (sjálvur pinnurin) ice-cream(el.lolly) stick
íspori	stirrup
íspuni	figment (of the brain(el.of the imagination)); creation of the imagination;hatta er tann beri íspuni (eis.)it is the figment of an overwrought brain
íspunnin	síspinna í
Ísrael	Israel;Israels ríki (bíbl.)the Kingdom of Israel
ísraeli	Israeli
ísraelskur	Israeli
ísraelsmaður	Israeli
ísrípa	(jarðfr.) stria
íss	1(til at vísa bilsniel.ovfarni) oh!, O!, dear me!(t.d.dear me, that was a bad mistake!); (ósømiligt) coo!(t.d.coo, what a lot of money!)2(skjálvti) ooh!(t.d.ooh, I was so frightened)(GG:ooh er oftast ósømiligtel.barnligt)3(ófýsiligt) ugh!(t.d.ugh, the water is cold!)
ísskjøldur	(jarðfr.) ice shield
ísskøva	(jarðfr.)ísskøvurglacial striae
ísstokkin	frozen over;(serl.um sjóleið) ice-bound
ístaðin	sístaður&gt;í staðin
ístaktur	covered with ice, iced up
ístig	stirrup
ístíð	(jarðfr.)(the) Ice Age, Glacial Period; eis.ísøld
ístíðar-	ice-age
ístíðarskái	(jarðfr.) interglacial period
ístígari	stirrup
ístoka	frost mist
ístraður	pot-bellied; paunchy
ístunga	(lækn.)suppository
ístur	(á fólki, djórum og fugli) leaf fat
ísturbjølgur	pot-belly; paunch
ísturbúkur	síísturbjølgur
ísturkíkur	síísturbjølgur
ísur1	1ice2(stb.)slide3ice-cream,ice(t.d.eat an ice, eat ices)bróta ísin (fl.m.)break the ice;ísurin er á rekithe ice is drifting;bróta ígjøgnum ísinbreak through the ice;bræða ísinmelt the ice;(fl.m.)break the ice;detta niður ígjøgnum ísinfall through the ice;fastur ísurfast ice;vera fastur í ísinumbe ice-bound;ísurin heldurthe ice bears
ísur2	(sj.)crown (, top) of the head
ísúgvandi	absorbent; eis.ísúgvin
ísúgvin	absorbent; eis.ísúgvandi
ísvatn	1ice water2melt water
ísvirki	ice factory
ísøki	(jarðfr.) glacial area
ísøld	(jarðfr.)Ice Age, Glacial Period; eis.ístíð
ítak	(lækn.)operation, surgical intervention, procedure
ítakandi	(sj.)concrete; tangible
ítari	better, more skilful, more capable
ítarligur	extremely good;hj-liga
ítastur	best, most skilful, most excellent;gera sítt ítastado/try one's utmost(t.d.he tried his utmost to help her); do everything in/within one's power; make every effort/endeavour; spare no effort; exert oneself to the utmost; leave no stone unturned
ítinna	(jarðfr.)phenocryst
ítinnugrót	(jarðfr.) porphyry
ítinnutur	(jarðfr.) porphyritic
ítinnuvond	(jarðfr.) porphyritic structure
ítonktur	(stb.)who remembers well
ítornað	sítorna
ítriv	1hobby; leasure time activity, recreation pastime;hjá teimum er tað bara ítrivthey do it for the fun of it; they make a sort of sport of it;hjá nógvum er tað veruligt ítriv atmany people make a pastime of -ing, many people think it great fun to2Spot-boiler (bók, listaverk, sum er skrivað/gjørt fyri at vinna pening),(uml.)commissioned work3(t.d.í røðuel.grein) comment,hetta er bara eitt ítriv í hesa forvitnisligu bókthis is just a comment on this interesting book
ítrótt	1(ítr.)sport, sportsflt; (fræls ítrótt) athletics, athletic sports; (bólspælo.s.fr.)games;ítrótt(í Svfo.s.fr.)the sports news; (í blað) the sports section;íðka ítróttgo in for sports (, athletics, games); be an athlete;hatta er dýr ítrótt (fl.m.)it is an expensive business;nú er ítrótt komin í taðit has become a sport, it has acquired a sporting interest2(skúlam.)physical education, physical exercises; gymnastics;(tlm.)gym;Sphysical jerks; (sum lestargrein) physical training(el.education)(stPE, PT, phys. ed.)
ítróttaandi	sportsmanship, sporting spirit
ítróttaáhugaður	interested in sports
ítróttabragd	(athletic) feat
ítróttabúni	sports clothes, sports wear, sports suit
ítróttadystur	match, contest, (sporting) event(t.d.we won four events)
ítróttafelag	sporting(el.athletic) association; (í skúla) athletic association; sports club
ítróttafelag	sporting(el.athletic) association
ítróttaframsýning	athletic display
ítróttagrein	(ítr.)sport
ítróttahandil	sports goods shop
ítróttaháskúli	folk high school for physical education; (í Ongl. og USAeis.)college of physical culture
ítróttahetja	sports star, ace(GG:a football ace; a tennis ace(el.star))
ítróttahøll	sports centre, sports hall, gymnasium
ítróttaidiot	sports freak;(svarar til)football (o.s.fr.)fanatic
ítróttakvinna	(ítr.)sportswoman, woman athlete
ítróttaligur	1sporting; athletic(t.d.feat)2sporty
ítróttamaður	(ítr.)athlete, sportsman;er tú ítróttamaður?do you go in for sports (, games)?
ítróttamerki	(ítr.)athletic diploma(el.badge)
ítróttar-	síítrótta-
ítróttaráðgevi	(ítr.)ráðgevi í ítróttamálum
ítróttasamband	(ítr.)The Faroese Sports Federation
ítróttasíða	(í blaði) sporting page, sporting section
ítróttaskaði	sports injury
ítróttaskógvar	sports(el.athletic) footwear
ítróttaskrivari	sports journalist(el.writerel.reporter); (í útv) sportscaster
ítróttastevna	(sports) meeting, sports rally; sports festival, athletic meeting;(ofta =)gymkhana (the school sports are in May)
ítróttatíðindafólk	sports reporter(GG:he covers sporting events for the Daily Mail)
ítróttatíðindi	sports(el.sporting) newseint.
ítróttaútgerð	sporting(el.sports) requisites
ítróttavedding	(ítr.)tipping
ítróttavenjari	(ítr.)coach;(tlm.)pro
ítróttavøllur	(ítr.) síleikvøllur
ítróttur	(ítr.) síítrótt
ítøka	(sj., kortsp.) síavtøka(4)
ítøkiligur	concrete; tangible;ítøkiligar samráðingarspecific discussions(el.negotiations); eis.ígripuligur
ítøkur	síítøkiligur;sbr.síúrtøkur
Ívar	(sern.)í osb:hatta var Ívar beinleysiÍvar the legless [said when a door opens by itself, because of a draught etc]
íverandi	immanent
íverksetari	entrepreneur;eis.ígongdsetari
íveruhús	(sj.)sísethús
ívist	sítilhald
ívista	sííhald
ívovin	weave in(t.d.a robe with flowers woven into the fabric), interweave; brocade(t.d.brocaded with gold thread);(fl.m.)weave into(t.d.weave compliments into one's speech); interweave(t.d.interweave one's speech with compliments);ívovin við silvurinterwoven with silver
