J2	(st.)Judge; Julius; Justice
J.A.	(st.)Joint Agent; Judge Advocate
Ja	(st.)James; January
jab	1stinga, prika (t.d.jab a needle into one’s hand; he jabbed his elbow into my side)2skúgva3nstingur, prik, skúgv; (t.d.he gave me a jab in the small of the back)4Skopping,koppseting(t.d.new flu jabs);innspræning5(í nevaleiki) høgg beint frammaná
jabber1	tvætl, suss, pjátr, bullan
jabber2	1tvætla, sussa, pjátra, bulla2ramsa upp
jabiru	(dý.)jøvurstorkur(Jabiru mycteria)
JAC	(st.) (tlm.)just around the corner
jacana	(dý.)blaðhønuættin(Jacanae)
jacaranda	(plfr.)palisandertræ(Jacaranda)
jacinth	(steinfr.)hyacinth
jack1	jack itinS gevast;jackoffSstinga av, rýma; fleyga sær, kirna;jackuplyfta við donkraft (t.d.a car); (tlm.)hækka (t.d.prices);bøta um;Sgevast, blaka frá sær;jack him up (tlm.)geva honum eina skortfleingju
jack2	(dý.)hann-, kall- (t.d.monkey)
Jack3	kelinavn fyri John;I’m all right, Jackvit hava tað gott; vit eru væl bjargað
jackal	1(dý.)sjakalur(Canis aureus)2(um persón) hjálparfólk,(niðr.)amboð
jackanapes	1nasvísur hólkur, kjaftbreiður hólkur; ovrásin og skammleysur maður2fínibeiggi, mótaprinsur
jackaroo	(avstr.) (tlm.)ein ið lærir á bóndagarði ið hevur seyðel.neyt
jackass	1asni (kalldýrið)2(fl.m.)lók, neyt, býttlingur; (síeis.laughingjackass)
jackboot	knæstivli, reiðstivli; hermannastivli, riddarastivli; løgreglustivli; (hjá sjómonnum) stivli, klovstivli
jackbox	stikkdós
jackdaw	(dý.)rókur(Corvus monedula)
jacket1	1jakki, troyggja2(á bók) kápa3(tøkn.)kápa4(á boripallum) undirstøði (úr stálrørum)5eplaflus,potatoes in their jacketsóflust epli;potatoes boiled (, baked) in their jackets… við flusi
jacket2	1lata í jakkael.troyggju; leggja kápu um2(tlm.)buka, banka
jacketing	(tlm.)fleingja, avsmyrjing
Jack Frost	frost (persónímyndað)
jack-in-office	braneggjaður embætismaður, krakkaveldismaður, býrokratur
jack-in-the-box	kassatrøll, trøll í dós
jack-in-the-green	(vera, ið dansað verður um í maiveitslum)
Jack	1sagulað2trækíli3(á klaveri) hamari4(í kortspæli) jassur, drongur5(í køki) steikivendari, vendiblað6(tøkn.)naddamáttur, donkraft7(tlf.)proppur, hólkur8(sigl.)stavnaflagg sum vísir heimahavn skipsins9pallur undir rá á mastur10(Jack -tar)vanligur sjómaður, sjógarpur11Speningur12kókispritt13(tlm.)(í tiltalu) gamli, hin rádni, vinur, frændi14(lum dýr) kall- (t.d.Jack monkey)15jacks flteitt spæl16[íyms.samb.]every man Jackhvør tann einasti, ein og hvør, allir;I’m all right, Jackeg líði onga neyð;before you could say Jack Robinsonáðrenn nakran vardi; áðrenn tú visti av;there are more jacks than one at the fairmong er geitin aðrari lík;jack of all tradesallahandamaður
Jack Ketch	bøðilin
jackknife	1(stórur) felliknívur; húklop2(um viðfestivogn) tað at skeiklast í mun til traktorin
jack-of-all-trades	allahandamaður, ein ið dugir alt til hendurnar
jack-o’-lantern	1vættraljós2lyktarmaður (holað grasker nýtt at hava ljós í allahalganaaftan)
jack pine	(plfr.)bankafura(Pinus banksiana)
jack plane	skrubbhøvul, grovhøvul
jackpot	pulja (í poker); (í happadrátti) tann stóri vinningurin;hit the jackpot (eis. fl.m.)fáa stóran vinning
jackpot rabbit	(am.)stórvaksin harusløg (av slagnumLepus)
Jack Robinson	before you could say Jack Robinsonáðrenn tú fekst talt upp í trý;áðrenn nakran vardi; áðrenn tú visti av
jack screw	naddamáttur, donkraft
jack snipe	(dý.)lítil mýrisnípa(Lymnocryptes minimus)
jackstones	eitt spæl
jackstraw	strámaður;(fl.m.)null
jackstraws	pinnaleikur
jacksy	S rumpa
jack-tar	(tlm.)sjómaður, sjógarpur
jack towel	rullihandklæði
jack-up	vøkstur, øking
jack-up rig	boripallur, ið kann flytast (við beinum, ið kunnu takast upp og setast niður)
Jacob	S stigi
Jacobean	sum stavar frá stjórnartíð James I (1603-25)
Jacobin	jakobin(ar)i
Jacobite	jakobiti (viðhaldsfólk hjá James II og hansara ætt)
Jacob’s ladder	1jákupsstigi (1. Mós 28, 12)2(plfr.)fjallaflóki(Polemonium caeruleum)3(sigl.)jákupsstigi, leytari
jaconet	lætt og mjúkt indiskt bummullarevni
jacquerie	bóndauppreistur
Jacuzzi®	gosbað
jade1	gamalt, slitið ross;(niðrum konu) titta, mer, flogsa
jade2	játa, játusteinur, jada (slag av grønum gimsteini)
jaded	pøstur, lúgvaður (t.d.the horse is jaded),dovnaður;a jaded appetiteringur matarlystur
Jaeger	
jag1	1tindur, oddur, tonn2skarð; riva (í klæði)3Skenning (t.d.have a jag on; sleep off jags)4rukkutúrur5túrur, umfar, ríð, herðindi (t.d.a crying jag)6rúsevnisskamtur; innspræning, „skot“7sskarða
Jag2	
JAG (D)	(st.)Judge Advocate General(Deputy) (am.)
jagged	1tindutur, taggutur, tentur, skørðutur2illa skorin, illa rivin, ójavnur3fullur, við kenning; “skeivur”
jagger	kakuspori
jagging iron,jagging wheel	kakuspori
jaggy	sagtentur, (sag)taggutur
jaguar	(dý.)jaguarur(Panthera onca)
jail-bait	Sómyndig genta
jail,jailbird,jailer	sígaolo.s.fr.
jake1	1(am., tlm.) bóndaflókur, dólgur, tjórneyt, bygdarfrell; nalvungi2(am.) pengar
jake2	1(am.) fínur, frálíkur, fyrstafloks2(am.) bygdasligur, ómentaður, óskúlaður; klombrutur, grovligur
jakes	Sves, bukka
jalap	(plfr.)jalaprót(Ipomoea purga)
jalop(p)y	(tlm.)gamalt lasafar, bilvrak
jalopy	(tlm.) lasafar, eitt vrak av einum bili, gamal, vanrøktur bilur
jalousie	persjenna
jam1	1súlta, súltutoy, meyk2(fl.m.)fragd; gloypubiti (t.d.jam for the Press)3[íosb]some people get all the jamsummi hava eydnuna við sær;money for jam Slættliga vunnin peningur;he really wants jam on it (fl.m.) (tlm.)hann vil hava bæði í posa og sekk;life is not all jamlívið er ikki tað bera spæl;money for jamlættliga vunnin peningur;it’s the commissions I depend upon to put a bit of jam upon my bread… fyri at fáa kjøt upp á breyðið;jam tomorrow (uml.)gylt lyfti
jam2	trongd, trokan, tysing, tipping; ferðsluproppur;get into a jam Shava trupulleikar, vera gyrdur í brøkur
jam3	1kroysta, kleima (t.d.he jammed his finger in the door);trýsta (t.d.one’s clothes into a suitcase)2tippa (t.d.the river was jammed with log); be jammedvera fastur (t.d.the ship was jammed in the ice); Svera gyrdur í brøkur;get(el.become) jammedseta seg fastan;Sgyrdur í brøkur; fara í baklás (t.d.the lock has jammed)3(óáv.)taka, vera trongur, vera trekur, læsa; læsast4(útv.)órógva (sending) við óljóðssendara5S(í jass) improvisera6jam the brakes onbremsa harðliga, høgga bremsurnar í
JAMA	(st.)Journal of the American Medical Association
Jamaica	1(landafr.) Jamaika2jamaikaromm
Jamaican1	jamaikabúgvi
Jamaican2	jamaikiskur, í/úrel.á/av Jamaika
jamb	durastavur; (í vindeyga) síðukarmur
jamboree	1(tlm.)gildi, veitsla (t.d.the film industry's annual jamboree in Cannes)2skótastevna
jamb stove	bileggarovnur, bíleggjaraovnur
James	(bíbilskt) Jákup;(sø.)James, Jákup;scallop of St Jamesjákupsskel
jam-full	á tremur
jammer,jamming station	óljóðssendari
jammy	1Sleskiligur, eiggiligur; framúr góður (t.d.he has a jammy job)2einki fyri3beistaheppin4kleimin (t.d.fingers)
jam pot	súltutoyskrukka
jam roll	rullukaka; kjøtrullael.deiggjrulla við fyllu
jam session	samkoma við jass-tónleikarum har spælt og improviserað verður til tess at hugna sær; jam-session
Jan.	(st.)January
jane1	S konufólk; genta; konufólka-ves
Jane2	
Janeiro	
Janet	
jangle	1sskeldast; skurra, skorra, ringla, glinta; kima (t.d.phones jangled in the offices)2s (áv.)skrambla (, skurraosfr.)við;it jangles my nervestað fer heilt inn á bein3nkegl, kjaftaslit, klandur, træta; skurran, ringlan, glintan
jangly	skurrandi (t.d.tone of voice)
Janissary	
janitor	duravørður; skúlatænari;(am.)húsavørður
janitress	kvinnuligur duravørður, kvinnuligur skúlatænari, kvinnuligur húsavørður
Janizary	janitsjarur (turkiskur hermaður)
jankers	S revsivenjingar
jannock	(stb.)ektaður, reiðiligur, heiðurligur, beinleiðis; fínur
January	januar
Janus-faced	1við janushøvdi (høvdið á rómverska gudinum Janus, sum hevði tvey andlit, so tað bar honum til at síggja frameftir og aftureftir; merkir oftast: tvey heilt ymisk lyndiseyðkenni) (t.d.the Janus-faced nature of American society)2(fl.m.)svikafullur (t.d.a Janus-faced politician)
Jap	(tlm.)= Japanese
Japan1	(landafr.)Japan
japan2	lakkarbeiði; japanlakk
japan3	lakka (við japanlakki)
Japanese1	1japan(ar)i2japanskt (mál)
Japanese2	japanskur
jape1	(gl.)skemt
jape2	1skemta2gera gjøldur við e-m, hava/halda e-n fyri gjøldur; háða
japer,japester	síjester
jar1	leirílat, krukka; glas (t.d.jam jar); (tlm.)eitt krússel.glas av øli
jar2	1grísl, skróv, níst, skurran2risting, skjálvti (t.d.we felt a slight jar when the engine joined the train);stoytur3(fl.m.)skelkur (t.d.the news gave me a jar);samanbrestur, kegl, træta
jar3	on the jará glopp, gloppa
jar4	1(um ljóð) skurra, nísta, grísla (t.d.the chalk jarred against the blackboard),skróva; gnella2(um rørslu) rista, skaka; ristast, nøtra, titra, skelva (t.d.the window jarred in the frame)3(fl.m.)vera í stríð við, hóska illa saman, ikki samljóða (t.d.our opinions jarred)4skeldast, keglast;(áv.)koma illa við, skelka (t.d.she was jarred by the burglary)5jaronsbyerta ein, særa ein;jar on sby’s earsskurra í oyrunum á einum;jar on sby’s nervesganga einum upp á nervarnar;jarwith(el. against)skurra ímóti; vera í stríð við, ikki samljóða við; (um lit) skríggja ímóti; (síeis.jarring)
jardinière	skreytpottur; skreytgrind undir blómum
jargon	sjargon; óskiljandi sermál; embætismál;(niðr.)krákumál, blandingsmál; uppgjørt mál
jarring	1skurrandi, grovur, uttan samljóð2ristandi, skelvandi (t.d.motion)3(fl.m.)skakandi, skelkandi; særandi; ertandi
jarvey	(írskt:) leigukuskur
jasmine	(plfr.)jasmin(Jasminum)
jasper	1(steinfr.)jaspis; jasperredjaspisreyður2(am.)bóndaflókur
jaspideous	(steinfr.) líkur jaspis, jaspishavin
jaundice	1(lækn.) gulusótt2(flm.) øvundsjúka, illnati, illgrunasemi
jaundiced	1sjúkur av gulusótt2øvundsjúkur;jaundiced with envygulur av øvund (t.d.he had a somewhat jaundiced view of the professor)
jaunt1	stuttleikaferð, útferð, túrur (t.d.a jaunt to the shore, a jaunt around the country)
jaunt2	fara á útferð, ferðast um, flakka
jaunty	kátur, lættur, skemtiligur, spelkin;wear one’s hat at a jaunty angleganga við húgvuni heilt upp á snurr
Java	(landafr.) Java
Javanese1	1javanesi, javanesari javanes(ar)i2javanskt (mál)
Javanese2	javanskur
javelin	1(sø.) sleingispjót, kastispjót2spjót (í ítrótt);throwing the javelinspjótkast
javel water,javelle water	bleikivatn
jaw1	1kjálkabein (t.d.upper jaw; lower jaw)2høka (t.d.a strong jaw); his jaw droppedhann gjørdist so lippusíður3(tlm.)kjaftur;his jaws were sethann beit á kampi;hold your jaw (óvand.)halt kjaft;there is too much jaw about himhann brúkar seg ov illa;none of your jaw ! (tlm.)eingin mutar ímóti!4tos, kegl, kjaftaslit5moralprædika6(tøkn.)klógv7jaws fltkløur, bitkløur; kjaftur, gap;the jaws of deathdeyðans føvningur
jaw2	(tlm.)skræða seg, gorra, møsna, brúka seg, brúka kjaft; skelda (t.d.the teacher jawed the lazy boys)
jaw bation	orðaskvaldur, orðabrask, innantóm tala; moralprædika
jawbone1	kjálkabein
jawbone2	(við støði í tí myndugleikael.høgu støðu ein hevur) streingja á, kreva eitt, skora á, leggja trýst á;congresswoman Weintrob jawboned local officials about their responsibilities toward immigrant communitykongresskonan Weintrob skoraði á lokal embætisfólk um at minnast til ta ábyrgd, tey hava tilflytarum viðvíkjandi
jawboning	(am.)almenn áheitan til yrkisfeløg um at sýna hógv í samráðingum
jawbreaker	(tlm.)orð ið eru torfør at bera fram;it is a jawbreakerhatta ber ikki til at siga; málslig spruttroynd
jaw-breaking word	orð sum eingin dugir at úttala
jaw-dropping	ovfarin, steinbilsin; undranarverdur, ótrúligur (t.d.jaw-dropping displays of genius);with jaw-dropping dexterityvið ótrúligum hegni;an eye-dropping scenerylandslagið gjørdi meg ovfarnan/málleysan; skelkandi (t.d.after having seen the report I must say it is pretty jaw-dropping stuff)
jaw-jaw1	Sendaleyst prát, gorr
jaw-jaw2	Sjabbael.meyla eitt langt og annað breitt
jaw-me-dead,jaw-me-down	S suss
jay1	(dý.)gnelliskjóra(Garrulus glandarius); (fl.m.)suss, møsn; gekkur
jay2	(am., tlm.)fátæksligur, vesælur; reyvkeðiligur;a jay townbygdaslig hol
jayhawker	(am., sø.) [geriljahermaður (guer/r/illa) sum stríddist fyri at varðveita trælahaldið í amerikanska innanlandsstríðnum, 1861-65]
jayvees	(am.) [studentar ið fyrireika seg til fyrsta árið á fróðskaparsetri]
jaywalker	(um fólk til gongu) klombur (ið leggur líka í ferðslureglurnar)
jazz	1djassur2Srok, roks, hóvasták; møsn (t.d.what's all this jazz about you leaving?);reyp, geip, fupp
jazz1	2djassa; spæla í djassstíli4rokast, fáa rok í;jazz upseta lív í, fríska upp (t.d.the company wants to jazz up its image; she tried to jazz the room up with a new rug);and all that jazz Sog alt hatta har; og alt tað fjasið (t.d.oh, love, life,and all that jazz)5Spráta, tvætla, møsna6Smogga
jazzband	djassorkestur
jazzed	spentur (t.d.he was really jazzed for the game; she was jazzed (up) to be playing in the band)
jazzman	djasstónleikari
jazzy	djasskendur; við lívi í, lívligur; grefligur, áleypandi
J. C. S.	(st.)Joint Chiefs of Staff
J. D.	(st.)Doctor of Laws
jealous	1øvundsjúkur, eljusjúkur(ofinn á), svartsjúkur (t.d.a jealous husband)2strangur, vandlátur (t.d.a jealous guardian; the Lord … is a jealous God)3be jealous of one’s rightsansa væl og virðiliga eftir sínum rættindum;keep a jealous eye on his movementshava eyguni eftir hvar ið hann fer
jealousy	øvundsjúka, øvund, eljusjúka, svartsjúka, ástarøvund;(bíbl.)vandlæti
jeans	cowboybuksur
jee	=gee¹; gee²; gee³
jeep	1n (herm.)jeppur2skoyra í jeppi
jeer1	háð, spott;jeers fltháanarróp (t.d.under the taunts and jeers of the mob)
jeer2	háða, speireka, spotta; gálva, skelkja(ateftir)
jeering	háðandi, speirekandi, spottandi
Jeez	(mðlv,S)áh jesus!
Jehovah	(bíbl.)Jehova;Jehovah’s WitnessesJehova vitnir
jejune	turrgeldur, berur, soltin, turrur; andleysur; innihaldsleysur (t.d.novel);óbúgvin (t.d.behaviour)
jell	1(tlm.)stívna (til lopael.sjelé)2(fl.m.)fáa fast snið (t.d.our plans haven’t jelled yet)3(áv.)geva fast snið; frysta fast
jellied	lopakendur; í lopael.sjelé (t.d.jellied eels)
jelly1	1lopi, sjelé;beat sby into a jellysmildra ein2tjúkk saft
jelly2	leggja í lopa; lata stívna til lopa
jelly baby	gummibamsa
jelly bean	1sukrað gummibomm2bløka, ónytta,(tlm.)lortur
jellyfish	1(dý.)hvalspýggja(Schyphozoa)2(tlm.)kloddi, bløka, vøttur
jellyroll	1kjøtrullael.deiggjrulla við fyllu2Skynslív; skøpini á konufólki; elskarinna;sell jellyrollskøkjulevnaður
jemimas	(gl.)fjaðrastivlar
jemmy	1(stutt) kúbein2S (matg.)seyðarhøvd
jennet	smávaksið spanskt ross; asnaryssa
jenneting	(tíðliga búgvið) summarsúrepli
jenny	1rennikrani2spunamaskina3(um ávís dýr) kvenndýr4lkvenn- (t.d.jenny monkey, jenny wren)
jeopardize	vága, seta í váða
jeopardy	vandi, váði
jerboa	(dý.)støkkmús(Dipodidae)
jeremiad	harmagrátur, gremjan
Jeremiah	Jeremia
Jericho	Jeriko;go to Jericho !far til Bloksbjørg!;I wish you were in (el. at)Jericho hevði tú verið á Bloksbjørgum
jerk1	1hvøkkur2rykk (t.d.he gave the rope a jerk; he started the car with a jerk),nykkur, skrykking3skump; kast; spjálk4(am.) Sdólgur, neyt, bløka5(physical) jerks flt (tlm.)fimleikur, „spjálk“;put more jerk into itleggja meira orku í;by jerksí stoytum
jerk2	1rykkja, skrykkja, rippa,jerk alongflyta seg í rykkjum2hvøkka3spjálka4nikka (t.d.he jerked his head towards the door)5støkka;jerk awakestøkka upp úr svøvni;jerk out one’s wordsstøkka orðini fram úr sær, kønka6jerk off (óvand.)fleyga sær, kirna
jerk3	turka kjøtálir í sól
jerkin	troyggja við ongum ermum;(sø.)vampi, tjúkkur bjálvi
jerkwater	(am.) jerkwater townlítil og týdningarleysur býur
jerky	1í stoytum, í rykkjum2ristandi, skinklandi3(um persón) støkkin, hveppin
jeroboam	(fløska ið tekuruml3 l)
Jerome	
jerque	(sigl.) tollkanna;jerque notetollkanningarváttan, tollavgreiðsluváttan
jerrican	flatur bensindunkur
jerry1	S(nátt)pottur; ølstova
Jerry2	Stýskari, týskur hermaður
jerry-builder	byggispekulantur
jerry-building	spekulatiónsbygging; byggifusk
jerry-built	illa smíðað, klamsað saman
jerry can	flatur dunkur til bensin; t.s.s.jerrican
jersey	1troyggja; blusa við longum ermum; slag av bundnum klæði2(dý.)jerseykúgv
Jerusalem	Jerusalemartichokebøllur av sólblómu(Helianthus tuberosus)sum verður nýttur til matna;Jerusalem ponyasni
jessamine	(plfr.)jasmin(Jasminum)
jesse,jessy	give him (, get) Jessegev honum krút!
jessie	djaikari,(óvand.)rumpari; kventil
jest1	skemt, hittinorð, stuttleiki;in jesttil stuttleika, skemtandi;take a jestskilja skemt
jest2	skemta(st), siga í skemti;jest about(el.with)skemta við
jestbook	hittinorðasavn
jester	skemtari, íspegil, fívil;(sø.)hirðfívil;he is a licensed jesterhann kann siga alt, hann kann vera bersøgin
jesting	skemtandi, skemingarsamur, skemtiligur (t.d.a jesting remark)
jestingly	skemtandi, skemtliga, á skemtiligan hátt
Jesuit	jesuiti
jesuitic(al)	jesuitiskur
Jesus	Jesus Christ!tú góðasti gud!
jet1	1sprænur (t.d.of water, jets of blood spurted out)2(á slangu) strútur3(gass:) gassbrennari4gasslogi5(í stoyping) strútur6(flogm.)jetflogfar; jetmotorur
jet2	1goysa, spræna, spýta, vella2(tøkn.)buka niður (t.d. pelar)
jet3	gagat (hart brúnkol nýtt til gersemi)
jet bead	kolperla
jet-black	kolasvartur, bikasvartur, ravnsvartur
jet engine	jetmotorur
jet fighter	jetstríðsflogfar, jetjagari
jet lag	møði eftir langan flogtúr
jet pilot	jetflogskipari
jet plane	jetflogfar
jet-propelled	reaksjónsrikin
jet propulsion	reaksjónsrakstur
jetsam	1reki, strandvarp; skipbrotafæ; farmur, ið blakaður verður fyri borð til tess at lætta skip2(fl.m.um fólk) skipbrotin
jet set	glæsilið (flokkur av samfelagsins ríkastu, ið ferðast millum frítíðarstaðirnar í jetflogførum; tey ríku ungu, ið liva í gleimi)
jettison	1tað at blaka farm út til tess at lætta um skipel.flogfar2tað at rakett kastar eitt stig av sær3sblaka fyri borð, lætta um far; (um rakett, rúmdarfar) kasta av4(fl.m.)tveita av sær, tveita fyri borð, seta byrðu av sær, gera seg frían av einum, lætta um
jetty1	bryggja, atløgubryggja, brimgarður
jetty2	kolasvartur
jeu d’esprit	(franskt)heilafimleikur
jeune premier	(franskt) (sjónl.)fyrsti elskari
jeune première	(franskt) (sjónl.)fyrsta elskarinna
Jew1	gýðingur, jødi
jew2	1(eis. jew down)lumpa, svika2tingast um prís;jew downtrýsta niður (t.d.he jewed me down to $45)
Jew-baiting	gýðingajagstran
jewel	1gimsteinur; prýði, prýðislutur; gripur, dýrgripur, skartgripur; (í urverki) steinur2(fl.m.)dýrgripur3sprýðael.seta við gimsteinum
jewel beetle	(dý.) skreytklukka (Buprestidae); eis.metallic wood-boring beetle
jewel box,jewel case	skrínel.kistil til skartgripir
jewelled	við steini í (t.d.ring)
jeweller	skartgripaseljari; gullsmiður (eis.goldsmith)
jewellery,jewelry	gimsteinar, skartgripir
Jewess	gýðingakona, jødakvinna
Jewish	jødiskur, gýðinga-
Jewry	gýðingatjóðin; gýðingabýarpartur; jødar,American Jewryamerikansku jødarnir;international Jewryaltjóða jødedómur
jew’s-ear	(plfr.)slag av átusoppum(Auricularia auricula-judae)
jew’s harp	gýðingaharpa
Jezebel	1(sern.)Jesabel (1 Kong 16, 31)2nsiðleys kona
JFK	(st.)John Fitzgerald Kennedy
jib1	1bummur, lyftiarmur á krana2(sigl.)klyvari, jibbur; (á stuttleikabátum eisini) fokka3útsjónd, yvirbragd;the cut of one’s jib (fl.m.)hvussu ein er klæddur
jib2	1(um ross) vera stygt, vera støkkið(atfyri onkrum), sporðreisast(t.e.fara upp á afturbeinini); steðga knappliga, vera treiskt2(fl.m.)mótmæla, seta seg upp ímóti, vera treyður;jib at (fl.m.)biðja seg undan, mæla ímóti, vera treyður, vera trekur,jib at doing itvera trekur at gera tað; víkja fyri3(sigl.)gippa
jibber	1støkkið ross, treiskt ross2jibber the kibbervið skeivum ljósum at fáa skipa at stranda
jib boom	(sigl.)klyvarabummur, stingunebbi, spryt
jib door	tapethurð
jibe1	1speisemi, sneiðorð2jibes flt (eis.)háð, spott3s: jibe atvera speiskur við, speireka, háða4(sigl.)gippa
jibe2	(am., tlm.)samsvara (við) (t.d.our views don’t jibe)
jiff,jiffy	(tlm.)løta,in a jiffbeinavegin;wait a jiff, jiffybíða mær eitt pikkulítið sindur
jig1	1lívligur dansur2pilkur (fiskireiðskapur)3(tøkn.)borilæra, borikassi4the jig is up Sleikur er lokin
jig2	1danda, dansa, hoppa2sálda, sælda3(fiska:) royna við pilki, pilka
jigaboo	(niðr. slang.)nekari
jig-a-jig	S„eitt lítið” (samlega)
jigger	1ein ið dansarjig2ein ið sáldar; sáld3jiggari(t.e.víð konufólkatroyggja)4(dý.)sandloppa, mararmýggj(Tunga penetrans)5(sigl.)gaffilsegl; mastur á seglskipi6talja7Shurð8fongsul(sklivi)9smálutur10løgin snigil11(am.)mál til spiritus (44, 3 ml); drammur, snapsur, glas12s(um fisk) sprakla; spjálka13ssvika við;well, I’m jiggered!tað var sum tramin!jigger upoyðileggja, forkoma; pøsa, lúgva14Sspilla, oyðileggja; fløkja
jiggermast	(sigl.)fjórða mastur á seglskipi
jiggery-pokery	(tlm.)fupp
jiggle	(tlm.)danda (t.d.her cheeks jiggled),gidda, vagga, rugga; hoppa (t.d.sit still and don’t jiggle); he jiggled a finger in his earhann skriðaði sær í oyranum
jiggs	(í illbøn)by jiggs!for tramin!
jigsaw	1(lítil) motorleyvsag2putlispæl
jigsaw puzzle	putlispæl, (tlm.) puslispæl
jihad	1heilagt kríggj2(fl.m.)herferð, átak
jillion	(skemt) a jillion oførgrynni av
jilt	1jilt himsvíkja hann, narra hann, geva honum krakk2n (uml=) glýðra, koks
Jim	(st.)James
Jim Crow	(am.)S nekari; rasuskilnaður; mismunur mótvegis nekarum;Jim-Crow carjarnbreytarvognur til nekarar einans;Jim-Crow schoolskúli til nekarar einans
jim-dandy	(am., tlm.)frálíkur
jim-jams	1fjáltur;it gives me the jim-jamseg verði ørur av hesum2S brennivínsøði
jimmy1	(stutt) kúbein
jimmy2	bróta seg inn;the burglar jimmied a windowinnbrotstjóvurin breyt seg inn igjøgnum eitt vindeyga (viðel.eins og við kúbeini)
jimp	fínur, snøggur; klænur, mjáur; knappur, tepur, neyvur, ikki nóg mikil
jimsonweed	(am.)gaddepli(Datura stramonium)
jingle1	1glint, ringlan2bjølluljómur3ríma, skjaldur, ramsa4lýsingaorðing; eyðkennisljóð, eyðkennislag
jingle2	ringla (við), glinta (t.d.the keys (, coins) jingled in his pocket; he jingled the keys (, coins) …)
jingo1	(niðr.) víðgongdur tjóðskaparmaður, tjóðskaparreypari;by jingotað veit Gud; pínadoy
jingo2	tjóðskaparreypandi
jingoism	víðgongd og reypandi tjóðskaparkensla, tjóðskaparreyp
jingoistic	tjóðskaparreypandi, krígshugaður
jink	1skákrennael.snirra undan einum, ið eltir2(flogm.)flogsnirra, snirra undan skotálopi3nsnirring
jinks	high jinksskemt og rok, gildi, skemt
jinn	andi (í islam)
jinricksha,jinrikisha	rickshaw (tvíhjólaður lættur leiguvognur, ið maður dregur)
jinx1	(am.)Sófrættafuglur, lutir ið hava óeydnu við sær; óeydna, óhapp
jinx2	(am.)Svera atvold til óhapp ella vanlukku;put a jinx onganda, rúna, kasta rúnir á, veita óeydnu
jinxed	gandaður
JIT	(st.)just in time
jitney	1(am.) S5 cent (mynt)2n[lítil bussur við lágum ferðagjaldi og smidligari ferðaætlan]3lódýrur
jitter1	S rista, skelva, darra
jitter2	1skjálvti, darran2fjálturhave the jittersdarrael.skelva av fjáltri; faftra, fjáltra;throw a fit of the jittersfáa nervaherðindi
jitterbird	(tlm.)rædduskítur
jitter buffer	blaktridoyvari
jitterbug	1(dansur) jitterbug2(avelt) ein ið dansar jitterbug3sdansa jitterbug (t.d.we jitterbugged to the catchy rhythms)2S nervavrak
jittery	S nervaveikur, fjálturstungin, bangafullur; skelvandi, darrandi (av fjáltri); støkkin (t.d.caffeine makes me jittery)
jiu-jitsu	síjujitsu
jive	1n (am.)(hot) jassur; (latínamerikanskur dansur); innantómt prát2sdansa jive; arga, tvætla;it doesn’t jive withtað samsvarar ikki við
J,j	
jn	(st.)junction
Jno	(st.)John
Joan	Joanof ArcJeanne d’Arc;(gl.)bóndagenta
job1	1arbeiði, starv (t.d.he has a job in my firm; he has a job with Brown & Co.),arbeiði (t.d.it is his job to see to that)2(eis.íteld.)verk, uppgáva3akkordarbeiði,(prent.)smáprent4(tlm.)trupult arbeiði, knoss, slit (t.d.it was a job to get it all ready; I had quite a job getting the things in order; you’ll job it an awful jobtú fert at fáa nógv stríð av tí)5alment starv nýtt til egnan fyrimun6Stilburður, viðburður, søga7innbrot, rán8(um gentu) steik (t.d.look at that blonde job in the red dress);(síeisjab)9[íyms.samb.]it was a(put-up)job,síput-up; it was abad(, good) job thattað var illa (heppið) at;make the best of a bad jobroyna at fáa sum frægast burturúr (hóast okkurt er miseydnað); ikki missa mótið;give it up as a bad jobkasta tað frá sær sum vónleyst;paidbythe jobakkordløntur;payment by the jobakkordløn;work by the jobarbeiða upp á akkord;have a jobdoingithava ilt við at fáa tað gjørt;he had aneasyjob of ithann slapp lættliga úr tí;do his jobforhim (fl.m.)oyðileggja hann, koyra hann á húsagang;make agoodjob of itklára tað fínt;it was a good job that you cametað var gott at tú komst;and a good job tootil alla lukku!;be on the jobrøkta sítt; vera í arbeiði;do a jobonspilla, oyðileggja;give sth up as a bad jobgeva skarvin yvir;oddjobstilvildarligt arbeiði;beonthe jobhava úr at gera; vera til reiðar, vera vakin;beout ofa jobvera arbeiðsleysur;it was atoughjobtað var krevjandi arbeiði
job2	1gera arbeiði2gera arbeiði upp á akkord3handla við pengum, handla við virðisbrøvum4misnýta alment starv til egnan fyrimun;job him into the postskaffa honum starvið; (síeis.jab); he jobbed his brother into the posthann skaffaði beigjanum starvið5Ssvika
Job3	have the patience of Jobhava Jobs tol;poor as Job’s turkey (am.) Sikki eiga sýru í vegg
job action	síindustrialaction
jobation	(tlm.)ábreiðsla, (long) moralprædika
jobber	1peningamarknaðarhandlari, virðisbrævahandlari2akkordarbeiðari3millumhandlari4ein ið mísnýtir alment starv til egnan fyrimun
jobbery	1misnýtsla av politiskari makt til egnan fyrimun2rotinskapur, mutur, nepotisma (tað at geva kenningum fyrimunir, tá størv skulu setast)
jobbing	1sum virkar sum millumlið2sum átekur sær fyrifallandi arbeiði3sum brúkar alment starv til egnan fyrimun
jobbing gardener	leiguurtagarðsmaður
jobbing waiter	leigutænari
job bonus	arbeiðsviðbót
job cafe,job café	vinnustova, yrkisstova
job card	1(handilsm.) arbeiðsseðil, tímauppgerð2=cost sheet
job carriage	leigubilur
job category	starvsflokkur
job centre	arbeiðsávísing
job control	(teld.)verkstýring
job control language	(teld.)verkstýrimál
job creation	arbeiðsskapan
job description	starvslýsing
job development	arbeiðsskapan
job enrichment	trivnaður/trivni á rbeiðsplássinum
job environment	arbeiðsumhvørvi
job evaluation	starvseftirmeting, starvskanning (meting av tí virði tey einstøku virkisstørvini hava í mun til hvørt annað og laga lønarlagið eftir tí)
job experience	starvsvenjing (hjá lærlingumt.d.)
job generation	arbeiðsskapan
jobholder	1(am.)í føstum starv; í almennum starvi2(uml.)tænastumaður
job-hop	skifta starv/arbeiði títt
job-hopper	(am.)fjakka, ein ið skiftir starv/arbeiði títt
job-hopping	(am.)fjakkan, tað at skifta starv tíðum
job-hunter	(tlm.)sum sóknast eftir arbeiði
jobless	arbeiðsleysur
job lot	blandað vørusending;(fl.m.)blandaður skari
job lot production	(uml.)hópframleiðsla, raðframleiðsla
job market	jobmarked
jobmaster	(gl.) ein ið leigar ross og vognar út
job mobility	sícareer mobility
job order	(handilsm.)framleiðslubílegging
job placement service	arbeiðsávísing, arbeiðsávísingartænasta
job price	1(handilsm.) stórkeypsprísur (lágprísur við at keypa nógv av einari vøru í senn)2(handilsm.) akkordløn, akkordgjald
job retraining	starvsumskúling
job rotation	starvsumferð
job satisfaction	(uml.)trivni á arbeiðsplássinum
Job’s comforter	ringur uggari (ein, ið einans ger ilt verri)
job security	(uml.)arbeiðstrygd
job seeker	sum sóknast eftir arbeiði
job slip	arbeiðsseðil
job specification	arbeiðslýsing
job status	starvstign
job training	starvsvenjing
job turnover	starvsfólkaskifti (t.d.job turnover at Hoover was only 5 per cent)
job work	1leyst arbeiði2(prent.) smáprent
jock1	1(am.)S fjeppari (t.d.a computer jock);ítróttafjeppari2diskarieis = jockey, disc jockey, jockstrap
Jock2	1bóndaflókur2(eyknevni) skoti3Sskøp
jockese	ítróttarprát
jockey1	1kappríðari, jockey2drongur, hjálpari3svikari
jockey2	1ríða2lumpa;jockey for positionroyna at fáa sær fyrimun, royna at leggja seg væl fyri;jockey sby out of his moneylumpa pengarnar frá einum;jockey sby into doing sthlumpa ein til at gera eitthvørt; troka (ein) burtur við snildum, lumpa ein við snildum (t.d.the Minister was jockeyed out of his post)3svika
jockstrap	1klovbind, ítróttabind2(am.) Sítróttafják
jocose	skemtingarsamur (ofta møðsamt)
jocular	kátur, stuttligur, skemingarsamur (t.d.she sounded in a jocular mood;jocularremarks; ajocularman)
jocularity	kæti, skemt, stuttleiki
jocund	kátur, glaður, lættur í sinni
jocundity	kæti, gleði
Jodhpurs	reiðbuksur
Joe	(st.)Josephnot for Joeikki fyri alt í verðini;a Joe Millergomul skemtisøga
joey	1(avstr.)(kenguru)ungi2(avstr.)húskallur3S(sirkus)fívil4Shyklari
jog1	stoytur, skump; hóvlig renning
jog2	1rista(st), skaka(st)2renna hóvliga, tvagla, tvassa, tvarra, tøssa; skumpa, koyra undir3kondirenna, jogga4[íyms.samb.]jog alongsmárenna, renna spakuliga;matters jog alongtað gongst sum frægast;we manage to jog along somehowvit hóra undan;jog sby’s memoryfríska minnini upp;we must be joggingvit mugu fara
jogger	joggari
jogging	hóvlig renning, heilsurenning, rennivenjing, jogging
joggle	1skumpa, rista, skumpa undir,joggle him uprista í hann; verða skumpaður, fara skinklandi; (íteld.)stoyta, skúgva2blindnagli;joggled frameblindnegld ramma3nskump
jog trot	1tvagl, vanagongd, gerandissjagg (t.d.go back to the jog trot of the office; the jog trot of daily life); the usual jog trotgrái gerandisdagurin;go on in the old jog trot(el.jog- trot way)vera í gamla sjagginum2jog-trot(brúkt suml.)av handahógvi
jog-trot	dreiva, dratla, tvagla, smárenna
Johannesburg	
john1	1(am.)Sves, wc.2kundi hjá gleðigentu
John2	1(sø.)Jóhan (síLackland);(í bíbliuni) Jóhannes (t.d.John the Baptistdoyparin)2Sjassur; kinesari; snillur
John Bull	persónsímyndingin av ensku tjóðini
John Doe	(løgfr.)N N
John Dory	(dý.)pætursfiskur(Zeus faber)
Johne’s disease	(dýralfr.)garnasótt (hjá seyði og neyti)(Paratuberculosis)
John Hancock	(am., tlm.)undirskrift
John Law	(am.)S løgreglumaður
johnny	S jassur; fínibeiggi, mótaprinsur; wc; hít
johnnycake	(am.)maiskaka;(avstr.)hveitikaka
johnny-come-lately	nýkomin
Johnny-on-the-spot	sum altið er tøkur
Johnny Raw	nýbyrjari
Johns Hopkins	(am.) fróðskaparsetur, lærdur háskúli í Baltimore
Johnson	(bókmentasnið átøkt tí hjá Samuel Johnson)
John Sullivans	S langar undirbuksur
John Thomas	S murtur, snippur, “javnaldurin”, “gamli”
joie de vivre	(fr.)lívsgleði, lívshugur
join1	groyping, skoyti; samankoming, felling
join2	1sambinda, binda saman (t.d.join the two towns by a railway)2sameina(eis.íteld.)(t.d.they are joined in a lifelong friendship); what God hath joined together, let no man put asundertað sum Guð hevur saman komið, má maður ikki sundur skilja;they joined fortunestey gingu saman í hjúnalag, giftast, ganga saman um eitt3seta saman (t.d.join two pieces of wood),seyma (, neglaosfr.)saman, festa (t.d.join two pieces of material together)4melda seg inn í (t.d.a club);fara upp í (t.d.the European Community); join the armyfara upp í herin;join battlefara undir bardaga; verða limur í (t.d.the Labour Party);fara saman við;join forces withganga saman við, fara í part við, taka seg saman, taka lógvatak saman, sameina megina;join handstaka saman hendur; leiðast;(fl.m.)fylkjast, lyfta í felag; joinintaka lut í, vera við í; taka undir, koma upp í;join in the game (eis.)spæla við;join up (tlm.)melda seg sjálvboðin; (síeis. I issue)5fara yvir til (t.d.let us join the ladies); I’ll join you in a minuteeg verði har beinanvegin; vera saman við;will you join us for dinner?hevur tú hug at eta døgurða (saman) við okkum?; sameina seg við, taka undir við (t.d.my wife joins me in thanking you),hitta6(um jørð) vera mark móti, hava mark við (t.d.his garden joins mine)7(óáv.)taka lut, vera við; vera saman við (t.d.I join with him in offering you help)8møtast, umskarast, (um áir eis.) renna saman í eitt
joinder	samband, sameining
joiner	snikkari, træsmiður
joinery	snikkaraarbeiði
joint1	1groyping, skoyti, samankoming, felling2(í múri) samankoming3(likam.)liður (t.d.finger joints)4(bókab.)brot5(plfr.)knæ, liður6(jarnbr.)skinnaraskoyti7steik (t.d.a joint of beef)8Sskeinkistova, bøli; pláss, hús9Smarihuanasigarett10beout ofjoint withikki hóska saman við, ikki samljóða við; vera misnøgdur við;put out of jointfáa úr lið, fáa av lagi, gera í ólagi;put his nose out of jointtroka hann burtur, ota hann burtur;the time is out of jointtíðirnar eru farnar av lagi
joint2	1skoyta, groypa, sambinda2passa saman, passa inn í3(um múr) fylla samankoming, fuka
joint3	sameindur, felags, samlaður;on (el. for) joint jointfyri felags rokning;joint actionfelags framførsla;joint and severalvið samábyrgdt.d. responsibility); joint authorsamhøvundur;joint concernfelags mál; jointcustodyfelags foreldramyndugleiki;by joint effortsvið sameindum mátti;during their joint livesso leingi tey eru á lívi
joint account	felagskonta; (handilsm.)on joint accountfyri/upp á felags rokning
joint committee	(tingm.)felagsnevnd
jointed	liðskiftur, við liðum (t.d. fishing rod)
jointed rush	(plfr.)tjarna-sev(Juncus articulatus)
jointer	1langhøvil2(múrara) fukijarn, fukiskavari3(á plógvi) forgrev
joint fish	samfiska
joint fishery	samfisking, samfiskiskapur
joint fishing	samfisking, samfiskiskapur
jointing	samankoming, skoyti, groyping
jointing plane	
jointless	(handv.) við ongum samankomingum/fellingum, (tlm.) við ongum fugum (t.d.flooring)
jointly	felags; við samábyrgd;be jointly and severally responsiblebera samábyrgd
joint meeting	felagsfundur
joint mice	mús á knænum
joint owner	samognari, samognarfólk, partseigari
joint property	felagsogn; (í skilnaðaruppgerð) ogn, virði, sum verða býtt millum hjúnini; sí eis.community property
joint stock	(handilsm.) [íløgukapitalur býttur sundur í ávísa nøgd av partabrøvum]
joint-stock	joint-stock bankpartabrævabanki; joint-stockcompanylutafelag
joint-stock company	(handilsm.) [virki sum partabrævaánararnir eiga í felag eftir íløgustøddini]
joint union delegate	felagsálitisfólk
jointure	einkjusæti, einkjulutur
joint venture	(handilsm.)samváði, samtak
joint venture company	(handilsm.)samváðafelag
joist	1biti, bjálki, undirslag, syll2gólvstroyggj3undirlag
joke1	1skemt, hittinorð;the joke wasagainstmehann gjørdi seg stuttligan upp á mína rokning;this is gettingbeyond(el.past) a jokenú er tað ikki stuttligt longur;carrythe joke too far gera ov nógv av í skemti;crack(el.cut) a jokeskemta, vera hittinorðaður;the jokeofittað stuttliga við tí;he is the joke of the townhann er til láturs í øllum býnum;jokeover!skemt til viks!;it is reallypasta joketað er ikki stuttligt longur;takea joke skilja skemt
joke2	skemta (við);I was only jokingtað var einans/bara í skemti
joker	1skemtari2(í kortspæli) jokari3(fl.m.)eithvørt óvæntað; vansi ið ikki sást frammanundan;(am.)setningur ið er lumpaður inn í lógel.sáttmála og fullkomiliga broytir týdningin
jokesmith	(am.)S skemtismiður, skemtihøvundur, skemtiteknari
joking1	skemt;joking apartskemt til viks
joking2	skemtandi;he’s not in a joking moodhann er ikki í tí stuttliga lagnum
jokingly	skemtandi, í skemti
jollification	1gleimur, fagnaður2veitsla, góður vertskapur
jollify	halda gleim, halda gildi
jollity	1kæti, gleði, gleimur2veitsla
jolly1	(tlm.)arga, smikra (t.d.jolly him into (doing) it),leggja gott orð inn fyri;jolly him alongleggja gott orð inn fyri hann, eggja honum til
jolly2	1kátur, glaðlyntur, skemtingarsamur; í góðum lag2(tlm.)frálíkt (t.d.weather);stórur (t.d.it is a jolly shame; he is a jolly fool)3hjsera, ógvuliga (t.d.he is jolly clever); he is in a jolly messhann er í eini rættiligari fløkju;jolly good!fínt! sera gott! frálíkt!take jolly good careansa sera væl eftir, vera sera varin;he is jolly well rightvíst hevur hann rætt
jolly3	1Smarinari2jolla3Sskemtilig viðmerking
jolly boat	(sigl.)jolla, skipsbátur
Jolly Roger	(sø.)sjórænaraflagg
jolt1	1stoytur, skump, skak, risting2n (fl.m.)skelkur (t.d.her pride had received a jolt);hvøkkur (t.d.the news gave us all a jolt)3Srúsevnisskamtur; drykkur; fongsulsrevsing
jolt2	1renna á; rista; skumpa, skaka (t.d.we were badly jolted in the old car; public confidence has been severely jolted)2(fl.m.)skelka
jolting	1skinklan, skramblan2(flm.) stoytur, skelkur, risting
Jonah	1(sern.)Jónas2nófrættafuglur
Jonathan	jónatansúrepli;Brother Jonathan(heiti fyri amerikanara)
Jones	keep up with the Jonesesikki standa aftan fyri grannarnar(viðv.bilum, sjónvarpiosfr.)
Jordan	(landafr.) Jordan
Jordan almonds	1ymisk sløg av mandlum2(søtmeti) mandlur við sukurglasing í ymsum litum
Jordanian1	jordan(ar)i
Jordanian2	jordanskur
jorum	stór drykkjuskál, punsjbolli
josh1	(am.)Sskemt, arging
josh2	skemta (við), arga smávegis
joshing	skemtandi
joss	kinesisk gudamynd
josser	S jassur
joss house	kinesiskt tempul
joss stick	roykilsispinnur
Jos stJoseph	
jostle	skumpa (undir);be jostledverða skumpaður aftur og fram; trokathey jostled with one another for seatstey trokaðust fyri at fáa sitipláss;jostle againstrenna ímóti;jostle throughtroka seg ígjøgnum
jot1	depil, prikkur, punkt;not a jotikki minsta vet, ikki ein moli, ikki petti (t.d.she doesn’t care a jot for him); sskriva niður;jot downrusla niður
jot2	rísla, krutla, klóra (t.d.jot down their names)
jotter	minnisbók
jottings	uppskriftir; niðurruslaðar viðmerkingar
joule	(al.)joule (orkueind)
jounce	1rista, skaka, skinkla2hoppa, leypa
journal	1dagbók, minnisbók2dagblað, tíðarrit, vikublað3fundarbók, gerðabók4(sigl.)skipsdagbók5(tøkn.)tøppur á ási
journalese	vánaligt blaðmál
journalism	1blaðvinna, blaðstarv, blaðskriving;school of journalismjournalistaháskúli2blaðútgáva; blaðheimurin3tíðindaflutningur
journalism student	journaliststudentur, journalistlesandi
journalist	blaðfólk, tíðindafólk
journalistic	blað-, blaðmanna-; dagblaðs-
journalize	skriva dagbók
journey	1ferð (mest á landi);reach one’s journey’s endkoma á mál;go on (el. make) a journeyfara undir eina ferð;a pleasant journey !góða ferð!;make the sad journeyganga ta tungu leið2kanningarferð3túrur (t.d.this bus goes ten journeys a day)
journeyman	sveinur, handverkarasveinur;journeyman paintermálarasveinur;journeyman bakerbakarasveinur
joust	1n (sø.)dystur, riddarakapping2sdystast, taka lut í kapping
Jove	Jupiter;by Joveá tú góðasti; Guð viti; pílar og skot; mín sann
jovial1	skemtingarsamur, glaðlyndur, hugnaligur; kátur, lívligur, vertskapsligur
Jovial2	sum viðvíkur gongustjørnuni Jupiter
joviality	kæti, gleimur
jowl	1kjálki, kinn, vangi (t.d.she had a large nose and heavy jowls)2(á neytum) bringsvølur (leysa húðin undir hálsinum oman móti frambeinunum), (á fugli) silpa;with a heavy jowlvið stórari undirhøku; (síeis.cheek)
joy1	gleði, frøi, eydna, lukka;weep for joy, shed tears of joygráta av gleði;joy of livinglívsgleði;wish him joyynsk honum góða eydnu;I wish you joy of it(speiskliga) væl gagnist;no joy! Shar er einki at gera; hasum fáa vit einki burturúr
joy2	(gl. skaldsk.) gleðast, frøast
joyful	kátur, glaður, fróur, lívligur
joy girl	gleðigenta
joy house	gleðihús
joyless	óglaður, óeydnusamur
joyous	glaður, kátur, fróur; gleðiboðandi
joyride1	(tlm.)skemtitúrur, hugnatúrur (serliga uttan loyvi)
joyride2	koyra ein túr til tess at hugna sær
joystick	stýripinnur(eis.íteld.),teldustýri
J.P.	(st.)Justice of the Peace
Jr,jr	(st.)junior
juba	(í trælatíðini í USA) [lívligur afrikanskur dansur har stevið verður tilskilað við lógvabrestum]
jube	(í kirkjuml.kór og skip) loft (á loftinum), svalir
jubilance	fagnan
jubilant	fagnandi, fegin, ógvuliga glaður
jubilate	fegnast, skera í fagnaðarróp
jubilation	sigursfagnaður; veitslurómur;cries of jubilationfagnaðarróp
jubilee	1(fimmtiára) minningarhald, fagnaðarhátíð; fagnaðarveitsla2(kat.)heilagt ár; fagnaðarár; frælsisár
Judaeo-Christian	jødakristin
judaic	jødiskur, gýðingaligur
Judaism	jødadómur, gýðingatrúgv, gýðingadómur
Judas1	1Judas2nsvíkjari
judas2	kagingarhol í hurð; njósnari
Judas kiss	judasarkossur
judder	rista, skelva
Jude	(bíbl.)(apostulin) Judas; Judasar bræv
Judea	(bíbl., landafr.)Judea
judge1	1dómari;the judges (at cattle showosfr.) dómsnevnd;as grave as a judgegravalvorligur;as sober as a judgepínliga edrúur2(ser)kønur maður (t.d.he says it’s a genuine Picasso, but he is no judge); be a judge of pictureshava skil fyri málningum;he is no judge (of that)hann hevur ikki skil fyri tí;I’ll be the judge of thattað fari eg sjálvur at meta um;Book of Judges(í bíbliuni) Dómarabókin
judge2	1døma; vera dómari (t.d.judge at a flower show); judge not that ye be not judgeddømið ikki, at tit ikki skulu verða dømd (Matt 7, 1)2meta um (t.d.horses; a distance)3haldast at vera (t.d.the book as a whole must be judged pretty boring),meta, halda (t.d.he judged it prudent to wait); judgeforyourselfmet sjálvur um;judgefrom appearancesdøma eftir útsjónd;judging from his conducteftir atburðinum at døma;you may judge(of)my astonishmenttygum kunnu ætla, hvussu forfardur eg varð
judgement	
judg(e)ment	1dómur, dómsúrskurður, dómsniðurstøða;judgment was given against himdómurin gekk ímóti honum;obtain judgment against himfáa dóm feldan yvir hann;deliver judgmentfella dóm;give judgment for themgeva teimum viðhald í málinum;pass(el.pronounce) judgment on (fl.m.)fella dóm yvir;set oneself up in judg(e)ment onseta seg sum dómara yvir;sit in judg(e)ment onsita og døma; (síeis I pass)2meining, meting;in my judg(e)menteftir míni áskoðan);to the best of my (, his etc.) judgmenteftir bestu sannføring;deliver (el. give) one’s judg(e)mentsiga sína meining3orð, umdømi, ummæli (t.d.sound judg(e)ment),metingarevni,dismissed because of errors of judgmentssagdur úr starvi tí skeivar avgerðir vóru tiknar;he is a man of judgmenthann er eitt skilafólk4revsing (t.d.it is a judgment on you for acting like thattað er revsingin fyri at …)5(átr.)(Guðs) revsing;day of judg(e)mentdómadagur
judgeship	dómaraembæti; embætisskeið hjá dómara
judgmatic(al)	skilagóður, skynsamur, gløggur
judgmental	1viðvíkjandi metingarevnum (t.d.judgmental error; judgemental decisions about the likelihood of company survival.)2dømandi (t.d.I don't like to sound judgemental, but it was a big mistake)
judgment book	dómprotokoll; lívsins bók
judgment creditor	dómhavi
judgment day	dómadagur
judgment debtor	dómfeldi
judgment sampling	sýnisroynd
judgment seat	dómarasæti
judicative faculty	metingarevni
judicatory	1ndómstólur2ldømandi, dóms-
judicature	dómsvald sum ein grein av ríkisvaldinum; dómskervi; dómstólur;the judicaturedømandi valdið
judicial	1(løgfr.)rættarligur, rættar- (t.d.inquiry; decisionúrskurður); dómara- (t.d.benchsæti)2(fl.m.)atfinningarsamur, rættvísur; gløggur, skarpur; kaldligur; óvildaður (t.d.investigation; conduct)
judicial act	rættargerð
judicial assembly	dómstólur
judicial bench	the judicial benchdómarasæti;(fl.m.)dómararnir
judicial combat	(sø., løgfr.)einvíggi, hólmgonga
judicial decision	rættarlig avgerð
judicial interpretation	(løgfr.)dómstóla tulking
judicially	rættarliga
judicial murder	avrætting óseka
judicial opinion	(løgfr.)úrskurður
judicial power	dómsvald, dømandi vald
judicial proceedings	bring (el.take) judicial proceedings againststevna, lógsøkja, leggja sak ímóti, reisa ákæru ímóti, taka upp søksmál ímóti
judicial review	(løgfr.)dómstólaroynd
judicial separation	sundurlesing, hjúnaskilnaður, skilnaður at borði og song
judiciary1	1dómsvald;the judiciarydómsvaldið2dómstólaskipan; dómskervi; dómarastætt
judiciary2	rættar- , dóms- , dømandi
judicious	skilagóður, skynsamur (t.d.we should make judicious use of the resources available to us; spend your money a little more judiciously)
Judith	
judo	judo
judy	Sgenta; býttlingur;make a judy of oneselfgera seg til láturs
jug1	1kanna, strútakanna, tútakanna, krúss, tútakrúss2Sfongsul(be in jug),gegl, myrkaskot
jug2	11stoyta í kannu2kóka í kannu2seta í geglið/fongsul, seta fastan
jugal	kinn-
jugal bone	(likam.) kinnbein (Oz zygomaticum)
jug-eared	(am., tlm.)við kálvaoyrum, við útrendum oyrum, við peiggjandi oyrum;he was often mocked for his jug earshann varð ofta argaður við sínum kálvaoyrum
jug ears	he was often mocked for his jug earshann varð ofta argaður við sínum kálvaoyrum
Juggernaut	1Jagannata (indiskurátr.)2(fl.m.)máttur ið ikki stendst ímóti og sum leggur alt í oyði á síni leið; okkurt ein gevur seg til í blindum3(tlm.)stórur lastvognur (til fjarferðslu), lastvagnatok
juggins	(tlm.)dylhøvd
juggle1	1gykla (t.d.with words)2fimla (t.d.the circus performer juggled with seven balls)3stríðast við, fáa at ganga upp, hava nógv fyri í senn (t.dshe works full time,jugglingher careerwithraising children)4lumpa; falsa;juggle the accountspilka við roknskapirnar;juggle the figuresfalsa tølini;juggle people out of their moneylumpa pengar frá fólki
juggle2	1gykl, gandalist2svik
juggler	gyklari
jugglery	gykl, gandalist; svik, fals
juglandaceous	(plfr.) sum hoyrir upp í valnøtarættina
Jugoslavia,Jugo-Slavia	(landafr.)Jugoslavia
Jugoslavian, -slavic	jugoslaviskur
Jugoslav,Jugo-Slav	1njugoslavi2ljugoslaviskur
jugular1	hálsæðr
jugular2	háls-
jugular vain	hálsæðr
jugulate	skera á háls
juice1	1saft, sevja;tobacco juicetubbakssevja; væta, løgur2Ssprutt; bensin; (ravmagns)streymur
juice2	pressa sevjuna úr; fríska upp; gera meira spennandi
juiced	S fullur
juice extractor	saftpressa
juicehead	drykkjumaður
juiceless	sevjuleysur
juiceman	okurkallur
juicer	S elektrikari;Sdrankari
juicy	1sevjuríkur, saftarmikil, leskiligur2vátur; (um pípu) súr3(tlm.)sum kastar av sær, sum gevur4spennandi, leskiligur; (um gentu) eiggilig5kleimin, morreyður (t.d.story)
jujitsu	jiujitsu (japansk glíming)
juju	verndargripur, gandagripur; gandamáttur
jujube	bomm, bróstsukur
ju-jutsu	
jukebox	jukeboks
jukeboxjoint	(am.)Sdansikjallari (við jukeboks)
jukejoint	dansibøli
julep	[kaldur, kryddaður drykkur]
Julia	
Julian	julianskur;Julian calendarjuliansk tíðarrokning
Juliet	
July	juli
jumble1	sugga, vavgreytur,in a jumbleí einum vavgreyti; hurlivasi
jumble2	vevja saman, blanda saman
jumble sale	loppumarknaður (sum liður í peningainnsavning)
jumbo	1nrisi; klóta2lrisavaksin, trøllvaksin, risa- ; jumbo- (t.d.jet)
jumboize	(sigl.)set upp í skip; leingja skip
jump1	1hopp, lop (t.d.clear the stairs at one jump; parachute jump; the long (, US. broad) jumplongdarlop;the high jumphæddarlop2hvøkkur (t.d.evolution takes place in jumps; a jump in prices); he gave a jumphann hvakk við3krepping, brotakast4(í kapprenning) forðing5(íteld.)lop6S„eitt lítið“7the jumps Sfjálturskreppingar; brennivínsøði, delirium tremens8get the jump on (am.) Sfáa undandrag, vera undan einum, vera fyri einum; ,be all of a jump (tlm.)vera fjálturstungin;be on the jump (tlm.)hava úr at gera; vera fjálturstungin
jump2	1hoppa, leypa (t.d.jump out of the window)2(um prísosfr.)gera lop upp eftir, snarhækka, (um persón eis.) hvøkka (við) støkka;he jumped (eis.)hann hvakk við3(um bil) høgga4(áv.)leypa (upp) um (t.d.a fence, a chapter in a book)5(knappliga) seta í hægri starv; hækka prísir nógv6rýma undan7lokka (t.d.be jumped into doing it)8mogga9[ísamb. viðn]jump one’sbailSrýma meðan ein er leysur undir borgan;jump thebusleypa úr bussinum;jump aclaimogna sær jørð tillutað øðrum; gera seg inn á annars mans rætt;jump thegunleggja avstað ov skjótt, tjóvstarta;jump thequeuefara fram um onnur í røð; troka seg fram;jump thetrackmissa slóðina10[ísamb. viðfs/hj]jumpatleggja eftir, taka gleðiliga við, smekka til;jumpdownsby’s throathella seg yvir ein, leggja á ein;jumpforjoyhoppa av gleði;jumpin(fl.m.)leypa til;jumpoffleypa avstað; byrja, fara í gongd;jumpon(fl.m.)finnast at; detta yvir, hella seg yvir ein;he nearly jumpedout ofhis skinhann hvakk við;jumptoconclusionsleypa framav;jump to one’s feetleypa á føtur;jumptogetherpassa samman;jumpupstøkka upp;jumpwithsamsvara við
jump ball	dómarakast
jump bid	(t.d.í bridge) lopmeld, lopmelding, tað at leypa (íliti el.í sang)
jumped-up	sum knappliga er komin fram; hovin, hástórur, erpin, dramblátur;they are a jumped-up lotteir eru nýkomnir framat
jumper	1leypari2troyggja, síð og víð blusa; matrósablusa3(am.)spensarkjóli4(tlm.)konduktørur5(tøkn.)boristong; slagborur, høggborur
jumping cracker	(fýrverk,tlm.) skrubbtussa
jumpingjack	spjálkidukka
jumping-off board	lopfjøl
jumping -off ground	(fl.m.)lopfjøl
jumping pit	lopgrøv
jumping sheet	loplak, bjargingarlak
jump leads	startkáplar
jump rope	hoppiband
jump seat	fellisetur
jumpy	hoppandi, skinklandi; støkkin, bangafullur, fjálturstungin, spentur, sperdur
Jun	(st.)June; Junior
junction	1sambinding, samband, groyping2vegamót, jarnbreytarmót, ferðslumót3áarmót
junction box	(ravm.)íbindingardós
juncture	tíð, stund, løta; avgerandi løta, kreppuløta;at this juncturejúst nú, nú sum støðan er, í hesum umstøðum
June	juni
Juneberry	(plfr.)berjamispel(Amelanchier x lamarckii)
jungle	1frumskógur, villskógur2(fl.m., eis.)ruðuleiki, lógloysi3(am.) Sfjakkaralega
jungle fever	(slag av malaria)
jungle growth	(flm.) fløkja, hurlivasi (t.d.of legal procedure)
jungle gym	klivlag, klivstættur
jungly	1frumskógarkendur, frumskógar-2kjarrvaksin
junior	1llægri, sum hevur minni at siga2lyngri, yngsti;he is my junior by some yearshann er nøkur ár yngri enn eg3n barristersum ikki erKing’s Counsel4n (am.)studentur næstsíðsta lestrarár
junior clerk	bankanæmingur
junior college	(am.) collegeið veitir tveyára skeið, ofta sum fyrireiking tilsenior college
junior high	sí junior high school
junior high school	(am.)(skúli ið fevnir um 7., 8. og 9. skúlaár)
junior partner	1(handilsm.)yngsti felagi2(í samgongu) tann minsti samgonguflokkurin, „kitt“
junior school	(skúli fyri børn í aldrinum 7-11 ár)
juniper	(plfr.)baraldur, einir, baraldsviður, einiberviður(Juniperus communis) juniper berryeiniber
junk1	1rusk, fras, burturkast, skrambul, órusl2møsn, tvætl3(sigl.)gamalt togverksburturkast4saltkjøt5junka (kinesiskt far)6Srúseitur
junk2	S blaka burtur
junk3	nyttuleyst, virðisleyst, sum einki nyttar (t.d.load up on salted junk food)
junket	1loypingur, rómastampur2gildi3(am.)ferð (, át) fyri almennan pening4útferð, skemtiferð5shalda veitslu, halda gildi; gera útferð, fara skemtiferð
junketing	1veitsluhald, vertskapur, gildisrómur2fara skemtiferð, gera útferð;(serst. am.)ferð (, át) fyri almennan pening
junk food	fras, sjoppumatur (matur við lágum føðsluvirði og við nógvum feitti og sukri)
junkie	S evnismisnýtari, narkomanur
junk mail	(am.) áskriftarleys postur, adressuleys sending (vørulistar, lýsingabløðo.s.fr.), 'ruskpostur'
junkman	ruslhandilsmaður (ein ið handlar við brúktum vørum)
junk playground	skrambulspælipláss
junk room	óruslukamar
junk shop	ruslhandil, marskandisarahandil (handil við brúktum lutum)
Juno	
Junoesque	bæriligur, hábærsligur, tignarligur
junta	hermannaráð, ríkisráð, serliga í Spania og Ibero-el.Latínamerika; (síeis.junto)
junto	1loyniráð, politisk samansvørjing; klika2hermannaráð, junta
Jupiter	
Jurassic	(jarðfr.)jura-;the Jurassic Period, the Jurassicjuraøld, juratíð, juratíðarskeiðið
juridical	løgfrøðiligur, rættarligur
jurisconsult	løgfrøðingur
jurisdiction	1(løgfr.)løgdømi;fisheries jurisdictionfiskiskaparløgdømi2(løgfr.)dómsvald3embætisøki, starvsøki, arbeiðsøki
jurisprudence	almenn løgfrøði; løgspeki, løgvísindi, rættarheimspeki; rættarkervi
jurisprudential	løgvísindaligur, løgspekiligur, løgfrøði-
jurist	løgfrøðingur
juristic(al)	løgfrøðiligur
juristic person	(løgfr.)løgpersónur
juror	nevningur; limur í dómsnevnd
jury1	1(løgfr.)nevningar; nevningating; nevningadómur;be(el.sit) on the jury (løgfr.)vera nevningur2(til framsýningarosfr.)dómsnevnd
jury2	(sigl.)neyð- (t.d.anchor, mast, sail, yard)
jury box	nevningabásur
juryman	nevningur
jury mast	(sigl.)neyðmastur
jury -rigged	(sigl.)neyðriggaður
jury rudder	(sigl.)neyðróður
jussive	(máll.)boðs-, boðsháttar-
just1	1rættvísur(tomótvegis) (t.d.decision)2reiðiligur (t.d.a just man);rættur (t.d.proportion)3rímiligur (t.d.the payment is just)4hóskandi, uppiborin (t.d.punishment)5heimilaður, grundaður (t.d.suspicion)6neyvur (t.d.scalesvekt)
just2	1beint, júst (t.d.he has just arrived),akkurát (t.d.he just managed to get through)2bara, bert, einans (t.d.she is just a child)3(tlm.)snøgt sagt (t.d.I just had to see you)4(viðleis.) beinleiðis, vissuliga, heilt, púra, fullkomiliga (t.d.it’s just splendid)5(viðboðsh)bara (t.d.just listenlurtið bara;just (you) wait),eitt sindur; bara (t.d.just tell me his address)6[íyms.samb.]justaboutumleið (t.d.just about a hundred; it was just about here); just about to goum at fara;justasí tí (t.d.just as he came);júst sum (t.d.just as I said); just as goodakkurát eins góður;justnowbeint nú; fyri løtu síðan (t.d.he was here just now); justsopúra rætt, júst;justunderfifty per centsløk fimmti prosent
just3	(sø.)=joust
justice	1rættvísi, rættlæti;substantial justicesonn/satt rættvísi;rough justicefrumkend/frumkent rættvísi2rættur3heimild (t.d.I must admit the justice of his claim)4(um persón) dómari5[íyms.samb.]dohim justice, do justice to himvera rættvísur mótvegis honum, veita honum frama, geva honum tað ið hansara er;do oneself justicebrúka øll síni evni, gera sítt besta;here he can do himself justice (eis.)her kann hann veruliga nýta síni evni;do justice to everybodygera rætt og skjal við øll;justice wasdoneto himhann fekk rættvísa viðferð;let justice be donelata rættvísina njóta frama, lata rættin ganga sína gongd;to do him justice (el.injustice)we must admit that he is industrioushann skal eiga tað at hann er arbeiðssamur;in justice (eis.)rættvísiliga;the justiceofhis claim (eis.)tað ið gevur honur rætt til hetta krav;Justice of the Peacefriðdómari (óløntur dómari uttan løgfrøðiliga útbúgving);withjustice av røttum
justice of the peace	friðardómari
justiceship	dómaraembæti, dómaratign
justiciable	sum kann leggjast fyri rættin (we signed the treaty under European law, justiciable under European Court)
justifiable	ráðiligur, umberandi, heimilaður, sum gevur heimild, sum gevur rættel.rættindi; justifiablehomicidedráp ið ikki verður revsað sambært lógini; (ofta =) neyðverjudráp
justification	1rættvísgering(eis. átr.)2verja, heimild(offyri)3grundgeving, grundir4(prent.)reglubreidd
justificative,justificatory	sum kann nýtast til at rættvísgera (grundgevael.greina), seta fram góðar orsakir fyri
justify	1rættvísgera, verjaI do not feel justified in doing iteg kann rættvísa gera tað;justify our existenceverja okkara tilverurættindi2grundgeva, geva grundir fyri, prógva (t.d.a statement which must be hard to justify)3heimila (t.d.nothing can justify such conduct)4(prent.)reglufylla5(teld.)staðrætta
justly	av røttum; rættvísiliga, av góðum grundum (t.d.he was justly indignant at his treatment)
jut1	jut outstanda framúr, standa og raða (t.d.a rock jutted out from the side of the bank); stinga framúr, seta framúr (t.d.she put up her head andjutted outher chin with determination)
jut2	nøs, nøv, nasi
Jutes	[jútar, ein av trimum germansku ættbólkunum sum løgdu Ongland undir seg í 5. øld (410e.t.o.) saman við anglum og sakslendingum/saksum]
Jutland	1(sern.)Jútland2ljútskur
Jutlander	júti
Jutlandic	jútskur
jutting	raðandi, sum stendur framel.uppundan, peiggjandi framel.upp;síjut1
juvenescence	byrjandi ungdómur; (upp)ynging
juvenescent	um at røkka unglingaárini
juvenile1	1ungmenni, unglingur, ungdómur;(plfr.)ungplanta2barna-el.unglingabók3(sjónl.) =juvenile lead
juvenile2	unglinga-, ungur
juvenile court	unglingadómstólur
juvenile delinquency	unglingamisbrot
juvenile delinquent	unglingamisbrótari
juvenile lead	(sjónl.)fyrsti elskari, elskari; sjónleikari ið spælir unglingaleiklutir
juvenilia	[verk sum rithøvundurel.listafólk hava avrikað, meðan hann/hon framvegis var ungur/ung]
juvenility	1ungdómur2unglingar, ung fólk (flt)
juvey,juvie	1(am.)S=juvenile delinquent2(am.)Sungdómsfongsul
juxtapose	seta lið um lið; javnseta, javnmeta;juxtaposedlið um lið; liðstaddur;juxtaposed tosettur undir liðina á
juxtaposition	javnseting, javnmeting; liðstøða
juxtaposition twins	samanvaksnir tvíburar
jynx	1(dý.) snúðurkriki (Jynx torquilla) t.s.s.wrynck2(am.)gykl, gandur,; tølan, dáran, bergtøka
