n1	(st.)1(málfr.) neuter2nominative3noon4noun5(tlm.,um ótilskilaða nøgd) number6note
N2	(bókstavurin) n
N3	(st.)1New2North, Northern
Na	(st.)Nebraska (postnummar), sí eis.Nebr.
NAACP	(st. am.)National Association for the Advancement of Coloured People
Naafi	(st.)Navy, Army, Air Force Institutes(uml. hermannaheim)
nab1	non-alcohol beer
nab2	1Staka, nápa2Shandtaka
nabe	1(am.) grannalag, øki, ið liggur uttanum, her um vegir, námind, nánd2grannalagsbiografur3granni
nabob	1(gl.)ríkmaður (evropeariel.innføddur, ið ríkaði seg upp í India)2(gl.)ríkur livimaðurel.njótingarmaður3(sø.)varakongur, landshøvdingi
nacarat	bjartur appilsinreyður litur
nacelle	1maskingondol2(til luftskip) gondol
nacre	perlumóðir
nacreous	perlumóður-
nadir	1(stjfr.)anddepil, beint niður, nadir (á himmalkúluniel.himmalhválvinum, móts.zenit)2(fl.m.)lágmark, lægsta punkt
naff1	naff off!gakk við tær!; slepp tær burtur!, gakkel.far tín veg!
naff2	Savoldaður, farin av móta; ótíðarhóskandi; smakkleysur, flatur; ónýtiligur
NAFO	(st.)Northwest Atlantic Fisheries Organization fiskiveiðifelagsskapurin fyri útnyrðingspartin av Atlantshavi
NAFTA	(st.)1North American Free Trade Agreement2New Zealand and Australia Free Trade Agreement
nag1	1gamalt, slitið ross, avdeyðaross2(serst.um konufólk) plága, syndaplága, marra(t.d.hon er sum marran)
nag2	deilan, at deila, píning, at pína, plágan, at plága, prik, at prika, grenj, at grenja
nag3	1liggja eftir einum (í heilum), illkenna ein, illkennast (um eittel.inn á ein), ganga og prika, grenja, smádeilast2plága, ganga á (ein)(toum at) (t.d.she -ged him to get his hair cut)3[íyms. samb.]nag aboutgrenja um;nag atsí 1, 2;she -ged him into buying the househon gekk á hann, inntil hann at enda keypti húsini
nagger	kvendi, illkvendi, gívur
nagging1	1smádeila; at ganga og prika2plágan
nagging2	nívandi (t.d.nagging fear; nagging pain)
nagsman	[vandur rossamaður sum hevur sum starv at venja ross og vísa ross fram]
nah	Snei
naiad	(gudal.)naiada, vatndís, áardís
nail1	1naglur, negl2(dý.)klógv3(á snikkaravirki) seymur, nagli4(serst. átr.)naglur5[íyms. samb.]do one’s -s1klippa negl2smyrja neglalakk á, mála neglirnar;hit the nail on the headraka seymin á høvdið;that was a nail in his coffintað var ein nagli til líkkistu hansara;pay on the nailgjalda beinanvegin, gjalda í hondina;as hard as -s1harður sum steinurin, miskunnarleysur, grótharður2í óførari venjing;-s in mourningsvartar negl
nail2	1negla, soyma2naglreka3styrkja við jarni (naglum)4Staka, handtaka, avdúka (t.d.nail a lie)5(am.S)mogga6[íyms. samb.]nail a lieavdúka eina lygn7[ísamb. viðfs//hj]naildown 1negla fast (t.d.nail carpet)2(fl.m.)fáa endaliga skil á onkrum, staðfesta nágreiniliga (t.d.the reason; the weakness of the plan)3(um avtalu) fáa í lag;that contract will nail down their agreementsáttmálin fer at binda tey til avtaluna4(um fólk) fáa at halda orð, fáa at standa við (eitt);nail sby down to a promisefáa ein at halda orð;I cannot nail her down to a specific dateeg fái hana ikki at siga ein fastan dag;nailon tonegla fast á;nail one’s colourstothe maststanda fast upp á, ikki vilja slaka (gevast);nailupnaglreka; negla afturel.negla fyri
nail-biter	1ein ið bítur negl2ræðufilmur, spenningsfilmur, ræðusøga, spenningsbók(o.tíl.)
nail-biting	(fl.m.)sum fær ein at bíta negl, øgiliga spennandi
nail biting	at bíta negl
nail brush	naglabust,(tlm.)neglabust
nail file	naglafíl, neglafíl
nail gun	soymipistól, (tlm.) seymipistól
nail polish	naglalakk,(tlm.)neglalakk
nail puller	seymtogari
nail punch	kavnagli, dorur (hjá træsmiði)
nail scissors	naglasaksur,(tlm.)neglasaksur
nail set	sínailpunch
nail varnish	naglalakk,(tlm.)neglalakk;nail varnish removerneglalakkloysari
naïve,naive	góðvarin, góðtrúgvin, bláoygdur
naiveté	góðvarni, góðtrúni
naked	1nakin, berur, nektaður2(plfr.)snøggur3(um ljós) opin; ikki avbyrgdur (t.d.bulb, light)4(um kenslur, gerð) ókrógvaður, opinberur, ófjaldur, reinur og skærur (t.d.fear//greed//hatred)5[íyms. samb.]with the naked eyevið berum eygum(t.e.hvørki við sjóneykuel.kikara);naked sworddrigið svørð
nakedness	1nakni, nekt2(bíbl.)blygd
naker	(gl.) glymskál, pavka
NAL	New American Literature
NALGO	National and Local Government Officers' Association
Nam	síVietnam
NAM	National Association of Manufacturers
namable	verdur at nevna, nevnandi, sum hevur uppiborið at verða nevndur, sum roknast kann við
namby-pamby1	kroyst; viðkvæmtel.kroystkent fólk; kventil; uppgjørtel.skaput fólk (t.d.he was a good boy, a namby-pamby, who kept the place assigned to him)
namby-pamby2	uppgjørdur, fjákutur, kroystkendur, sentimentalur; veikur,(tlm.)ryggjaleysur (t.d.namby-pamby liberals)
namby-pampy sentimentalism	kventlalótir
name1	1navn2heiti, eiti, nevni (t.d.what is the name of that kind of ornament?; Elsass is the German name for Alsace)3orð, giti, lov, (navn)frægd (t.d.some of the biggest names in the art world were at the party); the place got a bad nameplássið hevur ringt orð á sær4[íyms. samb.]the name of the gametað er hatta, tað snýr seg um;his name is mudhann er ikki væl í øgn við (ein), hann er fallin í ónáð; eingin hevur virðing fyri honum;call sby -stosa niðrandi við ein;(tlm.) give it a name (tlm.)hvat vilja tygum hava (at drekka)5[ísamb. viðs (+ fs el. hj)]draghis namethroughthe mud (fl.m.)dálka hann út;(tlm.)havea nameforvera gitinel.kendur fyri;havethe nameofbeing a miservera kendur sum ein píra;ithashis nameon(fl.m.)1tað er hansara, hatta átti hann (t.d.the game had his name on it: he led all the way)2hatta dámar honum; hatta er júst nakað fyri hann (t.d.here is a choclolate that has your name on it);keepone’s nameonthe booksverða verandi limur;lendone’s nametoleggja navn til;makeone’s name,makea nameforoneselfgerast(el.blíva) kendur;name-ssmetta um;she refused to name -shon sýtti fyri at nevna nøvn;putone’s namedown 1gerastel.blíva limur2skriva seg(fortil); tekna seg(forinn á (skúla);putone’s nametoskriva navnið undir;I can’t put a name to him(m)eg minnist ikki í løtuni, hvussu hann eitur;send inone’s namelata seg melda;takeone’s nameoffthe bookssiga seg burturúr6[ísamb. viðfs]byname, by the name ofat navni;go by/under the name ofvera kallaður/róptur;know by name1kenna av/at navni2kennast við navnið;inall but namebara ikki av navni;inname onlybara av navni;what’s in a name ?hvat hevur tað við málið at gera, hvønn talan er um?;inthe nameof 1í eins navni, í navninum á (t.d.cruel experiments carried out in the name of science)2hansara//hennara vegna (t.d.accept a gift in the name of the association); reserve a room in the name of Johnsonbíleggja rúm í navninum Johnson;what in the name of heaven?hvat í Guðs garði?, hvussu/hvat/hvar í víðu verð?;a man of namevíðagitin maður;of the name ofat navni;he has not got a pennytohis namehann eigur ikki sýru í vegg
name2	1nevna (atel.við navni), navngeva, kalla upp(after, (am.) foreftir)2(um upplýsing) nevna, ramsa upp (t.d.she -d a lot of places we could visit);siga navnið á, nevna (t.d.she refused to name her sources)3(til ávísan setning, starv) tilnevna, útnevna(astil) (t.d.name him as one’s successor; as student of the year, totil at); (við ávirki) tilnevnael.útnevna til (t.d.name her head of department)4(um val millum fleiri møguleikar) ráða fyri, avgera (t.d.the time);velja (t.d.you may name your weapon);áseta (t.d.the price; one’s conditions)5(stjm.)tala at, hava at6[íyms. samb.]nameafterkalla upp eftir;nameassíomf.: 3; the dead man has been -ed as John Smithmaðurin, sum var funnin deyður, æt John Smith;namefor(am.)kalla upp eftir;name the dayáseta brúdleypsdagin;younameit, they have ittey hava alt bæði líkt og ólíkt;gold, diamonds, you name itgull, diamantar hvat sum helst
name3	1navna- (t.d.name sign)2(tlm.)kendur, gitin
name board	(sigl.) navnabretti
name brand	vørumerki
name-calling	ókvæmisorð, illbønir, skemdarorð, bannan og blótan
name day	navnadagur
name directory	telefonbók
name-drop	nevna kend fólk at navni (og soleiðis látast at kenna tey); reypa av at kenna kend fólk
name-dropper	[ein ið reypar av at koma saman við kendum fólkum]
name-dropping	navnasletting, [tað soleiðis hissini nevna kend fólk at navni og soleiðis látast sum um, at ein kennir tey persónliga]
nameless	1navnleysur2ókendur (t.d.the work of a nameless medieval monk);a man who must be namelessmaður hvørs navn eg ikki má nevna3(skaldsk.um kenslur) andstyggiligur, ræðuligur (t.d.nameless yearning//horror)4sum ikki eru havandi á munniel.munnberandi, sum ikki kann sigast frá (t.d.crimes)5[íyms. samb.]a man who shall be namelesseg vil ikki siga, hvør maðurin er
namely	nevniliga
name part	(sjónl.,í filmi) høvuðsleikpartur, høvuðsleiklutur
nameplate	navnaskelti, hurðarskelti
name recording	navnaupptøka
namesake	navni (mín), navna (mín)
name tag	navnaspjaldur
name tape	navnaband (at seyma á klæði)
Namibia	(landafr.) Namibia (land í Suðurafrika)
Namibian1	namibiari
Namibian2	namibiskur
naming	navnagáva (t.d.naming ceremony)
NAMMCO	(st.)North Atlantic Marine Mammal Conservation Organization Umsitingarstovnurin fyri súgdýr í Norðuratlantshavi
nan	(tlm.)tænastugenta
nana	(tlm.) omma
nance	sínancy
Nancy	konufólkanavn
nancy1	(gl.Sniðr.)kventil; gjeikari, geykari, samkyningur
nancy2	kventalsligur, kventlutur
nanism	(lækn., plfr.) dvørgavøkstur
nankeen	1nankin (gult bummullarklæði)2-s fltnankinsbuksur
nanny	1dadda, barnagenta2(barnam. eis.)omma
nanny goat	(kvenn)geit
nannying	(fl.m.)at fjálga ov nógv um ein, ovurumsorgan
nanny state	tilsjónarríki
nano-	(forskoyti) nano- (t.d.second)
nanophanerophyte	(plfr.)dvørgloftplanta
nap1	1lúrur, dúrur, blundur, slang;have a nap after dinnerfáa sær ein døgurðalúr2(á plaggi) lógv3góð ábending, gott prai4heiti á kortspæli
nap2	1dúra, sova, fáa sær ein blund2(um ross) tippael.vedda sum vinnara3[íyms. samb.]he was caught -ping (tlm.)hann var tikin á bóli, tað kom óvart á hann
napalm1	napalm, bensinlopi (nýttur í eldspreingjum)
napalm2	sleppa napalmbumbur niður yvir
nape	nakkakulla;nape of the necknakkakulla
napery	(gl.)borðbúnaður
naphtha	nafta
