Ж	(знак на туалете) «для же́нщин»K, kvinnur (á hurð til toilett)
ж	síжеI, II (viðhvørt brúkt aftan á orði,ið endar við sjálvljóði)
ж.	1.же́нский род kvennkyn2.жи́тели íbúgvar, íbúgvatal
ж…	síжо́па
жа́ба1	If(Bufo) skrubbtussaннкжгл-a, froskpaddaлпжгл-a, rúðurpaddaлпжгл-a
жа́ба2	IIfgml.1.(ангина) hálsbetendilsiннксгл-i, ilt í hálsinum, hálsbruniнпмгл-i,hálstakс0о{a/ø}кн.,ред.2.: грудна́я жа́баgml.hjartakrampi [ja-]мгл-i, angina pectoris [aŋꞋkiːna pʰεʰkꞋtʰoːɹɪs]ж нескл.мед., bringutakс0о{a/ø}кн.,ред.
жа́берный1	Iadj(кжа́бры) tákna-, táknu-; жа́берная дуга́ táknabogiмгл-i; жа́берная кость táknabeinс0о; жа́берная кры́шка kápaжгл-a; жа́берная решётка táknatindarмсогл-arмн; жа́берная щель táknurivaжгл-a=>амёбный,лепесто́к@,тычи́нка2
жа́берный2	IIadj: жа́берная сеть gørn [-tn]с0oмн
жа́бий	adjskrubbtussu-ннк, froskpaddu-лп, rúðurpaddu-лп
жабо́	n indeclpípukragiмгл-i, rúðurkragiмгл-iкн.
жа́бра	f síжа́бры
жа́бры	(singжа́бра)f plurtáknirж0-irмн, táknurжгл-aмн@взятького-л.за жа́брыsetaur(t);ir(t)o-mknívin á barkanидиом.
жа́воронок	Gen, Accжа́воронк|а;plur ~и, ~ов, ~амm1.: полево́й жа́воронок (Alauda arvensis) lerkurмсогл-ar; лесно́й жа́воронок (Lullula arborea) trælerkurмсогл-ar2.fl.(о человеке) A-menniska [aː-]сгл-a,sbr.сова́ 2
жад	mjada [jaːta]жгл-a
жа́дина	f, mtlm., vanv.kargapisaжгл-aпренебр., kargavættiсгл-iпренебр.
жа́дничать	ipf(pfпожа́дничать)1.(скупиться) vera gírigurглigur, vera natinсоглосн, vera pírinсоглосн; vera kargurсогл{a/ø}(скупой)}2.(быть алчным) vera grammurсогл{a/o}, vera grískur [кɹʊʃк-]соглsk(grammur), óðurглeftir [εʰtː-] (Дат)}
жа́дно	advgrammliga; жа́дно есть eta grammliga
жа́дность	f1.(алчность) (к чему-л.,до чего-л. -eftir [εʰtː-]o-m) grammheitннкж0-ir, grammleikiнпмгл-i; havisjúkaжгл-aкн.; ágirndж0-irвыс.,библ.; жа́дность к деньга́м tað at vera grammur eftir [εʰtː-] pengum, tað at vera óður eftir [εʰtː-] pengum, tað at vera pengagrammur; жа́дность к еде́ matligheitннкж0-ir; есть с жа́дностью eta grammliga2.(скупость) gírigheitннкж0-ir, pírniсгл-i, natniсгл-i3.: с жа́дностью alspentur [al-], [ɔl-], grammliga
жа́дный	stfжа́ден, жа́дно, жадна́, жадны́ogжа́дныadj1.(к чему-л.,до чего-л. -eftir [[εʰtː-]o-m) (настойчивый в стремлении удовлетворить желание) grammurсогл{a/o}, óðurглeftir [εʰtː-]; жа́дный к деньга́м {до де́нег} óður eftir [εʰtː-] pengum, grammur eftir [εʰtː-] pengum, pengagrammur; жа́дный до еды́ matligur [maʰt-]глigur, átufrekurсогл; жа́дный на рабо́ту íðinсоглоснð/d, ágrýtinсоглосн(í arbeiði)2.(скупой) gírigurглigur, natinсоглосн, pírinсоглосн; kargurсогл{a/ø}(скупой)3.fl.(выражающий сильное желание чего-л.) grammligurглigur, grammurсогл{a/o}; жа́дное любопы́тство grammligt forvitni; жа́дными глаза́ми við grammum eygum
жадю́га	f, móvkm., vanv.kargapisaжгл-aпренебр., kargavættiсгл-i
жа́жда	f1.(желание пить) tostiмгл-i; испы́тывать жа́жду vera tysturсогл, tystair(t); я умира́ю от жа́жды eg doyggi í tosta2.чего-л.{+inf}(страстное желание) tráж0-ir, tráanж0-ir; hugurмсогл-ar;-ir; жа́жда сча́стья tráan eftir [εʰtː-] eydnu; жа́жда вла́сти maktgirndж0-ir; maktgreðiжгл-iпренебр.; жа́жда зна́ний kunnleikatrá; жа́жда приключе́ний ævintýrhugur =>утоли́ть
жа́ждать	жа́жд|у, ~ешь, ~утipf1.чего-л.,+ infbókl.(страстно желать) tráaaðieftir[εʰtː-]o-m, trákkastaðieftir[εʰtː-]o-m, tystair(t)eftir[εʰtː-]o-mвыс.; я жа́жду ме́сти eg trái eftir hevnd, eg brenniслнa-u-uav hevndarhuga; жа́ждать ми́ра tráa eftir friði, leingjastir(d)eftir friði2.gml.(испытывать жажду) tystair(t), vera tysturсогл=>а́лчущие1,кровь5
жаке́т	mjakkiмгл-i; (opna)troyggjaжгл-a(б.ч. вязаный)
жаке́тка	plurжаке́т|ки, ~ок, ~камf tlmsíжаке́т
жаку́зи	n indecl síджаку́зи
жале́йка	plurжале́/йки, ~ек, ~йкамf russ. blásiinstrument
жале́ть	ipf(pfпожале́ть)1.Acc(испытывать жалость) takaслнó-ó-isynd íДат, tykjastir(t){+}synd íДат, haldaслнe-i-itað vera synd íДат, harmaaðiВинкн.; я тебя́ не жале́ю eg taki ikki synd í tær2.оPrp,что-л.(сожалеть) vera keddurсоглav o-m, vera harmurсоглum o-t, vera forharmaður [-Ꞌha-]глaðurum o-t; angraaðio-t, iðraaðiseg umo-t(раскаиваться); syrgjair(d){+}o-t, harmastaðio-t(грустить об отсутствии); я (очень) жале́ю, что…eg eri (sera) harmur um, at...; я жале́ю, что сказа́л ей об э́том eg angri, at eg fortaldi [-Ꞌtʰa-]ннкhenni tað; жале́ть (о) проше́дшей мо́лодости syrgja farnan ungdóm, harmast farnan ungdóm3.Acc,чего-л.(беречь) sparair(d)(Вин, uppá o-t); не жале́ть себя́ ikki spara seg sjálvan; не жале́ть де́нег ikki spara upp á pengarnar; он жале́ет де́нег {де́ньги} hann er sparin við pengum; он труди́лся, не жале́я сил hann stríddist uttan at líva sær; не жале́ть жи́знидля Genvera fúsurсоглat leggja lívið við fyriВин=>голова́4
жа́лить	жа́л|ю, ~ишь, ~ятipf(pfужа́литьужа́л|ю, ~ишь, ~ят)Accstingaслнa-u-uВин(о насекомых); bítaслнei-i-iВин(о змеях,насекомых)
жа́лкий	stfжа́лок, жалка́, жа́лко, жа́лкиogжалки́;compжа́льчеadj1.(вызывающий жалость) syndarligurглigur; у неё жа́лкий вид tað er syndarligt at síggja hana; он мне жа́локbókl.mær tykir synd í honum2.(убогий) neyðarsligurглigur, syndarligurглigur; жа́лкое зре́лище ein syndarlig sjón; жа́лкая паро́дияfl.ein vánalig eftirlíkning [εʰtː-]; в жа́лком состоя́нии í einum neyðarsligum standi, í vána standi; име́ть жа́лкий вид síggja neyðarsligur út3.(презренный) neyðarsнескл., neyðarsligurглigur; жа́лкий трус ein elendigur [-Ꞌlε-]ннкглigurræðuskítur; игра́ть жа́лкую роль eigaнепрein neyðarsligum lut í (o-m)4.(ничтожный) vánaнескл., lúsaнескл.,грубо; жа́лкий результа́т eitt vána úrslit [ʏʂ-]; жа́лких 100 рубле́й lúsaгрубоhundrað rublar; жа́лкий челове́ктжneyðardýrс0о@жа́лкие слова́syndarlig tala;жа́лкая улы́бкаeitt neyðarsligt smíl =>влачи́ть
жа́лко	Iadvneyðarsliga, syndarliga,sí eis.жа́лкийIIpred síжаль
жа́ло	n(насекомого и др.) broddurмсогл-ar(hjá insektum o.ø.); tungaжгл-a(hjá slangu) (змеи)
жа́лоба	f1.(сетование) gremjanж0-ir, kvartanж0-irкн.; gremjingarж0-arмн2.(на Acc- umВин,в Acc- tilВин) (заявление) klaga [kʰlεava]жгл-a; kæraжгл-aюр.; пи́сьменная жа́лоба skrivlig klaga, klaguskriv; пода́ть жа́лобуна кого-л.klaga [kʰleːa]aðio-n; не име́ть никаки́х оснований для жа́лоб einki grundarlag hava fyri at klaga
жа́лобно	advsáran, sárliga; syndarliga, ønskriliga; жа́лобно проси́тьо чём-л.biðja so eymliga [εml-]um o-t
жа́лобный	stfжа́лоб|ен, ~на, ~но, ~ныadjklagu- [kʰlεavʊ-], syndarligurглigur, kvartandiглandiкн.; жа́лобным го́лосом sorgarbundin á málinum, syndarligur á málinum; жа́лобный крик klaguróp; жа́лобный писк eymkandi [εŋ̊k-] lát@жа́лобная кни́гаbók til klagur [kʰlεavʊɹ] (um vøru,tænastuveiting o.a.)
жа́лобщик	mjur.klagariмгл-ari, klagandiмприлюр.
жа́лобщица	fjur.klagariмгл-ari, klagandiжприлюр.(konufólk)
жа́лованный	adj:жа́лованная гра́мотаsøg. frælsis. og rættinbræv(hjа́ russ. stjórnini inntil 1917)
жа́лованье	ngml.lønж0-ir=>грошо́вый1
жа́ловать	жа́лу|ю, ~ешь, ~ютipf(pfпожа́ловатьпожа́лу|ю, ~ешь, ~ют)1.bert ipf Acctlm.(любить) vera góðurглviðВин, dámaar(d)Вин(агенс Дат); прошу́ люби́ть и {да} жа́ловать (его́)skemt.eg lati hann upp í tykkara hendur; halda lítiðum Вин(við neg) (с отрицанием); её не о́чень жа́ловали hon var ikki serliga væl lýdd, hon var ikki serliga væl dámd2.кого-л. чем-л.gml.(наградить) veitair(t)o-m o-t, gevaслнa-ó-io-m o-t3.к кому-л.gml.(соизволить прийти) vitjaaðio-n, komaслнo-o-oat vitjao-n
жа́ловаться	жа́лу|юсь, ~ешься, ~ютсяipf(pfпожа́ловатьсяпожа́лу|юсь, ~ешься, ~ются)1.на Acc(кому-л.) beklaga [-Ꞌkʰleːa]ннкaðisegum Вин, gremjaur(d){e/a}segum Вин, klagaaðium Вин, kæra segum Вин; жа́ловаться на бо́ли gremja seg um pínu; он жа́ловался мне, что ... hann gramdi seg um, at...; на что вы жа́луетесь? hvat bagir tygum? (lækni við sjúkling); на пого́ду нельзя (по)жа́ловаться ikki kann klagast um veðrið [vεkɹɪ]2.на Вин(подавать жалобу) klagaaðiAcc, kærair(d)Acc тжюр.; жа́ловаться в суд leggjaнепрsakmóti o-m, takaслнó-ó-iupp søksmálmóti o-mофиц.,юр.3.на кого-л. кому-л.(ябедничать) forklaga [-Ꞌkʰleːa]aðio-n fyri o-m, klagaaðio-n fyri o-m
жа́лостливый	stfжа́лостлив, ~а, ~о, ~ыadjtlm.sum følir samkenslu, samkennandiглandiкн.
жа́лостный	[-сн-]stfжа́лост|ен, ~на, ~но, ~ныadjtlm.1.síжа́лостливый2.síжа́лобный1
жа́лость	fsamkenslaжгл-a; из жа́лости tí einum tykir synd í (o-m), av samkenslu; не знать жа́лости vera eirindaleysurсогл@кака́я жа́лость!tað var spell [-tl]!; tað var synd!; tað var keðiligt!
жаль	Ipred1.(о сострадании,сочувствии) (кому-л.)Acc,чего-л., + инф.takaслнó-ó-isynd ío-m, tykjastir(t)synd ío-m, haldaслнe-i-itað vera synd ío-m, veraслнa-ó-esynd ío-m; жаль бра́та tað er synd í beiggja; мне жаль тебя́ eg taki synd í tær, eg haldi tað vera synd í tær, mær tykist synd í tær; мне жаль её до слёз eg kundi grátið, so synd haldi eg tað vera í henni; (мне) жаль смотре́ть на него́ eg haldi tað vera so synd í honum, tá eg síggi hann; eg taki synd í honum, tá eg hyggi at honum; mær tykist synd í honum, tá eg hyggi at honum2.(о сожалении,досаде):кому-л.жальчего-л. o-rharmastaðium o-t; мне жаль поте́рянных де́нег tað er keðiligt, at pengarnir eru farnir; tað er harmiligt, at pengarnir eru farnir; ему́ жаль куска́ хле́ба hann unnir ikki øðrum ein breyðmola [pɹεm-]; (мне) не жаль де́нег, мне жаль вре́мени eg gevi mær ikki far um pengarnar, tað er tíðina, eg treyðugt vil spilla [-tla]; eg leggi einki í pengarnar, tað er tíðina, eg treyðugt vil spilla [-tla]; хо́чется пое́хать, но жаль де́нег eg havi huga at fara. men unni mær ikki; ей жаль тра́тить на э́то де́ньги hon heldur tað vera keðiligt at spilla pengar upp á hetta; (мне) жаль нака́зывать его́ eg fái meg ikki til at revsa hann; мне жаль но́вого пла́тья a) (жаль,что оно пострадало) tað var synd. at tann nýggi kjólin skuldi fara so; b) (боюсь его испортить) eg nenni mær ikki at fara í tann nýggja kjólan; для тебя́ ей ничего́ не жаль hon vil gera alt fyri teg3.: жаль, что … tað er spell [-tl], at...; tað er keðiligt ..., tað er harmiligt ...; о́чень жаль, что… tað er stórt spell [-tl], at...; tað er (ógviliga) harmiligt, at...; tað er (grúliga) keðiligt, at...; жаль, е́сли он не придёт tað er spell [-tl], um hann ikki kemur, tað er keðiligt, vissннкhann ikki kemur; tað er harmiligt, kemur hann ikki; жаль, что он не придёт tað er spell [-tl], at hann ikki kemur; tað er harmiligt, at hann ikki kemur; tað er keðiligt, at hann ikki kemur; мне бу́дет жаль, е́сли ты опозда́ешь eg verði keddur, vissннкtú kemur for [fɔɹː]ннкseint, tað er keðiligt, vissннкtú kemur for [fɔɹː]ннкseintIIparent(к сожалению) tíverri [-Ꞌvε-]@как жаль!sum tað er harmiligt!;о́чень жаль!tað er stórt spell [-tl]!
жа́льче	comp avжа́лкий, жа́лко
жалюзи́	n indecljalousi [ʃaːluꞋsiː]с0{дат.0}(ставни); persiennur [pʰεʂiꞋεnː-]жгл-aмн(оконное из поперечных пластинок); rulligardina [-tl-]жгл-a(оконное,накручивающееся на горизонтальный валик)
жанда́рм	mgendarmur [ʃanꞋta-]мсогл-ar
жандарме́рия	fgendarmarí [ʃantaɹmaꞋrʊi]с0о
жанда́рмский	adjgendarm(a)- [ʃanꞋta-]
жанр	m1.(вид художественных произведений) genra [ʃaŋkɹa]ннкжгл-aпроф.(slag av bókmentum, málningum o.s.fr.), bókmentagreinж0-ar;-irспец.(литературный), listagreinж0-ar;-irспец.(в искусстве)2.list(живопись) málingж0-arav gerandismyndum, genrumálarí [ʃaŋkɹʊ-]с0опроф.3.(стиль) stílurмсогл-ar; mátiмгл-i(манера)
жанри́ст	mmálariмгл-ari, ið málar gerandismyndir, genrumálari [ʃaŋkɹʊ-]мгл-ariпроф.,síжанр2
жа́нровый	adj1.(кжанр 1) genru- [ʃaŋkɹʊ-]ннкпроф.; жа́нровый при́знак eyðkenni fyri eina genru [ʃaŋkɹʊ]2.list(кжанр 2) genru- [ʃaŋkɹʊ-]проф.; жа́нровая карти́на genrubílæt [ʃaŋkɹʊ-], gerandismynd,
жар	Genжа́ра, жа́ру,Prpо жа́ре, в жару́m1.(зной) hitiмгл-i2.(горячие угли) gløðurж0-ur{ó/ø}мн, eimurмсогл-ar3.(повышение температуры) fepurм0осн; у неё был (си́льный) жар hon hevði [hεijɪ] (nógvan) fepur; больно́й в жару́ tann sjúki hevur (nógvan) fepur; жар спал fepurin minkaði4.(горячность) ovurhugiмгл-i; с жа́ром yvriga, av ovurhuga; говори́ть с жа́ром hann tosar yvriga; рабо́тать с жа́ром arbeiða av ovurhuga@его́ бро́сило в жарhann bleiv heitur;её броса́ло {кида́ло} то в жар, то в хо́лодhon bleiv bæði køld og heit,sí eis.бро́сить5;чужи́ми рука́ми жар загреба́тьlataслнæ-ó-ao-nannan gera (tað skitna) arbeiðið fyri seg =>зада́ть5,подда́ть@
жара́	fhitiмгл-i(heitt veður o.tíl.); стои́т жара́ tað er heitt; кака́я сего́дня жара́! sum tað er heitt í dag!
жарго́н	mjargon [ʃaɹꞋkɔŋk]ж0-irпроф., лингв., bólkamálс0олингв.=>воровско́й
жаргони́зм	mjargonorð [ʃaɹꞋkɔŋk-]с0oпроф., лингв.
жарго́нный	stfжарго́н|ен, ~на, ~но, ~ныadjjargon- [ʃaɹꞋkɔŋk-]проф., лингв.
жа́рение	nsteikingжo-ar
жа́реное	n1.(жареная еда) stoktur maturмсогл-ir2.gml.síжарко́е@па́хнет жа́ренымtlm.,atf.her ero-tgott í væntu
жа́реный	adjstokturсогл; brendurсогл(um kaffi) (о кофе); ristaðurглaður(о хлебе,семечках,кофейных бобах); snerkturсогл; stiknaðurглaður(ос. о поджаренной баранине); grillaðurглaður(на решётке); жа́реный карто́фель stokt eplir; жа́реная теля́тина kálvasteik; жа́реный цыплёнок stoktur høsnarungi, stoktur kúllingurннк
жа́ренье	nsíжа́рение
жа́рить	жа́р|ю, ~ишь, ~ятipfApfзажа́ритьзажа́р|ю, ~ишь, ~ят, изжа́ритьизжа́р|ю, ~ишь, ~ят, поджа́ритьподжа́р|ю, ~ишь, ~ят что-л.steikjair(t){+}o-t; stiknaaðio-t(ос. о поджаренной баранине); grillaaðio-t(на решётке); brennair(d)o-t(kaffi,pf bertподжа́рить) (кофе); snerkjair(t)o-t; ristaaðio-t(хлеб,pf bertподжа́рить); жа́рить се́мечки rista fræBbert ipf1.: со́лнце жа́рит tað er brennandi sól(skin) ([sœl̥ʃɪn]); сего́дня жа́рит tað er so steikjandi heitt í dag2.óvkm.verður umsett við ym. sagnorðum um o-t skjótt,ágrýtið o.a.: он жа́рит на гармо́шке hann spennirir(t)seg ordiligaнеформ.út at spæla upp á harmoniku [-Ꞌmoː-]; он здо́рово жа́рит по-ру́сски hann snakkarннкaðirussiskt sum brent неформ.; дождь жа́рит tað oysirir(t)niður; жарь во всю! spelа avstað [aꞋstεa] tað dýrasta, tú orkar!; жарь! drív á!; koyr á!
жа́риться	жа́р|юсь, ~ишься, ~ятсяipf1.pfзажа́ритьсязажа́р|юсь, ~ишься, ~ятся, изжа́ритьизжа́р|юсь, ~ишься, ~ятся, поджа́ритьсяподжа́р|юсь, ~ишься, ~ятся(подвергаться жарению) blíva stokturсогл; blíva brendurсогл(о кофе); blíva ristaðurглaður(о хлебе,семечках, кофейных бобах); blíva snerkturсогл; blíva stiknaðurглaður(ос. о поджаренной баранине); blíva grillaðurглaður(на решётке)2.: жа́риться на со́лнце bakaaðiseg í sólini
жари́ща	fsteikjandi hitiмгл-i, glóðhitiмгл-i,; ну и жари́ща! sum tað er heitt!
жа́ркий	stfжа́рок, жарка́, жа́рко, жа́ркиogжарки́;compжа́рчеadj1.(знойный,горячий) heiturсогл; жа́ркие лучи́ heitar strálur; жа́ркие стра́ны heit lond; жа́ркий кли́мат heitt veðurlag2.fl.(страстный,бурный) logandi [luːwantɪ], [loːantɪ]глandi, brennandiглandi, heiturсогл; harðurсогл{a/ø}(бой и д.р.); жа́ркий спор harður orðadráttur; жа́ркий поцелу́й brennandi (heitur) kossur
жа́рко	Iadvheitt, hart,sbr.жа́ркийIIpred кому-л.жа́ркоo-rer heitur; мне ужа́сно жа́ркоeis.eg eri um at sálast av hita; за́втра бу́дет жа́рко tað verður heitt í morgin; бы́ло жа́рко tað var heitt (í veðrinum [vεkɹ-])@от э́того ни жа́рко, ни хо́лодноtað ger ongan mun, tað ger hvørki til ella [εtla] frá =>не́бо@
жарко́е	nsteikж0-ir
жаро́вня	plurжаро́в|ни, ~ен, ~нямf(сосуд) glóðkerс0о{+}кн.; kolovnurмсогл-ar(печка)
жаро́к	Genжарка́; plurжарк|и́, ~о́в, ~а́мm tlm. dim tilжар
жаропонижа́ющее	nfepurlækkandi medisin [-Ꞌsiːn]с0о
жаропонижа́ющий	adjfepurlækkandiглandi
жаросто́йкий	adjsum tolir hita; eldfasturсогл{a/ø}(огнеупорный)
жароупо́рный	adjsum tolir hita; eldfasturсогл{a/ø}(огнеупорный)
жар-пти́ца	ffólk.eldfuglurмсогл-ar(í russ. ævintýrum fuglur við gløðandi fjaðrum)
жа́рче	comp avжа́ркий, жа́рко
жары́нь	f óvkm.brennandi hitiмгл-i, steikjandi hitiмгл-i, glóðhitiмгл-i
жасми́н	m(Jasminum) jasmin [ʃasꞋmiːn]ж0-ir
жасми́нный	stfжасми́н|ен, ~на, ~nо, ~ныadjjasmin- [ʃasꞋmiːn-]
жасми́новый	adjjasmin-  [ʃasꞋmiːn-]
жа́тва	f1.(процесс) akurskurðurмсогл-ir2.(время,страда) akurskurðurмсогл-ir(tíð)3.(урожай) ávøksturм0осн-ar,-ir{ø/a};согл-ir{ø/a}, grøðiжгл-i, fruktж0-ir(ávøkstur)
жа́твенный	adj: жа́твенная маши́на heystingarmaskinaжгл-a
жа́тка	plurжа́т|ки, ~ок, ~камfheystingarmaskinaжгл-a
жать1	Iжм|у, ~ёшь, ~ут;imperжми, жми́теipf AccA 1.pfсжатьсожм|у́, ~ёшь, ~у́т; imper сожми́, сожми́те Acc(давить) trýstair(t)Вин, kroystair(t)Вин; klemmaaðiВин, kleimair(d)Вин(сдавливать); жатькому-л.ру́ку (pfпожа́тьпожм|у́, ~ёшь, ~у́т; imper пожми́, пожми́те) takaслнó-ó-ií hondinaá o-m; жму (ва́шу) ру́ку (фраза в конце письма) bestu heilsanir (síðst í brævi); жать проти́вника к реке́ (pfприжа́тьприжм|у́, ~ёшь, ~у́т; imper прижми́, прижми́те) rekaслнa-ó-ifíggindan móti ánni;2.(поджимать) vera knappurсогл{a/ø}(um tíð); сро́ки жмутtlm.vit hava knappa tíð3.bert ipf что-л.(быть тесным) vera ov [ɔ] trongur; сапо́г жмёт но́гу stivlin er ov trongur; пиджа́к жмёт под мы́шками jakkin er ov trongur undir hondunum4.pfвы́жатьвы́жм|у, ~ешь, ~ут; imper вы́жми, вы́жмите что-л.(выдавить) pressaaðio-t; жать виногра́д pressa víndrúvur; жать лимо́н pressa eina sitrón [-Ꞌtʰɹɔun]; жать сок из лимо́на pressa saft úr einari sitrón [-Ꞌtʰɹɔun]5.pfвы́жатьвы́жм|у́, ~ешь, ~ут; imper вы́жми, вы́жмите что-л.ítr.(о штангистах и др.) lyfta [lɪʰtːa]ir(t)o-t{o-m}, pressaaðio-tBbert ipf intróvkm.verður umsett við ym. sagnorðum um o-t skjótt,ágrýtið o.a.: drívaслнei-i-iá (at arbeiða o.a.); жать на всю кату́шку roynair(d)av øllum [œtl-] alvi@жать со́ки изкого-л.mergsúgvaслнey-u-oo-n
жать2	IIжн|у, ~ёшь, ~ут;imperжни, жни́теipf(pfсжатьсожн|у́, ~ёшь, ~у́т; imper сожни́, сожни́те)что-л.(серпом и др.) skeraслнa-ó-oo-t(korn); sláaслнó-ó-io-t(við líggja) (косить); heystaaðio-t, skeraслнa-ó-oakur (korn) (убирать)
жа́ться	жм|усь, ~ёшься, ~утся;imperжмись, жми́тесьipf1.к Dat(придвигаться близко к кому-л.,чему-л.) trýstair(t)seg uppat Дат2.(тесниться) trokastaði, skotrastaði; все жа́лись в углу́ øll [œtl] trokaðu seg saman í krókinum3.(съёжиться) skultraaðisær; жа́ться от хо́лода skultra sær av kulda; он жа́лся в углу́ hann sat í krókinum og skultraði sær4.tlm.(колебаться) himprastaði, dragaслнó-ó-iá Ꞌ bæði5.tlm.(экономить) sparair(d); píraaði, vera gírigurглigur(скупиться); не жмись! ver ikki so kargur!
жа́хнуть	жа́хн|у, ~ешь, ~утpf Аccóvkm.lammaaðitil Вин; жа́хнуть по спине́ gevaслнa-ó-io-mnevan um ryggin
жбан	mkannaжгл-a(stór,við loki)
жва́чка	plurжва́ч|ки, ~ек, ~камf1.(у жвачных живочных) jóturс0крн(тж действие); gorс0о(полупереваренная пища в желудке, б.ч. у жвачных); жева́ть {пережёвывать} жва́чку a) (о жвачных животных) jótraaði; b)fl.(повторять) jótraaði(upp í saman), njótraaði2.óvkm.(табак) skráж0-ir, tuggaжгл-a; tyggigummiс0гл(-inum)(о жевательной резинке)
жва́чные	plur(подотряд Ruminantia) jóturdýrс0омн
жва́чный	adjjótur-
жг…	1.жги́, жги́теimper avже́чь2.жгись, жги́тесьimper avже́чься3.жгу, жгу́тpres avже́чь4.жгусь, жгу́тсяpres avже́чься5.жглаo.s.fr. pret avже́чь6.жгласьo.s.fr. pret avже́чься
жгут	Genжгут|а́;plur~ы́, ~о́в, ~а́мm1.(закрученная полоса) bendilм0осн-s,-ar; соло́менный жгут hálmbendil2.lækn.(для остановки кровотечения) æðrapressa [akɹa-]жгл-a, (bregd løgd um arm o.a.), æðrabregd [akɹa-]с0oмед.; наложи́ть жгутна что-л.bindaслнa-u-ufyri o-t3.plur(шнуры) pyntisnórarмсогл-arмн(á akslum á uniformi o.a.)
жгу́тик	mbivhárс0o
жгу́чий	stfжгуч, ~а, ~е, ~иadjbrennandiглandi; gløðandiглandi(горячий); жгу́чее со́лнце brennandi sól; жгу́чий моро́з gellandi [-tl-] frost; жгу́чие слёзы brennandi tár; жгу́чая боль brennandi pína, sviðiмгл-i@жгу́чий брюне́тsvarthært fólk;жгу́чий вопро́сbrennandi spurningur
ж.д.	síжеле́знаядоро́гаsíжеле́зный
ж/д	síж.д.
ждать	жд|у, ~ёшь, ~ут;pretждал, ждала́, жда́л|о, ~иipf кого-л.,чего-л.bíðaaði, bíðaaðieftir [εʰtː-]Дат(ожидать); væntaaðiВин; væntaaðisæro-t(надеяться на что-л.); ждать авто́буса bíða eftir bussinum; мо́жно ждать бу́ри vit kunnu vænta okkum ódnarveður; я жду пока́ она́ оде́нется eg bíði eftir at hon skal verða liðug at lata seg í; жду сестру́ ка́ждую мину́ту eg vænti systur mína hvørja løtu; жду его́ за́втра eg vænti hann í morgin; мы ждём, что он прие́дет за́втра vit vænta, at hann kemur í morgin; vit vænta hann at koma í morgin; жда́ли её ско́рого прие́зда tey væntaðu hana at koma skjótt, tey væntaðu hana at vera skjóta; его́ ждут здесь tey bíða eftir honum her; tey vænta hann her; ждать госте́й vænta gestir; ребёнок о́чень ждёт дня рожде́ния barnið gleðir seg til føðingardagin; я о́чень жду встре́чи с ним eg gleði meg til at møta honum; я жду мно́гого от пое́здки eg vænti mær nógv av ferðini; ждать подде́ржкиот кого-л.vænta (sær) stuðul fráo-m; не ждать ничего́ хоро́шего ikki vænta (sær) nakað gott; я жду, что ты ей помо́жешь eg vænti, at tú hjálpir [j-] henni; э́того я ме́ньше всего́ ждал! hetta hevði [hεijɪ] eg minst av øllum [œtl-] væntað!; их ждёт блестя́щая карье́ра teir kunnu vænta sær eina strálandiннкkarrieru [kʰaɹːiꞋeː-]ннк; нас ждёт дли́нный путь vit hava langan veg fyri framman; ждатьчего-л.со стра́хом {с трево́гой}eis.stúrair(d)fyrio-m, kvíðair(d);aðifyrio-m; э́того мы жда́ли с больши́м нетерпе́ниемeis.vit ótolnaðustaði; ждать пока́что-л.не ко́нчится bíða eftir, ato-tverður liðugt; bíða, tilo-tverður liðugt; чего́ ждут? hvørjum bíða tey eftir? от него́ мо́жно ждать всего́ mannннкkann vænta sær alt av honum; придётся до́лго ждать, пока́ ... tað verður leingi at bíða, til...@вре́мя {де́ло} не ждётtað hevur skund, tað hastarннкaði; málið tolirir(d)ikki at bíða;не ждал не гада́лlítið vardiir(d)tað meg;того́ и ждиsíтого́и гляди́,síгляде́ть@;она́ ждёт ребёнкаhon skal hava smá, hon er upp á vegin =>дожда́ться@,заста́витьI,мо́ре@
же1	Iconj1.adversmen, meðan (harafturímóti [-tː-]); мы пойдём че́рез лес, остальны́е же - по доро́ге vit fara gjøgnum skógina, meðan hini fara eftir [εʰtː-] vegnum [veːn-]; vit fara gjøgnum skógina, hini fara harafturímóti [-aʰtː-] eftir [εʰtː-] vegnum [veːn-]; он - мечта́тель, брат же его́ - практи́чный челове́к hann er ein droymari, men beiggi hansara er ein praktiskur maður; hann er ein droymari, meðan beiggi hansara er ein praktiskur maður; hann er ein droymari, beiggi hansara er harafturímóti [-aʰtː-] ein praktiskur maður2.conjunog; (при указании причинных связей) júили не переводится/ella verður ikki umsett; когда́ мы прие́хали, прие́хали же мы ле́том tá vit komu, komu vit um summarið; спроси́ его́, он же зна́ет э́то spyr hann, hann veit tað jú
же2	IIpart1.intens часто не переводится/skal oftast ikki umsetastчто же мне де́лать? hvat skal eg gera?; как же её (всё-таки) зову́т? hvussu er tað (nú), hon eitur?; есть же таки́е лю́ди! at sovorðin fólk finnast!; что же ты молчи́шь? hví stendur tú og tegir?; пойдём же! kom [kʰɔmː], lat okkum fara!; ну и что же íðan hvat so2.(ведь) jú; ты же его́ зна́ешь tú kennir hann jú; я же говори́л тебе́ eg segði [sεijɪ] tað jú við teg3.(указывает на тождество) sami; тот же tann sami; э́тот же hesin sami; он же hann (tann sami); тогда́ же um somu tíð; здесь же her (á sama stað); там же har (á sama stað), á sama stað; так же somuleiðis, upp á sama máta; сего́дня же nettupp í dag; така́я же кни́га ein bók av sama slag; ein sama slag bókнеформ.; тот же врач tann sami læknin
жева́ние	ntyggingж0-ar; jótranж0-ir(о жвачных)
жёваный	adj1.(зубами) tugdurсогл2.tlm.(мятый) rukkuturсогл
жева́тельный	adj1.(кжева́ть) tyggi-2.:жева́тельная рези́нка tyggigummi; жева́тельный таба́к a) skrátubbak; b) (кусок табака) skráж0-ir(petti av tubbaki)
жева́ть	жу|ю́, ~ёшь, ~ю́тipf что-л.1.(размельчать во рту) tyggjair(d){y/u}o-t; jaglaaðio-t(медленно,с трудом); жева́ть таба́к tyggja skrá2.fl.(обсуждать) meylaсоглo-t, júkaсоглo-t@живём, (да) хлеб жуёмorðt.tað gongst so dánt; enn eru vit ikki skolaðir út av látriидиом.=>жва́чка
жёг	pret avжечь
жезл	Genжезл/а́;plur~ы́, ~о́в, ~а́мogже́злаo.s.fr. m1.hátíð.,gml.(трость) stavurмсогл-s,-ir;-ar;-ar{a/ø)(um ym. prýddar stavar o.a.,tignarmerki); ма́ршальский marsjalsstavur2.jarnb.(на железных дорогах) signalstavur [-Ꞌnaːl-]мсогл-s,-ir;-ar;-ar{a/ø}3.(у регулировщика движения)stavur el. gassi brúktur at stýra ferðslu við
жела́емое	n:выдава́ть {принима́ть} жела́емое за действи́тельное droymair(d)ynskidreymar
жела́емый	Ipartic avжела́тьIIadjynsktur [iŋ̊kst-]согл, ynskiligurглigur, ynski-
жела́ние	nynskiсгл-i; hugurмсогл-ar;-ir(охота); bønж0-ir(áheitan) (просьба тж); после́днее жела́ние tað síðsta ynskið; по жела́нию eftir [εʰtː-] vild; по ва́шему жела́нию eftir [εʰtː-] tykkara ynski; по со́бственному жела́нию eftir [εʰtː-] egnum ynski; доби́ться выполне́ния своего́ жела́ния fáa uppfylt sítt ynski, fáa sín vilja, fáa gjørt eftir [εʰtː-] síni bøn; про́тивчьего-л.жела́ния móti ynskinumhjá[tʃʰ-]o-m; у меня́ нет никако́го жела́ния туда́ идти́ eg havi púrt ongan hug at fara hagar; име́ть {возыме́ть} жела́ние +infhava hug at +инф., fáaслнe-i-ihug at +инф.;у кого-л.есть жела́ние +inf o-rhevur hug at +инф.; е́сли у вас есть жела́ние vissннкtit vilja, um tit hava hug (til tað); жела́ние уе́хать hugur at fara burtur; при всём жела́нии ... so fegin eg vil ...; при всём жела́нии, я ниче́м не могу́ помо́чь so fegin eg vil, kann eg ikki hjálpa [j-] =>вы́полнить1,горе́тьB 5,загоре́ться3,испо́лнить1,сгора́ть
жела́нный	stfжела́н|ен, ~на, ~но, ~ныadj1.(которого желают,ожидаемый) kærkominсоглосн, vælkominсоглосн; (eftir)ynsktur [εʰtːɪɹiŋ̊kst-]согл; жела́нный гость ein kærkomin gestur, ein vælkomin gestur; жела́нная весть gleðilig tíðindi, fagnаrboðкн.; жела́нная цель tað ætlaða málið2.lfgml.(любимый) kærurсогл, elskaðurглaður
жела́тельно	predtað er ynskiligt, tað er at ynskja, tað er ynskjandi; жела́тельно, что́бы… tað er ynskiligt, at...; tað er at ynskja, at...
жела́тельный	stfжела́телен, жела́тельн|а, ~о, ~ыadj1.(нужный) ynskjandiглandi, ynskiligurглaður2.: жела́тельное наклоне́ние ynskishátturмсогл-ir{á/æ};согл-ir, optativс0oпроф.
желати́н	mgelatin [keːlaꞋtʰiːn]с0о; husblas [huːsplas]с0о(в тонких пластинках)
жела́ть	ipf(pfпожелать)1.кого-л.,чего-л.;что-л.tlm.(við konkretum subst.) (хотеть) viljaнепрo-t{at +инф.}, gjarna viljaнепрo-t{at +инф.}, viljaнепрhavao-t{at +инф.}, havaнепрhug (at +инф., til at +инф.) (хотеть); он жела́ет познако́митсья с тобой hann vil gjarna koma at kenna teg; она́ о́чень жела́ла э́того {+ inf; + что́бы} hon vildi fegin hava heta {at ...}; жела́тьчьей-л.руки́ beraслнa-ó-oupp bønarorðуст.; что вы жела́ете? (вопрос к покупателю) hvat vilja tygum hava? (við keypara); он не жела́ет слу́шать мои́х сове́тов hann vil ikki lurta eftir [εʰtː-] ráðunum hjá [tʃʰ-] mær; жела́ю ви́деть его́ eg vil sleppa at síggja hann; сам того́ не жела́я uttan at vilja tað sjálvur; av óvart (нечаянно); я его́ знать не хочу́ eg vil einki hava við hann at gera; я не жела́ю име́ть с ним никако́го де́ла eg vil einki hava við hann at gera2.кому-л. чего-л.(выражать пожелание) ynskjair(t)o-m o-t; жела́ю тебе́ всего́ хоро́шего! eg ynski tær alt tað besta!; жела́ю уда́чи! eg ynski tær eydnu; жела́ю тебе́ сча́стья eg ynski tær eydnu3.pfвозжела́тького-л.bókl.(испытывать страсть к кому-л.) tráaaðieftir [εʰtː-]o-m, girnastaðio-nкн.=>оста́вить@
жела́ющие	plurвсе жела́ющие øll [œtl-], sum vilja; øll [œtl-], sum hava hug; жела́ющих оказа́лось мно́го nógv vóru, sum vildu vera við; жела́ющие поступи́ть (в учебное заведение) umsøkjararnirмгл-ariмн опр.(til lærustovn); там мно́го жела́ющихtlm.,atf.har vóru nógvir murtar um agniðпог., har vóru nógv um boðiðпог.
желва́к	Genжелвак|а́;plur~и́, ~о́в, ~а́мmknykilм0осн, knúturмсогл-ar(vølur); kjálkamuskulм0осн-a,-ar(мускул)
желе́	n indeclgele {gelé} [ʃeꞋleː]с0o
железа́	plurже́лезы, желёз, железа́мfkertilм0осн-s,-ar; eitilм0осн-s,-ar(лимфатическая); потовы́е же́лезы sveittakertlar; железа́ вну́тренней секре́ции endokrinur [-Ꞌkʰɹiː-]соглспец.kertil =>ви́лочковый,зо́бный
желе́зистый1	Iadj(содержащий железо) jarn- [jan-], [-tn-], sum inniheldur jarn [-tn], jarnhavin [-tn-]лпсогл, jarnkendur [jantʃʰ-]нпсогл; желе́зистый исто́чник jarnkelda [jantʃʰ-], [-tn-]; желе́зистый препара́т jarnpreparat [janpʰɹeːparaːt], [jatnpʰɹeːparaːt]ннк
желе́зистый2	IIadj(кжелеза́) kertil-, kertla; eitla-
желёзкa	plurжелёз|ки, ~ок, ~камf dim avжелеза́
желе́зка1	Iplurжеле́з|ки, ~ок, ~камf(железный предмет) jarn [jatn]с0о{a/ø}, jarn- [jan-], [jatn-] (um ym. lutir úr jarni); jarnpetti [jan-]сгл-i(кусок); jarnpláta [jan-]жгл-a(пластинка); jarnstong [jan-]ж0-ur{o/e}(стержень)
желе́зка2	IIf: на всю желе́зкуóvkm.í fullari [-tl-] ferð, (í) full speed [fʊlspyːt]неформ., tað dýrasta ein er mentur, av dýrastu makt (ехать и т.п.); so hart ein orkar (громко); fult frá, for frá (включить радио и т.п.)
желе́зно	advóvkm.tað vikast ikki, tað svitast ikki
железнодоро́жник	mjarnbanaarbeiðari [janpaː-]ннкмсогл-ari, jarnbreytararbeiðari [janpɹ-]нпмсогл-ari; starvsfólkс0оvið jarnbana [janpaː-]ннк, starvsfólkс0оvið jarnbreyt [janpɹ-]нп
железнодоро́жный	adjjarnbana- [janpaː-]ннк, jarnbreytar- [janp-]нп; железнодоро́жная сеть jarnbananetннк, jarnbreytarnetнп; железнодоро́жная ста́нция jarnbanastøðннк, jarnbreytarstøðнп, tokstøð; железнодоро́жная катастро́фа tokvanlukka; желерзнодоро́жный биле́т tokbilletннк, ferðaseðilнпtil tok =>спра́вочник,указа́тель2
желе́зный	adj1.(содержащий железо) jarn- [jan-], [jatn-]; желе́зная руда́ jarnmálmur [jan-]2.(из железа) jarn- [jan-], [jatn-], úr jarni [-tnɪ]; желе́зная решётка jarnrimar [jan-]; желе́зные опи́лки jarnspønir [jan-]3.fl.(твёрдый) jarn- [jan-], [jatn-], jarnharður [-tn-]согл{a/ø}(суровый); sum ikki kann verða vikið frá, óreingiligur [-Ꞌrɔ-] (неукоснительный); желе́зная во́ля jarnvilji [jan-], [jatn-]; желе́зная ло́гика jarnharður logikkur; желе́зное доказа́тельство óreingiligt prógv@желе́зная доро́гаjarnbani [janpaː-]ннкмгл-i, jarnbreyt [janp-]нпж0-ir; е́хать желе́зной доро́гой {по желе́зной доро́ге} koyra við toki; рабо́тать на желе́зной доро́ге arbeiða við jarnbananннк;желе́зный блескjarnglansur [jan-];желе́зный векjarnøld [-tn-] =>дисципли́наI,за́навес@
железня́к	Genжелезняка́mjarnsteinur [jans-]мсогл-ar; бу́рый железня́к brúnjarnsteinurмсогл-ar
желе́зо	n1.(металл, вещество) jarn [-tn]с0о{a/ø}; рабо́та по желе́зу jarnsmíð [jans-]; кру́глое желе́зо rundjarn [rʊnj-]; ста́рое желе́зоeis.gamalt jarn (ym. burturkast); принима́ть желе́зо taka jarn (sum medisin)2.teld., jarg.(аппаратное обеспечение) hardware [haɹtvεaɹ]с0о;ж0-ir, tólbúnaðurлпмсогл-ir=>кова́ть@,оби́ть1,прутко́вый
железобето́н	mjarnbetong [jatn-], [janp-]с0о, armerað [-Ꞌmeː-] betong [peꞋtʰɔŋk]
железобето́нный	m1.(кжелезобето́н) jarnbetong- [jatnp-], [janp-], úr jarnbetongi [jatnp-], [janp-], úr armeraðum [-Ꞌmeː-] betongi [-Ꞌtʰɔ-]; железобето́нный элеме́нт jarnbetongelement [jatnp-], [janp-]2.fl.,tlm.(не поддающийся эмоциям) grótharðurсогл{a/ø}(um kenslur o.a.), stívurсогл(um medferð o.a.) (негибкий)
жёлоб	plurжелоб|а́, ~о́в, ~а́мm1.tekn.(лоток) sliskaжгл-a2.(углубление для стока и др.) rennaжгл-a; кро́вельный жёлоб takrenna; сто́чный жёлоб renna (fram við gongubreyt)3.jarðf.(впадина в море) rennaжгл-a(á havsbotni); глубоково́дный жёлоб djúphavsrenna@ жёлоб Фаре́рской[-рэ́-]ба́нкиBankarennan [paŋ̊ka-]жгл-aопр.
желобо́к	Genжелобк|а́;plur~и́, ~о́в, ~а́мm1.dim avжёлоб (lítil) rennaжгл-a2.(углубление) foyraжгл-a, skoraжгл-a(неглубокий разрез)
желте́ть	ipf1.pfпожелте́ть (становиться жёлтым) gulnaaði2.(виднеться) lýsair(t)gulur, skyggjaaðigulur; в траве́ желте́ли одува́нчики hagasóljurnar lýstu gular í grasinum
желте́ться	ipflýsair(t)gulur, skyggjair(d)gulur
желтизна́	fgulur liturмсогл-ir
желти́ть	желчу́, желт|и́шь, ~я́т ipf что-л.geraнепрo-ngulan; málaaðio-ngulan (красить в жёлтый цвет)
желтова́тый	stfжелтова́т, ~а, ~о, ~ыadjgulligurглigur, gulleitturсогл, guldæmdurсогл
Жёлтое мо́ре	Gula haviðс0о{a/ø}опр., Gulahavс0о{a/ø}кн.
желто́к	Genжелтк|а́;plur~и́, ~о́в, ~а́мm(eggja)blommaжгл-a, eggjareyðiмгл-i
желтоко́жий	stfжелтоко́ж, ~а, ~е, ~иadjvið gulari húð
жёлто-кори́чневый	adjmorgulur [mɔɹ-]согл
желтоли́цый	adjsum er gulur í andlitinum [anl-]
желторо́тый	stfжелторо́т, ~а, ~о, ~ыadj: желторо́тый (птене́ц) nalvungiмгл-iпренебр., hvølpurмсогл-arпренебр.
желту́ха	fgulsóttж0-ir, gulusóttж0-ir
жёлтый	stfжёлт, желта́, жёлтоogжелто́, жёлтыogжелты́adjgulurсогл@жёлтая пре́сса {печа́ть}tann gula pressan;жёлтый профсою́зfakfelag, ið arbeiðir móti tí skipaðu fakfelagsrørsluni;жёлтая лихора́дкаlækn.gulur fepurм0осн-s,-ar;жёлтая вода́lækn.grønur sterннкм0({0<>i}), grønt starлпс0о; жёлтое пятно́anat.(macula lutea) tann guli bletturin [pʰlε-];жёлтое те́лоanat.(corpus luteum) økslс0омн;жёлтый домgml.sinnissjúkrahúsс0о=>биле́т@
желудёвый	adjakarn-,síжёлудь
желу́док	Genжелу́дк|а;plur~и, ~ов, ~амmmagiмгл-i; у неё боли́т желу́док hon hevur ilt í búkinum, hon hevur ilt í maganum; бо́ли в желу́дке magailskaжгл-a, búkpína; на голо́дный желу́док á fastandi hjarta [j-] =>боле́тьII,расстро́йство2,я́зва1
желу́дочек	Genжелу́дочк|а; plur~и, ~ов, ~амm1.dim avжелу́док2.(в сердце) innrúmлпс0о(í hjarta)3.(мозга) ventrikkul [-Ꞌtʰɹɪ-]м0осн-s,-ar
желу́дочный	adjbúk-, maga =>сок1
жёлудь	plurжёлуди, желуд|е́й, ~я́мmakarnс0о{a/ø}@морско́й жёлудь(Balanus) rúðurс0осн, gjarс0о
же́лчный	stfже́лч|ен, ~на, ~но, ~ныadj síжёлчный
жёлчный	stfжёлч|ен, ~на, ~но, ~ныadj1.bert lf(кжелчь) gall- [kal-], [katl-]; жёлчный пузы́рь gallbløðra [kalp-], [katlp-], gall [-tl]; жёлчный ка́мень gallsteinur [kal̥s-], [katls-]; жёлчный прото́к gallræsi [kalr-], [katlr-]2.fl.(язвительный,злой) gallsúrur [kal̥s-], [katls-]согл; ilskurсоглsk
желчь	f síжёлчь
жёлчь	f1.(жидкость) gall [-tl]с0о2.fl.(раздражение,злоба) gall [-tl]с0о(øði); изли́ть жёлчьна кого-л.goysair(t)gor og galloman yvir o-n
жема́ниться	жема́н|юсь, ~ишься, ~ятсяipftlm.skapaaðisær, geraнепрseg Ꞌ til
жема́нник	mtlm.apuspjótс0о, skaput fólk
жема́нница	ftlm.skaput konufólk, skapikrukkaжгл-aнеодобр.
жема́нничать	ipf tlm.skapaaðisær, geraнепрseg Ꞌ til
жема́нный	stfжема́нен, жема́нн|а, ~о, ~ыadjskaputurсогл, tilgjørdurсогл, affekteraður [-Ꞌtʰeː-]энкглaður
жема́нство	nskaparí [-Ꞌrʊi-]энкс0о, skapaktigheit [-Ꞌaʰk-]энкж0-ir
же́мчуг	plurжемчуг|а́, ~о́в, ~а́мm kollperlurжгл-aмн(ektaðar); иска́тель же́мчуга perlufiskariмгл-ari
жемчу́жина	fbeinl.,fl.perlaжгл-a(ektað)
жемчу́жница	f(Pinctada;Margaritifera,Margaritana) perluskelж0-ar{+}
жемчу́жный	adj1.(кже́мчуг) perlu-; жемчу́жное ожере́лье perluband2.(напоминающий жемчуг) perlu-; жемчу́жные зу́бы perluhvítar tenn
жена́	plurжён|ы, ~, ~амf1.(супруга) konaжгл-a(hjúnafelagi); брать в жёныgml.giftastir(t)(um mannfólk)2.gml.,hátíð.(женщина) kvinnaжгл-a
жена́тик	mtlm.,skemt.giftur maðurмнепр(oftast um nýgiftan)
жена́тый	stfжена́т, ~а, ~о, ~ыadjgifturсогл(um mannfólk ella í plur eis. hjún); он жена́т на мое́й сестре́ hann er giftur við systur mínari; жена́тые лю́ди gift fólk@жена́тая жизнь {жена́тое положе́ние}tað at vera giftur (um mannfólk), hjúnaband [tʃʰ-] (um mannfólk)
Жене́ва	fGenève [ʃeꞋneːv]м нескл.
Жене́вское о́зеро	Genèvevatnið [ʃeꞋneːv-]с0о{a/ø}опр.
же́нин	adjhja [tʃʰɔa] konuni; hjá [tʃʰɔa] konu míni {konu tíniи т.д.}; же́нины серёжки oyraringarnir hjá konuni; oyraringarnir hjá konu míni {konu tíniи т.д.}
жени́ть	женю́, же́н|ишь, ~ятipf/pf кого-л. на комgiftair(t)o-n við o-ri(um menn)@без меня́ меня жени́лиorðt.tað varð gjørt upp á nakkan av mærпог.
жени́тьба	fhjúnalagс0о{a/ø}
жени́ться	женю́сь, же́н|ишься, ~ятсяна ком-л.1.(о мужчине) giftastir(t)við o-ri(um mannfólk); уда́чно жени́ться fáa eina góða konu, verða væl giftur; жени́ться по любви́ giftast av kærleika, giftast av kerligheitннк2.tlm.bert plur(вступить в брак) giftastir(t),sbr.пожени́ться
жени́х	Gen, Accжених|а́; plur~и́, ~о́в, ~а́мm1.(сватающийся) drongurмсогл-s,-ir{+};согл-ir{+}(fríggjari hjá gentu); fríggjariмгл-ari(ухаживающий;тж любовник), biðilм0осн-s,-arуст., поэт.,unnustiмгл-iпоэт.;brúðgómur [pɹʏk-]мсогл-ar(во время свадьбы); он жени́х мое́й до́чери hann er forlovaður [-Ꞌloː-] við dóttur mínari2.: вы́годный жени́х góður maðurмнепр(at giftast við), góð giftaжгл-a(um mann)3.tlm.(молодой человек брачного возраста) fríggjariмгл-ari(ungur ógiftur maður); он уже́ жени́х hann er longu giftingarførur4.skemt.(о большом мальчике) ein trøllvaksin drongurмсогл-s,-ir{+};согл-ir{+}
жёнка	plurжён|ки, ~ок, ~камf1.tlm.(супруга) konaжгл-a(hjúnafelagi)2.óvkm. (женщина) konufólkс0о
женолю́б	mkonufólkarevurмсогл-ar
женолюби́вый	stfженолюби́в, ~а, ~о, ~ыadjtlm.: женолюби́вый челове́к konufólkalókurмсогл-ar, konufólkanálgurмсогл-ar, konufólkarevurмсогл-ar
женоненави́стник	mbókl.konufólkahatariмгл-ari, kvinnuhatariмгл-ari
женоподо́бный	stfженоподо́б|ен, ~на, ~но, ~ныadjkventluturсогл, kventlasligurглigur
же́нский	adj1.(кже́нщина) konufólka-, kvinnu-;же́нское лицо́ konufólkaansiktннк, kvinnuandlit [-anl-]; же́нский труд konufólkaarbeiði, kvinnuarbeiði; же́нская кома́нда kvinnulið; (моя́) же́нская родня́ skyldkonur [ʃɪl̥k-]жгл-aмн; же́нское движе́ние kvinnurørsla2.(свойственный женщинам) kvinnuligur, kvinnu-; же́нская красота́ kvinnuligur vakurleikiнп; же́нская ло́гика kvinnulogikkur [-kɪ-]3.(для женщин) konufólka-, damu- [taː-]; же́нская оде́жда konufólkaklæðir, damuklæðir; же́нский туалет kvinnutoilett [-tʰɔilεʰtː], damutoilett [-tʰɔilεʰtː], konufólkavesiнеформ.4.biol.(относящийся к особам женского пола) kvinnuligur, kvenn-; же́нскиe половы́е кле́тки kvinnuligar kynskyknur@же́нские боле́зниkvinnusjúkur;же́нские права́kvinnurættindi;же́нский вопро́сkvinnuspurningurin; же́нская ли́нияkvennleggurмсогл-ir; по же́нской ли́нии í kvennlegg, í móðurætt;же́нский родmáll.kvennkyn;сло́во же́нского ро́да kvennkynsorð =>полII,ри́фма,цвето́к1
же́нственность	fkvinnuligheitннкж0-ir, kvinnuleikiнпмгл-i, kvinnuskapurлпмсогл-ir; feminitetur [femiːniꞋtʰeː-]интмсогл-ar,
же́нственный	stfже́нственен, же́нственн|а, ~о, ~ыadjkvinnuligurглigur
жёнушка	plurжёнуш|ки, ~ек, ~камf kel. tilжена́ 1
же́нщина	fkonufólkс0о, konaжгл-a(взрослая женщина), kvinnaжгл-a; dama [taː-]жгл-a(б.ч. о незнакомой взрослой женщине,отличающейся хорошей одеждой и др.);plur eis.konufólkс0особир.; же́нщина-врач kvinnuligur lækni; пе́рвенсто Евро́пы среди́ же́нщин evropameistaraskapurin [εvꞋroː-] fyri kvinnur
женьше́нь	m(Panax gingseng) ginseng [kɪnꞋsεnk]с0{дат.0}; ginsengrót [kɪnꞋsεnk-]ж0-ur{ó/ø}(корень)
жерди́на	ftlm.síжердь
жёрдочка	plurжёрдоч|ки, ~ек, ~камf dim avжердь
жердь	plurже́рди, жерд|е́й, ~я́мfstongж0-ur{o/e}@худо́й как жердьklænur sum ein sperðilидиом.; sum ein strika í luftiniидиом.
жерёбая	adj: жерёбая кобы́ла kviðinсоглоснð/dryssa, fyltungсоглryssa
жеребёнок	Gen, Accжеребёнка;plurжеребя́т|а, ~, ~амmfylс0о{+}; hestfylс0о{+}(мужского пола); ryssufylс0о{+}(женского пола)
жеребе́ц	Gen, Accжеребц|а́; plur~ы́, ~о́в, ~а́мmgraðhesturжсогл-a, greðingurжсогл-a
жереби́ться	жереб|и́тся, ~я́тсяipf(pfожереби́тьсяожереб|и́тся, ~я́тся) folaaði
жеребьёвка	plurжеребьёв|ки, ~ок, ~камflutakastс0о{a/ø};произвести́ жеребьёвку kastaaðilut; реши́тьчто-л.жеребьёвкойeis.kastaaðilutum o-t
жеребя́чий	adjfylja-
же́рех	m(Aspius aspius)fiskur av karpuættini(en.asp; da.asp)
жерло́	plurже́рл|а, ~, ~амn1.(вулкана) (vulkan)kratur [-Ꞌkʰaːnkʰɹaː-]ннкс0осн,goskoppurлпмсогл-arгеол.2.(орудия) (byrsu)múliмгл-i, (byrsu)kjafturмсогл-ar3.tekn.(отверстие в печи) opс0о(í ovni o.tíl.)
жёрнов	plurжернов|а́, ~о́в, ~а́мoggml.жёрнов|ы, ~ов, ~амmmyllusteinurмсогл-ar; kvørnarsteinur [-tn-]мсогл-ar, kvarnarsteinur [-tn-]мсогл-ar(ручной мельницы)
же́ртва	f1.(приносимое в жертву) offurс0осн(тжперен., шахм.),(eis.fl.talv); offurdjórс0o(о животном - тж); принести́ в же́ртву (кому-л.) beraслнa-ó-o(o-m) offur, ofraaði(til o-n); blótaaði(til o-n) (у древних скандинавов)2.(обряд)síжертвоприноше́ние3.gml.(дар,пожертвование) gávaжгл-a4.(добровольный отказ,отречение) offurс0осн; uppofranжo-ir; принести́ всё в же́ртву ofra alt; гото́вый на же́ртвы offurfúsur5.(пострадавший) offurс0осн; же́ртвы сталини́зма ofrini fyri stalinismuna [staːliꞋnɪ-]; име́ются же́ртвы mannskaði var, fólk lótu lív; челове́ческие же́ртвы mannskaðiмгл-i; челове́ческих жертв не́ было eingin mannskaði var; обошло́сь без жертв eingin mannskaði var; же́ртвы пожа́ра tey, sum fórust í eldinum (о погибших); же́ртвы кораблекруше́ния teir, sum fórust við skipinum; teir, sum lótu lív við skipinum; пасть {стать} же́ртвойGenfalla [-tla] sum offur fyriДат, gerast offur fyriДат6.(жищника и т.п.) fongurмсогл-ir{+}, offurс0осн; лев набро́сился на свою́ же́ртву løvan legði [lεijɪ] eftir [εʰtː-] ofrinum hjá sær@приноси́тького-л. {что-л.}в же́ртвучему-л.ofraaðio-n{o-t}fyri o-t;приня́ть же́ртвуtalvtakaслнó-ó-iav einum ofri, takaслнó-ó-iímóti [-Ꞌmɔu-] einum ofri;отклони́ть же́ртвуtalvikki takaслнó-ó-iav einum ofri, ikki takaслнó-ó-iímóti [-Ꞌmɔu-] einum ofri;же́ртва неуда́чного або́ртаóf.,vanv.ein dummur faniмгл-iбран., eitt úthálað reyvarholс0обран., вульг.
же́ртвенник	m1.(место,на котором приносятся жертвы) altarс0о; offursteinurмсогл-ar(камень); blótsteinurмсогл-ar(у древних скандинавов)2.(стол в церкви) offurborðс0о(í russ. ortodoksum kirkjum)
же́ртвенный	stfже́ртвен|ен, ~на, ~но, ~ныadj1.(кже́ртва) offur-; же́ртвенное живо́тное offurdjór2.(самоотверженный) offurfúsurсогл, sum vísir offurvilja
же́ртвовать	же́ртву|ю, ~ешь, ~ютipf(pfпоже́ртвоватьпоже́ртву|ю, ~ешь, ~ют)1.что-л.(отдавать) ofraaðio-t; gevaслнa-ó-iо-t, lataслнæ-ó-ao-t2.Ins(ради Gen, для Gen) ofraaðiAcc(fyri Вин); же́ртвовать собо́й ofra seg3.talv(в шахматах) ofraaðio-t
жертвоприноше́ние	n1.(процесс) offurgerðж0-ir, ofringж0-ar; blótс0о(у древних скандинавов)2.(приносимое в жертву) offurс0осн, offurgávaжгл-a
жест	m1.(движение) handarbragð [-pɹεa]с0о{a/ø}{0<>i}, handarbráс0о{0<>i}(рукой); veipanж0-ir(большие движения рукой); faktirннкж0-ir; сде́лать нетерпели́вый жест руко́й gera eitt ótolið handarbrá; ótolin veipaaðivið hondini; же́стом пригласи́ть к себе́ báknaaði(o-m) at koma til sín; же́стом предложи́тькому-л.сесть bjóðaaðio-mat seta seg (við at vísa á sessin við hondini); язы́к же́стов teknmál [tʰεkn-]2.(поступок) gerðж0-ir(б.ч. в сложн.vinargerðи т.д. или с прил.), gestus [kε-]ннкм0-ar{дат.0}; дру́жеский жест vinargerð; благоро́дный жест stórbær gerð; краси́вый жест vøkur gerð; сде́лать широ́кий жест stórtøkin [stœɹ̥tʰ-] gerð
жестикули́ровать	жестикули́ру|ю, ~ешь, ~ютipfveipaaði(við hondunum), veiggjaaði(við hondunum), gestikulera [kεstɪkʰuꞋleː-]ннкaði
жестикуля́ция	fveipanж0-ir(við hondunum), veiggjanж0-ir(við hondunum), handakeipurжгл-aмн, gestikulering [kεstɪkʰuꞋleː-]ннкж0-ar
жёсткий	stfжёсток, жестка́, жёстко, жёсткиogtlm.жестки́;compжёстчеadj1.(твёрдый) harðurсогл{a/ø}; stívurсогл(негнущийся); seigurгл{+}(о мясе); óslætturсогл{æ/ø}, grovurсогл(грубый на ощупь); rísinсоглосн, stríðurгл(о волосах, траве и т.п.); стать жёстким {жёсче} harðnaaði; stívnaaði; seikkastaði(о пищевых продуктах и д.р.); жёсткий дива́н hørð divan; жёсткие во́лосы rísið hár, strítt hár; жёсткое полоте́нце grovt [kɹɔft] handklæði [haŋ̊klεa]; жёсткая ко́жа grov húð; жёсткая трава́ stívt [stʊi̯ft] gras; жёсткое мя́со seigt [sɔʰkt] kjøt; с жёсткими черта́ми лица́ við grovum andlitsdrøgum [anl-], grefligurглigurí útsjónd, stórskorin [stœʂs-]соглосн2.(суровый) harðurсогл{a/ø}(um sinnalag o.a.); у неё жёсткий хара́ктер hon er hørð av lyndi, hon er hørð í sinnalag, hon er harðlynt; жёсткие слова́ hørð orð; жёсткий моро́з hart frost3.(строгий) strangurсоглng; knappurсогл{a/ø}; жёсткий гра́фик ein knøpp tíðarætlan, ein stramm tíðarætlan; жёсткая ме́ра strangt tiltak [tʰɪl̥t-]; жёсткие усло́вия harðar treytir@жёсткая вода́hart vatn =>ваго́н@,диск9,по́рно,порногра́фия
жёстко	Iadv, stf avжёсткийIIpredtað er hart; здесь жёстко спать her er hart at sova@мя́гко сте́лет, да жёстко спатьorðt.jarnhond [-tn-] í einum floyalshandska [flœijal̥shan̊ka] (реже[flɔi-])пог.
жёстко-ко́рпусный	adj: жёстко-ко́рпусная надувна́я ло́дка rib-bátur [rɪpː-]
жёсткокры́лые	plur(отряд Coleoptera) verndarveingjaðсприлмн
жёстко-надувно́й	adj: жёстко-надувна́я ло́дка rib-bátur [rɪpː-]
жёсткость	fharðleikiнпмгл-i, harðheitннкж0-ir, herðaжгл-a; stívheitннкж0-ir; tað at vera seigur,síжёсткий; ребро́ жёсткости stívariмгл-ari, ribbaжгл-aпроф.(б.ч. мн)
жесто́кий	stfжесто́к, ~а, ~о, ~и;compжесто́чеadj1.(суровый,безжалостный) harðrendur [haɹ-]согл, brutalur [-Ꞌtʰaː-]ннксогл, grummurсогл; fyrilitsleysurсогл(ни с чем {кем} не считающий); жесто́кий тира́н ein harðrendur valdsharri [val̥s-]; жесто́кий нрав harðrendir siðir, brutalirннкsiðir; жесто́кое обраще́ние (с кем-л.) ring viðferðж0-ir(av o-m); жесто́кий челове́кeis.ein øgilм0осн-s,-arog bøðilм0осн-s,-ar2.(очень сильный) sterkurсогл, harðurсогл{a/ø}; жесто́кая боль sterk pína, ring pína; жесто́кая борьба́ hart stríð; жесточа́йшая конкуре́нция beinhørð kapping; жесто́кий отпо́р hørð mótstøða; жесто́кие бои́ harðir bardagar; жесто́кая эксплуата́ция eirindaleys eyðræning; жесто́кая судьба́ hørð lagna; жесто́кие муче́ния ræðuligar kvalir =>шторм
жесто́ко	advræðuliga, harðliga; жесто́ко ошиби́ться geraнепрeitt ræðuligt mistak, faraслнó-ó-aræðuliga skeivur, takaслнó-ó-aræðuliga feil; жесто́ко обраща́тьсяс кем-л.faraслнó-ó-ailla [ɪtla]við o-m
жестокосе́рдие	ntað at vera harðhjartaður [haɹja-]
жестокосе́рдный	stfжестокосе́рд|ен, ~на, ~но, ~ныadjharðhjartaður [haɹja-]глaður
жестокосе́рдый	stfжестокосе́рд, ~а, ~о, ~ыadjhátíð.,gml.síжестокосе́рдный
жесто́кость	ftað at vera harðhjartaður [haɹja-], brutalitetur [pɹutʰaːliꞋtʰeː-]ннкмсогл-ar, harðskapur [haʂ-]мсогл-ir, fyrilitsloysiсгл-i(пренебрежение); име́ть жесто́кость сказа́ть vera nóg harður av sær at siga
жесто́че	comp avжесто́кий
жёстче	comp avжёсткий
жесть1	Ifblikkс0о(tilfar); лист же́сти blikkpláta
жесть2	II1.inter, jargá, Jesus [ɔijɪsʊs]; pínadoyð, pínadoyð og sáligheit2.pred, jargtað er ræðuligt, tað er forferdiligt [-ˈfε-]энк
жестя́ник	m síжестя́нщик
жестя́нка	plurжестя́н|ки, ~ок, ~камf1.(банка) blikkс0о(ílat), blikkdósж0-ir2.tlm.(кусок жести) blikkpettiсгл-i, blikkplátaжгл-a(лист)
жестяно́й	adjblikk-
жестя́нщик	fblikksláariннкмгл-ari, blikksmiðurмсогл-a,-ir
жето́н	m1.(значок) merkiсгл-i(какого-л. общества); minnispeningurмсогл-arкн.(в память чего-л.)2.(для автомата и т.п.) pengiмгл-i(til automat o.tíl.)3.(в игре) spælimerkiсгл-i
жечь	жгу, жжёшь, жгут;pretжёг, жгла, жгло, жгли;imperжги, жги́теipf1.pfсжечьсо|жгу́, ~ жжёшь, ~жгут; pret ~жёг, ~жгла, ~жгло, ~жгли; imperсожги́, сожги́теAcc(уничтожить огнём) brennair(d)Вин; жечь ста́рые пи́сьма brenna gomul brøv2.что-л.(для отопления,освещения) brennair(d)o-t, lataслнæ-ó-ao-tbrenna, lataслнæ-ó-ao-tloga [luːwa]; жечь дрова́ brenna (pinna)brenni,sbr.5; жечь све́чи brenna ljós (kertuljós); жечь свет lata ljósið loga; зря жечь электри́чество brúkair(t)elektrisitet [eꞋlεʰtɹɪsɪꞋtʰeːt] til onga nyttu3.Acc bert 3. pers brúktur(причинять боль) svíðaсоглei-i-i; па́лец (ужа́сно) жжёт tað svíður ræðuliga illa [ɪtla] í fingrinum; со́лнце жгло ей голову sólin bakaði á høvdið [hœtːɪ] á henni; пе́рец жёг язы́к piparið sveið [svεi] (реже[svai]) á tunguni4.Acc(мучить) nítaсоглei-i-iДат, pínair(d)Вин; э́ти слова́ жгли её hesi orðini nitu henni fast5.: жечь у́голь brenna trækol, 2; жечь ко́фе brenna kaffi; жечь кирпи́ч brenna múrsteinar [mʏ-]
же́чься	жгусь, жжёшься, жгу́тся;pretжёгся, жглась, жглось, жглись;imperжгись, жги́тесьipf1.bert 3. pers brúktur(вызывать ожог) svíðaслнei-i-i, brennaслнa-u-u2.pfобже́чьсяобо|жгу́сь, ~ жжёшься, ~жгу́тся; pret обжёгся, обожгла́сь, обожгло́сь, обожгли́сь; imper обожги́сь, обожги́тесьtlm.(получать ожоги) brennaслнa-u-useg
жж...	жжёшьo.s.fr. pres avжечь
жже́ние	nsviðiсгл-i; я чу́вствую жже́ние в го́рле tað svíður í hálsinum
жжёнка	fpunsurмсогл-ar, punsjurмсогл-ar
жив...	живу́o.s.fr. pres avжить
живе́ц	Gen, Accживц|а́;plur~ы́, ~о́в, ~а́мmlivandi agnс0о{a/ø}(smáfiskur el.a.); лови́ть на живца́ fiska við livandi agni
жив-живёхонек	adjtlm.sprelllivandiглandiнеформ., spillivandiглandiнеформ.
живи́...	живи́, живи́теimper avжить
живи́нка	f: живи́нка в де́леtlm.góður hugurмсогл-ar;согл-ir, eldhugurмсогл-ar;согл-ir
живи́тельный	stfживи́телен, живительн|а, ~о, ~оadjupplívandiглandi, lívgandiглandi, stimbrandiглandi(стимулирующий)
живи́ть	живлю́, жив|и́шь, ~я́тipf Accbókl.stimbraaðiВин, lívgaaðiВин
живи́ца	fbleytt harpiksс0о, bleytt harpeisлпс0о
жи́вмя	adv: жи́вмя житьgml., óvkm.búgvaнепрfast
живмя́	adv síжи́вмя
жи́вность	f kolltlm.alifuglurмсогл-arсобир.(домашняя птица); fenaðurмсогл-irсобир., kríatúrс0омн собир.(овцы,скот); smákyktс0особир., smádýrс0особир.(мелкие животные); grellс0особир., smáfiskurмсогл-arсобир.(мелкая рыба)
жи́во	adv1.(ярко,отчётливо) livandi (áhugavert); жи́во интересова́тьсяInsinteressera [-Ꞌseː-]ннкseg livandi fyriДат, havaнепрlivandi áhuga fyriДат; жи́во предста́вить себе́что-л.livandi hugsa særo-t, síggjao-tlivandi fyri sær; жи́во расска́зывать fortelja [-Ꞌtʰε-] livandi, siga livandi frá; жи́во чу́вствоватьчто-л.livandi følao-t2.(оживлённо) lívliga3.tlm.(быстро) skjótt, kvikliga; жи́во! skunda tær!; kvika tær!; живе́й! skunda tær!; kvika tær!; skjótari!
живогло́т	m óvkm., vanv.øgilм0осн-s,-arog bøðilм0осн-s,-arнеодобр.
живодёр	m1.gml.(тот,кто сдирает кожу)o-r, ið flettir deyð djór2.fl. óvkm.(жестокий человек) bølmenniсгл-i, bøðilм0осн-s,-ar(harðrendur maður)
живо́й	stfжив, жива́, жи́во, жи́выadjI 1.(не мёртвый) livandiглandi, á lívi; живо́е существо́ kyktс0о, livandi vera; живо́й язы́к livandi mál; он ещё жив hann livir enn, hann er á lívi enn, hann er livandi enn; он ещё жив? livir hann enn?; живо́й или мёртвый livandi ella [εtla] deyður; пока́ бу́ду жив so leingi eg livi2.(полный сил) lívligurглandi; sprækinсоглосн(подвижный,энергичный); birgurсогл(бодрый); gløggurсогл, kvikurсогл(at fata) (сообразительный - тж); живы́е глаза́ lívlig eygur; живо́й интере́с livandi áhugi; живо́й ребёнок lívligt barn; живо́й стари́к birgur gamal maður3.(реальный) livandiглandi, virkuligurннкглigur, veruligurнпглigur; жива́я жизнь tað virkuligaннкlívið; изобрази́ть живы́х люде́й lýsa livandi fólk, lýsa fólk av holdi og blóði; жива́я действи́тельность livandi veruleikiнп4.(выразительный,яркий) livandiглandi; lívligurглigur; живо́й слог livandi stílur; живо́е повествова́ние livandi frásøgn; живы́е кра́ски lívligir litir; живо́е воображе́ние livandi fantasiur [fan̊taꞋsiː-]ннкмсогл-s,-ir{0<>i}; живы́е воспомина́ния (ljós)livandi minnir5.(интенсивный,активный) livandiглandi, virkinсоглосн; принима́ть живо́е уча́стиев чём-л.taka aktivanннкlutí o-m, taka virknan lutí o-m; живо́е любопы́тство stórt forvitni; живо́е жела́ние sterkt ynskiIIm: живы́е и мёртвыеbíbl.livandi og deyðIIIn: всё живо́е alt livandi@Nomживчем-л. Имlivir (bara) ío-m; она́ была́ жива́ одно́й наде́ждой hon livdi bara í vónini;быть в живы́хvera livandi, vera á lívi;жив-здоро́вfrískurсоглskog ferðugurглugur;оста́ться в живы́хsleppaслнa-u-o(undan) við lívinum, veraслнa-ó-eeftir [εʰtː-] á lívi;он оди́н оста́лся в живы́хbara hann kom undan við lívinum, bara hann slapp (undan) við lívinum;оста́вшиеся в живы́хtey, sum komu frá tí við lívinum; tey, ið vórðu bjargað (спасшиеся);оста́вить в живы́хlataслнæ-ó-aliva;живо́го ме́ста не оста́витьна ком-л.smyrjaнепрo-nav;живо́го ме́ста не оста́лосьна ком-л.hann var so avsmurdur;жива́я вода́lívsins vatn (í russ. søgnum o.ø.);жива́я о́чередьkøннк, bíðirøðнп(har ein ikki er skrivaður upp frammanundan);жива́я ра́наbeinl.,fl.opið sár;жива́я связьа) (через людей) persónligt [-Ꞌsɔʊ-] samband; b) (постоянная) støðugt samband;жива́я си́лаlivandi kykt (djór og fólk í móts. til mekaniskan mátt);ни одно́й живо́й души́ikki ein livandi sál, ikki eitt (livandi) kykt;ни жив ни мёртвmeira deyður enn livandi;как живо́йlivandi, ljóslivandi; я ви́жу его́ как живо́го eg síggi hann so ljóslivandi fyri mær;по живо́му ре́затьtlm.(порывать связь, отношения) ≈ skeraслнa-ó-oá stokkinumперен., идиом.=>весI @,деньги@,два́I 2,е́ле@,заде́ть@,и́згородь,инвента́рь@,карти́на@,ни́тка@,темпера́мент1,уголо́к@,хлеб@
живопи́сец	Gen, Accживопи́сц|а;plur~ы, ~ев, ~амm(lista)málariмгл-ari, kunstmálariннкмгл-ari
живопи́сный	stfживопи́с|ен, ~на, ~но, ~ныadj1.bert lf(кжи́вопись) málninga-, málara-; живопи́сная мастерска́я atelier [atʰeꞋʎjeː], [atʰeꞋʎjeːɹ]ннкс0опроф.(hjá málara), verkstovaлпжгл-a(hjá málara); живопи́сный портре́т (málað) portrett [pʰɔɹ̥Ꞌtʰɹεʰtː]инт, (málað) andlitsmynd [anl-]нп(í móts. til tekning),sí eis.жи́вопись2.(красивый) pittoreskur [-Ꞌrε-]интсоглред.; náttúruvakurсоглосн{a/ø}(о виде на пейзаж и т.п.); litfagurсоглосн{a/ø}кн., litfríðurгл, litríkurсогл(красочный)3.(о языке,сравнении и т.п.) málandiглandi(um mál,samanberingar o.tíl.)
жи́вопись	f1.(искусство) málningalistж0-ir, málarakunsturннкмсогл-s,-ir, málarí [mɔalꞋrʊi]ннкс0о; занима́ться жи́вописью fáast við at mála; жи́вопись ма́слом oljumáling, máling við olju; акваре́льная жи́вопись akvarellmáling [-Ꞌrεlm-], máling við vatnlitum [vanl-]; шко́ла жи́вописи málaraskúli2.koll(картины) málningarмсогл-arмн, málarí [mɔalꞋrʊi]ннкс0омн; стенна́я жи́вопись veggmálarí, veggmálningar
живородя́щий	adjsum fær livandi ungar
живоры́бный	adj: живоры́бный садо́к brunnurмсогл-ar(til livandi fisk), karс0о{a/ø}(til livandi fisk); живоры́бное су́дно brunnbátur; гибри́дное живоры́бное су́дно hybridbrunnbátur [hyˈpɹi:t-]
жи́вость	flívс0о, lívligheitннкж0-ir
живо́т1	IGenживот|а́;plur~ы́, ~о́в, ~а́мm(часть тела) búkurмсогл-ar; magiмгл-i(желудок); vombж0-urпренебр., шутл.; у него́ боли́т живо́т hann hevur ilt í búkinum; отрасти́ть живо́т fáaслнe-i-ibúk; наби́ть живо́т stappaaðií seg@у меня́ живо́т подвело́tlm.eg eri gorhungraðurглaður
живо́т2	IIGenживот|а́;plur~ы́, ~о́в, ~а́мmgml.(жизнь) lívс0о; не на живо́т, а на́ смерть upp á lív og deyð, um lív og deyð; не щадя́ живота́ uttan at spara seg =>жизнь@
животво́рный	stfживотво́р|ен, ~на, ~но, ~ныadjlívgevandiглandi, lívgandiглandi, sum fær til lívs
живо́тик	m dim avживо́т I =>надорва́ть@
животи́на	fóvkm.húsdjórс0о; бесслове́сная животи́на ómælandi djór
животново́д	mneytaalariмгл-ari, neytabóndiмгл-ur
животново́дство	nneytahaldс0о, neytaalingж0-ar
животново́дческий	adjneyta-, neytahalds- [-hal̥s-]
живо́тное	n1.(живое существо в противоположность человеку) djórс0о, dýrс0о; дома́шнее живо́тное húsdjórс0о, húsdýrс0о2.fl.(о человеке) beistс0о
живо́тный	adj1.(относящийся к живым существам;присущий животному) djóra-, animalskur [aːniꞋma-]ннксоглпроф.; живо́тный мир {живо́тное ца́рство} djóraríkið, djóraheimurin; живо́тный жир animalskt feitt, djórafeitt; живо́тная пи́ща animalskur matur, matur av djórum ; живо́тное ма́сло smør2.fl.(грубый,низменный) dýriskurннксоглsk, djóriskurннксоглsk, sum djór, ráurгл; живо́тная я́рость vill [-tl] øði; живо́тный страх blind ræðsla
животрепе́щущий	stfживотрепе́щущ, ~а, ~е, ~иadjaktuellur [-Ꞌεlː-]согл, sum leikar á, brennandiглandi
живу́честь	f1.(жизнеспособность) lívføriсгл-i, lívsevni [lʊi̯fs-]сгл-i, tað at vera lívseigur [lʊi̯fs-]2.fl.(устойчивость) tað at vera lívseigur [lʊi̯fs-]3.(судна) livitíðж0-ir(hjá skipi)
живу́чий	stfживу́ч, ~а, ~е, ~иadj1.(жизнеспособный) lívseigur [lʊi̯fs-]гл, seiglívaðurглaður, lívsterkur [lʊi̯fs-]согл; живу́чее расте́ние lívseig planta; он живу́ч как ко́шка lívið fæst ikki av honum2.fl.(прочно сохраняющийся) sum heldur sær leingi, lívseigurгл; живу́чий обы́чай lívseigur siður
жи́вчик	m1.tlm.(подвижный человек) lívligtглigurfólkс0о2.(сперматозоид) sáðkyknaжгл-a3.tlm.(биение артерия) sjónligur æðrasláttur [akɹ-]м0осн-ar,-ir;согл-ir
живьём	advtlm.livandi
жи́голо	m indeclgigolo[tʃɪkːolo]мгл-гл
Жигули́1	IЖигул|е́й, ~я́мf plurZjiguli [ʃiːkuꞋliː]с нескл.(herður við ánna Volga)
Жигули́2	IIЖигул|е́й, ~я́мf plur«Zjiguli» [ʃiːkuˈliː]м нескл.(kent bilmerki, uttanlands kent sum «Lada»)
жид	Gen, Accжид|а́;plur~ы́, ~о́в, ~а́мm1.gml.(еврей) jødiмгл-i, gýðingurмсогл-arкн.2.óvkm.,vanv.(презрительное название) jødiмгл-i@ве́чный жидtann ævigi jødin
жи́дкий	stfжи́док, жидка́, жи́дко, жи́дки;compжи́жеadj1.(текучий) flótandiглandi; в жи́дком состоя́нии flótandi, í flótandi líki, í flótandi formi; жи́дкое состоя́ниеfys.flótandi skap, flótandi líki; жи́дкий во́здух flótandi luft; жи́дкая пи́ща flótandi matur, spónamatur2.(недостаточно густой) tunnurсогл; vatnuturсогл(водянистый); tynturсогл(разжиженный); жи́дкий как вода́ sum vatn (tunnur); жи́дкий суп tunn súpan; жи́дкий чай tunt te, svakt te, veikt te; сде́лать бо́лее жи́дким tynnair(t); стать жи́дким tynnastir(t)3.(редкий) ótætturсогл{æ/ø}, glisinсоглоснред.; tunnurсогл; жи́дкий лес ótøtt skóg; жи́дкие во́лосы tunt hár4.tlm.(не обладающий силой-о голосе, звуках) veikurсогл, spakuligurглigur(um mál, ljóð)5.tlm.(слабый, тщедушный) skirvisligurглigur, lakurсогл{a/ø}; жи́дкие му́скулы slappirннксоглmusklarннкм0оснмн6.fl.,tlm.(слабый,тщедушный) sum roynistir(d)illa [ɪtla], lakurсогл{a/ø}; innantómurсогл, innihaldsleysurсогл(малосодержательный); ógrundaðurглaður(необоснованный); жи́дкий аргуме́нт tuntсоглнеформ.argument [aɹkuꞋmε-]ннк=>лёд,мы́ло1,те́ло1,то́пливо
жидкова́тый	stfжидкова́т, ~а. ~о. ~ыadj tlm. heldur tunnurсогл,í tynra lagi, í so tunnurсогл
жидкокристалли́ческий	adj: жидкокристалли́ческий диспле́й {монито́р} LCD-skermur [εlː seː Ꞌteː-], LCD-skíggi [εlː seː Ꞌteː-]
жи́дкостный	adjvesku-ннк, жи́дкостный дви́гатель motorur [-Ꞌtʰoː-] til flótandi brennievni; жи́дкостный ко́мпас sprittkumpass, flotkumpassлп
жи́дкость	fveskaннкжгл-a, løgurмсогл-ir{+}(тж об отваре); vætaжгл-a(о воде и др.); flotс0о(в организме)
жидо́вка	plurжидо́в|ки, ~ок, ~камf1.gml.(еврейka) jødnna [jøːtˈɪnta]жгл-aуст., gýðingurмсогл-arкн. (konufólk), gýðingakonaжгл-aкн.2.óvkm.,vanv.(презрительное название) jødiмгл-i(konufólk),
жидо́вский	adjóvkm.,vanv. jøda-, jødiskurсоглsk
жидомасо́н	móvkm.o-r, ið tekur undir við einari heimsumfatandi samansvørjing av jødum og frímúrarum, sum sbr. antisemitar o.a. skal eitast vera til
жи́жа	f1.(вязкая и т.д.) evjaжгл-a; наво́зная жи́жа flottøðс0о{0<>i}; снег преврати́лся в гря́зную жи́жу kavin bleiv til skitna evju2.tlm.(жидкая часть пищи) soðс0о; løgurмсогл-ir(отвар); saftж0-ir(сок)
жи́же	comp avжи́дкий
жи́жица	f dim tilжи́жа
жизнеде́ятельность	f1.biol.(способность к жизненным отправлениям) lívsvirksemiсгл-i, lívsfunktión [-fʊŋ̊kʃɔun]ж0-ir2.(энергичность) lívligheitннкж0-ir(живость), ágrýtniсгл-i;жгл-i
жизнеде́ятельный	stfжизнеде́ятелен, жизнеде́ятельн|а, ~о, ~ыadj1.biol.(способный к жизненным отправлениям) lívførurсогл2.bókl.(энергичный,деятельный) lívligurглigur(живой), ágrýtinсоглосн, virkinсоглосн
жизнелю́б	mlívsglaður persónur [-Ꞌsɔu-]мсогл-ar
жизнелюби́вый	stfжизнелюби́в, ~а, ~о, ~ыadjlívshugaðurглaður, sum elskar lívið
жизнелю́бие	nlívsgleðiжгл-i, lívshugurмсогл-ar;-ir
жи́зненно	adv: жи́зненно необходи́мый lívsneyðugur, alneyðugur; жи́зненно ва́жный lívsviktigurннк, lívsneyðugur
жи́зненность	f1.(жизненная сила) lívskraftж0-ir{a/e}, lívsmegiжгл-i, lívsmátturмсогл-ir; vitalitetur [vitʰaːliꞋtʰeː-]ннкмсогл-ar2.(близость к действительности) tað at vera nær veruleikanum3.(важность) neyðsynж0-ar{+}, tað at vera alneyðugur
жи́зненный	stfжи́знен, ~на, ~но, ~ныadj1.(кжизнь) lívs-, livi-; жи́зненный о́пыт lívsroynd; жи́зненный путь lívsleið, æviжгл-i; жи́зненная му́дрость lívsvísdómur; жи́зненный укла́д lívsmáti, liviháttur; жи́зненный у́ровень livifóturмнепр, livistandardurннкмсогл-ar2.(важный) lívsviktigurннкглigur, lívsneyðugurглugur, neyðsynjar-; aktuellur [-Ꞌεlː-]согл(актуальный); átrokandiглandi(срочный); жи́зненный вопро́с lívsviktigurннкspurningur, lívstýðandi spurningur3.(близкий к действительности) sum er nær veruleikanum, livandiглandi, veruleikatrúgvurсоглgv, sum hevur tætt samband við (gerandis)lívið@ жи́зненное простра́нствоlivirúmс0о;часто приводится по-немецкиLebensraum [leːpεn̊sraum]с0о=>путь@,у́ровень3
жизнеобеспече́ние	n bókl.tað at halda ti lívsneyðuga uppi, tað at tryggja tað lívsneyðuga; varðveitsla [vaɹvai̯sla]жгл-aavtí, sum er lívsneyðgtкн.; жизнеобеспече́ние в усло́виях Се́вера tað lísneyðuga fyri lívi norðanfyri; систе́мыжизнеобеспече́ниястраны́ — тепло-, водо-, энергоснабже́ния lívsneyðugar skipanir í landunum eru vatn. hita-, og orkuveitingar
жизнеописа́ние	nævisøgaжгл-a, lívssøgaжгл-a
жизнеощуще́ние	nbókl.heimsfatanж0-ir
жизнепонима́ние	nbókl. heimsáskoðanж0-ir
жизнера́достность	flívsgleðiжгл-i
жизнера́достный	stfжизнера́дост|ен, ~на, ~но, ~ныadjlívsglaðurгл
жизнеспосо́бность	flívføriсгл-i, lívførleikiмгл-i, lívskraftж0-ir{a/e}, lívsmátturмсогл-ir
жизнеспосо́бный	stfжизнеспосо́б|ен, ~на, ~но, ~ныadjlívførurсогл
жизнеутвержда́ющий	stfжизнеутвержда́ю|щ, ~а, ~е, ~иadjlívsjáttandiглandi
жизнь	f1.(существование) lívс0о; tilveraжгл-a; челове́ческая жизнь mannalív; борьба́ за жизнь bardagi fyri lívinum2.(период существования) æviжгл-i, æviskeiðс0о; сре́дняя челове́ческая жизнь miðallivialdurin hjá einum menniskja; всю (мою́) жизнь alt lívið, alla [atla] mína ævi, alla [atla] mína lívstíð; в пе́рвый год жи́зни tað fyrsta [fɪsta] árið av lívinum; при её жи́зни meðan hon livdi, meðan hon var á lívi3.(образ существования) lívс0о; о́браз жи́зни lívsmáti, lívsháttur, lívsstílur,lív, levnaðс0о; дереве́нская жизнь bygdarlív; вести́ здоро́вый о́браз жи́зни livair(d)(að)eitt sunt lív; там дорога́я жизнь har er dýrt at liva; бе́дная жизнь fátæksligt lív4.(деятельность) lívс0о; обще́ственная жизнь samfelagslív; семе́йная жизнь familjulív, heimalív5.(реальная действительность) lívс0о; о́браз взят пря́мо из жи́зни hesin persónurin [-Ꞌsɔu-] (í skaldsøgu o.tíl.) er tikin beint úr (tí veruliga) lívinum6.(оживление): по́лный жи́зни fullur [-tl-] av lívi; у́лицы полны́ жи́зни gøturnar yðjaur(d){+}í lívi@жизнь есть борьба́lívið er ein bardagi, lívið er ein kampurшутл.;претвори́ть {провести́}что-л.в жизньsetaur(t)o-tí verk;датькому-л.жизньgevao-mlív;дарова́тькому-л.жизньgevao-mgriðкн.,выс.;как жизнь?hvussu gongst?;вопро́с жи́зни (и сме́рти)avgerandi spurningur; ein spurningur um lív ella [εtla] deyða; э́то для меня́ вопро́с жи́зни hetta er lívið um at gera fyri meg;(находи́ться) ме́жду жи́знью и сме́ртью(vera) millum [-tl-] lív og deyða;не на жизнь {живо́т}, а на́ смертьupp á lív og deyð, um lív og deyð;брать всё у жи́зни{жить по́лной жи́знью} njótaслнey-u-olívið av heilum huga;по́лная жизньríkt lív;устро́итькому-л.весёлую жизньtlm.,skemt.geraнепрo-mfortreðнеформ., geraнепрo-mónáðir;не от хоро́шей жи́зниtlm.við ringum tannabitiпог., treyðugt;жизнь коротка́, иску́сство ве́чно {до́лго}lívið er stutt, listin long (цитируется также по-латыниars longa, vita brevis est);(никогда́) в жи́зни{tlm.ни в жизнь} aldrin í lívinum, aldri á ævini, ikki í mín dag; tað kemur ikki upp á tal (исключено); (ни за что) в жи́зниaldrin í verðini =>боя́ться1,возникнове́ние,войти́@,воплоти́ть@,воплоти́ться@,гроб@,до́рого@,духо́вный1,зараба́тывать4,класть@,ключII @,лиши́ть,опа́сность,отда́ть@,отня́ть1,при́знак,пройти́@,сохрани́ть3,усло́виеB 1
жиклёр	mdysa [tyː-]жгл-a
жи́ла1	If1.(кровоносный сосуд) æðr [akɹ]ж0-ar2.(сухожилие) sinж0-ar, spongж0-ur{o/e}; soymiмгл-i(у китов)3.nám.(геологическое тело) lindж0-ir; напа́сть на золоту́ю жи́луfl.gera góðan fongперен.4.tekn.(кабеля) leiðariмсогл-ari(í kápli)@тяну́ть жи́лыиз кого-л.plága [pʰlɔava]aðilíviðav o-m
жи́ла2	IIf, móvkm. ,vanv.gírigt fólkс0о, nábalsklógvжнепрпренебр., kargapisaжгл-aпренебр.
жиле́т	mvesturмсогл-ar; спаса́тельный жиле́т redningsvesturннк, bjargingarvesturнп
жиле́тка	plurжиле́т|ки, ~ок, ~камf dim avжиле́т@пла́каться в жиле́ткукому-л.kærair(d)sína neyðfyri o-m, gremjaur(d){e/a}{+}segfyri o-m
жиле́тный	adjvesta-; жиле́тный карма́н vestalummi
жиле́ц	Gen, Accжильц|а́;plur~ы́, ~о́в, ~а́мm1.(снимающий квартиру, комнату) leigariмгл-ari; logerandi [loꞋʃeː-], [loꞋseː-]ннкмприл(снимающий комнату)2.(обитатель)o-r, ið býr í einum húsum@он не жиле́ц (на све́те)hann hevur ikki langa tíð eftir [εʰtː-], hann liggur at doyggja
жи́листый	stfжи́лист, ~а, ~о, ~ыadj1.(с выступающими жилами) spengruturсогл2.(о мясе и т.п.) slintruturсогл, soymuturсогл(о китовом мясе), seigurгл(жёсткий)3.tlm. (сильный) sterkurсогл
жи́лить	жи́л|ю, ~ишь.~ятipf что-л. óvkm.leggjaнепрo-t undir seg, kraddaaðio-tinn undir seg, krøkjair(t)o-tinn undir seg
жи́литься	жи́л|юсь, ~ишься, ~ятсяipf1.óvkm(напрягаться) kýtair(t)seg, leggjaнепрˈnógv fyri, spennair(t)seg ˈút, leggjaнепрalla [atla] orku í2.óvkm.(скупиться) vera pírinсоглосн, vera gírigurглigurpírair(d)
жили́ще	nbústaðurмсогл-ir(hús,íbúð); heimс0о
жили́щно-коммуна́льный	adj: жили́щно-коммуна́льный отде́лdeild við ym. tænastuveitingum fyri eitt ella fleiri íbúðahús
жили́щно-строи́тельный	adj: жили́щно-строи́тельный кооперати́в (styttЖСК)byggifelag,har limir skjóta pengar inn í bygging av íbúðаhúsi
жили́щно-эксплуатацио́нный	adj: жили́щно-эксплуатацио́нная конто́ра (ЖЭК)skrivstova, ið stendur fyri viðlíkahaldi o.ø. av íbúðahúsum
жили́щный	adjbústaðar-, húsa-; жили́щное строи́тельство húsabygging; жили́щный кри́зис húsaneyðж0-ir; жили́щные усло́вия bústaðarviðurskifti =>фонд2
жи́лка	plurжи́л|ки, ~ок, ~камf1.dim avжи́ла2.(на листьях,крыльях насекомых) æðr [akɹ]ж0-ar(á bløðum, veingjum á insektum)3.(о минерале) áringж0-ar(í marmori o.ø.); мра́мор с жи́лками árað marmor4.(способность) gávurжгл-aмн, æðr [akɹ]ж0-arшутл.(um listagávur o.tíl.); у неё поэти́ческая жи́лка hon hevur yrkjaragávur, hon er ikki sør at duga at yrkja
жило́й	adjhúsa-, bústaðar- (предназначенный для жилья); sum búð verður í (обитаемый); sum búgvandi er í, sum kann búgvast í (пригодный для жилья); жило́й дом sethús; íbúðahús (с несколькими квартирами,часто многоэтажный); жило́й кварта́л sethúsaøkiсгл-i; жило́й масси́в íbúðaøkiсгл-i; жило́е помеще́ние sethúsabygningur, íbúðabygningur; жила́я пло́щадь bústaðarareal [-aːl]ннкс0о(;0-ir)проф., bústaðarvíddж0-ir(gólvvíd,tá køkur,baðiverilsi o.a. ikki eru tald uppí); жила́я ко́мната rúm at búgva í
жилпло́щадь	f síжила́япло́щадь
жильё	n1.(обитаемое место) bústaðurмсогл-ir; вдали́ от челове́ческого жилья́ langt frá mannabygdum; при́знаки жилья́ merki um, at fólk býr her2.tlm.(жилище) logi [loꞋʃiː], [loꞋsiː]ннкс0о(временное), tilhaldс0о;0o{a/ø}; иска́ть жильё leita eftir [εʰtː-]o-mat búgva í; найти́ себе́ жильё finna særo-tat búgva í3.tlm.(проживание) búgvс0о; ме́сто для жилья́ eitt stað at búgva í; него́дный для жилья́ óhóskandi at búgva í
жим	mítr.pressaжгл-a
жи́молость	f(Lonicera) kaprifolium [kʰaːpʰɹiꞋfoːliʊm]ж0-ir, geitarblaðлпс0о{a/ø}; души́стая жи́молостьsíкаприфо́ль
жир	Genжи́ра, жи́ру, Prpо жи́ре, в жиру́;plurжир|ы́, ~о́в, ~а́мmfeittс0о; spikс0о(покровный жир китов,тюленей); tálgж0-ir(нутряное сало); lýsiсгл-i(жидкий жир от рыб,китов и др.); нутряно́й жир mørurмсогл-s,-ir; ры́бий жир livralýsi; кито́вый жир hvalalýsi (от больших китов); grindalýsi (от голов гринд); гуси́ный жир gásarfeitt; по́чечный жир nýrumørurмсогл-s,-ir; жиры́plurfeittstoffннкс0о, fitievniнпсгл-i, feittsløgс0о{a/ø}, feittс0о; живо́тные жиры́ animalskt [aːniꞋmaː-]ннкпроф.feittstoffннкпроф., animalsk [aːniꞋmaː-]ннкпроф.fitievniнп, djórafeitt; расти́тельные жиры́ vegetabilskt [veːkɪtʰaꞋpiː-]ннкпроф.feittstoffннкпроф., plantufeitt, planturunninлпfitievniнп; пи́ща, бе́дная жира́ми soltinсоглоснmatur, matur við lítlum feitti@он ло́пается от жи́руóvkm., atf.hann er so spikafeitur;сбро́сить ли́шний жирslaknaaði, faraслнó-ó-aꞋ aftur [aʰtː-] (á holdinum);не до жи́ру, быть бы жи́вуtilt.nú ræður um at sleppa toluliga heilskapaður burturúr [-Ꞌʉuɹ] =>бе́ситься@,заплы́тьII,кито́вый,обрасти́2,@,оплы́тьI 1,покро́вный,треско́вый
жира́ф	m(Giraffa) giraffur [kiꞋra-]мсогл-ar
жира́фа	fgml.síжира́ф
жире́ть	ipf(pfожире́ть, разжире́ть) fitnaaði
жи́рно	adv: жи́рно есть eta feitan mat; жи́рно нама́зать хлеб smyrjaнепрtjúkt upp á breyðið, kleiggjaaðiupp á breyðið@(сли́шком) жи́рно бу́детóvkm., atf.heldur nógv, nakað nógv av tí góða
жи́рность	f1.(содержание жира) fitiжгл-i(innihald av feitti); feittinnihaldс0о2.(упитанность) fitiжгл-i; holdс0омн(тж - б.ч. о животных)
жи́рный	stfжи́рен, жирна́, жи́рно, жи́рныogжирны́adj1.(содержащий много жира) feiturсогл; жи́рный кусо́к feitur biti; жи́рная пи́ща feitur matur2.(толстый,тучный) feiturсогл, tjúkkurсогл, sum er væl í holdum3.(сальный) feitt-, snykuturсогл(от рыбьего,китового жира); жи́рное пятно́ feittblettur [pʰlε-]4.(насыщенный полезными веществами) feiturсогл; жи́рная по́чва feit jørð, gróðrarmikilсоглоснjørð5.kem.(о соединениях и др.) feitt-; жи́рная кислота́ feittsyraннк, fitisýra ; жи́рные соедине́ния feittforbindilsirннк, feittsambondнп=>шрифт1
жи́ро	n indeclfíggj.endossement [εntɔsːɪꞋmaŋk]с0офин.
жирова́ть1	Iжиру́|ю, ~ешь, ~ютipf что-л.smyrjaнепрo-tvið feitti
жирова́ть2	IIжиру́|ю, ~ешь, ~ютipffitnaaði, dragaслнó-ó-iá holdini (um vill djór)
жирови́к	Genжировик|а́;plur~и́, ~о́в, ~а́мm1.min.(горная порода) fitisteinurмсогл-ar2.lækn.(опухоль) feittknykilмсоглосн-s,-ar, feittvølurмсогл-s,-ir{ø/a}
жиро́вка	plurжиро́в|ки, ~ок, ~камftlm.girokort [ʃiː-]с0о, giroblankett [ʃiː-]ннкж0-ir
жирово́й	adjfeitt-; жирова́я ткань feittvevннк, feittvevnaðurнп; жирово́е яйцо́ skellegg [-tl-] (ótroðið egg) =>плавни́кI
жироприка́з	mfíggj.giroávísing [ʃiː-]ж0-ar
жироско́п	m síгироско́п
жирото́пный	adjsmelti-, bræðingar-; жирото́пный котёл lýsipottur
жиря́нка	plurжиря́н|ки, ~ок, ~камf: жиря́нка обыкнове́нная (Pinguicula vulgaris) undirløgugrasс0о{a/ø}
жите́йский	adjlívs-, verðins-ннк, veraldar-нп(жизненный); gerandis- (обыденный); vanligurглigur, almindiligur [-Ꞌmɪ-]ннкглigur(обычный); жите́йский о́пыт lívsroynd; жите́йская му́дрость verðinsklókskapur [-kʰlœʰk-]ннк, veraldarvísdómurкн.; жите́йские забо́ты gerandissorgir; жите́йский разгово́р ein samtala sum vant, ein vanlig samtala, eitt almindiligtннкprát@де́ло жите́йскоеhetta hendir so javnan, hetta kann henda øllum [œtl-]
жи́тель	míbúgviмгл-i, -búgviмгл-i; городско́й жи́тель býarfólkс0о; се́льский жи́тель bygdarmaðurмнепр, bygdarfólkс0о; жи́тели Москвы́ moskvabúgvar, fólkið í Moskva; он - жи́тель Му́рманска hann býr í Murmansk; э́тот райо́н насчи́тывает мно́го жи́телей nógv fólk býr í hesum landspartinum [lan̊s-]
жи́тельница	f síжи́тель
жи́тельство	n: ме́сто жи́тельства bústaður; ме́сто постоя́нного жи́тельства fastur bústaður; где её ме́сто жи́тельства?тжhvar býr hon?; име́ть жи́тельствогде-л.hava bústað onkustaðni,тжbúgvaнепрonkustaðni; перемени́ть ме́сто жи́тельста skiftair(t)bústað; пра́во жи́тельства loyvi at búgva (onkustaðni)@вид на жи́тельствоuppihaldsloyvi [-hal̥s-]сгл-i
житие́	Genжити|я́;plur~я́, ~и́й, ~я́мn1.gml.(жизнь) lívс0о2.kirkj.,bókm.:житие́ святы́х halgisøgaжгл-a
жи́тница	f1.gml.(амбар) kornløða [kʰɔnl-]жгл-a, korngoymsla [kʰɔnk-]жгл-a2.fl.(хлебородная область) korngoymsla [kʰɔnk-]жгл-a(um landspartar o.a. við góðum korngróðri); зернова́я жи́тница страны́ korngoymsla landsins [lan̊s-]
жи́то	ndial.(зерно) korn [-tn]с0о; hveitiжгл-i(пшеница); rugurмсогл-ar(рожь); byggс0о(ячмень)
житу́ха	fóvkm.góðalívс0о, eitt lív sum hønan í korninum [-tn-]пог.
жить	жив|у́, ~ёшь, ~у́т;pretжил, жила́, жи́ло, жи́лиipf1.(существовать,быть живым) livair(d)(að); до́лго жить liva leingi; когда́ жил Пу́шкин? nær livdi Pusjkin [pʰʊʃkɪn]?; он жил в XIX ве́ке hann livdi í 19. øld; во́роны живу́т до 40 лет ravnar kunnu blíva upp til 40 ára gamlir, ravnar kunnu liva í upp til 40 ár; жить по́лной жи́знью liva lívið; ей остаётся немно́го жить hon hevur ikki langt eftir [εʰtː-]2.(вести тот или иной образ жизни) livair(d)(að); жить сча́стливо liva lukkuliga; он уме́ет жить hann dugir at liva; он живёт хорошо́ hann livir væl3.(проживать;обитать) búgvaнепр; haldaслнe-i-itil, havaнепрtilhald (временно); livair(d)(að)(о птицах,животных и др.); где он живёт? hvar býr hann?; он там живёт с бра́том hann býr har saman við beiggja sínum,sbr.6; он до́лго жил за грани́цей hann búði leingi uttanlands; на како́й у́лице ты живёшь? hvørjari gøtu býrt tú í?; у неё есть где жить? hevur hon nakrastaðni at búgva?; э́та пти́ца живёт в А́фрике hesin fuglurin livir í Afrika; э́то расте́ние живёт в воде́ henda plantan veksur í vatni4.чем, на что(добывать себе пропитание) livar(d)(að)avo-m; жить свои́м трудо́м liva av sínum arbeiði; жить на ни́щенскую пе́нсию liva av einari neyðarsligari pensjón [-Ꞌʃɔun]; жить на 4000 крон в ме́сяц liva fyri 4000 krónur um mánaðin [mɔanan] (ред. [mɔanajɪn]); жить за счёт {на сре́дства}кого-л.livaav o-m, lataслнæ-ó-ao-nføða seg5.Ins(быть увлечённым): жить наде́ждами liva í vónini; жить нау́кой liva fyri vísindunum; жить детьми́ liva fyri børnini [-tn-] (barnanna sakir); жить мы́сльюо чём-л.verða hildinсоглоснá lívi av tankanum [tʰaŋ̊k-]um o-t6.с кем-л.(находиться в любовной связи) haldaслнe-i-isamanvið o-m, livair(d)(að)samanvið o-m(sum par),sbr.3@как (вы) живёте?hvussu hava tygum tað?; hvussu veit við?; жил да был... {жил-был}...einaferð var...;жить свои́м умо́мliva eftir [εʰtː-] sínum egna høvdi [hœtːɪ]; ему́бы жить да житьhann kundi livað leingi afturat [aˈtʰɹ-];живу́т же лю́ди!summi duga!; tað er munur á monnum! =>век@,здоро́во@,приказа́ть@,сре́дство4
житьё	ntlm.lívс0о; сла́вное тогда́ житьё бы́ло! tá var gaman at liva!кн.,поэт.; он нам житья́ не дава́л hann gjørdi okkum lívið súrt, hann plágaði [pʰlɔava] lívið av okkum; (нам) от него́ житья́ не́ было hann var ein plága [pʰlɔava] fyri okkum, hann var sum ein marra, tað var ikki livandi fyri honum;кому-л.житья́ нет (отGen) tað er ikki livandihjá[tʃʰ-]teimum(fyri Дат); житья́ нет от шу́му her er ikki livandi fyri gangi; здесь не житьё, а рай {ма́сленица} hetta er eitt paradís [pʰaː-]
житьё-бытьё	n-ntlm.líviðс0оопр., tilveranжгл-aопр.
жи́ться	живётся;жило́сьipf óptlm.1.við adv: ей живётся пло́хо hon hevur tað ringt; tað gongur illa [ɪtla] hjá [tʃʰ-] henni, tað gongst henni illa [ɪtla]; ей живётся хорошо́ hon hevur tað gott; tað gongur væl hjá [tʃʰ-] henni, tað gongst henni væl; как тебе́ живётся? hvussu hevur tú tað?; hvussu gongst?2.кому-л.,við neg: ему́ не живётся на одно́м ме́сте hann støðast ikki, hann stetas t ikkiнеформ.
ЖКО	[жэ-ка-о́]n indecl= жили́щно-коммуна́льный (sí) отде́л
ЖКХ	[жэ-ка-ха́]n indeclжили́щно-коммуна́льное хозя́йствоfyritøkur o.a.,ið veita húsarhaldum o.ø. tænastuveitingar
жлоб	Gen, Accжло́ба;plurжло́б|ы, ~ов, ~амogGen, Accжлоб|а́;plur~ы́, ~о́в, ~а́мmóvkm.,vanv.gírigt fólkс0о, nábalsklógvжнепрпренебр.
жм...	1.жмуo.s.fr. pres avжать2.жми́, жми́теimper avжать
жм...	1.жмуo.s.fr. pres avжать2.жми́, жми́теimper avжать
жмот	móvkm.gírigt fólkс0о, nábalsklógvжнепрпренебр.
жму́рик	mjarg.líkс0о
жму́рить	жму́р|ю, ~ишь, ~ятipf(pfзажму́ритьзажму́р|ю, ~ишь, ~ят): жму́рить глаза́síжму́риться
жму́риться	жму́р|юсь, ~ишься, ~ятсяipf(pfзажму́ритьсязажму́р|юсь, ~ишься, ~ятся) klípair(t)eyguni saman, krympaaðieyguni saman
жму́рки	f plur: игра́ть в жму́рки spælair(d)blindabukk
жмых	Genжмых|а́;plur~и́, ~о́в, ~а́мogGenжмы́х|а;plur~и, ~ов, ~амmfóðurkakaжгл-a, fóðurkøkaнпжгл-a; oljukakaжгл-a, oljukøkaнпжгл-a
жмя́кать	frekv síжмя́кнуть
жмя́кнуть	жмя́кн|у,~ешь, ~утpf(frekvжмя́кать)1. что-л.(уронить) dumsaaðio-t, lorkaaðio-t niður; langa [laŋka]энкaðio-tí o-t {móti o-m}2.Acc tlm.(нажать) kroystair(t)Вин
жн...	1.жнуo.s.fr. pres avжать II2.жни́, жни́теimper avжать II
жне́йка	plurжне́йки, жне́ек, жне́йкамfheystingarmaskinaжгл-a
жнец	makurskurðarmaðurмнепр
жнея́	fgml.,dial.síжни́ца
жнивьё	plurжни́вь|я, ~ев, ~ямn1.(поле) elmaжгл-a, ekraжгл-a2.síстерня́2
жни́ца	fakurskurðarkonaжгл-a
жоке́й	mjockey [tʃɔʰkːi]м0-ar{дат.0}
жоке́йский	adjjockey- [tʃɔʰkːi-]
жонглёр	mjonglørur [ʃɔŋkꞋløː-]мсогл-ar
жонгли́ровать	жонгли́ру|ю, ~ешь, ~ютipf чем-л.beinl.,fl.jonglera [ʃɔŋkꞋleː-]aðivið o-m
жо́па	ftabu!reyvж0-arвульг.@братького-л.за жо́пуtabu!taka í herðatoppiná o-m;он берёт жо́пойtabu!hann hevur tað so ikki í høvdinum [hœtː-] (um ein, sum er eitt arbeiðsgrev, men ikki verður hildin at vera vitugur);мы в жо́пеtabu!vit eru í trongum skóm, vit eru sperdir, vit eru gyrdir í brøkur;жо́па (ты) (с ру́чкой)tabu!(tú ert) ein dummur hundurбран., tín dummi hundurбран.;пошёл {иди́} в жо́пуtabu!renn meg í reyvinaвульг.
жопе́нь	plurжопе́н|и, ~ей, ~ямf óvkm., óf. síжо́па
жор	mtað at fiskur bítur væl
жох	móvkm.(скряга) natiðсоглоснfólkс0о, píriðсоглоснfólkс0о; snúiðсоглоснfólkс0о, sniltсоглfólkс0о(пройдоха)
жра́мши	síжрать
жратва́	fóvkm. maturмсогл-ir
жрать	жр|у, ~ёшь, ~ут;pretжрал, жрала́, жра́л|о, ~иipf(pfсожра́ть сожр|у́, ~ёшь, ~у́т; pret сожра́л, сожрала́, сожра́л|о, ~и)что-л.koyrair(d)o-tí seg, skræða [skɹeːa]ir(d)o-tí seg (жадно, быстро) (mest um djór);óvkm.etaслнá-ó-eo-t@не жра́мшикто-л.óvkm.o-rgongur svangur,o-rhevur ikki etið
жре́бий	m1.(условный значок) lutakastс0о{a/ø}; luturмсогл-ир; броса́ть {тянуть} жре́бий kasta lut; жре́бий пал на неё luturin fall [-tl] á hana; ему́ вы́пал жре́бий е́хать tað fall [-tl] í hansara lut at fara; по жре́бию við lutakasti; разыгра́тьчто-л.по жре́бию kastaaðilutum o-t2.gml.(доля) lagnaжгл-a, forløgс0о{a/ø}мнуст., поэт.@жре́бий бро́шенterningarnir eru kastaðir (цитируется также по-латыниjacta est alea [jaʰkta eːst aːlea]); nú má svíða sum svøllur [-tl-]пог.
жрец	Gen, Accжрец|а́;plur~ы́, ~о́в, ~а́мm(heiðin) presturмсогл-ar; offurpresturмсогл-ar(совершающий жертвонприношения)@жрецы́ нау́киgml.,hátíð.(nú oftastspott.) tænararnirмгл-ariмн опр.hjá [tʃʰ-] vísindunum
жри́ца	fprestinna [-Ꞌɪnta] ([-Ꞌɪnːa]нп)жгл-a; offurprestinna [-ɪnta] ([-ɪnːa]нп)жгл-a(совершающая жертвоприношения)
ЖСК	[жэ-эс-ка́]m indeclжили́щно-строи́тельный (sí) кооперати́в
жу...	1.жую́o.s.fr. pres avжева́ть2.жу́й, жу́йтеimper avжева́ть
жу́желица	f(сем. Carabidae) svartaklukkaжгл-a
жужжа́ние	nsurrс0о, hurrс0о; (kúlur o.a.) hvinс0о(пуль и др.); (av maðkum) tosс0о(червей); жужжа́ние мух flugusurr; жужжа́ние пря́лки rokkaduniмгл-i, hurr frá rokki
жужжа́ть	жужж|у́, ~и́шь, ~а́тipfsurraaði; hurraaði; (kúlur o.a.) hvínaслнei-i-i(пули и др.); (maðkar o.a.) tosaaði(о червях и др.)
жуи́р	mgml.lívsnjótariмгл-ari
жуи́ровать	жуи́ру|ю, ~ешь, ~ютipfgml.njótaслнey-u-olívið
жук1	IGen, Accжук|а́;plur~и́, ~о́в, ~а́мm(отряд Coleoptera) klukkaжгл-a=>колора́дский,ма́йский@,наво́зный@
жук2	IIGen, Accжук|а́;plur~и́, ~о́в, ~а́мm(плут)óvkm.,atf.skálkurмсогл-ar, snilt og listilært fólk
жула́н	m: (обыкнове́нный) жула́нsíсорокопу́т-жула́н
жу́лик	msnýtariмгл-ari, svikariмгл-ari(обманщик); [svɪnl-]энкмгл-ariнеодобр., kúllurмсогл-arнеодобр., skálkurмсогл-ar(мошенник); tjóvurмсогл-ar(вор)
жуликова́тый	stfжуликова́т, ~а, ~о, ~ыadjtlm.1.(склонный к жульничеству) fullur [-tl-]соглav sviki, sum snýtir2.(свойственный жулику) kúllaligurглigurнеодобр., beistaligurглigurнеодобр.
жу́лить	жу́л|ю, ~ишь, ~ятipf(pfсжу́лить,сжу́л|ю, ~ишь, ~ят)tlm.síжу́льничать
жульё	n koll tlm.nýtararмгл-ariмн, svikararмгл-ariмн(обманщики); [svɪnl-]энкмгл-ariмннеодобр., kúllarмсогл-arмннеодобр., skálkarмсогл-arмн(мошенники); tjóvarмсогл-arмн(вор)ы
жу́льничать	ipf(pfсжу́льничать)tlm.snýtair(t)(обманывать); svikaaði(в игре и др.); svindla [svɪnla]ннкaði(заниматься мошенничеством)
жу́льничество	nsnýtс0о; svikс0о(в игре и др.); svindilм0осн-s,-arнеодобр.
жупа́н	msøg.slag av troyggju við ongum ermum hjá ukrainarum og polakkum
жу́пел	mskrímslс0о(at ræða o-n við), grýlaжгл-а(at ræða o-n við)
журавлёнок	Gen, Accжуравлёнка;plurжуравля́т|а, ~, ~амmtranaungiмгл-i
журавли́ный	adjtrana-@журавли́ные но́гиstaraleggirмсогл-irмн
жура́вль	Gen, Accжуравл|я́;plur~и́, ~ей, ~а́мm1.djór.(Grus grus) traniмгл-i2.(шест у колодца) stongж0-ur{o/e}(at vippa vatn upp úr brunni við)@лу́чше сини́ца {сини́цу} в ру́ки, чем жура́вль {журавля́} в не́беtilt.hond er, ið hevurпог.
жури́ть	жур|ю́, ~и́шь, ~я́тipf кого-л.tlm.havaнепрꞋ ato-m, gevaслнa-ó-io-meina átalu
журна́л	m1.(периодическое издание) tíðarritс0о, blaðс0о{a/ø}; но́мер журна́ла nummar av einum blað,тжhefti av tíðarriti; журна́л мод mótablað; еженеде́льный журна́л vikublað; ежеме́сячный журна́л mánaðarblað; э́тот журна́л выхо́дит раз в две неде́ли hetta blaðið kemur út fjúrtanda hvønn dag; литерату́рный журна́л bókmentatíðarrit2.(для записей) dagbók [tak-], [tεa-]ж0-ur{ó/ø}; journalur [ʃʊɹꞋnaː-]мсогл-ar; журна́л заседа́ний gerðabókж0-ur{ó/ø}; журна́л входя́щих и исходя́щих journalur yvir út -og inngangandi post; промысло́вый журна́л veiðidagbókтжофиц.; fiskidagbók, journal [ʃʊɹꞋnaːl]ннкж0-ir; путево́й журна́л ferðadagbók =>ва́хтенный@,кла́ссный1,судово́й
журнали́ст	mjournalistur [ʃʊɹnaꞋlɪ-]мсогл-ar; tíðindamaðurмнепр; blaðmaðurмнепр(при газете,журнале)
журнали́стика	fjournalistikkur [ʃʊɹnalɪsꞋtɪʰk-]мсогл-ar; blaðstarvс0о{a/ø}(о работе в газетах,журналах)
журнали́стка	plurжурнали́ст|ки, ~ок, ~камfjournalistur [ʃʊɹnaꞋlɪ-]мсогл-ar(konufólk); tíðindakvinnaжгл-a; blaðkvinnaжгл-a(при газете,журнале)
журнали́стский	adjjournalistiskur [ʃʊɹnaꞋlɪ-]согл, tíðinda-
журна́льный	adjtíðarrit-, blað-; журна́льная ста́тья grein í tíðarriti@журна́льный сто́л {сто́лик}avísborð [-Ꞌvʊis-]
журча́ние	n1.(о воде и др.) surklс0о, tutlс0о(аv vatni o.ø.); журча́ние ручья́ tutlan av áarløki2.fl.(речь) tutlс0о(tos)
журча́ть	журч|у́, ~и́шь, ~а́тipf1.(о воде и т.п.) surklaaði, tutlaaði(um ljóð av á o.a.)2.fl.(тихо разговарывать) tutlaaði(tosa spakuliga)
жу́ткий	stfжу́ток, жутка́, жу́тко, жу́тки;compжу́тчеadj1.(тягостный) óhugnaligur [-Ꞌhuːn-]глigur, óunniligur [-Ꞌʊnː-]глigur; ræðuligurглigur(вызывающий чувство ужаса); жу́ткое зре́лище ein ræðulig sjón; жу́ткие мы́сли ræðuligur tankar2.tlm.(очень плохой,ужасный) ræðuligurглigur(nógvur;ringur); жу́ткий на́сморк eitt ræðuligt krím; жу́ткая пого́да eitt ræðuligt veður, eitt ófýsiligt [-Ꞌfʊi-] veður3.tlm.(крайний в своём проявлении) ræðuligurглigur, øgiligurглigur(sterkur,harður); жу́ткая головна́я боль ein ræðulig høvuðpína@жу́ткое де́лоtað er ræðuligt; руга́ется он - жу́ткое де́ло tað er ræðuligt, hann bannar
жу́тко	Iadv1.(кжу́ткий 1) óhugnaliga [-Ꞌhuːn-], óunniliga [-Ꞌʊnː-]2.tlm.(очень) ræðuligaIIpred1.(страшно) tað er óhugnaligt [-Ꞌhuːn-], tað er óunniligt [-Ꞌʊnː-]; в лесу́ но́чью жу́тко tað er so óhugnaligt úti í skógini um náttina, tað er so óunniligt úti í skógini um náttina; мне жу́тко в темноте́ eg ræðist í myrkri, eg unnist ikki í myrkri; ей ста́ло жу́тко hon ønskraðist við2.tlm.(очень много) ræðuliga nógv; наро́ду - жу́тко! tað er ræðuligt, tað er nógv fólk
жу́тче	comp avжу́ткий, жу́тко
жуть	If1.(чувство беспокойства,страха) óhugni [-huːnɪ]мглi; его́ жуть берёт hann ønskrast við2.tlm.: до жу́ти ræðuliga; он лени́в до жу́ти tað er ræðuligt, hann er dovin; tað er ræðuligt, so dovin hann erIIpred: (кака́я) жуть! tað er ræðuligt; грибо́в там - жуть! tað er ræðuligt, har eru nógvir svamparннк; жуть как мно́го tað er ræðuligt, tað er nógv; жуть как я уста́л! tað er ræðuligt, eg eri móður
жу́хлый	stfжухл, ~а, ~о, ~ыadj(утративший яркость) litfarinсоглосн, bliknaðurглaður; følnaðurглaður(утративший свежесть); жу́хлая трава́ avfallið [-tlɪ]соглоснgras, følnað gras; upptornaður [-tn-]глaður(высохший); rukkuturсогл(морщистый,мятый)
жу́хнуть	жу́хн|ет, ~ут;pretжу́хнулo.s.fr.ogжух, ~ла, ~ло, ~лиipf(pfзажу́хнутьзажу́хн|ет, ~ут; pret зажу́хнул o.s.fr.ogзажу́х, ~ла, ~ло, ~ли;пожу́хнутьпожу́хн|ет, ~ут; pret пожу́хнул o.s.fr.ogпожу́х, ~ла, ~ло, ~ли) (тускнеть) litfarastслнó-ó-a, bliknaaði; følnaaði, falla [-tla]слнa-u-aꞋ av (утрачивать свежесть); torna [-tna]aðiupp, skorpna [skɔʂna]aði(сохнуть)
жу́чить	жу́ч|у, ~ишь, ~атipf кого-л.óvkm.lærair(d)upp á o-n(поучать); illkennair(d)o-n, knarraaðiinn á o-n(донимать)
жу́чка	plurжу́ч|ки, ~ек, ~камftlm.hundur bundin í garði(kemur av tí vanliga hundanavninumЖу́чка)
жучо́к1	Iplur~и́, ~о́в, ~а́мm1.Gen, Acc жучка́ dim avжук2.Gen, Acc жучка́(насекомое)felagsheiti fyrifýr, húsbukko.a.; ме́бель с жучко́м møblar, sum eru etnir av fýri3.Gen жучка́tlm.(в электрических пробках)heimagjørd elektrisk sikkring4.Gen жучка́tlm.(послушивающее устройство) fjald mikrofon [-Ꞌfoːn]ж0o-ir
жучо́к2	IIGen, Accжучк|а́;plur~и́, ~о́в, ~а́мmtlm.(ловкий делец) besnissaður [-Ꞌsnɪ-]глaðurнеформ.forrætningsmaður [-Ꞌraʰt-]мнепр
жэк	[жэк]м indeclжили́щно-эксплуатацио́нная (sí) конто́ра
жюри́	n indecldómsnevndж0-ir
