ф	1.ферзь frúgv, drotning (í talvi)2.фара́да F farad [faː-]
ф.	1.фунт pund2.фут fótur (mál)
фа	n indeclmus.f {F} [εfː-]с0о; фа мино́р f-moll [εfmɔlː]
фаб...	фабри́чный
фабзавко́м	mфабри́чно-заводско́й комите́тsovjet.fakfelagsstjórn [faːkfeːlaʰkstjœtn] (á fyritøku)
фабко́м	mфабри́чный комите́тsovjet.síфабзавко́м
фа́брика	f(завод) fabrikk [-Ꞌpɹɪʰkː]ннкж0-ir, verksmiðjaнпжгл-a(einamest í løttum ídnaði); fabrikk [-Ꞌpɹɪʰkː]ж0-irпроф., verksmiðjaнпжгл-a(á skipi) (на рыболовном судне); пряди́льная фа́брика spinnarí [-Ꞌrʊi]ннкс0о, spunavirkiнпсгл-i=>тка́цкий,шве́йный
фабрика́нт	mfabrikantur [-Ꞌkʰa-]ннкмсогл-ar, verksmiðjueigariнпмгл-ari
фабрика́т	mídnaðarvøraжгл-a
фабрика́ция	f1.(производство) framleiðslaжгл-a2.fl.(что-л. ложное) uppspuniмгл-i
фабрикова́ть	фабрику́|ю, ~ешь, ~ютipf что-л.1.gml.(изготовлять) framleiðair(d)o-t(á verksmiðju), fabrikera [-Ꞌkʰeː-]ннкaðio-t2.pfсфабрикова́тьсфабрику́|ю, ~ешь, ~ютspott.(создавать что-л. ложное) spinnaслнa-u-uo-tupp, finnaслнa-u-uupp áo-t; фабрикова́ть слу́хиeis.loypair(t)o-tút í Ꞌ orðидиом.
фа́брить	фа́бр|ю, ~ишь, ~ятipf(pfнафабритьнафа́бр|ю, ~ишь, ~ят)что-л.gml.(красить) litaaðio-t, farvaннкaðio-t(skegg,yvirskegg); (мазать воском) voksaaðio-t, smyrjaнепрo-tvið voksi (yvirskegg)
фабри́чно-заводско́й	adjvirkis-; verksmiðju-; фабри́чно-заводско́е предприя́тие ídnaðarfyritøka =>учени́чество@,ФЗО
фабри́чный	adjverksmiðju-нп, fabriks- [-Ꞌpɹɪ-]ннктжпроф.; ковры́ фабри́чного произво́дства teppir framleidd á verksmiðjuнп; фабри́чная цена́ prísur av verksmiðjuнп; фабри́чная ма́рка vørumerki
фа́була	fbókm.handling [hanl-]ннкж0-ar, plot [pʰlɔʰtː]с0опроф.,спец.
фавн	mmyt.faunur [faun-]мсогл-ar
Фаво́р1	Im bíbl.Tabor [tʰaːpoɹ]с нескл
фаво́р2	IImbókl.: быть в фаво́реу кого-л.standaслнó-ó-aí mætihjá[tʃʰ-]o-mкн.; vera væl umtókturсоглav o-m, vera væl dámdurсоглav o-m; быть не в фаво́реу кого-л.vera illa [ɪtla] dámdurсоглav o-m
фавори́т	m1.(любимец) elskulingurмсогл-ar; favorittur [faːvoꞋrɪ-]ннкмсогл-ar2.gml.(любовник) elskariмгл-ari3.ítr.(в скачках и т.п.) favorittur [faːvoꞋrɪ-]мсогл-arспорт.(í kappríðing o.tíl.)
фавори́тка	plurфавори́т|ки, ~ок, ~камf1.(любимица) elskulingurмсогл-ar(konufólk); favorittur [faːvoꞋrɪ-]ннкмсогл-arспорт.(í kappríðing o.a. - konufólk)2.gml.(любовница) elskarinda [-Ꞌi-]жгл-a3.ítr.(в скачках и т.) favorittur [faːvoꞋrɪ-]мсогл-arспорт.(konufólk)
фаго́т	mfagott [-Ꞌkɔʰtː]ж0-ir
фаготи́ст	mfagottistur [faːkoꞋtʰɪ-]мсогл-ar, fagottspælari [-Ꞌkɔ-]мгл-ari, fagottleikari [-Ꞌkɔ-]нпмгл-ari
фагоци́т	mfagocyttur [faːkoꞋsʏʰtː-]мсогл-arпроф., átukyknaлпжгл-a
фагоцито́з	mfagocytosa [faːkosyꞋtʰoː-]жгл-aпроф., kyknuátлпс0о
фа́за	f1.(период) (tíðar)skeiðс0о; stigс0о{0<>i}, fasa [faː-]ннкжгл-a(стадия); фа́за луны́ (kvartal)skiftiсгл-i, mánafasa [-faː-]ннкжгл-a; во всех фа́зах разви́тия á øllum [œtl-] menningarstigumнп, í øllum [œtl-] fasumннкav útvikklingiннк; в после́дней фа́зечего-л.á síðsta stigiav o-m, seinastí o-m2.el.(электрическая) fasa [faː-]жгл-a
фаза́н	m(Phasianus) fasanur [-Ꞌsaː-]мсогл-ar, fasánur [-Ꞌsɔa-]лпмсогл-ar
фаза́новый	adjfasan- [-Ꞌsaːn-]
фазе́нда	[-зэ́-]f1.(имение) fazenda [-Ꞌsε-]жгл-a(;0-ir)(stórur garður,góðs,í Brasilia og Portugal)2.tlm.,skemt.(дача) summarhúsс0о, frítíðarhúsс0оá bygd
фа́зис	mbókl.síфа́за
фа́зный	adjfasu- [faː-]; фа́зное напряже́ние fasuspenningur
...фа́зный	í samans-fasaður [faː-]; трёхфа́зный trífasaður
фа́зовый	adjfasu- [faː-]
фа́йер	m teld., jarg.firewall [faijεɹvɔˑl]м нескл комп.
файл	mteld.fílaжгл-a, fílurмсогл-ar, fílж0-ir
фа́йловый	adjfílu-, fíl-, file- [fail-],síфайл
файл-се́рвер	(eis.[-сэ́-])m teld.fíluservariмгл-atiкомп., проф.
...фак	í samansфакульте́т fakultet [-Ꞌtʰeːt], megindeildлп; юрфа́к juridiskt [-Ꞌriːt-] fakultetпроф., løgfrøðilig megindeildлп
фак.	факульте́т
фа́кел	m1.(светильник) kyndilм0осн-s,-ar, fakkulннкм0осн-s,-ar2.(пламя) flammaжгл-a(í ketli,oljufýri o.tíl.)3.astr.(на солнце) sólarkyndilм0осн-s,-ar
фа́кельный	adjkyndla-[tʃʰɪnla-];фа́кельное ше́ствие kyndlagonga
фа́кельщик	m1.(факелоносец) kyndlaberari [tʃʰɪnla-]мгл-ari2.(поджигатель)o-r, ið setur eld á við kyndli [tʃʰɪnlɪ]
факи́р	mfakirur [-Ꞌkʰiː-]мсогл-ar
факс	m síтелефа́кс
факс-аппара́т	mtelefax [-faʰks] {telefaks}с0о, fax [faʰks] {faks}с0о(apparat)
факсаппара́т	m síфакс-аппара́т
факси́миле	In indeclljósprentс0о, faksimile [-Ꞌsiːmilε]с нескл.проф.IIadjljósprentaðurглaður, í faksimile [-Ꞌsiːmilε]проф.; ру́копись факси́миле ljósprentað handrit [hanɹ-], handrit [hanɹ-] givið út í faksimileпроф.IIIadví ljósprenti, í faksimile [-Ꞌsiːmilε]проф.; изда́ть факси́миле geva út í ljósprenti, geva út í faksimileпроф.
факси́мильный	adj: факси́мильное изда́ние ljósprentс0о, faksimile [-Ꞌsiːmilε]с нескл.проф., faksimileútgáva [-Ꞌsiːmilε-]проф.
факс-маши́на	ftelefax [-faʰks]{telefaks}с0о, fax [faʰks] {faks}с0о(apparat)
факс-моде́м	[-дэ́м]mfaxmodem [faʰks-] {faksmodem}с0о{0<>ir}
факсова́ть	факсу́|ю, ~ешь, ~ютipf что-л.sendair(d)o-t sum fax [faʰks] {faks},faxa[faʰksa] {faksa}aðio-t
факт	Imfaktumс0о{+}, kensgerningurннкмсогл-ar, sannroyndж0-ir; доказа́тьчто-л.на фа́ктах prógva okkurt við fakta; фа́кты говоря́т за себя́ fakta tala fyri seg sjálvi, kensgerningarnirннкtala fyri seg sjálvar; печа́льно, но факт tað er syrgiligt, men satt; невероя́тно, но факт tað er ótrúligt [-Ꞌtʰɹʉu-], men sannheitннк; остаётся фа́ктом, что ... tað stendur fast, at ...; tað svitast ikki, at...; tað umrindast ikki, at ...кн.; ста́витького-л.пе́ред сверши́вшимся фа́ктом stilla [-tla]o-nframman fyri einum fait accompli [fεʰtakʰɔm̊Ꞌpʰliː]ннкпубл.; э́то факт! tað passar!неформ.; tað er heilt pálítiligt [-Ꞌlʊi-]энк!IIpredфакт , что ... (действительно, верно) tað er royndur lutur, at ...; tað svitast ikki, at ...; факт, что кома́нда выи́грывает tað er einki at taka seg aftur [aʰtː-] í, at liðið er við at vinna; tað er sikkurtннк, at liðið er við at vinna; факт тот, что ... (дело в том,что) tað, sum er ...или не переводится/ella verður ikki umsett; факт тот, что вре́мени оста́лось ма́ло lítil tíð var eftir [εʰtː-]@фактparentóvkm.tað er heilt sikkurtннк, tað er heilt vist; он, факт, не придёт tað er heilt sikkurtннк, hann ikki kemur;фактpartóvkm.jú, неуже́ли действи́тельно е́дет? - факт! álvara, kemur hann? - ja!
факти́ческий	adjfaktiskurннксоглsk; veruligurглigur, virkuligurннкглigur(действительный); факти́ческие да́нные faktiskarннкupplýsingar; факти́ческое положе́ние tann veruliga støðan, tey faktiskuннкviðurskiftini; факти́ческая сто́имость realvirði [-Ꞌaː-]
факти́чный	stfфакти́ч|ен, ~на, ~но, ~ныadj bókl.faktuellur[-ˈεlˑ-]интсогл, samsvarandiглandifaktaннк
фактогра́фия	fbókl. faktuell [-ˈεlː]интlýsingЖ0-ar
фа́ктор	mfaktorur [-Ꞌtʰoː-]ннкмсогл-arпубл.; фа́ктор вре́мени tíðarfaktorurinннкпубл.; уче́сть все фа́кторы, игра́ющие роль rokna við øllum [œtl-] faktorumннкпубл., sum spæla inn
фа́кторинг	mfactoring [faʰkt-]ж0-ar, lánс0оupp á faktura [-ˈtʰuː-]торг., спец.
фа́кторинговый	adjfactoring- [faʰkt-]торг., спец.
факто́рия	fgml.handilsstøðж0-ir
факту́ра1	If(накладная) faktura [-Ꞌtʰuː-]жгл-a(;0-ir), fakturi [-Ꞌtʰuː-]мгл-i; предвари́тельная факту́ра proformafaktura [-Ꞌfɔ-] =>профо́рма@
факту́ра2	IIf1.(отделка) hagreiðing [hak-]ж0-arav tilfari, yvirflatuviðgerð [vɪtʃ-]ж0-ir(поверхности); strukturur [-Ꞌtʰuː-]ннкмсогл-arпроф.(í yvirflatu)2.list,bókm.(художественное своеобразие) strukturur [-Ꞌtʰuː-]ннкмсогл-arпроф., teksturur [-Ꞌtʰuː-]мсогл-arспец., tilgerðж0-ir(оформление); skapс0о{a/ø}(форма)3.fl.(внешние данные)útsjónd [ʏʰt-]ж0-ir(yvirbragd, likamsburður o.a. á fólki)
факту́рный1	If(кфакту́ра I) faktura- [-ˈtʰuː-]
факту́рный2	IIstfфакту́р|ен, ~на, ~но, ~ныadj1.(кфакту́ра (() struktur- [-Ꞌtʰuːɹ-]ннк, tekstur-[-Ꞌtʰuːɹ-]м спец, yvriflatu-, í skapi2.(характеризуемый ярко выраженной фактурпй) sermerkturсогл(í skapi o.ø.), eyðkendur (εʰtʃ-íсогл(í skapi o.ø.)
факультати́в	mtlm.vallærugreinж0-ar;0-ir
факультати́вный	stfфакультати́в|ен, ~на, ~но, ~ныadjikki kravdurсогл, valfríurгл; факультати́вные предме́ты vallærugreinar
факульте́т	mfakultet [-Ꞌtʰeːt]с0о, megindeildлпж0-ir(á universiteti o.ø.); учи́ться на юриди́ческом факульте́те lesa jura, lesa til sakføraraнеформ.=>медици́нский
факульте́тский	adjfakultets- [-Ꞌtʰeː-], megindeildar-лп
фал	mfallс0о(на кораблях), dragс0о{a/ø}(ос. на фар. лодке)
фала́нга1	If1.søg.(строй пехоты) falanks [-Ꞌlaŋ̊ks]ж0-ir(herfylking í gamla Grikkalandi)2.(партия) falangistaflokkur [-Ꞌkɪ-]мсогл-ar
фала́нга2	IIfanat.fingrabeinс0о, kongurмсогл-ar
фала́нга3	IIIfdjór.(отряд Solifugae)hópur av liðdjórum(en.solifugae; da.solifuger)
фаланги́ст	mfalangistur [-Ꞌkɪ-]мсогл-ar
фа́лда	f1.(сюртука,фрака и т.п.) velс0о(á klæðum)2.(складка) lekс0о(на одежде,шторах и т.д.)
фа́линь	mfanglínaжгл-a
фалли́ческий	adjfalliskurсоглsk
фаллоимита́тор	mdildoж0-ir,мгл-гл
фалло́пиев	adj: фалло́пиева труба́anat.eggjaleiðariннкмгл-ariпроф., egggørn [-tn]лпж0-ar{ø/a}
фа́ллос	m bókl.fallosм0-arкн.
фалре́п	m skip.gelendari [keꞋlε-]мгл-ari(av tog,á landgangi o.tíl.)
фальсифика́т	mfalsumинтс0o({0<>i}), forfalsking [-Ꞌfa-]ннкж0-ar
фальсифика́тор	mforfalskari [-Ꞌfa-]ннкмгл-ari, falsariнпмгл-ari; фальсифика́торы исто́рии søguforfalskararннк, søgufalsararнп
фальсифика́ция	f1.(действие) forfalsking [-Ꞌfa-]ннкж0-ar, falsanнпж0-ir2.(что-то подделанное) forfalsking [-Ꞌfa-]ннкж0-ar, falsumинтс0o({0<>i}),o-tfalsaðнп
фальсифици́ровать	фальсифици́ру|ю, ~ешь, ~ютipf/pf что-л.forfalska [-Ꞌfa-]ннкaðio-t, falsaнпaðio-t
фальста́рт	mtjóvstarturмсогл-ar; взять фальста́рт tjóvstartaaða
фальц	m1.tekn.(выемка) notж0-ir2.tekn.(шов) falsurмсогл-ar3.prent.(место сгиба) brotс0о, falsurмсогл-ar
фальцева́льный	adjfalsi-; фальцева́льная маши́на falsimaskina
фальцева́ть	фальцу́|ю, ~ешь, ~ютipf(pfсфальцева́тьсфальцу́|ю, ~ешь, ~ют)что-л.tekn.,prent.falsaaðio-t
фальце́т	mfalsett [-Ꞌsεʰtː]ж0-ir; петь фальце́том syngja falsett
фальцо́вка	plurфальцо́в|ки, ~ок, ~камftekn.,prent.falsingж0-ar
фальцо́вщик	mtekn., prent.falsariмгл-ari
фальшбо́рт	mskansaklædningurмсогл-arмор.
фальши́вить	фальши́в|лю, ~ишь, ~ятipf(pfсфальши́витьсфальши́в|лю, ~ишь, ~ят)1.(быть неискренним) vera falskurсогл{a/ø}, hyklaaði2.(производить фальшивые звуки) syngjaслнa-u-ufalskt [fal̥st] (при пении); spælair(d)falskt [fal̥st] (при игре)
фальши́вка	plurфальши́в|ки, ~ок, ~камftlm.falsað skjalс0o{a/ø}, falsaður teksturмсогл-s,-ir, falsumинтс0o(skjal, tekstur), forfalsking [-Ꞌfa-]ннкж0-ar(skjal,tekstur)
фальшивомоне́тчик	mfalskmyntariннкмгл-ari, pengafalsariмгл-ari
фальши́вый	stfфальши́в, ~а, ~о, ~ыadj1.(поддельный) falskurсоглsk{a/ø}; фальши́вые де́ньги falskir pengar; фальши́вые зу́бы forlornar [-Ꞌlɔɹ-]ннкtenn, handilstennкн.,уст.2.(неискренний) falskurсоглsk{a/ø}; tilgjørdurсогл(искусственный); фальши́вая улы́бка falskt [fal̥st] smíl3.(в музыке) falskurсоглsk{a/ø}; фальши́вая но́та falskur tóni@фальши́вое положе́ниеtvítýdd støðaкн.;фальши́вая ма́чтаneyðmastur
фальшки́ль	mstrákjølurмсогл-ir{ø/a}{+};согл-s,-ir;согл-arkjøldragс0о{a/ø}{0<>i}(б.ч. на фар. лодке и т.п.)
фальшь	ffalskheitж0-ir; hyklarí [hʏʰklaꞋrʊi]ннкс0о, hyklс0о(лицемерие); kávalótirж0-irмн(притворство)
фами́лия	f1.(семейное нименование) eftirnavn [εʰtː-]с0о{a/ø}; как ва́ша фами́лия? hvussu eita tygum til eftirnavn?2.(род) ættж0-ir, slektж0-ir3.gml.(семья) familja [-Ꞌmɪ-]жгл-a=>деви́чий@,и́мя1,смени́ть1,спроси́ть1
фами́льный	adjfamilju- [-Ꞌmɪ-], ættar-; фами́льная черта́ ættarbregði [-pɹeːjɪ]сгл-i; фами́льное схо́дство familjulíkheit; фами́льный портре́т familjumynd
фамилья́рничать	ipf с кем-л.geraнепрsær dæltvið o-nкн., veraслнa-ó-e(ov [ɔ]) familjerur [-Ꞌjeː-]ннксоглvið o-n
фамилья́рность	ffamiliaritetur [-Ꞌtʰeː-]ннк, tað at gera sær dælt (við o-n)кн.; framligheitж0-ir(бесцеремонность)
фамилья́рный	stfфамилья́р|ен, ~на, ~но, ~ныadjfamilierur [-Ꞌjeː-]согл; framligurглigur(бесцеремонный)
фан	mjarg.fan [fanː]м0-ar (опр-ur){+}неформ., fjeppariмгл-ari
фанабе́рия	fgml.,tlm.stóraktigheit [-Ꞌa-]энкж0-ir, errinskapurмсогл-ar(заносчивость); arrogansa [-Ꞌka-]ннкжгл-a(надменность); snobbс0о, snobbarí [-Ꞌrʊi]с0о(снобизм)
фана́т	mtlm. fan [fanː]м0-ar(опр-ur){+}неформ., fjeppariмгл-ari
фанати́зм	mfanatisma [-naꞋtʰɪ-]жгл-a
фана́тик	mfanatikari [-Ꞌnaː-]мгл-ari
фанати́ческий	adjfanatiskur [-Ꞌnaː-]соглsk
фанати́чка	plurфанати́ч|ки, ~ек, ~камffanatikari [-Ꞌnaː-]мгл-ari(konufólk)
фанати́чный	adjfanatiskur [-Ꞌnaː-]соглsk
фана́тка	plurфана́т|ки, ~ок, ~камf tlm.fan [fanː]м0-ar(опр-ur){+}неформ., fjeppariмгл-ari(konufólk)
фана́тский	adjtlm. fan- [fanː-]неформ.,fjeppara-
фан-брига́да	ffanbólkurмсогл-arнеформ.. fjepparabólkurмсогл-ar(lokalur)
фан-гру́ппа	ffanbólkurмсогл-arнеформ.. fjepparabólkurмсогл-ar
фан-группиро́вка	plurфан-группиро́в|ки, ~ок, ~камffanbólkurмсогл-arнеформ.. fjepparabólkurмсогл-ar(lokalur)
фан-движе́ние	nfjeppararørsla жгл-a
фане́ра	f1.(тонкая пластинка дерева) finer [-Ꞌneːɹ]с0о2.(клеёная) krússfiner [-neːɹ]с0о, krossviðurлпмсогл-ir
фане́рный	adjkrússfiner- [-neːɹ], úr krússfineri [-neːɹ]
фанерова́ть	фанеру́|ю, ~ешь, ~ютipf/pf что-л.klæðair(d)o-tvið fineri [-Ꞌneː-]
фа́нза	f1.(изба) bóndahúsс0о(í Kina og Korea)2.argot(дом) húsс0о
фанк	mfunk [fɔɲ̊k]с0о{0<>i}муз.
фанк...	funk- [fɔŋ̊k-]
фанк-бе́нд	[-бэ́-]m síфанк-бэ́нд
фанк-бэ́нд	mfunkbólkur [fɔŋ̊k-]мсогл-ar
фанк-гру́ппа	ffunkbólkur [fɔŋ̊k-]мсогл-ar
фанк-коллекти́в	mfunkbólkur [fɔŋ̊k-]мсогл-ar
фанк-компози́ция	f funkkompositión [fɔŋ̊kkʰɔmpʰoːsiʃɔʊn]ж0-ir, kompositión [ˈ-ʃɔʊn]ж0-irí funkstíli [fɔŋ̊k-]
фан-клу́б	mstuðulsfelagс0о{a/ø}{0<>i}
фанк-ро́к	mfunk-rokkur [fɔŋ̊k-] {funk-rockur [fɔŋ̊krɔʰkː-]}мсогл-ar
фан-са́йт	mstuðulssíðaжгл-a
фан-се́ктор	mpartur av stadion og øðrum, har fjepparar sita
фант	mgml.1.plur(игра) pantspælс0о{æ/ø}; игра́ть в фа́нты spæla pantspæl; игра́ в фа́нты pantspæl2.(предмет) pantс0о(í pantspæli)3.(задание) uppgávaжгл-a(sum luttakari í pantspæli fær)
фантазёр	msveimariмгл-ari; droymariмгл-ari(мечтатель); fantastur [-Ꞌtʰa-]интмсогл-ar(далеко от действительности)
фантазёрка	plurфантазёр|ки, ~ок, ~камfsveimariмгл-ari; droymariмгл-ari(мечтатель); fantastur [-Ꞌtʰa-]интмсогл-ar(konufólk)
фа́нтази	n indecl síфэ́нтази
фантази́ровать	фантази́ру|ю, ~ешь, ~ютipf(pf сфантази́рватьсфантази́ру|ю, ~ешь, ~ют)1.(предаваться фантазиям) fantasera [-Ꞌseː-]ннкaði; droymair(d)(мечтать), dagdroymair(d)(грезить)2.pfсфантази́роватьсфантази́ру|ю, ~ешь, ~ют(о Prp)tlm.(выдумывать) spinnaслнa-u-u(о-t) í (um Вин), pentaaði(о-t) saman (um Вин), bjóraaði(о-t) saman (um Вин)3.mus.(о музыкальном произведении) fantasera [-Ꞌseː-]aðiмуз., improvisera [-Ꞌseː-]aðiмуз.
фанта́зия	f1.((способность воображения) fantasiur [-Ꞌsiː-]ннкмсогл-s,-ir, fantasi [-Ꞌsiː-]ннкж0-ir; hugflogс0о{0<>i}; бога́тая фанта́зия lívligur fantasiurннк, hugflog; лишённый фанта́зии fantasileysur [-Ꞌsiː-]ннк, uttan fantasiннк;тжturrgeldurсоглпренебр.; дать во́лю фанта́зии geva fantasiinumннкleysar teymar2.(мечта) dreymurмсогл-ar, dagdreymurмсогл-ar(грёза); предава́ться фанта́зиямsíфантази́ровать13.(нечто надуманное) heilaspuniмгл-i, fantasi [-Ꞌsiː-]ннк, fantasiur [-Ꞌsiː-]ннкмсогл-s,-ir; плод фанта́зии heilaspuni, fantasifostur [-Ꞌsiː-]ннкс0осн4.(прихоть) grillaннкжгл-a, lúnurжгл-aмн, ríggjurжгл-aмн; что за фанта́зия пришла́ тебе́ в го́лову!eis.hvat er tað, sum er stungist upp á teg!; hvat er tað, sum er skotist upp á teg!5.mus.(музыкалльное произведение) fantasi [-Ꞌsiː-]ж0-irмуз.
фантасмаго́рия	ffantasifostur [-Ꞌsi-]ннкс0осн, heilaspuniсгл-i; yvirsjónж0-ir(галлюцинация)
фанта́ст	m1.(человек с богатой фантазией) fantastur [-Ꞌtʰa-]интмсогл-ar; droymariмгл-ari, sveimariмгл-ari(мечтатель)2.(писатель) høvundurмсогл-arat science-fiction [saiεn̊sꞋfɪʰkʃɔn],síфанта́стика
фанта́стика	f1.(представления,образы) fantasi [-Ꞌsiː-]ннкж0-ir(o-t íspunnið o.tíl.)2.koll(литературные произведения) fantastiskar [-Ꞌtʰa-] bókmentirж0-irмн, fantasy [-siː]с нескл.; нау́чная фанта́стика science fiction [saiεn̊sꞋfɪʰkʃɔn]ннкж0-irпроф., vísindaskaldskapur [-skalsk-]лпмсогл-ir3.fl.: э́то про́сто фанта́стика tað er heilt fantastiskt [-Ꞌtʰa-]энк,tað er heilt ótrúligt [-Ꞌtʰɹʉu-]
фантасти́чески	advfantastiska [-Ꞌtʰa-]ннк; фантасти́чески бога́тый fantastiskaннкríkur
фантасти́ческий	adj1.(проникнутый фантастикой) fantastiskur [-Ꞌtʰa-]соглsk(um bókmentir o.a.),síфанта́стика2.(похожий на фантазию) fantasi- [-Ꞌsiː-]ннк3.(невероятный) ótrúligur [-Ꞌtʰɹʉu-]глigur, fantastiskur [-Ꞌtʰa-]ннксоглsk4.tlm.(исключительный) einastandandi [-Ꞌsta-], einastandandi [-Ꞌsta-] +пол., sjáldsama [ʃɔl̥s-] +пол., fantastiska [-Ꞌtʰa-]ннк+пол.
фантасти́чный	stfфантасти́ч|ен, ~на, ~но, ~ныadj síфантасти́ческий
фа́нтик	m1.síфант22.tlm.(обёртка) bommpappírс0о(brúkt í spæli)
фанто́м	m1.bókl.(привидение) fantom [-Ꞌtʰoːm]интс0оред.; dreygurмсогл-ar, hamurмсогл-s,-ir, spøkilsiсгл-i(призрак)2.lækn.(модель тела) fantom [-Ꞌtʰoːm]с0омед.
фанфа́ра	f1.(инструмент) trompet [-Ꞌpʰeːt]ж0-ir2.(сигнал) fanfara [-Ꞌfaːɹa]жгл-a
фанфаро́н	mtlm.gabbс0о, gabbariмгл-ari, skrøggariмгл-ari
фанфаро́нство	ntlm.gabbс0о, skrøggс0
ФАО	[фа́о]f indeclПродово́льственная и сельскохозя́йственная организа́цияя ООН FAO [faːo]с нескл., Food and Agricultural Organization of the United Nationsангл., Matvøru-og landbúnaðarfelagsskapur [lanp-] ST
ФАПСИ́	nФедера́льное аге́нтство прави́тельственной свя́зи и информа́ции при Президе́нте Росси́йской Федера́ции Stjórnarnevndin [stjœtn-] fyri samskifti og kunning hjá forsetanum í Russisкka Sambandsríkinum [-pan̊s-]
ФАР	[фар]n indeclФедера́льное аге́нтство (sí) по рыболо́вству
фа́ра	f(bil)lyktж0-ir
Фара́д	m indecl(styttФ) Farad [-ˈradː]жнескл(сокр.F)
Фара́да	f síФара́д
фарао́н1	Im1.søg.(египетский монарх) farao [faː-]м0-ar{дат.0}(режеfáraoм0-ar{дат.0})2.vanv.(полицейский) politimaður [-ˈtiː-]мнепр
фарао́н2	IImfaraospæl [faː-]с0{æ/ø}(kortspæl)
фарва́тер	[-тэр]mfarvatn [faɹ-]с0о{a/ø}@быть {плыть} в фарва́теречего-л.fl.eltair(t)o-tперен.,sigla í kjalarvørrinumá o-mперен.
Фарве́ль	[-вэ́-]mKappinмгл-iопр.мор., Hvarviðсгл-iопр.кн.
Фаренге́йт	[-ре-] og [-рэ]m: 200опо Фаренге́йту 200 stig Fahrenheit [faːɹɪnhait], 200 gradir [-aː-]ннкпроф.Fahrenheit [faːɹɪnhait]
фаре́рец	[-рэ́р-]Gen, Accфаре́рц|а;plur~ы, ~ев, ~амmføroyingur [føːɹɪŋk-]мсогл-ar
фаре́рка	[-рэ́-]plurфаре́р|ки, ~ок, ~камfføroyingur [føːɹɪŋk-]мсогл-ar(konufólk);она́ фаре́ркатжhon er føroysk [føːɹɪsk], hon er úr Føroyum [fœɹjʊn]
Фаре́ро-Шетла́ндский кана́л	[-рэ́-]síФаре́рско-Шетла́ндскийкана́л
Фаре́рская ба́нка	[-рэ́-] Føroyabanki [fœɹjapaɲ̊tʃɪ]мгл-i(grynna) =>жёлоб@
Фаре́рские острова́	[-рэ́-] Føroyar [fœɹjaɹ]ж0-arмн; на Фаре́рские острова́ til Føroyar [fœɹjaɹ], til Føroya [fœɹja]кн.; на Фаре́рских острова́х í Føroyum [fœɹjʊn]; с Фаре́рских острово́в úr Føroyum [fœɹjʊn] (об отходе судна и др. тжfrá Føroyum [fœɹjʊn]мор.,спец.); догово́р был заключён ме́жду Росси́ей и Фаре́рскими острова́ми ein avtala varð gjørd millum [-tl-] Russland og Føroyar
фаре́рский	[-рэ́-]adjføroyskur [føːɹɪsk-]соглsk; фаре́рский язы́к føroyskt [føːɹɪst]сприлskt; на фаре́рском языке́ á føroyskum =>ФЭЗ
Фаре́рско-Шетла́ндский кана́л	[-рэ́-] Hetlandsrennan [-lan̊s-]жгл-aопр.
Фаре́ры1	[-рэ́-] If plurtlm.Føroyar [fœɹjaɹ]ж0-arмн; на Фаре́ры til Føroyar [fœɹjaɹ], til Føroya [fœɹja]кн.; на Фаре́рах í Føroyum [fœɹjʊn]; с Фаре́р úr Føroyum [fœɹjʊn] (об отходе судна и др. тжfrá Føroyum [fœɹjʊn]мор.,спец.)
Фаре́ры2	[-рэ́-] IIm plurtlm.síФаре́рыI
фаринги́т	mhálsbruniнпмгл-i, hálsbtendilsiннксгл-i
фарисе́й	m1.bíbl.(представитель религиозной группы) fariseari [faːɹɪꞋseː-]мгл-ari2.fl.(лицемер) fariseari [faːɹɪꞋseː-]мгл-ari, hyklari ([hʏʰkl-]ннк), [hiː-]мгл-ari(ханжа)
фарисе́йский	adj1.(кфарисе́й 1) fariseiskur [faːɹiꞋseː-]соглsk,síфарисе́й12.fl.(лицемерный,жанжеский) fariseiskur [faːɹiꞋseː-]соглsk, skinhelligur [ʃɪnꞋhεlː-]энкглigur
фарисе́йство	n1.(учение)læran hjá farisearum,síфарисе́й12.fl.(лицемерие, ханжество) hyklarí [hʏʰklaꞋrʊi]ннкс0о{0<>i}, hyklс0о, skinnhelligheit [ʃɪnꞋhεlː-]энкж0-ir(ханжество), fariseisma [faːɹɪseːꞋɪ-]жгл-a
фармако́лог	mfarmakologur [-Ꞌloːk-]мсогл-ar
фармакологи́ческий	adjfarmakologiskur [-Ꞌloːk-]соглsk
фармаколо́гия	ffarmakologi [-Ꞌkiː]ж0-ir, heiliráðfrøðiлпжгл-i
фармакопе́я	ffarmakopé [-Ꞌpʰeː]ж0-irспец.
фармаце́вт	ffarmaceutur {farmaseutur} [-Ꞌsœut-]мсогл-ar
фармаце́втика	ffarmaci {farmasi} [-Ꞌsiː-]ж0-ir
фармацевти́ческий	adjfarmaceutiskur {farmaseutiskur} [-Ꞌsœu-]соглsk;фармацевти́ческий препара́т farmaceutiskt preparat [-ˑraˑt]
фармаци́я	ffarmaci {farmasi} [-Ꞌsiː-]ж0-ir
фармпрепара́т	m síфармацевти́ческий, препара́т
фарс	msjónl.,fl.farsaннкжгл-a, glantrileikurмсогл-s,-ir
фарси́	m indecl síперси́дскийязы́к
фарт	móvkm.lukkaжгл-a(счастье), heldннкс0о(удача)
фарти́ть	фарти́тipf(pfподфарти́тьподфарти́т, пофарти́тьпофарти́т)ópóvkm.:ему́ фарти́т hann er heldigurннкглigur, hann er heppinнпсоглосн
фарто́вый	adjóvkm.1.(удачливый) heldigurннкглigur, heppinсоглоснкн.2.(очень хороший) frálíkurсогл, óførurсогл
фа́ртук	m1.(передник) fyriklæðiсгл-i(тж[fɪɹkla][fɪɹklεa]сгл{a/ø}{0<>i); svintaжгл-a(из более грубого материала для грязной работы)2.(трала) slitmáttaжгл-a(á troli)
фарфо́р	m1.(материал) porcelen {porselen}[-Ꞌleːn]с0o, postalín [-Ꞌlʊin]нпс0o2.koll(изделия) porcelen {porselen}[-Ꞌleːn]с0o, postalín [-Ꞌlʊin]нпс0o
фарфо́ровый	adjporcelens- {porselens-} [-Ꞌleː-], postalíns- [-Ꞌlʊi-]; úr porceleni {porseleni-} [-Ꞌleː-], úr postalíni [-Ꞌlʊi-]
фарцева́ть	фарцу́|ю, ~ешь, ~ютipf чем-л.tlm.børsaaðivið o-mнеодобр., handla [-nla]aðisvartvið o-m(við útlendskum vørum o.tíl.)
фарцо́вка	ftlm.børsingж0-arнеодобр., spekulatión [-Ꞌʃɔun]ж0-irнеодобр.(við útlendskum vørum,síфарцева́ть)
фарцо́вщик	mtlm.børsariмгл-ariнеодобр., spekulantur [-Ꞌla-]мсогл-arнеодобр.(við útlendskum vørum,síфарцева́ть)
фарш	m1.(рубленное мясо) maliðсоглоснkjøt; malinсоглоснfiskur (рубленная рыба)2.(начинка) fylla [-tla]жгл-a; farsс0о(готовый)@сде́лать фаршиз кого-л.morlaaðio-nsundur
фарширо́ванный	adjfarseraður [-Ꞌseː-]глaður, fylturсогл(начинкой)
фарширова́ть	фарширу́|ю, ~ешь, ~ютipf(pfзафарширова́тьзафарширу́|ю, ~ешь, ~ют)что-л.farsera [-Ꞌseː-]aðio-t(мясным или рыбным фаршем); fylla [-tla]ir(t)o-t(любой начинкой)
ФАС1	I [фас]f indeclФедера́льная антимонопо́льная слу́жба Antimonopoltænastan í Russiska Samveldinum
ФАС2	II [фас] Свобо́дно вдоль бо́рта су́дна, FAS [fasː], Free аlongside shipангл.
фас3	IIIm: в фас, фа́сомsíанфа́с
фаса́д	ffasada {façada} [-Ꞌsaːta]ннкжгл-aпроф., framsíðaжгл-a(á húsum)@за фаса́домчего-л.≈við o-msum skálkaskjól
фаса́дный	adjfasadu- {façadu-} [-Ꞌsaːt-]ннкпроф., framsíðu- (á húsum)
фасе́т	mfacet {fasett} [-Ꞌsεʰtː]ж0-ir
фасе́тка	plurфасе́т|ки, ~ок, ~камf síфасе́т
фасе́точный	adjfacet- {fasett-} [-Ꞌsεʰtː-]@фасе́точные глаза́samansett eygur
фа́ска	plurфа́с|ки, ~ок, ~камftekn.avfasing [-faː-]ж0a-rспец., fasaður [faː-] kanturмсогл-sспец.; smigskurðurмсогл-ir(косая врубка)
фасо́ванный	adjpakkaðurглaðurinn
фасова́ть	фасу́|ю, ~ешь, ~ютipf(pfрасфасова́тьрасфасу́|ю, ~ешь, ~ют)что-л.pakkaaðio-tinn, emballera [-Ꞌleː-]aðio-tпроф.
фасо́вка	plurфасо́в|ки, ~ок, ~камf1.(действие) (inn)pakkingж0-ar, emballering [-Ꞌleː-]ннкж0-arпроф.(til liðugvøru)2.(материал) innpakningurмсогл-ar, emballasja [-Ꞌlaː-]ннкжгл-aпроф.(til liðugvøru)
фасо́вочный	adjpakki-
фасо́вщик	mpakkariМгл-ari
фасо́левый	adjbøn-
фасо́ль	f(Phaseolus) bønж0-ir
фасо́н	m1.(модель) fasongur {façonur} [-Ꞌsɔŋk-]ннкмсогл-s,-ir; sniðс0о{0<>i}(покрой); пла́тье но́вого фасо́на ein kjóli við einum nýggjum fasongiннк, ein kjóli við einum nýggjum sniði; потеря́ть фасо́н missa fasonginннк, missa skapið2.(манера) mátiмгл-i, fasongur {façonur} [-Ꞌsɔŋk-]ннкмсогл-s,-ir; на англи́йский фасо́н upp á eingilskan máta, upp á eingilskan fasongннк3.óvkm.: для́ фасо́на fyri at vísa seg, fyri at gera seg upp
фасо́нистый	stfфасо́нист, ~а, ~о, ~ыadjóvkm.smarturсогл, flotturсогл
фасо́нить	фасо́н|ю, ~ишь, ~ятipfóvkm.geraнепрseg Ꞌ upp, erpaaðisær
фасо́нный	adj1.(кфасо́н 1) fasong- [-Ꞌsɔŋk-]ннк2.tekn.(о разн. изделиях) fasong- [-Ꞌsɔŋk-]; фасо́нная сталь fasongstál [-Ꞌsɔŋk-]
фастфу́д	m1.(помещение) fastfoodrestauratión [fastfʊtːrεstɹaʃɔun]ж0-ir2.(еда) fastfood [fastfʊtː]м0{дат.0}, skundverðurлпмсогл-ir
фастфу́дный	adjfastfood- [fastfʊt-], skundverðar-лп
фастфу́довский	adjfastfood- [fastfʊt-], skundverðar-лп
фа́сция	f anat.(оболочка) paðс0о{0<>i}
фат	mgml.lapsurмсогл-ar(франт); skapс0о, uppgerðс0о(позёр)
фата́	fslørс0о(hjá konufólki); сва́дебная фата́ brúðarslør
фатали́зм	mfatalisma [faːt̥aꞋlɪ-]интжгл-a, lagnutrúgvж0-ar{+}
фатали́ст	mfatalistur [faːtaꞋlɪ-]ннкмсогл-ar
фаталисти́ческий	adjfatalistiskur [faːtaꞋlɪ-]ннксоглsk
фаталисти́чный	stfфаталисти́ч|ен, ~на, ~но, ~ныadj síфаталисти́ческий
фата́льный	stfфата́лен, фата́льн|а, ~о, ~ыadj1.(неотвратимый) sum ikki slepst undan, sumo-mer lagaður2.(роковой,трагический) fatalur [-Ꞌtʰaː-]ннксогл, syndarligurглigur
фа́та-морга́на	flognbráж0-ir, fatamorgana [faːtamɔɹꞋkaː-]ннкс0гл-a
фа́тва	frel.fatwa [faʰtva]жгл-a
фатова́тый	stfфатова́т, ~а, ~о, ~ыadjlapsuturсогл(франтоватый); skaputurсогл, uppgjørdurсогл(ходульный)
фатовско́й	adjlapsuturсогл(франтоватый); skaputurсогл, uppgjørdurсогл(ходульный)
фатовство́	nlapsarí [-Ꞌrʊi-]ннкс0о{0<>i}(франтовство); skapс0о, uppgerðс0о(позёрство)
фа́тум	mlagnaжгл-a; forløgс0о{a/ø}мнвыс., балл.
фа́уна	ffauna [fauna]жгл-a(;0-ir)спец.; djóralívс0о, djóraríkiсгл-i
фахве́рк	mbindingsverkс0о
фа́хверк	m síфахве́рк
фашиза́ция	fspjaðing ella útbreiðsla av fascismu
фаши́зм	mfasisma {fascisma}[-Ꞌsɪ-]жгл-a
фаши́на	frískneppiсгл-i, greinakneppiсгл-i(til at styrkja veg í mýrilendi o.a.)
фаши́нный	adj(sum er) av) rískneppum, (sum er) av greinakneppum
фаши́ст	mfasistur {fascistur [-Ꞌsɪ-]}мсогл-ar
фаши́ствующий	adjfasistakendur {fascistakendur} [-Ꞌsɪ-]согл, fasistoidur {fascistoidur} [-sɪstoꞋiː-]интсогл; við fasistiskum {fascistiskum} [-Ꞌsɪ-] atburði
фаши́стский	adjfasistiskur {fascistiskur} [-Ꞌsɪ-]соглsk
фаэто́н	m1.slag av hestavogni við kalesju2.slag av persónbili við kalesju
фая́нс	m1.(материал) fajansa [-Ꞌja-]жгл-a2.koll(изделия) steintoy [-tʰœi] (реже[-tʰɔi])с0о{0<>i}úr fajansu
фая́нсовый	adj1.(о материал) fajansu [-ˈja-]2.(об изделиях) steinyoys- [-tʰœis-], fajansu- [-ˈja-]
ФБК	[эф-бэ-ка́]m indeclФонд борьбы́ с корру́пцией Antikorruptiónsgrunnurin [ˌan̊tikʰɔːʊʰpˈʃɔuns-]мсогл-arопр.
ФБР	[фэ-бэ-э́р]n indeclФедера́льное бюро́ рассле́дований (США) FBI [ˌεfpiꞋai],Federal Bureau of Investigationангл.(amerikanska sambandsløgreglan)
ФГУП	[вгуп]n indeclstytt. fyriФедера́льное госуда́рственное унита́рное предприя́тие Føderal [-Ꞌraː-]интsameind ríkisfyritøka
Феб	mmyt.Phoebus [føːpʊs]м0-ar({0<>i})
февра́ль	Genфевраля́mfebruar [feːpɹuaːɹ]м неск.
февра́льский	adjfebruar- [feːpɹuaːɹ-]@февра́льская револю́цияfebruarkollveltingin (í Russlandi í mars 1917)
федерали́зм	[eis.-дэ-]mføderalisma [-Ꞌlɪ-]жгл-aспец.(politisk hugsan og skipan)
федерали́ст	[eis.-дэ-]mføderalistur [-Ꞌlɪ-]мсогл-arспец.; samríkismaðurлпмнепр, samveldismaðurлпмнепр
федерали́стский	[-дэ-]adjføderalistiskur [-Ꞌlɪ-]соглskспец.
федера́лы	федера́л|ов, ~амm plurtlm.soldatarí russiska herinum(í Tjetjnja o.a)
федера́льный	[eis.-дэ-]adjføderalur [-Ꞌraː-]интсоглпроф., sambands- [-pan̊s-] (входит во многие сложн.),sí eis.федерати́вный; федера́льный ка́нцлер sambandskanslari (í Týsklandi); федера́льная поли́ция sambandsløgregla; федера́льная слу́жбаnavn á ym. stovnum innan fyri útinnandi vald hjá russisku stjórnini@Федера́льное Собра́ние (Росси́йской Федера́ции)Sambandstingið [-pan̊s-] (í Russiska Sambandinum) (russiska tjóðartingið);Федера́льная слу́жба контрразве́дки, ФСК [фэ-эс-ка́] Russiska mótnjósningartænastan (til 1995),sí eis.ФСБ
Федерати́вная Респу́блика Герма́ния	[eis.-дэ-] Týska Sambandsríkið [-pan̊s-]сгл-iопр.; (1949-1990 тж) Vesturtýsklandс0о{a/o}неофиц.
федерати́вный	[eis.-дэ-]adjsambands- [-pan̊s-], føderativurсоглпроф.; федерати́вное госуда́рство sambandsríki; федерати́вная респу́блика sambandslýðveldi =>Югосла́вия
федера́ция	[eis.-дэ-]f1.(государство) sambandsríki [-pan̊s-]сгл-i, føderatión [-Ꞌʃɔun]ж0-irпроф.2.(объединение) sambandс0о{a/o}, felagsskapurмсогл-ir=>Росси́йскаяФедера́ция,сове́тIII
Фе́дра	fmyt.Phaedra [feːt-]жгл-a, Fedraжгл-a
феери́ческий	adj1.sjónl.(кфее́рия 1) ævintýrspæls-2.fl.(сказочный) ævintýr-, ævintýrligurглigur
феери́чный	stfфеери́ч|ен, ~на, ~ноadjbókl.síфеери́ческий2
фее́рия	[-ее́-úttalast oftast sum eitt hálvlangt ljóð]f1.sjónl.(жанр) ævintýrspælс0o{æ/ø}2.bókl.(зрелище) ævintýrsjónж0-ir, gandasjónж0-ir
фейсбу́к	[фэ-]mfacebok [fεispʊʰk]ж нескл
фейерве́рк	m1.(огни и изделия) fýrverkarí [-Ꞌrʊi-]ннкс0о{0<>i}, fýrverkнпс0о(skreyteldur og einstakir lutir); пусти́ть фейерве́рк skjóta fýrverkaríннк2.fl.(поток,обилие) fýrverkarí [-Ꞌrʊi-]с0о{0<>i}; фейерве́рк кра́сок eitt fýrverkarí av litum; фейерве́рк слов eitt fýrverkarí av orðum
фейк	[фэ-]m1.jarg.(информация) fake [fεik} {feykред.}с0о{0<>i}жарг.2.jarg.(подделка) kopivøra [-ˈpʰiː-]жгл-a, kopivara [-ˈpʰiː-]ннкжгл-а
фе́йковый	[фэ́-]adj jarg.fake- [fεik-] {feyk-ред.}жарг., fakaður [fεik-] {feykaðurред.}глaðurжарг;фе́йковыые но́вости fake [fεik}с0о{0<>i}жарг.
Фейсбу́к1	I[фэ-]mFacebook [fɛispʊʰkː]ж нескл
фейсбу́к2	II[фэ-]m síða á Facebook
фейсбу́чный	[фэ-]adj tlm.Facebook- [fɛispʊʰkː-], (sum er) á Facebook [fɛispʊʰkː]
фека́лии	f plurlækn.mannatrekkurмсогл-ar, avføring [εav-]ж0-arэвф.,проф.
фека́льный	adjfekalur [-kʰaː-]соглвет., спец.; фека́льные колифо́рмные бакте́рии fekalar coliformar {koliformar} [-ˈfɔ-] bakteriur [-ˈtʰeː-]
фелла́х	mfellah [fεlːa]мгл-гл(bóndi í arabiskum londum)
фельдма́ршал	mfeltmarsjalurмсогл-ar
фельдма́ршальский	adjfeltmarsjal-; фельдма́ршальский жезл feltmarsjalstavur
фельдфе́бель	msøg. ≈yvirsersjanturмсогл-ar(hægsti undiroffiserur í russ. herinum innan 1917)
фе́льдшер	plurфе́льдшер|ы, ~ов, ~амogфельдшер|а́, ~о́в, ~а́мm hjálparmaður hjá lækna(uttan hægri útbúgving); вое́нный фе́льдшер feltskeriмгл-iист.
фельдъе́герь	plurфельдъе́гер|и, ~ей, ~ямogфельдъегер|я́, ~е́й, ~я́мmsøg.feltjekariмгл-ariист., kurerur [-Ꞌreː-]мсогл-arист.
фельето́н	mgreinarstubbiмгл-i, smágreinж0-ar;0-ir(oftast skemtilig ella satirisk)
фельетони́ст	m o-r,ið skrivar greinastubbar el. smágreinar,síфельето́н
фелю́га	ffelucca [-ˈlʊʰkːa] ж0-ir(жгл-а)(bátaslag á Miðalhavinum o.a.)
Феми́да	fmyt.Themis [tʰeːmɪs]ж0-ar
фемини́зм	mfeminisma [-Ꞌnɪ-]жгл-a, kvinnurørslaжгл-a
фемини́ст	m o-r, sum stuðlar feminismuni (mannfók)
фемини́стка	plurфемини́ст|ки, ~ок, ~камffeministur [-Ꞌnɪ-]мсогл-ar, kvinnusakskvinnaжгл-a
фемини́стский	adjfeministiskur [-Ꞌnɪ-]соглsk, kvinnurørslu-, kvinnurættinda-
фен	mhárturkariмгл-ari, fønariмгл-ari, fønж0-ir; суши́ть фе́ном fønaaði(hár), turkaaði(hár við hárturkara)
фён	mfønж0-ir(vindur)
фе́нечка1	Iplurфе́неч|ки, ~ек, ~камjarg.armbandс0о{a/o}(heimagjørt, við glasperlum o.a.)с0о{a/o}; ≈ vinarbandс0о{a/o}
фе́нечка2	IIфе́неч|ки, ~ек, ~камf jarg(отличительная черта) sereyðkenni [-εʰtʃʰε-]сгл-i, sermerkiсгл-i;serheitж0-ir(странность,своеобразие)
фе́никс	mFøniksмсогл-ar; восста́ть из пе́пла как пти́ца фе́никс reisastir(t)úr øskuni sum fuglurin Føniks
фени́л	mfenyl [-Ꞌnyːl]с0о({0<>i})
фено́л	mfenol [-Ꞌnoːl]с0о({0<>i})
фено́лог	mfenologur [-Ꞌloːk-]мсогл-arспец.
феноло́гия	ffenologi [-Ꞌkiː]ж0-ir
фено́мен	m1.(явление) fyribrigdiсгл-i, fenomen [-Ꞌmeːn-]ннкс0о(;0-ir)2.(о человеке) úrmælingur [ʏɹ-]мсогл-ar, fenomen [-Ꞌmeːn-]энкс0о
феноме́н	m síфено́мен
феномена́льный	stfфеномена́|лен, ~льна, ~льно, ~льныadjbókl.undrunarverdurсогл, uttan líka, einskila-, fenomenalur [-Ꞌnaː-]ннксогл
феноти́п	mfenotypa [-tʰyː-]жгл-aспец.
фе́нхель	m(Foeniculum vulgare) fennikulм0осн-s,-ar
фе́нька1	Iplur.фе́ньки, фе́нек, фе́нькамf jarg. síфе́нечкаI
фе́нька2	IIplur.фе́ньки, фе́нек, фе́нькамf jarg. síфе́нечкаII
фе́нька3	IIIplur.фе́ньки, фе́нек, фе́нькамf jarg. síфе́ня I
фе́ня1	Ifjarg.tjóvamálс0о(serligt russ. argot),sbr.блатно́й язы́к, блатна́я му́зыка =>бо́тать
фе́ня2	IIf: мне э́то до фе́ниóvkm.eg leggi ein lortвульг.í tað; eg skítiвульг.á tað =>едре́не
феода́л	flensharri [leː-]мгл-i, feudalharri [fœuꞋtaː-]мгл-iспец.
феодали́зм	mfeudalisma [fœutaꞋlɪ-]жгл-a, lensskipanж0-ir
феода́льный	adjfeudalur [fœuꞋtaːl-]согл, lens- [leː-], lensskipanar- [leː-]; феода́льный строй feudal skipan, lensskipan
Фере́йские острова́	[-рэ́-]gml.síФаре́рскиеострова́
фере́йский	[-рэ́-]adjgml.síфаре́рский
фе́рзевый	adjdrotningar-, frúar- (í talvi); фе́рзевый гамби́т frúgvarbragdс0о{a/ø}, drotningarbragdс0о{a/ø}
ферзь	Genферз|я́; plur~и́, ~е́й, ~я́мmfrúgvжнепр, drotningж0-ar(í talvi)
фе́рма1	If(хозяйство) (bónda)garðurмсогл-ar{a/ø}; farmurннкмсогл-ar(тк в США и др.); моло́чная фе́рма garður við mjólkneytum; рыбово́дная фе́рма alibrúkс0о; песцо́вая фе́рма (blá)revagarður; семе́йная фе́рма familjubrúk [-Ꞌmɪ-]с0о
фе́рма2	IIfdragari [-aːk-]мгл-ari, sperraжгл-a
ферма́та	ffermata [-Ꞌmaː-]сгл-a(+)
ферме́нт	menzym {ensym} [-Ꞌsyːm]с0о(;0-ir), kveikiлпмгл-i
фермента́ция	fgeringж0-ar; fermentering [-ˈtʰeː-]ж0-arспец.,кул.
ферменти́ровать	ферменти́ру|ю, ~ешь, ~ютipf1.(находиться в процессе ферментации) geraaði;fermentera [-ˈtʰeː-]aðiспец., кул.2.что-л.(подвергать ферментации) fáaслнe-i-io-tat gera; fermentera [-ˈtʰeː-]aðio-t спец., кул.
фе́рмер	mbóndiмгл-ur; farmariннкмгл-ari(в США и др.)
фе́рмерский	adjbónda-; farmara- (в США и др.)
фе́рмерство	n1.(хозяйство) bóndadriftж0-ir; farmaradriftж0-ir(в США и др.)2.koll(фермеры) bøndurмгл-ur; farmararмгл-ariмн(в США и др.)
фе́рмерша	plurфе́рмерш|и, ~, ~амftlm.1.(жена фермера) konaжгл-abónda; konaжгл-afarmaraннк(в США и др.)2.(арендатор или владелец земли) bóndiмгл-ur; farmariннкмгл-ari(konufólk) (в США и др.)
Фермопи́лы	Фермопи́л, ~амf plursøg.Thermopylae [tʰεɹꞋmoːpʰylε]с нескл.
феррома́рганец	Genферрома́рганцаmjarnmangan [janmankaːn]с0о
ферроспла́в	mjarnlegering [janlekeː-]ннкж0-arпроф.
ферт	mtlm.,vanv.apuspjótс0опренебр., erpiskíturмсогл-arпренебр.(самодовольный); lapsurмсогл-ar(франт)@стоя́ть фе́ртомstanda hendur í hupp;ходи́ть фе́ртомerpaaðisær, brestair(t)sær
фе́ска	plurфе́с|ки, ~ок, ~камffez [feːs], [fεʰts]ж0-ir(kollur)
фест	m slangfestivalur [fεstiˈvaː-]мсогл-ar
фестива́ль	mfestivalur [-iꞋvaː-]мсогл-ar
фестива́льный	adjfestival- [-ivaːl-]
фестива́льчик	mlítil festivalur [-ˈivaː-]мсогл-ar, minifestivaur [miˑnifεstivaˑ-]мсогл-ar
фесто́н	m1.(на ткани и др.) (seymað) tungaжгл-a(á klæðum,gardinum o.ø.)2.arkit.(лепное украшение)(stukk)guirlanda [-kɪɹ-]жгл-a
фе́та	ffetaм нескл, fetaosturмсогл-ar
фе́тва	f síфа́тва
Фети́да	fThetis [tʰe:tɪs]ж0-ar
фети́ш	m1.(обожествляемая вещь) fetich [feːtɪʃ]интж0-ar2.fl.(предмет слепого поклонения) fetich [feːtɪʃ]интж0-ar, avgudur [au-]мсогл-arперен.
фетишизи́ровать	фетишизи́ру|ю, ~ешь, ~ютipf что-л.bókm.dyrkaaðio-tsum ein avgud [au-], geraнепрo-ttil eina fetich [feːtɪʃ]инт
фетиши́зм	m1.(культ) fetichdyrkanж0-ir, fetichisma [-Ꞌʃɪ-]жгл-a2.(извращение) fetichisma [-Ꞌʃɪ-]жгл-a(perversitetur)3.fl.tað at dyrkaВинsum ein avgud, tað at gera eina fetich [feːtɪʃ]интúrДат
фетр	mfiltс0о; tógviмгл-iуст., tóviмгл-iуст.
фе́тровый	adjfilt-; tóv-уст.; фе́тровая шля́па filthattur, tóvhatturуст.
фефёла	fóvkm.,atf.ótrivavættiсгл-i, skitsúgvжнепр;(неповоротливая женщина) klomburс0осн(konufólk)
фехтова́льный	adjfekti-, fikti-кн.;фехтова́льное иску́сство fektikynstur; фехтова́льная ма́ска fektimaska
фехтова́льщик	mfektariмгл-ari, fiktariмгл-ariкн.
фехтова́ние	nfektingж0-ar, fiktingж0-arкн.
фехтова́ть	фехту́|ю, ~ешь, ~ютipffektaaði, fiktaaðiкн.
фешене́бельность	ftað at vera fashionabul [faʃːoꞋnaː-]
фешене́бельный	stfфешене́бе|лен, ~льна, ~льно, ~льныadjbókl.fashionabul [faʃoꞋnaː-]ннксоглосн, fínurсогл
фе́я	fálvurмсогл-ar, vætturж0осн
ФЗО	[фэ-зэ-о́]n indeclsøg.фабри́чно-заводско́е обуче́ние yrkisútbúgving, fakútbúgving [faː-] (á verksmiðju o.tíl.); шко́ла ФЗО fakskúli [faː-]
фи	interfý, uff
фиа́лка	plurфиа́л|ки, ~ок, ~камf(Viola) blákolla [-tla]жгл-a; фиа́лка боло́тная (Viola palustris) ljós blákolla; фиа́лка трёхцве́тная (Viola tricolor) trílitt blákolla, stjúkmóðurblóma [ʃʏkm-]жгл-aред.
фиа́лковые	plur(сем. Violaceae) blákolluættin [-tl-]ж0-irопр.
фиа́ско	n indeclfiasko [-Ꞌa-]ннкж0-ir;потерпе́ть фиа́ско fáa fiaskoннк; фильм потерпе́л фиа́ско filmurin var ein fiaskoннк
фи́бра	f1.gml.(жилка) tægrж0-ir2.(материал) fipur {fibur-}ннкж0осн, trevjaнпжгл-a@все́ми фи́брами (души́)av øllum [œtl-] hjarta [j-]
фибри́н	mfibrin [-Ꞌriːn]с0о({0<>i}), trevjuevniлпсгл-i
фи́бровый	adjfibur-ннк;фи́бровый чемода́н fipurkuffert {fiburkuffert}
фибро́зный	adjfibrøsur [-Ꞌpɹøː-]соглпроф., tægruturсогл
фибро́ма	ffibrom [-Ꞌpɹoːm]с0о({0<>i})мед.
Фи́вы	f plursøg.Theben [tʰeː-]м0{дат.0}
фиг	móvkm.: на́ фиг til fjandansбран., til helvitisбран.; фиг с ним skítвульг.í hann; на́ фиг {на фига́} он нам ну́жен hvat traminбран.skulu vit brúka hann til; э́то им по́ фигуjarg.tey eru so beint tilfriðs [-Ꞌfɹɪsː]неформ., tað ger teimum (so) akkurát [-Ꞌrɔat] tað samaнеформ.
фиг.	stytt. фигу́ра
фи́га	f1.síинжи́р2.óvkm. síку́киш@гляде́ть в кни́гу и ви́деть фи́гуtlm.lesa í bók og ikki forstanda [-Ꞌsta-]ннкeitt kis [kʰiːs]
фигля́р	m1.gml.(фокусник, акробат) gyklariмгл-ari, klovnurмсогл-ar2.tlm.,vanv.(кривляка) íspegilм0осн-s,-ar, bajassur [-Ꞌja-]мсогл-arред.
фигля́рство	nfjákavesinС0о, fjantavesinС0онеформ.
фигня́	fóvkm.lorturмсогл-arгрубо, lortс0огрубо(о-t vánaligt)
фи́говый	ffiku-; фи́говое де́ревоsíинжи́р1@фи́говый листо́кfikublað
фиго́вый	adjóvkm.skít(-)вульг., lort(-)вульг.
фигу́ра	f1.(изображение) figurur [-Ꞌkuː-]ннкмсогл-ar; воскова́я фигу́ра voksfigurur; постоя́нная фигу́ра в коме́диях fastir figurarннкí skemtileikum; фигу́ра вса́дника (статуя) standmyndж0-irav reiðmanni2.(телосложение) vakstrarlagс0о{a/ø}{0<>i}, skapс0о{a/ø},figurur [-Ꞌkuː-]ннкмсогл-ar; у неё хоро́шая фигу́ра hon sær gott út upp á kropp, hon er pen upp á kropp, hon er væl vaksin, hon sær gott út av vøkstri, hon sær gott út av skapi; э́то по́ртит фигу́ру hetta oyðileggur [-Ꞌlε-] figurinннк3.tlm.(личность) figurur [-Ꞌkuː-]ннкмсогл-ar; он (значи́тельная) фигу́ра hann er ein týðandi figururннк, hann er ein týðandi persónur [-Ꞌsɔu-]; стра́нная фигу́ра ein løgin figurur [-Ꞌkuː-]энкмсогл-ar; э́то что за фигу́ра? hvat er hetta fyri ein persónur [-Ꞌsɔu-]; кру́пная полити́ческая фигу́ра týðandi persónur [-Ꞌsɔu-] í politikki [-Ꞌtʰɪ-]4.talv(в шахматах) maðurмнепр(talvfólk annað enn finna), offiserar [-Ꞌseː-]мсогл-arмн(talvfólk annað enn finnur); чёрные фигу́ры teir svørtu offiserarnir5.kort.(в картах) harrablaðс0о{a/ø}{0<>i}, málablaðс0о{a/ø}{0<>i}6.(положение - в полёте и т.п.) figurur [-Ꞌkuː-]ннкмсогл-arпроф.(в танцах); фигу́ры вы́сшего пилота́жа figurarпроф.í kunstflúgving7.bókm.(словесный оборот) figurur [-Ꞌkuː-]мсогл-arспец.; ритори́ческая фигу́ра retoriskur [-Ꞌtʰoː-] figururспец.8.(чертёж,схема) myndж0-ir, tekning [tʰεkn-]ж0-ar, figurur [-Ꞌkuː-]ннкмсогл-ar9.mat.(часть плоскости) figurur [-Ꞌkuː-]мсогл-ar; геометри́ческая фигу́ра geometriskur [keːoꞋmeː-] figurur10.mus.(в музыке) figurur [-Ꞌkuː-]мсогл-arспец.
фигура́льно	advmyndliga;фигура́льно выража́ясь myndliga talað
фигура́льный	stfфигура́лен, фигура́льн|а, ~о, ~ыadjmyndligurглigur, flutturсогл; в фигура́льном смы́сле í fluttari merking
фигура́нт	mgml.1.(танцовщик) dansariмгл-ari(ið ikki dansar solo), figurantur [fiːkuˈra-]мсогл-ar2.(статист) statistur [-Ꞌtʰɪ-]мсогл-arред., уст., figurantur [fiːkuˈra-]мсогл-arред., уст.3.(участник, обсуждаемое лицо)o-r, sum er uppi í o-m(gerð, atgerð),o-r, sum orð verður skift um
фигури́ровать	фигури́ру|ю, ~ешь, ~ютipf1.(присутствовать) vera til staðar, vera hjástaddur [tʃʰ-]согл{a/ø}2.(быть названным) standaслнó-a-a(в списке и т.п.); nevnastir(d), figurera [fiːkuꞋreː-]ннкaði
фигури́ст	mkunstskoytari [-skœi-] (ред.[-skɔi-])мгл-ari, kunstskoyturennari [-skœi-] (ред.[-skɔi-])мгл-ari
фигури́стка	plurфигури́ст|ки, ~ок, ~камfkunstskoytari [-skœi-]([-skɔi-])мгл-ari, kunstskoyturennari [-skœi-]([-skɔi-])мгл-ari(konufólk)
фигу́ристый	stfфигу́рист, ~а, ~о, ~ыadjóvkm.1.(замысловатый) fløkturсогл, fløkjasligurглigur(av skapi);фигу́ристо выража́ться málbera seg fløkt2.(имеющий хорошую фигуру) vælvaksinсоглосн
фигу́рный	adj1.(воспроизводящий фигуры) figur- [fiꞋkuːɹ-];фигу́рная жи́вопись figurmáling [fiꞋkuːɹ-], figurmálarí [fiꞋkuːɹ-]2.(имеющий очерчание,форму чего-л.) dánað sum figurur [fiꞋkuːɹ-]; фигу́рное зе́ркало spegl í skapi sum rundingur, hestaskógvuro.s.fr.; фигу́рная резьба́ myndaskurður3.(исполняемый с фигурами) kunst-, list-; фигу́рное ката́ние kunstskoyting [-skœi-] (реже[-skɔi-]), kunstskoyturenning [-skœi-] (реже[-skɔi-]); фигу́рное пла́ваниe kunstsvimjing; фигу́рный полёт kunstflúgving; фигу́рные коньки́ kunstrenningarskoytur [-skœi-] (реже[-skɔi-])4.talv(в шахматах) (gjørt) við monnum, (gjørt) við offiserum [-Ꞌseː-]; фигу́рная ата́ка eitt álop við monnum =>ско́бкаII
фидбе́к	[-бэ́к]m jarg.afturmelding [aʰtː-]ж0-ar, feedback [fiːtpεʰk]ннкс0о({0<>i})проф.
фидбэ́к	síфидбе́к
ФИДЕ	[фидэ́]f indeclFIDE [Ꞌfiːtε] (Fédération Internationale dеs Echecs)с нескл., Altjóða talvsambandiðс0оопр.
фи́дер	[-дэр]m1.el.(кабель) føðikápilм0осн-s,-ar, høvuðskaðalм0осн-s,-ar2. skip.(контейнеровоз) feedari [fiːt-]мгл-ari(bingjuskip)
фи́дерный	[-дэр]adj:фи́дерное су́дно feederskip [fiːtεɹ-]
Фи́джи	1.plur indecl(острова) Fiji [fiːtʃi]ж нескл. мн(oyggjar)2.n indecl(государство) Fiji [fiːtʃi]с нескл.(land)
фи́жмы	фижм, фи́жмамf plurgml.fiskabeinsskjúrtс0о; krinolina [-Ꞌliː-]жгл-a(юбка)
физ...1	I физи́ческий fysiskur [fyː-]соглsk, alisligurлпглigur; физфа́к (физи́ческий факульте́т) fysiskt fakultet [-Ꞌtʰeːt], alisfrøðiligлпmegindeildлп
физ...2	II физкульту́рный ítrótta-, fimleika-,síфизкульту́ра; физвоспита́ние kropslig venjing; физзаря́дкаtlm.kropsvenjing
фи́зик	mfysikari [fyː-]мгл-ari, alisfrøðingurнпмсогл-ar
фи́зика	ffysikk [fyꞋsɪʰkː]ж0-ir, alisfrøðiнпжгл-i; а́томная {я́дерная} фи́зика atomfysikk [-Ꞌtʰoː-], kjarnorkufysikk [-tn-], kjarnorkualisfrøði [-tn-]нп
физиогно́мика	ffysiognomikk [fyːsioknoˈmɪʰkː]интж0-irспец.
физио́лог	mfysiologur [fyːsioꞋloːk-]мсогл-ar,lívvirkisfrøðingurлпмсогл-ar
физиологи́ческий	adjfysiologiskur [fyːsioꞋloːk-]соглsk, lívvirkisligurлпглigur
физиоло́гия	ffysiologi [fyːsioloꞋkiː]ж0-ir, lívvirkisfrøðiлпжгл-i
физионо́мия	f1.tlm.(лицо) ansiktннкс0о, andlit [anl-]с0о; snáðж0-ir(частопренебр.), skorturмсогл-arгрубо, gronж0-irгрубо2.fl.,tlm.(внешний облик) útsjónd [ʏʰt-]ж0-ir
физиотерапе́вт	mfysioterapeutur [fyːsiotʰeːɹapʰœu-]мсогл-ar, alisviðgeriлпмгл-i
физиотерапевти́ческий	adjfysioterapeutiskur [fyːsiotʰeːɹapʰœu-]соглsk
физиотерапи́я	ffysioterapi [fyːsio-]ж0-ir, alisviðgerð [-vɪtʃ-]лпж0-ir
физи́чески	adv: физи́чески невозмо́жно fysiskt [fyː-] ómøguligt [-Ꞌmøːv-]ннк
физи́ческий	adj1.(кфи́зика) fysiskur [fyː-]соглsk,fysikk- [fyꞋsɪʰkː-];alisligurлпглigur, alis-лп; alisfrøðiligurнпглigur(относящийся к науке);физи́ческое сво́йство fysiskur eginleiki, alisligurлпeginleiki; физи́ческий кабине́т fysikkstova [fyꞋsɪʰk-]2.(телесный) kropsligurглigur, likamligurглigur, fysiskur [fyː-]ннксоглsk; физи́ческий труд kropsligt arbeiði, fysisktннкarbeiði; физи́ческий недоста́ток kropsligt brek; рабо́тники физи́ческого и у́мственного труда́ tey, ið fáast við handligt og andligt arbeiði; примени́ть физи́ческое наси́лие brúka likamligan harðskap [haʂ-]; физи́ческое воспита́ние kropslig venjing3.(относящийся к половым отношениям) holdsligurглigur, kynsligurглigur; физи́ческая бли́зость kynslig samvera4.bókl.(вещественный,материальный) materiellur [-Ꞌεlː-]согл; физи́ческий изно́с маши́н materielt slit av bilum@физи́ческая культу́раsíфизкульту́ра;физи́ческая геогра́фияfysisk geografi [keːokɹaꞋfiː];физи́ческая хи́мияfysisk kemi [kʰeꞋmiː]
фи́зия	f óvkm.skorturмсогл-arгрубо, gronж0-irгрубо
физкульту́ра	fkropsvenjingж0-ar; fimleikurмсогл-s,-ir, gymnastikk [kʏmnaꞋstɪʰkː]ннкс0оуст.(гимнастика)
физкульту́рник	f1.(спортсмен) ítróttamaður [-tɹɔʰtː-]мнепр2.tlm.(преподаватель) fimleikalærariмгл-ari
физкульту́рница	f1.(спортсменка) itróttakvinna [-tɹɔʰtː-]жгл-a2.tlm.(преподавательница) fimleikalærarinna [-ɪnta]жгл-a
физкульту́рный	adjítrótta- [-tɹɔʰtː-]
фикс	: иде́я фикс ein fiks idé [-Ꞌteː]ннк
фикса́ж	m1.(раствор) fikserbað [-Ꞌseː-]с0о2.(вещество) fiksativ [-Ꞌtʰiːv]с0о; fiksersalt [-Ꞌseː-]с0о(соль)
фикса́тор	mhaldariмгл-ari; palur [pʰaː-]мсогл-arтехн.
фиксатуа́р	mhárkremс0о, brillantina [-ɪʎjan̊Ꞌtʰiː-]жгл-a
фикса́ция	f1.(запись) tað at festa (niður)2.(установление) ásetanж0-ir3.(закрепление) festingж0-ar4.foto(фото) fiksering [-Ꞌseː-]ж0-a;síфикси́ровать(русскому отглагольному сущ. в переводе часто или предпочтительно соответствует глагольная форма)
фикси́ровать	фикси́ру|ю, ~ешь, ~ютipf что-л.1.pfзафикси́роватьзафикси́ру|ю, ~ешь, ~ют(записывать) festair(t)o-tá blað (на бумагу), goymair(d)o-tí minni, leggjaнепрsæro-tí geyma (в памяти)2.pfзафикси́роватьзафикси́ру|ю, ~ешь, ~ют(устанавливать) ásetaur(t);ir(t)o-t, leggjaнепрo-tfast3.pf(сосредоточивать) festair(t); фикси́ровать внима́ниена Prpfesta uppmerksemið [-Ꞌmε-]við Вин; фикси́ровать свой взглядна Prpstarair(d)at Dat, bínair(d)Винígjøgnum [-Ꞌtʃœ-]4.(закреплять в определённом положении) festair(t)o-tío-t, haldaслнe-i-io-mføstum; fiksera [-Ꞌseː-]aðio-tпроф.,мед.; фикси́ровать сло́манную но́гу fiksera eitt brotið bein5.foto(фото) fiksera [-Ꞌseː-]aðio-t
фикти́вный	stfфикти́в|ен, ~на, ~но, ~ныadj1.(выдуманный) fiktivurинтсогл; pentaðurглaðursaman, íspunninсоглосн(придуманный); фикти́вный капита́л fiktivur kapitalur [kʰaːpiꞋtʰaː-]2.(поддельный) falskurсогл{a/ø}@фикти́вный бракproformahjúnaband [-Ꞌfɔɹmatʃ-]
фи́кус	m(Ficus elastica) ficus [fiːkʊs]ж0-ar
фи́кция	ffiktión [-Ꞌʃɔun]интж0-ir
филантро́п	mfilantropur [-Ꞌtʰɹoː-]интмсогл-ar, vælgerariмгл-ari
филантропи́ческий	adjfilantropiskur [-Ꞌtʰɹoː-]интсоглsk, vælgerandiглandi
филантро́пия	ffilantropi [-Ꞌpʰiː]ж0-ir
филармони́ческий	adjfilharmoniskur [-Ꞌmoː-]соглsk
филармо́ния	ffilharmoni [-Ꞌniː]ж0-ir
филатели́ст	[-тэ-]mfrímerkjasavnariмгл-ari, frímerkjasamlariмгл-ari, filatelistur [-Ꞌlɪ-]мсогл-ar
филателисти́ческий	[-тэ-]adjfrímerkja-, filatelistiskur [-Ꞌlɪ-]соглsk]
филатели́я	[-тэ-]ffilateli [-Ꞌliː]ж0-ir, tað at savna frímerkir, tað at samla upp á frímerkir
филе́1	In indecl1.(мясо) filet [-Ꞌleː]ж0-ir(av kjøti)2.(рыбное) flakс0о{a/ø}, filet [-Ꞌleː]ннкж0-ir; филе́-ба́бочка butterfly [pɔʰtːεɹflai]с нескл., flapsс0омн; треско́вое филе́ toskaflak
филе́2	IIn indecl(вышивка) filet [fiꞋleː]ж0-ir(slag av seyming)
филе́й	m síфиле́I
филе́йный1	Iadj1.filet- [-Ꞌleː-] (síфиле́I 1)2.flaka-, filet- [-Ꞌleː-]ннк(síфиле́I 2); филе́йная маши́на flakamaskina
филе́йный2	IIadjfilet- [fiꞋleː-] (síфиле́II)
филёнка	plurфилён| ки, ~ок, ~камf1.(доска) fylling [-tl-]ж0-ar(í hurð o.a.); panel [-Ꞌneːl]с0о2. (полоска) bordiмгл-i(ið skilur litir frá hvørjum øðrum á einari flatu)
филёр	mgml.uppdagari [-Ꞌteː-]ннкмгл-ari, detektivur [-Ꞌtʰiː-]мсогл-ar
филети́рование	nflakaskeringж0-ar; филети́рование вручну́ю hondskering [hɔnʃ-]ж0-arav flaki =>ли́ния4
филети́ровать	филети́ру|ю, ~ешь, ~ютipf/pf Accflakaskeraслнa-ó-oВин, skeraслнa-ó-oВинtil flak (fisk)
филетиро́вочный	adj fisk. flakaskeri-, flaka-; филетиро́вочная маши́на flakaskerimaskina, flakamaskina
филиа́л	mdeildж0-ir, filialur [-Ꞌaː-]ннкмсогл-ar; úthandilм0осн-s,-arист.(коммерческого учреждения,в другой местности); филиа́л ба́нкатжútbankiмгл-i(б.ч. в другом городе)
филигра́нный	adj1.(кфилигра́нь 1) filigran- [-Ꞌkɹanː-]2.fl.(о выполнении) nettligurглigur, fínligurглigur; nærkvæmsligur [naɹ̥kasl-]глigur(тщательный)
филигра́нь	f1.(изделие) filigran [-Ꞌkɹanː]с0о({0<>i})2.(водяной знак) vatnmerki [vanm-]сгл-i
фи́лин	m(Bubo bubo) stór hornugla [-tn-]жгл-a
фили́ппика	fbókl.torutalaжгл-a
филиппи́нец	Gen, Accфилиппи́нц|а; plur~ы, ~ев, ~амmfilippinari [-Ꞌpʰiː-]мгл-ari, filipsoyingurлпмсогл-ar
филиппи́нка	plurфилиппи́н|ки, ~ок, ~камffilippinari [-Ꞌpʰiː-]мгл-ari, filipsoyingurлпмсогл-ar(konufólk); она́ филиппи́нкатжhon er filippinsk [-Ꞌpʰiː-], hon er úr Filippinunum [-Ꞌpʰiː-]ннк
Филиппи́нские острова́	Filippinurnar [-Ꞌpʰiː-]ннкжгл-aмн опр., Filipsoyggjarнпж0-ar{+}мн(на + Prp -á + Дат)
филиппи́нский	adjfilippinskur [-Ꞌpʰiː-]соглsk
Филиппи́ны	Филиппи́н, ~амf plurFilippinurnar [-Ꞌpʰiː-]ннкмгл-aмн опр., Filipsoyggjarнпж0-ar{+}мн(на + Prp - á + Дат)
фили́стер	msmáborgariмгл-ari
фили́стерский	adjsmáborgaraligurглigur
фили́стерство	nsmáborgaraligheitж0-ir
филокарти́ст	npostkortasamlariмгл-ari
филол.	1.филоло́гия2.филологи́ческий
фило́лог	mmálgranskariмгл-ari, málfrøðingurмсогл-ar, filologur [-Ꞌloːk-]интмсогл-ar
филологи́ческий	adjfilologiskur [-Ꞌloːk-]интсоглsk, málfrøðiligurглigur
филоло́гия	ffilologi [-Ꞌkiː-]интж0-ir, málfrøðiжгл-i, málgranskingж0-ar
фило́н	móvkm.letivættiсгл-i
фило́нить	фило́н|ю, ~ишь, ~ятipfóvkm.dovnastaði, letastaði
филос.	1.филосо́фия2.филосо́фский
фило́соф	mfilosoffur [-Ꞌsɔ-]ннкмсогл-ar, heimspekingurнпмсогл-ar
философи́чный	stfфилософи́ч|ен, ~на, ~ноadjgml.síфилосо́фский
филосо́фия	ffilosofi [-Ꞌfiː-]ннкж0-ir, heimspekiнпжгл-i@разводи́ть филосо́фиюtlm.filosofera [-Ꞌfeː-]aðiнеформ.
филосо́фски	adv(невозмутимо) uttan at lata við seg koma, filosofiskt [-Ꞌsoː-]ннк
филосо́фский	adj1.(кфилосо́фия) filosofiskur [-Ꞌsoː-]ннксоглsk, heimspekiligurнпглigur2.fl.(вдумчивый,спокойный) filosofiskur [-Ꞌsoː-]ннксоглsk; филосо́фское споко́йствие filosofisk ró; филосо́фским ви́дом við einum filosofiskum úttrykkiннк, við einum filosofiskum yvirbragdi@филосо́фский ка́меньvísdómssteinur
филосо́фствовать	филосо́фству|ю, ~ешь, ~ютipf1.gml.(заниматься философскими построениями) fáastслнe-i-ivið filosofiskar [-Ꞌsoː-]ннкspurningar, fáastслнe-i-ivið heimspekiligarнпspurningar2.fl.,tlm..(умствовать) filosofera [-Ꞌfeː-]aðiнеформ.,неодобр.(fáast við grundleysar spekulatiónir o.tíl.)
филумени́я	ftaðatsamla upp á etikettir av svávuldósum
фи́лькин	adj: фи́лькина гра́мота pappírslepiмгл-i
фильм	m1.(со снимками) filmurмсогл-ar;согл-s,-ir, kykmyndж0-irкн., kvikmyndж0-irкн.; худо́жественный фильм spælifilmur; звуково́й фильм talufilmur, filmur við talu2.(плёнка) filmurмсогл-ar;согл-s,-ir(leingja sum,spælifilmur o.a. verður tikin upp á) =>документа́льный,игрово́й,снять8,ста́вить14,цветно́й1
фильмме́йкер	[-мэ́-]mfilmsleikstjóri [-stjɔu-]нпмгл-i, filminstruktørurннкмсогл-arпроф.
фильмоско́п	mframvísariмгл-ari, ljósmyndatólнпс0о
фильмоте́ка	ffilmsavnс0о{a/ø}
фильтр	mfilturс0осн
фильтра́т	mfiltrat [-Ꞌtʰɹaːt]с0оспец., sílaður løgurмсогл-ir{ø/a}
фильтра́ция	f1.(фильтровка) filtrering [-Ꞌtʰɹeː-]ж0-ar2.(просачивание) seyringж0-ar
фильтрова́льный	adjfiltrer- [-Ꞌtʰɹeː-]ннкпроф.; фильтрова́льная бума́га filtrerpapír [-Ꞌtʰɹeː-]ннкпроф.
фильтрова́ть	фильтру́|ю, ~ешь, ~ютipf(pfпрофильтрова́тьпрофильтру́|ю, ~ешь, ~ют, отфильтрова́тьпрофильтру́|ю, ~ешь, ~ют)что-л.filtrera [-Ꞌtʰɹeː-]aðio-t
фимиа́м	mroykilsiсгл-i@кури́ть фимиа́мкому-л.rósaar(t);aðio-mtil skýggja
фимо́з	m lækn.ov [oː] trong forhúðж0-ir(á kynslimi hjá manni)
фин...	í samansfíggjar-,t.d.финотде́л
фина́л	m1.(конец) endiмгл-i; endabresturмсогл-s,-ir(заключительное усилие и т.п.)2.sjónl.(часть спектакля и т.п.) endamyndнпж0-ir, síðsta myndнпж0-ir, finala [-Ꞌnaː-]ннкжгл-a3.mus.(часть музыкального произведения) finala [-Ꞌnaː-]жгл-a4.ítr.(часть спортивного соревнования) finala [-Ꞌnaː-]жгл-a;вы́йти в фина́л koma í finaluna
финали́ст	mfinalistur [-Ꞌlɪ-]мсогл-ar
фина́льный	adj1.(конечный) enda-; фина́льная часть (оперы, симфонии) finala [-Ꞌnaː-]жгл-aмуз.; фина́льная сце́на endamyndж0-ir, síðsta myndж0-ir, finala [-Ꞌnaː-]ннкжгл-a; фина́льный акко́рд endaakkord2.ítr.(о спортивных соревнованиях) finalu- [-Ꞌnaː-]; фина́льный матч {фина́льная встре́ча} finaludystur [-Ꞌnaː-]
финанси́рование	nfíggingж0-ar, finansiering [finan̊sꞋjeː-], [finan̊Ꞌʃeː-]ннкж0-ar; наро́дмое финанси́рование crowdfunding [kʰɹautfɔ-]ж0-ar, hópfíggingжo-ar
финанси́ровать	финанси́ру|ю, ~ешь, ~ютipf/pf что-л.fíggjaaðio-t
финанси́ст	m1.(специалист) fíggjarfrøðingurмсогл-ar2.(владелец капитала) pengamaðurмнепр
фина́нсовый	adjfíggjar-; фина́нсовые дела́ fíggjarmál; фина́нсовый год fíggjarár, roknskaparár; фина́нсовое положе́ние figgjarstøða; фина́нсовые затрудне́ния fíggjartrupulleikar
фина́нсы	m plur1.(денежные дела) fíggjarmálс0омн, fíggjarviðurskiftirсгл-iмн; мини́стр фина́нсов fíggjarmálaráðharri, finansministari [-Ꞌna-]ннк2.tlm.(деньги) pengarмгл-iмн, finansur [-Ꞌna-]энкж0-urмншутл.@у него́фина́нсы пою́т рома́нсыtlm.,skemt.hann eigur ikki eitt oyra
финва́л	m(Balaenoptera physalus) nebbafiskurмсогл-ar
фи́ник	mdadlaжгл-a
финики́ец	Gen, Accфиники́йц|а; plur~ы, ~ев, ~амmfønikari [-Ꞌniː-]мгл-ari, føniki [-Ꞌniː-]мгл-i
финики́йский	adjfønikiskur [-Ꞌniːk-]соглsk
Финики́я	fsøg.Fønikien [-Ꞌniːk-]ннкс0{дат.0}, Fønikia [-Ꞌniːk-]с нескл.(тжбибл.жгл-a)
фи́никовый	adjdadlu-; фи́никовая па́льма (Phoenix dactylifera) dadlupálmi
фининспе́ктор	[-ын-]plurфининспектор|а́, ~о́в, ~а́мmфина́нсовый инспе́ктор skattaeftirlitsmaður [-εʰtː-]мнепр
фини́фть	f1.(на металлических изделиях) emalja [eꞋmaʎja]жгл-a(á metalllist)2.oftast plur(художественные изделия) emalja [eꞋmaʎja]жгл-a(listaverk)
фи́ниш	m1.(заключительная часть состязания) síðsta takiðс0o{a/ø}; endadysturмсогл-s,-ir2.(конечный пункт) málс0o(í ítróttakappingum o.tíl.); прийти́ к фи́нишу koma í mál; от ста́рта до фи́ниша frá starti til mál; судья́ на фи́нише máldómari
финиши́ровать	финиши́ру|ю, ~ешь, ~ютipf/pf1.(прийти к финишу) komaслнo-o-oí mál2.(делать финишный рывок) spurtaaðiспорт.
фи́нишный	adjmál-; фи́нишная черта́ málstrika; фи́нишная ле́нта málsnórur; фи́нишный рыво́к endaspurtureis.fl.; он вы́шел на фи́нишную пряму́юeis.fl.nærkast endanum
фи́нка1	Iplurфи́н|ки, ~ок, ~камf(женщина) finsk konaжгл-a, finsk gentaжгл-a(девушка)
фи́нка2	IIplurфи́н|ки, ~ок, ~камf(нож)knívur við stuttum, breiðum blað
Финля́ндия	fFinnlandс0о{a/o}
финн	mfinniмгл-i
фи́нно-уго́рский	adjfinsk-ugriskurсоглsk-соглsk; фи́нно-уго́рские языки́ finsk-ugrisk mál
фи́нский	adjfinskurсоглnsk; фи́нский язы́к finskt [fɪŋ̊kst]сприлskt@фи́нские са́ниsparkariмгл-ari;фи́нский ножsíфи́нкаII
Фи́нский зали́в	Finska víkinж0-irопр.
финт	m1.óvkm.(хитрая уловка) snildirж0-ir, knepннкс0о2.ítr.(в спорте) fintaсгл-a
фи́нта	f(Alosa fallax) stavsildж0-ir
финти́ть	финчу́, финт|и́шь, ~я́тipftlm.hjáputrast [tʃʰ-]aði, tosaaðivið kávalæti
финтифлю́шка	plurфинтифлю́ш|ки, ~ек, ~камf1.tlm.(мелкое украшение) nipsс0о2.tlm.,niðr.(легкомысленная женщина) leyslátað konufólkс0о
ф.и.о.	[фи́о] фами́лия, и́мя и о́тчество (á oyðubløðum) eftirnavn [εʰtː-], fornavn og faðirsnavn; ва́ше ф.и.о?skemt.hvat er navnið?
Ф.И.О.	[фи́о]síф.и.о.
фиоле́товый	adjviolettur [-Ꞌlε-]согл
фио́рд	msíфьорд
фиориту́ра	ffioritur [-ˈtʰuːɹ]Ж0-ir
фирма́	f síфи́рма2
фи́рма	f1.(предприятие) firmaс0гл-a, felagс0о{a/ø}{0<>i}(handilsfelag), fyritøkaжгл-a2.(oftast úttalaðфирма́)óvkm.dygdarvøraжгл-a(о товаре); valaarbeiðiсгл-i(о работе); Ю́рка - не фирма́ tað er eingin fongur í Jurij@под фи́рмойчего-л.við at látast sumo-t, við at látast verao-t
фи́рма-рие́лтер	[-э́л-]Genфи́рмы-рие́лтераfhúsameklarafelаgс0о{a/ø}{0<>i}
фи́рма-спо́нсор	f-msponsorfyritøkaжгл-a
фирма́ч	Gen, Accфирмач|а́; plur~и́, ~е́й, ~а́мmtlm.stjóri [stj͈-]мгл-ifyri felag; umboðс0оfyri felag (представитель)
фи́рменный	adj1.(кфи́рма 1) firma- ; фи́рменный магази́н handil hjá [tʃʰ-] firma (sum firma eigur sjálvt); фи́рменное блю́до specialitetur [speːsiaːliꞋtʰeː-]мсогл-ar(hjá restauratión o.tíl.)2.óvkm.(очень хороший) fínurсогл(frálíkur), óføra góðurгл{+}=>знак1
фирн	mjarðf.fyrni [-tnɪ]сгл-iгеол.
фисгармо́ния	f(stovu)orgulс0осн, harmonium [-Ꞌmoː-]с0-um
фиска́л	mtlm.smettariглari(smettubiti)
фиска́лить	фиска́л|ю, ~ишь, ~ятipftlm.на Accsmettaaðium Вин, slatraaðium Вин
фиска́льный	adjfíggjar-, skatta- (налоговый)
фиста́шка	plurфиста́ш|ки, ~ек, ~камf1.(Pistacia vera) pistasjutræ [-Ꞌstaː-]с0o{æ/ø}{0<>i}2. (плод) pistasjunøt [-Ꞌstaː-]ж0-ir
фиста́шковый	adj1.(кфиста́шка) pistasju- [-Ꞌstaː-]2.(о цвете) pistasjugrønur [-Ꞌstaː-]согл
фи́стула	f(свищ) fistilм0осн-s,arмед.
фистула́	f síфальце́т
фити́ль	Genфитил|я́;plur~и́, ~е́й, ~я́мm1.(у лампы и т.п.) veikurмсогл-s,-ir2.(у пушки и т.п.) fjúsс0о3.: вста́вить фити́лькому-л.gevao-meina yvirháling [-Ꞌhɔa-]энкнеформ., gevao-mav grovfílini [kɹɔf-]=>подкрути́ть
фи́тнес	[-нэ-]mfitness [fɪʰtn-]с0о
фи́тнес-...	[-нэ-] fitness- [fɪʰtn-]
фитнес-клу́б	[-нэ-]mfitnessfelag [fɪʰtn-]с0o{a/ø}{0<>i}
фитнес-програ́мма	[-нэ-]f(venjngar)skráжo-ir{+}fyri fitness [fɪʰtn-]
фи́тнесс	[-нэ-]m síфи́тнес
фи́тнесс-...	[-нэ-]síфи́тнес-...
фитнес-це́нтр	[-нэ-]mfitnesssentur [fɪʰtn-]с0осн, fitnessdepil [fɪʰtn-]нпм0осн-s,-ar, fitnessmiðstøð [fɪʰtn-]нпж0-ir
фито..	í samansvakstrar-, plantu-
фитопланкто́н	mfytoplankton [fyː-]с0оспец., plantuplanktonс0о
фитосанита́рный	stfфитосанита́р|ен, ~на, ~но, ~ныadjfytosaniterur [fyːtosaːniˈtʰeː-]соглспец.
фитотерапе́вт	m serfrøðingur í leking við læknaurtum, síфитотерапи́я
фитотерапи́я	flekingж0-arvið læknaurtum, fytoterapi [fyː-] ж0-irспец.,ред.
фитю́лька	plurфитю́льки, фитю́лек, фитю́лькамf1.(предмет) smátingс0о2.(о человеке) pinkulingurссогл-ar, nollс0о
фи́фа	ftlm.,atf.pyntidukkaжгл-aпренебр., pyntireyvж0-arгрубо,пренебр.
ФИФА́	f indecl(Междунаро́дная федера́ция футбо́ла) FIFAм нескл.fr.Féderation internationale de football association)(Altjóða fótbóltsfelagsskapurin)
фифи́	m indecl(Tringa glareola) vaðstelkurмсогл-ar
фи́фти-фи́фти	advtlm.helvt [hεl̥t] um Ꞌ helvt, fifty-fifty [ꞋfɪftiꞋfɪf̥ti]энкнеформ.
фи́цис	m(Phycis blennoides) lítlabrosmaжгл-a
фи́шинг	mphishing [fɪʃː-] ж0-arинтерн., спец.
фи́шка	plurфи́ш|ки, ~ек, ~камfspælimerkiсгл-i@ голубы́е фи́шкиsíблю-чи́с
фишлу́па	ffiskaluppurмсогл-ar
ф-ка	фа́брика verksmiðja
ФКЦБ	[эф-ка-це-бэ́]f indeclФедера́льная коми́ссия по ры́нку це́нных бума́г Samveldisnevndin fyri virðisbrævamarknaðin
флаг	mflaggс0о{a/ø}; merkiсгл-i(государственные флаги, в определённой форме о фарерском флаге); андре́евский флаг andriasarflagg [-Ꞌtɹiː-] (stavnamerki hjá russiskum krígsskipum); вое́нно-морско́й флаг herflotaflagg; госуда́рственный флаг tjóðarflagg, tjóðmerki; удо́бный флаг hentleikaflagg; подня́ть флаг vindaслнa-u-uflagg á stongофиц.,выс., havaнепрflagg á stongофиц.,выс., koyra flaggið upp; вы́весить {подня́ть} флаг в честьGenflaggaaðifyri Дат; спусти́ть флаг takaслнó-ó-iflaggið niður, dragaслнó-ó-iflaggið niður, koyrair(d)flaggið niður; strikaaðiflaggið (тж как знак капитуляции), gevaслнa-ó-iseg yvir (сдаться); подня́ть {вы́кинуть} бе́лый флаг dragaслнó-ó-itað hvíta flaggið upp; почему́ по́дняты фла́ги? hví verður flaggað?; hví flagga tey?; hvørjum verður flaggað fyri?; под росси́йским фла́гом undir russiskum flaggi@под фла́гомчего-л.a) (под лозунгом) í navniпосс.; b) (под предлогом) við at látast;оста́ться за фла́гомa) (отстать) dragnaaðiafturúr [aʰtː-]; b) (не быть допущенным) ikki sleppaслнa-u-oframat [-Ꞌεat] =>госуда́рство,приспусти́ть,спускA 2
флаг-капита́н	mgml.flotayvirmaður í stápi
фла́гман	m1.(командующий) flota(deildar)ovastiмгл-i2.(судно командующего) herovastaskipс0о3.(корабль) flaggskipс0о(самое крупное или лучшее судно)
фла́гманский	adj: фла́гманское су́дно (судно командующего) herovastaskipс0о; (корабль) flaggskipс0о(самое крупное или лучшее судно)
флагшто́к	mflaggstongж0-ur{o/e}
фла́ер	mflogseðilмосн-s-ar(við reklamum o.tíl), lýsingarseðilмосн-s-ar, flyers [flaiεʂ]м нескл МН торг., проф.
флажо́к	Genфлажк|а́; plur~и́, ~о́в, ~амm1.(маленький флаг) (lítið) flaggс0о{a/ø}; сигна́льный флажо́к signalflagg [-Ꞌnaː-]2.(бумажный) pappírsflaggс0о{a/ø}; ёлочные флажки́ jólatræsfløgg
флажоле́т	m1. (муз. инструмент) flageolett [flaːʃoˈlεʰtː]ж0-ir(slag av floytu)2.(звук) flageolett [flaːʃoˈlεʰtː]ж0-ir, flageoletttóni [flaːʃoˈlεʰtː-]мгл-i
фла́йер	m síфла́ер
флако́н	mflakong [-Ꞌkʰɔŋk]ннкж0-ir
флама́ндец	Gen, Accфлама́ндц|а; plur~ы, ~ев, ~амmflamlendariмгл-ari, flamlendingurмсогл-ar
флама́ндка	plurфлама́нд|ки, ~ок, ~камmflamlendariмгл-ari, flamlendingurмсогл-ar(konufólk)
флама́ндский	adjflamskurсоглsk; флама́ндский язы́к flamskt [flam̊st]сприлskt
фламе́нко	n indeclflamenco [-Ꞌmεŋ̊ko]мгл-гл;с0гл(-inum)
флами́нго	n indecl(Phoenicopterus) flamingo [-Ꞌmɪŋko]ж0-ir
фланг	m1.(сторона шеренги) síðaжгл-a, liðж0-ir; armurмсогл-ar{a/ø}(боевого расположения войска); атакова́ть во фланг álop á síðuna; обойти́ с фла́нга fara uttanum frá síðuni2.talv(в шахматах): короле́вский фланг kongamegin; фе́рзевый фланг frúgvamegin
фланго́вый	adjIm ytsti maður á fylkingararmi(síфланг1)IIadjsíðu-, á síðuna; фланго́вая ата́ка álop á síðuna
Фла́ндрия	fFlandernс0{дат.0}
флане́левка	plur.флане́лев|ки, ~ок, ~камftlm.matrósablusa [-Ꞌtʰɹɔus-]жгл-a
флане́левый	adjflonell- [-Ꞌnεl-]
флане́ль	fflonell [-Ꞌnεlː]с0о({0<>i})
фланёр	mtlm.,gml.o-r, ið gongur og letast
фла́нец	Genфла́нц|а; plur~ы, ~ев, ~амmflansi (тж[flaŋ̊ksɪ])мгл-i
флани́ровать	флани́ру|ю, ~ешь, ~ютipfgml.válaaði, gangaслнe-i-iog malaслнó-ó-a
фланки́ровать	фланки́ру|ю, ~ешь, ~ютipf/pf Accherm.skjótaсоглey-u-oeftir [εʰtː-]Датfrá síðuni
фла́нцевый	adjflansa-
флеби́т	márabetendilsiннксгл-i, æðrabruni [akɹa-]нпмгл-i
фле́гма	f1.síфлегмати́зм2.f, m síфлегма́тик
флегмати́зм	mflegmaинтс0гл-a
флегма́тик	mflegmatikari [-Ꞌmaː-]интмгл-ari
флегмати́ческий	adj síфлегмати́чный
флегмати́чность	f síфлегмати́зм
флегмати́чный	stfфлегмати́ч|ен, ~на, ~но, ~ныadjflegmatiskur [-Ꞌmaː-]интсоглsk
флегмо́на	fflegmona [-Ꞌmoː-]с0гл-aмед.
флейм	m intern.orðastríðс0о{0<>i}, trætaжгл-a(serl. á sosialum miðlum); разду́ть флейм birtair(t)upp undir [ʊˈpʰʊ-] orðastríð
фле́йта	ffloyta [-œi-] (реже[-ɔi-])жгл-a(musikkinstrument) =>волше́бный1
флейти́ст	mfloytuspælari [-œi-] (реже[-ɔi-])мгл-ari
фле́ксия	fmál.1.(способ словоизменения) bendingж0-ar2.(окончание) endingж0-ar(bendingarending)
флекти́вный	adjbendingar-; флекти́вные языки́ bendingarmál
Флемиш-ка́п ба́нка	: Flemish Cap [flεmːɪʃˈkʰaʰpː]м нескл
флепс	[флэ-]: филе́ {разде́лка} флепс butterfly [pɔʰtːεɹflai]с нескл.спец., flapsс0омн спец.
флёр	m1.(ткань) florс0о(tunt klæði)2.fl.,gml.,bókl.(покров) slørс0оперен.
флёрдора́нж	mbrúðarkransurмсогл-ar
фле́шка	[флэ́-]plurфле́ш|ки, ~ек, ~камf tlm.USB-lykil [uː εsː Ꞌpeː-]м0осн-s,-ar, geymiмгл-i
флеш-ка́рта	[флэ́-]fUSB-lykil [uː εsː ˈpeː-]мосн-s,-ar, geymiмгл-i
флешмо́б	(eis.[флэ-])mflashmob [flaʃmɔp]м0{0<>i},ж0-ir
флеш-па́мять	[флэ-]fflash-goymsla [flaʃ-]жгл-a
флибустье́р	msjórænariмгл-ari
фли́гель	plurфлигел|я́, ~е́й, ~я́мoggml.~и ~ей, ~ямmvongurмсогл-ir{+};-s,-ir{+}(á húsum); armurмсогл-ar{a/ø}(á húsum)
фли́гель-адъюта́нт	msøg.adjutantur [-Ꞌtʰa-]мсогл-ar(hjá tsarinum)
флирт	mflirtur [flœɹ̥t-]ннкмсогл-ar
флиртова́ть	флирту́|ю, ~ешь, ~ютipf с кем-л.flirta [flœɹ̥ta]ннкaði
флокс	m(Phlox) floksс0о, flammublómaжгл-a
флома́стер	mfiltpennurмсогл-ar
фло́ппи-диск	mfloppy [flɔʰpːi] diskм0-ar(опр-ur)
флор	mdúrkс0о(serliga í maskinrúmi o.ø.)
фло́ра	ffloraжгл-a, gróðurс0осн(растение)
Флоре́нция	fFirenze [-Ꞌrεn̊sε] (тж[-Ꞌrεn̊tsε])м нескл., Florensм0{дат.0}уст.
Флори́да	f1.(полуостров) Florida [flɔrita]ж нескл.(hálvoyggj)2.(штат) Florida [flɔrita]м нескл.(statur)
флори́н	mflorin [-Ꞌriːn]ж0-ir
флот	mflotiмгл-i; морско́й флот havgangandi floti; вое́нно-морско́й флот (ВМФ) marina [-Ꞌriː-]жгл-a, herfloti; поступи́ть во флот fara upp í flotan, gerast marinari [-Ꞌriː-]; служи́ть в {на} фло́те vera marinari [-Ꞌriː-]ннк=>возду́шный2,торго́вый
флоти́лия	f1.(военные суда) flotadeildж0-ir(herfloti)2.(отряд судов) flotiмгл-i(fiskiskip o.a.)
флотово́дец	Gen, Accфлотово́дц|а; plur~ы, ~ев, ~амmhátíð.flotaovastiмгл-i
фло́тский	1.adj(кфлот) flota-, marinu- [-Ꞌriː-] (тк о военно-морском флоте)2.mtlm.(служащий во флоте) marinari [-Ꞌriː-]ннкмгл-ari
флэпс	síфлепс
флэш-па́мять	f síфлеш-па́мять
флюга́рка	plurфлюга́р|ки, }ок, ~камm1.(часть флюгера) veðurhaniмгл-i(um sjálvan tann partin,sum melur)2.(флажок) vimpilм0осн(á báti o.ø.)3.(над дымовой трубой) roykhettaжгл-а
флю́гер	1.plurфлюгер|а́, ~о́в, ~а́мoggml.флю́гер|ы, ~ов, ~амm(прибор) veðurhaniмгл-i2.fl.plurфлю́гер|ы, ~ов, ~амogtlm.флюгер|а́, ~о́в, ~а́мm(о человеке) vinglс0о, vingliskølturмсогл-arпренебр.
флюи́ды	m plurfl.útstrálingж0-ar
флюоресце́нтный	adjfluorescerandi [-Ꞌseː-]глandiспец.
флюоресци́ровать	флюоресци́ру|ю, ~ешь, ~ютipffluorescera [-Ꞌseː-]aðiспец.
флюорогра́фия	ffotografering [-Ꞌfeː-]ж0-irav mynd á skermi
флюс1	Im(опухоль) tannbúldннкж0-ir, tannsvullur [-tl-]лпмсогл-ar;согл-s,-ir
флюс2	IImtekn.flusс0о(til jarnsmelting, lodding o.tíl.), flusmiddilннкс0оснпроф.
фля́га	ffeltfløskaжгл-a; lummafløskaжгл-a, pisaжгл-aшутл.(fløska) (для водки и т.п.)
фля́жка	plurфля́ж|ки, ~ек, ~камf síфля́га
ФНПР	[фэ-эн-пэ-э́р]f indeclФедера́ция незави́симых профсою́зов Росси́и Sambandið av óheftum russiskum fakfeløgum [faː-]
ФНС	[фэ-эн-э́с]f indeclФедера́льная нало́говая слу́жба Føderala [-ˈraː-] skattatænastan (í Russlandi)
ФОБ	[фоб]n indeclСвобо́дно по бо́рту fob [fɔpː], FOB [fɔpː], Free On Boardангл.
фо́бия	ffobi [-Ꞌpiː]ж0-irспец.
ФОБС	[фобс]n indeclФОБ с погру́зкой fobs [fɔps], FOBS [fɔps], Free On Board Stowedангл.
фойе́	n indeclforhøll [-tl]ж0-ir{ø/a}, foyer [fwaꞋjeː]ннкмгл-гл
фок	mfokkaжгл-a
фок-ма́чта	fstórmastur [stœ-]ж0осн
фокстерье́р	[-тэ-]mfoksterriariмгл-ari
фокстро́т	mfoxtrot {fokstrott} [fɔʰkstʰɹɔʰtː]м0-ar(опр-ur)
фо́кус1	Im1.fys.,mat.(точка пересечения лучей) fokusс0о{0<i}, brennidepilнпм0осн-s,-ar2.foto(в фотографировании) fokusс0о{0<i}; наводи́ть на фо́кус setaur(t);ir(t)í fokus, fokusera [-Ꞌseː-]aði; сни́мок не в фо́кусе myndin er ikki í fokus3.lækn.(очаг воспаления) centrum [sε-]с0-um, miðdepil [miːt-], [mɪt-]нпм0осн-s,-ar(fyri bruna o.tíl.)4.fl.(средиточие) fokusс0о{0<>i}; miðdepil [miːt-], [mɪt-]м0осн-s,-ar(центр); в фо́кусе внима́ния í fokus, í brennideplinumкн.; фо́кус землетрясе́ния miðdepilin fyri jarðskjálvtan [jaʂʃɔl̥t-]
фо́кус2	IIm1.(трюк) tryllikunstur [-ʏlː-]ннкмсогл-s,-ir, gandakynsturс0оснкн.; пока́зывать фо́кусы vísa kunstir; ка́рточный фо́кус kortkunstur2.(сложность,секрет) kunsstykkiсгл-i, kunsturмсогл-s,-ir; в э́том-то и фо́кус tað er nettupp tað, sum er kjarnan [-tn-] í málinum; э́то не фо́кус hetta er eingin kunstur3.(уловка) snildж0-ir, hokupokus [ˌhoːkʊsꞋpʰoː-]с0o({0<>i})4.mest plur(капризы)tlm.grillaннкжгл-a, lúnurжгл-aмн, ríggjurжгл-aмн; он вы́кинул фо́кус tað skeytst upp á hann, tað stakst upp á hann
фокуси́ровать	фокуси́ру|ю, ~ешь, ~ютipf/pf(pf eis.сфокуси́роватьсфокуси́ру|ю, ~ешь, ~ют)что-л.1.foto,fys.(собирать лучи в фокус;устанавливать фокус) fokusera [-Ꞌseː-]aðio-t2.на чём-л.bókl.(ставить в центр) fokusera [-Ꞌseː-]ннкaðiupp á o-tпубл.
фо́кусник	m1.(артист) tryllikunstnari [-ʏlː-]ннкмгл-ari, gandakallur [-tl-]нпмсогл-ar{a/ø}2.tlm.(ловкач) fuppmakariмгл-ariпренебр., snýtariмгл-ari3.tlm.(капризный человек) lúnuskølturмсогл-ar
фо́кусничать	ipftlm1.(капризничать) vera lúnuturсогл2. (хитрить, лукавить) brúkaar(t)snildir3.(манерничать) vera tilgjørdurсогл, geraнепрseg Ꞌ til, geraнепрseg Ꞌ upp
фо́кусный	adj: фо́кусное расстоя́ние brennivíddж0-ir
фол	m ítr.brotс0оá reglur (í ítrotti)
фолиа́нт	mbókl.foliantur [-Ꞌa-]мсогл-ar
фолк	mfolk-tónleikur [fɔuk-]мсогл-s,-ir
фолк-гру́ппа	ffolk-bólkur [fɔuk-]мсогл-ar
фолк-кома́нда	ffolk-bólkur [fɔuk-]мсогл-ar
Фолкле́ндские острова́	Falklandsoyggjarnar [-lan̊s-]ж0-ar{+}мн опр.
фолк-му́зыка	ffolk-tónleikur [fɔuk-]мсогл-s,-иr, folk-musikkur [fɔuk-]мсогл-ar
фолк-ро́к	mfolk [fɔuk] rockur [rɔʰkː-] folk [fɔuk] {rokkur}мсогл-ar
фолли́кул	mfollikul [-Ꞌliː-]м0осн-s,-arспец.
фолло́вер	mfylgjariмгл-ari(á netinum o.a.)
фольга́	ffoliaжгл-a; silvurpappír [sʏlpʰapʰʊiɹ]с0о(тонкая для упаковки)
фо́льга	fgml.,fakm.síфольга́
Фо́лькетинг	mFólkatingiðс0oопр.(в Дании)
фолькло́р	mfólkaminniсгл-iмн, folklore [fɔl̥kloːɹ]с0о{дат.0}
фольклори́ст	mfólkaminnisfrøðingurмсогл-ar
фольклори́стика	ffólkaminnisfrøðiжгл-i
фолькло́рный	adjfólkaminnis-
Фома́	mbíbl.o.a.Tummasм0-ar{0<>i}@неве́рный {неве́рующий} Фома́tann vantrúni Tummas
фон1	Im1.(задний план) bakgrundж0-ir; botnurмсогл-ar, grundlitur [kɹʊnl-]мсогл-ir(основной цвет); на све́тлом фо́не á ljósari bakgrund, á ljósum botni; основно́й фон ковра́ grundliturin í teppinum; дом видне́ется на фо́не тёмного не́ба húsið dagar upp móti luftini; радиоакти́вный фон bakgrundsradioaktivitetur [-kɹʊn̊s-]2.(в приёмнике и т.п.) bakgrundsóljóð [-kɹʊn̊s-]с0о@на фо́нечего-л.viðo-mí huga; afturímóti [aʰtːʊɹʊiꞋmɔutɪ]o-m=>выделя́ться2
фон2	IImfys.(единица) fonс0о
фона́рик	m(lítil) lyktж0-ir; карма́нный {электри́ческий} фона́рик lummalykt
фона́рный	adjlykta(r)-; фона́рный столб lyktarpeli, lyktarsteyri
фона́рь	Genфонар|я́; plur~и́, ~е́й, ~я́мm1.(прибор) lyktж0-ir; lanterna [-Ꞌtʰε-]жгл-a(на судне); у́личный фона́рь gøtulykt, gøtuljósс0о; карма́нный фона́рь lummalykt2.arkit.(выступ в здании) karnappur [-Ꞌna-]мсогл-ar; yvirljósс0о(стеклянная крышка)3.tlm.,skemt.(синяк) blátt eygaсгл-a(av slag o.ø.); подста́вить {наста́вить} фона́рькому-л.gevaслнa-ó-io-meitt blátt eyga@мне э́тодо фонаря́óvkm. eg leggi ein lort í taðгрубо, eg skíti á taðгрубо;ты что, с фонарём?tlm.,atf.ert tú rættsiktaður? =>волше́бный@
фонд	m1.(денежные средства) grunnurмсогл-ar; фонд зарабо́тной пла́ты løngjaldingargrunnur2.(запас) goymslaжгл-a; фонд библиоте́ки bókagoymslurnar hjá [tʃ-] bókasavni, beholdningurin [-Ꞌhɔln-]ннкпроф.av bókum hjá [tʃʰ-] bókasavni; жили́щный фонд bústaðirмсогл-ir(meingið av húsum og íbúðum einum øki,landi); земе́льный фонд Росси́и jørðin í Russlandi (alt landið)3.plur(ценные бумаги) virðisbrøvс0о{æ/ø}4.(организация) grunnurмсогл-ar; Росси́йский фонд культу́ры tann russiski mentunargrunnurin; фонд иму́щества ognargrunnur (ið fæst við privatisering o.a. av almennari ogn)@золото́й фондa)beinl.(золотой запас) gullgoymsla; b)fl.(о ком-л.,чём-л. особенно ценном) tann dýrabarasta ognin =>резе́рвный
фо́ндовый	adj1.(кфонд 1, 2) gruns-2.(кфонд 3) virðisbræva-; фо́ндовая би́ржа virðisbrævabørsur, fondsbørsur
фоне́ма	[-нэ́-]ffonem [-Ꞌneːm]с0о
фонемати́ческий	[-нэ-]ffonem- [-Ꞌneːm], fonematiskur [-Ꞌmaː-]соглsk
фонендоско́п	[-нэ-]mstetoskop [-Ꞌskoːp]с0о
фоне́тика	[-нэ́-]f1.(звуковой строй) ljóðskipanж0-ir, fonetikk [-Ꞌtʰɪʰkː]ж0-irпроф.2.(наука) ljóðlæraжгл-a, ljóðfrøðiжгл-i, fonetikk [-Ꞌtʰɪʰkː]ж0-irпроф.
фонети́ст	[-нэ-]mfonetikari [-Ꞌneː-]мгл-ari, ljóðfrøðingurлпмсогл-ar
фонети́ческий	[-нэ-]adj1.(касающийся звукового строя) ljóð-, ljóðligurглigur, fonetiskur [-Ꞌneː-]соглskпроф.; фонети́ческий зако́н ljóðlóg2.(касающийся науки) ljóðfrøðiligurглigurспец., fonetiskur [-Ꞌneː-]соглskпроф.=>знак1
фо́новый	adjbakgrunds-; фо́новое излуче́ние bakgrundsstráling
фоногра́мма	fljóðupptøkaжгл-a(á diskli,plátu,bandi)
фоно́граф	mfonografur [-Ꞌkɹaː-]мсогл-ar
фонологи́ческий	adjfonologiskur [-Ꞌloːk-]соглsk, ljóðskipanarligurлпглigur
фоноло́гия	ffonologi [-Ꞌkiː-]ж0-ir, ljóðskipanarlæraлпжгл-a
фоноте́ка	fljóðbandasavnс0o{a/ø}, upptøkusavnс0o{a/ø}
фонт	mteld.fonturмсогл-ar
фонта́н	m1.(сооружение) springvatnс0о{a/ø}, gosbrunnurнпмсогл-ar2.(струя жидкости) sprænurмсогл-s,-ir; фонта́н не́фти oljusprænur; кровь бьёт фонта́ном из ра́ны blóðið sprænir úr sárinum; фонта́н (от) кита́ blásturм0осн-a,-ar;-ar,-arhjá [tʃʰ-] hvali3.fl.,tlm.,atf.(поток) floymurмсогл-ar, flóðж0-ir; фонта́н красноре́чия ein flóð av tungusnildi; фонта́н слёз táraflóð@бить фонта́номsprænair(d), spríkjair(t);заткни́ фонта́нtlm.,skemt.tig onkuntíð við tær;э́то не фонта́нtlm.,skemt.hetta hevur lítið upp á seg
фонтани́ровать	фонтани́ру|ет, ~ютipfsprænair(d)(upp), spríkjair(t)(upp)
фо́ра	f: дать фо́рукому-л.a) (дать преимущество) gevao-mfyrimun; b)fl.(превзойти) leggjaнепрo-naftur um [aʰtːʊrꞋumː] seg, faraслнó-ó-afram Ꞌ umo-n
фораминифе́ра	f(подтип Foraminifera) holberiмгл-iбиол.
фо́рвард1	Im ítr.(в футболе) forward [fɔːɹvɔɹt]м0-ar(опр-ur), framherjiмгл-i
фо́рвард2	IIm fíggj.(сделка, документ) forwardsáttmáli [fɔːɹvɔɹt-]мгл-iфин., terminssáttmáli [-ˈmiː-]мгл-iфин.
фо́рвардный	adj: фо́рвардный контра́ктsíфо́рвардII
фордеви́нд	[-дэ-]mfordevind [-Ꞌvɪnt]м нескл.(б.ч. о судах), undangongaжгл-a; идти́ в фордеви́нд siglair(d){+}undan, siglair(d){+}fordevind (б.ч. о судах)
фордыба́чить	фордыба́ч|у, ~ишь, ~атipfóvkm.síфордыба́читьСЯ
фордыба́читься	фордыба́ч|усь, ~ишься, ~атсяipfóvkm.vera tvørurсогл, vera treiskurсоглsk
форе́йтор	m søg. reiðmaður, ið situr á fremsta rossi í toymi
форелево́дство	(eis. [-рэ́-])nsílaalingж0-ar
форе́левый	(eis. [-рэ́-]) adjsíla-
форе́ль	(eis.[-рэ́-]) f(Salmo trutta) sílс0о, eyrriði [εɹjɪ]мгл-i; европе́йская форе́льsíку́мжа; го́рная форе́ль (Salvelinus alpinus) bleikjaжгл-a; ра́дужная форе́ль (Oncorhynchus mykiss) ælabogasíl
фо́рзац	mprent.forsatsurмсогл-s,-ir
фо́ринт	mforint [-Ꞌrɪ-]ж0-ir
фо́рма	f1.(внешнее очертание,вид) skapс0о, formurмсогл-ar(фигура и т.п.); sniðс0о, líkiмгл-i; квадра́тный по фо́рме fýrkantaður av skapi; стол кру́глой фо́рмы eitt runt borð; име́ть фо́рму ша́ра vera skaptur sum ein kúla, vera sum ein kúla av skapi; в фо́рме ша́ра í kúlulíki, av skapi sum ein kúla, kúluskaptur; с краси́выми фо́рмами við vøkrum formum (о фигуре); изо́гнутой фо́рмы boygdur [pɔkt-]согл; принима́ть всевозмо́жные фо́рмы fáa alskyns skap; спор при́нял о́струю фо́рму orðadrátturin harðnaði2.(тип) slagс0о{a/ø}{0<>i}; líkiсгл-i(способ выражения); в пи́сьменной фо́рме skrivliga, í skrivligum líki; в фо́рме письма́ sum bræv; тяжёлая фо́рма диабе́та ein álvarslig typa [tʰyː-] av sukursjúku3.(система, совокупность приёмов) slagс0о{a/ø}{0<>i}, skipanж0-ir; formurмсогл-ar(stjórnarlag o.tíl.); фо́рма и содержа́ние formur og innihald (í list); фо́рмы рабо́ты sløg av arbeiði; фо́рмы эне́ргии sløg av orku, orkuformar; фо́рмы стиха́ yrkingaformar; национа́льный по фо́рме tjóðskaparligur í skapi; фо́рма правле́ния stýrislag4.tekn.(приспособление) formurмсогл-ar; отли́тый в фо́рме stoyptur í formi; лите́йная фо́рма stoypiformur5.(одежда) uniformur [-Ꞌfɔ-]ннкмсогл-ar, eyðkennisbúni [εʰtʃ-]нпжгл-iофиц.; búniжгл-i(б.ч. у скаутов,спортсменов и т.п.); шко́льная фо́рма skúlauniformurннк; офице́рская фо́рма offisersuniformur [-Ꞌseː-]ннк; носи́ть фо́рму ganga í uniformiннк6.mál.(средство внешнего выражения) formurмсогл-ar; фо́рмы словоизмене́ния bendingarformar, bendingarsnið; основны́е фо́рмы глаго́ла grundformarnir hjá [tʃʰ-] sagnorðinum7.(образец) forskriftж0-ir, fyriskipanж0-ir8.(бланк) oyðublaðс0о{a/ø}{0<>i}, blankett [-ˈkʰεʰtː]ннкж0-ir; formularur [-ˈlaː-]мсогл-arпроф.9.ítr.(состояное человека) formurмсогл-ar, konditión [-Ꞌʃɔun]ж0-ir; не в фо́рме ikki í formi; он в хоро́шей фо́рме hann er í góðum formi@по {во} всей фо́рмеsoleiðis, sum gerast skal =>вое́нный2,вну́тренний@,прилага́тельное
формали́зм	m1.(соблюдение внешней формы) formalisma [-Ꞌlɪ-]жгл-a2.bókm.,list(направление в искусстве и др.) formalisma [-Ꞌlɪ-]жгл-a
формали́н	mformalin [-Ꞌliːn]с0о({0<>i})
формали́ст	m1.(соблюдающий внешние формы человек) formalistur [-Ꞌlɪ-]мсогл-ar2.bókm.,list(кформали́зм 2) formalistur [-Ꞌlɪ-]
формали́стика	ftlm.,atf.formalisma [-Ꞌlɪ-]жгл-a(формали́зм 1), formalitetir [-Ꞌtʰeː-]мсогл-s,-ir
формалисти́ческий	adjformalistiskur [-Ꞌlɪ-]соглsk
формали́стский	adj síформалисти́ческий
формальдеги́д	[-дэ-]mformaldehyd [-Ꞌhyːt]с0о({0<>i})
форма́льно	advformelt [-Ꞌmε-]ннк, formliga; sum eitt eiti, proforma [-Ꞌfɔ-]ннк(только по названию)
форма́льность	f1.(кформа́льный 1) formalitetur [-Ꞌtʰeː-]мсогл-s,-ir2.(то,что нужно для оформления) formalia [-Ꞌmaː-]с нескл. мн, formalitetir [-maːliꞋtʰeː-]мсогл-s,-irмн
форма́льный	stfформа́лен, форма́льн|а, ~о, ~ыadj1.(официальный, законный) formellur [-Ꞌmεlː-]согл, formligurнпглigur; форма́льный отка́з formelt nei, formligtнпnei; в форма́льном отноше́нии formelt, formligaнп2.(об отношении к делу) formalistiskur [-Ꞌlɪ-]соглsk, bureaukratiskur [pyːɹoꞋkʰɹaː-]соглsk3.(по видимости) at síggja til, sum eitt eiti@форма́льная ло́гикаformellur [-Ꞌmεlː-]соглlogikkur [-Ꞌkɪ-]
форма́т	mformat [-Ꞌmaːt]с0о(stødd á blað,bók o.tíl.), støddж0-ir(á blað,bók o.tíl.)
формати́рование	nteld.formatering [-Ꞌtʰeː-]ж0-ar
формати́ровать	формати́ру|ю, ~ешь, ~ютipf/pf что-л.teld.formatera [-Ꞌtʰeː-]aðio-t
форма́ция	f1.:обще́ственно-экономи́ческая форма́ция samfelagsskipanж0-ir2.bókl.(тип,структура)o-t, sum verður skapt;o-t, sum verður myndað3.jarðf.(о горных породах) formatión [-Ꞌʃɔun]ж0-irгеол.
фо́рменка	plurфо́рмен|ки, ~ок, ~камftlm.,skip.(uniforms)blusa [-Ꞌfɔ-]жгл-a
фо́рменный	adj1.(установленного образца) uniforms- [-Ꞌfɔ-]ннк, eyðkennis- [εʰtʃ-]нп; фо́рменная фура́жка uniformskaskett [-Ꞌfɔ-]2.tlm.(сущий) ordiligurннкглigur, sannurсогл{a/o}, rætturсогл{æ/ø}; фо́рменный бой rættiligur bardagi; фо́рменным о́бразом reiðiliga; он стал фо́рменным специали́стом hann er blivin ein rættur serfrøðingur
формирова́ние	n1.(действие) gerðж0-ir, myndanж0-ir; формирова́ние прави́тельства skipanж0-irav stjórn [stjœtn]2.(воинская часть) samansetingж0-ar, skipanж0-ir(av herdeild o.t.)3.(отряд) (her)deildж0-ir
формирова́ть	формиру́|ю, ~ешь, ~ютipf(pfсформирова́тьсформиру́|ю, ~ешь, ~ют)что-л.1.(создавать,составлять) setaur(t);ir(t)o-tsaman, myndaaðio-t; формирова́ть прави́тельство skipa stjórn [stjœtn]; формирова́ть полк seta eitt regiment [reːkiꞋmε-] saman2.fl.(придавать определённую форму) skapaaðio-t, formaaðio-t, myndaaðio-t; формирова́ть мировоззре́ние skapa eina heimsáskoðan, forma eina heimsáskoðan
формирова́ться	формиру́|юсь, ~ешься, ~ютсяipf(pfсформирова́тьсясформиру́|юсь, ~ешься, ~ются)1.(слагаться) skapastaði;ar(t), myndastaði2.bert 3. pers brúktur(составляться) verða setturсоглsaman3.(развиваться) búnastaði
формова́ть	форму́|ю, |ешь, ~ютipf(pfсформова́тьсформу́|ю, ~ешь, ~ют, отформова́тьотформу́|ю, ~ешь, ~ют)что-л.1.(придавать форму) formaaðio-t, evnaaðio-ttil; modellera [moːtɪꞋleː-]ннкaðio-t2.(литейную форму) geraнепр(stoypi)form
формо́вка	fformingж0-ar, tilevningж0-ar; modellering [moːtɪꞋleː-]ннкж0-ar(из пластичного материала и т.п.)
формово́й	adj1.síформо́вочный2.(пригодный для отливки) klárurсоглat koyra í form3.(сделанный в форме) forma-; формово́й хлеб formabreyð
формо́вочный	adjform-, forma-
формо́вщик	mformariмгл-ari
Формо́за	fFormosa [-Ꞌmoː-]ж нескл.,síТайва́нь
формообразова́ние	nmyndanж0-irav formum (sløgum o.ø.)
формообразова́тельный	adjmál.formmyndandiглandi, orðmyndandiглandi
фо́рмула	mformilм0осн-s,-ar
формули́ровать	формули́ру|ю, ~ешь, ~ютipf(pfсформули́роватьсформули́ру|ю, ~ешь, ~ют)что-л.orðaaðio-t, formulera [-Ꞌleː-]ннкaðio-t
формулиро́вка	plurформулиро́в|ки, ~ок, ~камf1.(действие) orðingж0-ar, formulering [-Ꞌleː-]ннкж0-ar2.(выражение) orðalagс0о{a/ø}, orðingж0-ar, formulering [-Ꞌleː-]ннкж0-ar
формуля́р	m1.(библиотечная карточка) lánarakortс0о(читателя); útlánskortс0о(книги)2.(машины и т.п.) maskinbók [-Ꞌʃiː-]ж0-ur{ó/ø}, maskinjournal [-Ꞌʃiːnʃʊɹnaːl]ж0-ir, loggbókж0-ur{ó/ø}(har upplýsingar um brúk o.a. verða førdar inn)3.gml.(послужной список) tænastubókж0-ur{ó/ø}(hjá embætismonnum o.ø til 1917)
форпи́к	mskip.forpeakur [-pʰiːk-]мсогл-arмор., forpikkurмсогл-arмор.
форпо́ст	m1.(передовой пост) forposturмсогл-ar2.fl.(передовой пункт) forposturмсогл-arперен.,неформ.
форс	móvkm.:для фо́рсу fyri at vísa seg, fyri at gera seg upp =>сбить@
форси́рование	n1.(ускорение) økingж0-ar(av ferð o.tíl.); tað at skunda undir2.(кфорси́ровать 2) tað at bróta seg yvir um, tað at bróta seg,síфорси́ровать(русскому отглагольному сущ. в переводе часто или предпочтительно соответствует глагольная форма)
форси́рованный	Ipartic avфорси́роватьIIstfфорси́рован, ~на, ~но, ~ныadj: форси́рованный марш snarmarsjur, sprongdarmarsjur; форси́рованными те́мпами við miklari ferð, av grimd
форси́ровать	форси́ру|ю, ~ешь, ~ютipf/pf что-л.1.(темп) økjair(t)umo-t, setaur(t);ir(t)o-tupp (ferð); skundaaðiundiro-t, hurtaaðiundiro-t; koyrair(d)undiro-t(наступление события и др.); форси́ровать ве́чный шахtalvforcera {forsera} [-Ꞌseː-]aðiævigt skákшахм., framtvingaaðiævigt skákшахм.2.herm.(водный рубеж и др.) brótaслнey-u-oseg yvir Ꞌ umo-t(на другую сторону чего-л.), brótaслнey-u-oseg gjøgnumo-t(через что-л.)
форси́ть	форшу́, форс|и́шь, ~я́тipfóvkm.geraнепрseg Ꞌ upp, erpaaðisær
форс-мажо́р	mforce majeure [fɔʂmaꞋʃøːɹ]с0оспец., торг.
форс-мажо́рный	adjforce majeur- [fɔʂmaꞋʃøːɹ-]; форс-мажо́рные обстоя́тельства force majeur [fɔʂmaꞋʃøːɹ] umstøðurторг.
форсу́нка	plurфорсу́н|ки, ~ок, ~камfdysa [tyː-]жгл-a
форт	Prpо фо́рте, в форту́; plurфорты́, ~о́в, ~а́мmfortннкс0о, skansiмгл-i, virkiсгл-i
фо́рте	[-тэ]IadvforteIIn indeclforteс нескл.
фо́ртель	mtlm.páfunnннкс0о, innskotс0о; вы́кинуть фо́ртель takaслнó-ó-io-ná bóli
фортепья́нный	[-тэ-]adjklaver- [-Ꞌveːɹ-], piano- [-Ꞌaː-]; фортепья́нный конце́рт klaverkonsert [-Ꞌveːɹ-]
фортепья́но	[-тэ-]n indeclklaver [-Ꞌveːɹ]с0о, piano [-Ꞌaː-]с0гл(-inum)
форти́ссимо	advfortissimo [-ˈtʰɪ-]
фортификацио́нный	adjfestnings-ннк, virkis-; фортификацио́нное сооруже́ние virkiсгл-i, skansiмгл-i; verndarvirkiсгл-i
фортифика́ция	f1.(наука) virkisgerðж0-ir, skansagerðж0-ir2. (фортификационное сооружение) virkiсгл-i, skansiмгл-i, verndarvirkiсгл-i3.(фортификационные работы) skansaarbeiðiсгл-i, arbeiðiсгл-iupp á virki
фо́ртка	plurфо́рт|ки, ~ок, ~камf síфо́рточка
Форт-Лами́	m indeclFort-Lamy [-Ꞌmiː]м нескл.,síНджаме́на
фо́рточка	plurфо́рточ|ки, ~ек, ~камftrekkrúturмсогл-ar;-s,-ir, trekkvindeyga [-vɪnta] (реже[-vintεija])сгл-a
Форту́на1	Ifmyt.Fortuna [-Ꞌtʰuː-]жгл-a
форту́на2	IIfgml.eydnanжгл-aопр.; lagnanжгл-aопр., forløgс0o{a/ø}мнбалл., выс.(судьба) =>колесо́@
фо́рум	m1.søg.(площадь) forumс0o({0<>i})(opið pláss)2.(собрание) (ráð)stevnaжгл-a, (fjøldar)fundurмсогл-ir
форшма́к	Genфоршмака́m hakkað sild el. kjøt bakað saman við eplum
форште́вень	[-штэ́-]Genфорште́вн|я;plur.~и, ~ей, ~ямmframstevniс0о, framstavnurмсогл-ar
фосге́н	mfosgen [-Ꞌkeːn]с0о({0<>i})
фосфа́т	mfosfat [-Ꞌfaːt]с0о(;0-ir)({0<>i})
фо́сфор	mfosforс0о({0<>i})
фосфоресце́нция	ffys.fosforescensur [-Ꞌsε-]мсогл-arспец., tað at vera sjálvvlýsandi [ʃɔl-]
фосфоресци́ровать	фосфоресци́ру|ет, ~ютipfvera sjálvlýsandi [ʃɔll-]глandi, fosforescera [-Ꞌseː-]aðiспец.
фосфоресци́рующий	adjsjálvlýsandi [ʃɔl-]глandi, fosforescerandi [-Ꞌseː-]глandi
фосфори́т	fosforitt [-Ꞌrɪʰtː]с0о({0<>i})
фосфори́ческий	adjsjálvlýsandi [ʃɔl-]глandi, fosforescerandi [-Ꞌseː-]глandiспец.
фо́сфорный	adjfosfor-; фо́сфорная бо́мба fosforbumba
фо́тик	m óvkm.fotografiapparat [-ˈfiːaʰpːaraːt]ннкс0о, fototólнпс0о; kamera [kʰaː-]с0огл-аспец.
фо́тка	plurфо́т|ки, ~ок, ~камf óvkm.fotografi [-ˈfiː-]с0о, fotomyndнпж0-ir, fotoс0гл(-num)
фо́ткаться	ipf óvkm.fotografera [-ˈfeː-]aðiseg, takaслнó-ó-ifotografi [-ˈfiː] av sær, verða fotograferaður [-ˈfeː-], lataслнæ-ó-aseg fotografera [-ˈfeː-], lataслнæ-ó-aseg av avmynda
фо́то	n indecltlm.fotografi [-Ꞌfiː]ннкс0о, fotomyndнпж0-ir, fotoс0гл(num)
фотоаппара́т	mfotografiapparat [-Ꞌfiːaʰpːaraːt]ннкс0о, fototólнпс0о; kamera [kʰaː-]с0гл-aспец.
фотоателье́	[-тэ-]n indeclfotoatelier [-atʰeːlieː]ннкс0опроф., myndastovaлпжгл-a
фотобума́га	ffotopappírс0о
фотогени́чный	stfфотогени́ч|ен, ~на, ~но, ~ныadjfotogenur [-Ꞌkeː-]ннксогл
фото́граф	mfotografur [-Ꞌkɹaː-]мсогл-ar, ljósmyndariлпмгл-ari, myndatakariлпмгл-ari
фотографи́рование	nfotografering [-Ꞌfeː-]ж0-ar, ljósmyndanлпж0-ir
фотографи́ровать	фотографи́ру|ю, ~ешь, ~ютipf(pfсфотографи́роватьсфотографи́ру|ю, ~ешь, ~ют)Accfotografera [-Ꞌfeː-]aðiВин, takaслнó-ó-ieina (foto)myndav Дат
фотографи́роваться	фотографи́ру|юсь, ~ешься, ~ютсяipf(pfсфотографи́роватьсясфотографи́ру|юсь, ~ешься, ~ются) takaслнó-ó-ofotografi [-Ꞌfiː-] av sær, lataслнæ-ó-aseg fotografera [-Ꞌfeː-], lataслнæ-ó-aseg avmynda
фотографи́ческий	adjfotografiskur [-Ꞌkɹaː-], fotografi- [-Ꞌfiː-], ljósmynda-лп
фотогра́фия	f1.(действие) fotografering [-Ꞌfeː-]ж0-ar2.(снимок) fotografi [-Ꞌfiː-]с0о, fotomyndнпж0-ir, fotoс0гл(-num)3.síфотоателье́; мне на́до в фотогра́фиютжeg má fara til fotografin [-Ꞌkɹaː-]
фотока́рточка	plurфотока́рточ|ки, ~ек, ~камffotografi [-Ꞌfiː]с0o, fotomyndнпж0-ir, fotoс0гл(-num)
фотоко́пия	ffotokopiс0о, ljóstakлпс0о{a/ø}; снима́ть {сде́лать} фотоко́пию taka eitt fotokopi, gera eitt fotokopi
фотокорреспонде́нт	m síфоторепортёр
фотолюби́тель	famatørfotografur [aːmaꞋtʰøːɹfoːtokɹaː-]мсогл-ar, áhugafotografur [-kɹaː-]мсогл-ar
фото́метр	mljósmálariмгл-ari, ljósmátariмгл-ari
фотометри́ческий	adjljósmálingar-, ljósmátatingar-
фотоме́трия	fljósmálingж0-ar, ljósmátingж0-ar
фотомоде́ль	[-дэ́-]ffotomodellж0-ir
фотомонта́ж	mfotomontasja [-tʰaː-]жгл-a
фото́н	mfoton [-ˈtʰoːn]ж0-ir
фотонабо́р	mfotosatsurмсогл-ar
фотонабо́рный	adj: фотонабо́рная маши́на fotosetimaskina
фотоплёнка	plurфотоплён|ки, ~ок, ~камffilmurмсогл-ar;-s,-ir(til fotografiapparat)
фоторепорта́ж	mfotoreportasja [-tʰaː-]жгл-a, myndafrásøgnнпж0-ir{ø/a}
фоторепортёр	mpressufotografur [-kɹaː-]мсогл-ar
фотоси́нтез	[-тэ́з]mfotosyntesa [-sʏn-]жгл-a, ljóssamevningлпж0-ar
фотосни́мок	Genфотосни́м|ка; plur~ки, ~ков, ~камmfotografi [-Ꞌfiː]с0о, fotomyndнпж0-ir, fotoс0гл(-num)
фотоста́т	mfotostatur [-staː-]мсогл-ar
фотосфе́ра	ffotosfera [-ˈsfeː-] жгл-aпроф., ljóshválvлпс0о
фотосъёмка	plurфотосъём|ки, ~ок, ~камffotografering [-Ꞌfeː-]ж0-ar
фототелегра́мма	fgml.myndatelegramm
фототелегра́ф	mgml.myndatelegrafur [-kɹaː-]мсогл-ar
фототерапи́я	[eis.-тэ-]fljósviðgerð [vɪtʃ-]ж0-ir
фототи́пия	fljósprentс0о
фотофи́ниш	mmálfotoс0гл(-num)
фотохи́мия	ffotokemi [-kʰeˌmiː]ж0-ir
фотоэлеме́нт	mfotocella [-sεlːa]ннкжгл-aпроф., ljóskyknaнпжгл-a
ФПГ	[эф-пэ-гэ́]fФина́нсово-промы́шленная гру́ппа (samtak av feløgum í fíggjar-og ídnaðargeiranum)
фрагме́нт	mbrotс0о, fragment [-Ꞌmε-]ннкс0опроф.(úr teksti,musikkverki o.ø.)
фрагмента́рный	stfфрагмента́р|ен, ~на, ~но, ~ныadjsum er í brotum; í pettum, fragmentariskur [-Ꞌtʰaː-]ннксоглskпроф.(отрывочный)
фра́ер	(eis.фраер|а́, ~о́в, ~а́м)m1.jarg.(мужчина) fýrurэнкмсогл-arнеформ.(mannfólk)2.jarg.,óvkm.(франт) lapsurмсогл-arнеодобр., mótaprinsurмсогл-arнеодобр.3.jarg.,óvkm.(неопытный,наивный человек) muaжгл-aпренебр.(um fólk)4.jarg. (человек, не имеющий отения к преступному миру)o-r, sum ikki hoyrir til tann kriminella heimin(i málinum hjá brostsmonnum o.tíl.. síблатно́йII)
фра́за	f1.(предложение) setningurмсогл-ar(í máli)2.atf.(напыщенное выражение) innantómt orðс0о, frasa [-aː-]ннкжгл-a, tómorðс0о; пусты́е фра́зы frasurннк3.(устойчивая) máliskaжгл-a, tiltak [tʰɪl̥t-]с0о{a/ø}4.mus.(ряд звуков,аккордов) frasa [-aː-]жгл-a
фразеологи́ческий	adjmál.sum viðvíkur tiltøkum,sum viðvíkur orðafellum [-tl-], fraseologiskur [fɹaːseoꞋloːk-]соглskспец.; фразеологи́ческий слова́рь orðabók yvir tiltøk, tiltaksorðabók [tʰɪl̥tʰaʰks-], orðabók yvir orðafellir [-tl-]
фразеоло́гия	f1.(наука) fraseologi [fɹaːseoloꞋkiː]ж0-irспец., vísindiniсгл-iмнum tiltøk o.a., máliskufrøðiлпжгл-i2.(совокуоность фразеологизмов) tiltøkс0о{a/ø}мн, máliskurжгл-aмн, orðafellir [-tl-]сгл-iмн3.(пустые фразы) tóm orðс0о, frasur [-aː-]ннкжгл-aмн
фразёр	matf.o-r, sum brúkar frasur [fɹaː-]ннк;o-r, sum brúkar tómorðкн.
фразёрство	ntað at brúka frasur [fɹaː-]ннк; tað at brúka tómorðкн.
фра́йер	m síфра́ер
фрак	mkjóliмгл-i(velajakki til mannfólk); во фра́кетжí kjóla og hvítt, kjólaklæddurсогл{æ/ø}
фракту́ра	ffraktur [-ˈtʰuːɹ]ж нескл(slag av gotiskari prentaðariskrift)
фракцио́нный	adjfraktións- [-Ꞌʃɔu-]ннк, bólka- (av politiskum flokki o.tíl.)
фра́кция1	If1.(в парламенте) tingbólkurмсогл-ar2.(в партии) fraktión [-Ꞌʃɔun]ннкж0-ir, bólkurмсогл-ar(í politiskum flokki o.tíl.)
фра́кция2	IIfkem.(смеси) fraktión [-Ꞌʃɔun]ж0-irспец.
фраму́га	fovari parturмгл-arav vindeyga
франк	mfrankur [-aŋ̊k-]мсогл-ar
фра́нки	m plur(племя) frankar [-aŋ̊k-]мгл-iмн
франко...	í samansfransk-, franskur, á fronskum; франкоязы́чный franskmæltur
фра́нко-...	í samansfranskur-; фра́нко-ру́сский franskur-russiskur
франт	mlapsurмсогл-ar; mótaprinsurмсогл-ar
франти́ть	франчу́, франт|и́шь, ~я́тipftlm.vera lapsuturсогл, pyntaaðiseg
франти́ха	ftlm.pyntidukkaжгл-aнеодбр., pyntireyvж0-irнеодбр.
франтова́тый	stfфрантова́т, ~а, ~о, ~ыadjlapsuturсогл, pyntuturсогл
франтово́й	adjlapsuturсогл, pyntuturсогл
франтовство́	nlapsarí [-Ꞌrʊi]с0о, pyntisjúkaжгл-a
Франц Ио́сиф	síЗемля́Фра́нцаИо́сифа
Фра́нция	fFrankaríki [-aŋ̊k-]ннксгл-i, Frakland [-εak-]нпс0о{a/o}
францу́женка	plurфранцу́жен|ки, ~ок, ~камffronsk kvinnaжгл-a
францу́з	mfransmaðurмнепр, fraklendingur [-εak-]нпмсогл-ar, fransurмсогл-arкн., уст.
Францу́зская полине́зия	Franska Polynesia [pʰoːlyꞋneː-]с нескл.
францу́зский	adjfranskurсоглnsk{a/o}; францу́зский язы́к franskt [fɹaŋ̊kst]сприлskt{a/o}; на францу́зском языке́ á fronskum@смесь францу́зского с нижегоро́дскимspott.skurvblandingurмсогл-ar;францу́зская боле́зньgml.kynssjúka;францу́зская бу́лкаgml.fransbreyð =>замо́к@
франча́йзер	mfranchisor [fɹantʃʰais-]м0-ar(опр-ур), franchiseveitari [fɹantʃʰais-]мсогл-arэк.
франча́йзи	m indeclfranchisee [fɹantʃʰaisi]мгл-гл, franchisetakari [fɹantʃʰais-]мгл-ariэк.
франча́йзинг	mfranchise [fɹantʃʰais]с0о, franchising [fɹantʃʰais-]ж0-arэк.
фрахт	m1.(плата) fraktж0-ir(gjald), farmagjaldс0о{a/ø}2.(груз) fraktж0-ir(farmur), farmurмсогл-ar; góðsс0особир.
фрахтова́тель	mbefraktari [-Ꞌfɹa-]мгл-ari
фрахтова́ть	фрахту́|ю, ~ешь, ~ютipf(pfзафрахтова́тьзафрахту́|ю, ~ешь, ~ют)что-л.befrakta [-Ꞌfɹa-]aðio-t, fraktaaðio-t, chartra [tʃʰa-]aðio-t(skip til farmaflutning)
фрахто́вщик	mfraktmaðurмнепр, flutningsfelagс0о{a/ø}
фрахто́вый	adjfrakt-, farma-, góðs-
фра́чный	adjkjóla- (til mannfólk); фра́чная па́ра kjólasettс0о, velakjóliмгл-i(til mannfólk)
ФРГ	[фэ-эр-гэ́]f indecl síФедерати́внаяРеспу́блика Герма́ния
фрега́т1	Im(судно) fregatt [-Ꞌkaʰtː]ж0-ir
фрега́т2	IIm(птица) (сем. Fregatide) fregattfuglur [-Ꞌkaʰtː-]мсогл-ar
фреза́	plurфре́з|ы, ~, ~амffresariмгл-ari=>ди́сковый
фре́зерный	adjfresi-; фре́зерный стано́к fresimaskina
фрезерова́ние	nfresingж0-ar
фрезерова́ть	фрезеру́|ю, ~ешь, ~ютipf(pfотфрезерова́тьотфрезеру́|ю, ~ешь, ~ют)что-л.fresaaðio-t
фрезеро́вщик	mfresariмгл-ari(maður, sum arbeiðir við fresimaskinu)
фрезо́вщик	mfresariмгл-ari(fólk)
фрейди́зм	mfreudianisma [fɹɔitiaꞋnɪ-]жгл-a
фрейди́ст	mfreudianari [fɹɔitiꞋaː-]мгл-ari
фрейди́стский	adjfreudianskur [fɹɔitiꞋaː-]соглsk
фрейли́на	[-рэ-]fhoffdama [-taː-]ннкжгл-a, hovkonaжгл-aкн., hovfrúgvжнепркн., выс.
фреймво́рк	[фрэ-]m teld., jarg.framework [fɹεimvœɹ̥k]с0{дат0}комп.
фре́кинг	[фрэ́/]mfracking [fɹaʰkːɪŋk]ж0-arтехн.
френд	[фрэ-]m jarg.vinurмсогл-ir(á sosialum miðlum o.tíl.)
фре́ндить	[фрэ-]фре́нжу, фре́нд|ишь, ~ятipf(pfзафре́ндить [-фрэ́-]зафре́нжу, зафре́нд|ишь, ~ят)кого-л. jarg.geraнепрo-ntil vin (á sosialum miðli o.tíl.)
френоло́гия	ffrenologi [-Ꞌkiː]ж0-ir
френч	m slag av uniformsjakka
фрео́н	mfreon [fɹeːɔn]с0о({0<>i})
фрео́новый	adjfreon- [fɹeːɔn-]
фре́ска	ffreskoж0-ir, freskomálningurмсогл-ar; kálkmálningurмсогл-ar(gjørdur á vátum kálki)
фре́сковый	adjfresko-; фре́сковая жи́вопись freskoж0-ir, freskomálningurмсогл-ar; kálkmálningurмсогл-ar(gjørdur á vátum kálki)
фриво́льность	f1.(кфриво́льный) ósømiligheit [-Ꞌsøː-]ж0-ir, ósiðiligheit [-Ꞌsiː-]ж0-ir, frivolitetur [-Ꞌtʰeː-]мсогл-s,-irред.2.(поступок) ósømilig [-Ꞌsøː-] gerðж0-ir, ósiðilig [-Ꞌsiː-] gerðж0-ir; ósømiligt [-Ꞌsøː-] orð, ósiðiligt [-Ꞌsiː-] orð (высказывание); frivolitetur [-Ꞌtʰeː-]мсогл-s,-irред.
фриво́льный	stfфриво́|лен, ~льна, ~льно, ~льныadjósømiligur [-Ꞌsøː-]глigur, ósiðiligur [-Ꞌsiː-]глigur, frivolur [-Ꞌvoː-]соглред.
фриги́дность	ffrigiditetur [-kiːtiꞋtʰeː-]мсогл-ar
фриги́дный	stfфриги́д|ен, ~на, ~но, ~ныadjfrigidur [-Ꞌkiː-]согл{+}
фриги́йский	adjfrygiskur [-yːk-]соглsk@фриги́йский колпа́кfrygisk húgva
фриз1	Imarkit.frisiннкмгл-iпроф., архит.
фриз2	IIm(народность) frísiмгл-i
фри́зский	adjfrísiskurсоглsk; фри́зский язы́к frísisktсприлskt
фрик	m tlm.freak [fɹiːk]м0-ar(опр-ur)жарг.;originalur [ɔɹkiˈnaː-]энкмсогл-ar, serur knokkurмсогл-ar, serskøltur [sεʂk-]мсогл-ar(чудак)
фрикаде́лька	[-дэ́-]plurфрикаде́|льки, ~лек, ~лькамfkjøtbolliмгл-i(из мяса); fiskabolliмгл-i(из рыбы)
фрикасе́	[-сэ́]n indeclfrikasse {frikase} [-Ꞌseː]ж0-ir
фрикати́вный	adjmál.frikativurсогллингв.; фрикати́вный звук frikativurмсогл-arлингв., trongaljóðс0олингв.
фрикцио́н	mfriktiónskopling [fɹɪʰkˈʃɔunskʰɔpl-]ж0-ar
фрикцио́нный	ffriktións- [-Ꞌʃɔu-]; фрикцио́нная му́фта friktiónskopling [-Ꞌʃɔunskɔpl-]
фрила́нс	m freelancearbeiði [fɹiːlan̊s-]ннксгл-iпроф., freelansarbeiði [fɹiː-]ннксгл-iпроф.,frílansarbeiðiнксгл-iпроф.; fríyrkisarbeiðiлпсгл-i
фрила́нсер	mfreelancari [fɹiːlan̊s-]ннкмгл-ariпроф., freelansari [fɹiː-]ннкмгл-ariпроф.,frílansariннкмгл-ariпроф.; fríyrkismaðurлпмнепр
Фри́таун	mFreetown [fɹiːtʰaun]м0{дат.0}
фро́нда	f1.søg.(во Франции) frondaжгл-a(la fronde, í Fraklandi 1648-53)2.fl.,bókl,gml.(оппозиция) mótstøðaжгл-a, andstøða [ans-]жгл-a
фрондёр	mbókl.,gml.andstøðingur [ans-]мсогл-ar
фрондёрство	ngml.,bókl.mótstøðaжгл-a, andstøða [ans-]жгл-a
фронди́ровать	фронди́ру|ю, ~ешь, ~ютipfgml.,bókl.veraслнa-ó-eí andstøðu [ans-]
фронт	plurфронт|ы́, ~о́в, ~а́мm1.(линия) fronturннкмсогл-ar, hermót [hεɹ-]нпс0о; ли́ния фро́нта frontlinjaннк; на фро́нте á hermótinumнп, við frontinннк; держа́ть фронт halda frontinumннк, standa seg á hermótinumнп2.(высшее войсковое объединение) fremstu herliðiniс0омн опр.3.(область) økiсгл-i, umráðiсгл-i; fronturмсогл-arб.ч.шутл.; на культу́рном фро́нте á mentunarfrontinumб.ч.шутл.4.(объединение) fylkingж0-ar; наро́дный фронт fólkafylking; fólkafronturмсогл-arист.(ос. о Европе в 1930-х г.)5.veður.(раздел между воздушными массами) brúgvжнепр; холо́дный фронт kuldabrúgv@встать {вы́тянуться} во фронтherm.standa rætt;борьба́ на два фро́нтаbardagi á tveimum frontumннк=>бое́цI @,еди́ный1
фронта́льный	stfфронта́лен, фронта́льн|а, ~о, ~ыadj1.(кфронт 1) front-, hermóts-; фронта́льная ата́ка álop (beint) á hermótið [hεɹ-]2.(находящийся в передней части) fram-; фронта́льная стена́ framveggur; фронта́льное столкнове́ние frontalur [-Ꞌtʰaː-]ннкsamanstoytur3.(кфронт 5) brúgva-, við brúgvaløgum4.fl.(общий) alfevnandiглandi, umfatandiглandi; almennurсогл; фронта́льная прове́рка eftirlit av øllum [-tl-]
фронтиспи́с	m1.arkit.(фасад) høvuðsfasada [-saːta]жгл-a(á bygningi), frontispice [-Ꞌspɪːs]ж0-irархит.,спец.2.prent.(рисунок,портрет) frontispice [-Ꞌspɪːs]ж0-irполиг.
фронтме́н	[-мэ́н]mforsangari [-saŋk-]мгл-ari
фронтови́к	Gen, Accфронтовик|а́; plur~и́, ~о́в, ~а́мm hermaður el. yvirmaður, ið er ella hevur verið á hermótinum
фронтово́й	adjfront-ннк, hermóts- [hεɹ-]нп; фронтово́й това́рищ krígskammeratur [[kʰɹʊi̯ʰkskʰamːɪraː]ннк
фронто́н	mgalvurмсогл-ar(á fasadu,yvir vindeyga), fronton [-Ꞌtʰoːn]ж0-irархит., спец.
фрукт	m1.oftast plur(плод) fruktж0-irсобир.; сушёные фру́кты turkað frukt2.óvkm.,niðr.(о человеке): ну и фрукт {хоро́ш фрукт} á, dennнеформ.íspegil ; что э́то за фрукт? hvat er hetta fyri ein fýrur?
фрукто́вый	adjfrukt-; фрукто́вый сок fruktsaft; фрукто́вое де́рево frukttræ
фрукто́за	ffruktosa [-Ꞌtʰoː-]жгл-a, fruktsukurс0осн
Фру́нзе	[-зэ]m indeclsovjet.Frunze [fɹʊn̊sε]м нескл.,síБишке́к
фрэнд	m síфренд
фрэ́ндить	síфре́ндить
ФСБ	[фэ-эс-бэ́]f indeclФедера́льная слу́жба безопа́сности Росси́йской Федера́ции Trygdartænastan í Russiska Sambandsríkinum [-pan̊s-]
ФСИН	[фэ-эс-и-э́н]f indeclФерера́льная слу́жба исполне́ния наказа́ний Føderala [-ˈraː-] tænastan til útinnan av revsing (russiska fongsulsverkið o.a.)
ФСК	[фэ-эс-ка́]f indeclФедера́льная слу́жба контрразве́дки (sí)
ФСНП	[эф-эс-эн-пэ́]f indeclФедера́льная слу́жба нало́говой поли́ции Росси́йской Федера́ции  (tann russsiska skattaløgreglutænastan inntil 2003)
ФСО	[фэ-эс-о́]f indeclФедера́льная слу́жба охра́ны Russiska vaktartænastan
ф.ст.	фунт сте́рлингов £, pund sterling
фтизиа́тр	mtuberklalækni [-ˈpε-]мгл-i
фтизиатри́я	ftuberklafrøði [-Ꞌpε-]жгл-i
фтор	mfluor [fluːoːɹ]с0o({0<>i})
фто́ристый	adjfluor- [fluːoːɹ]
фу	inter1.(для выражения укоризны,досады и др.) oy; uff; fu2.(для выражениа усталости;облегчния) áh [ɔː]@фу́-тыtlm.,spott.ikki eiti á, tað skal eg halda við;фу́-ты, ну́-тыtlm.,spott.nei, hygga síggj!
фу́га	ffuga [fuːka]жгл-a(musikkverk)
фуга́нок	Genфуга́н|ка; plur~ки, ~ков, ~камmslætthøvilм0осн-s,-ar
фуга́с	mlandmina [lanm-]жгл-a
фуга́ска	plurфуга́с|ки, ~ок, ~камfspreingibumbaжгл-a
фуга́сный	adjspreingi-; фуга́сная бо́мба spreingibumba
Фуглё	m indeclFugloyж0-ar{+}; на (о́стров) Фуглё til Fugloyar [fʊkliːjaɹ]; на (о́строве) Фуглё á Fugloynni [-ɔi̯tnɪ]опр. (на острове); í Fugloy [fʊklɪ] (как географическое понятие); ба́нка Фуглё Fugloyarbanki [fʊkliːjapaɲ̊tʃɪ]
Фуглефьо́рд	mFuglafjørðurмсогл-ir{ø/a/i}{+}; в Фуглефьо́рд til Fuglafjarðar; в Фуглефьо́рде í Fuglafirði,см тжв А1, В 1
фугова́ть	фугу́|ю, ~ешь, ~ютpf(pfсфугова́тьсфугу́|ю, ~ешь, ~ют)что-л.1.(стругать) hølvaaðio-tvið slætthølvi2.(клеить) límaaðio-tsaman (sum er hølvað)3.(заполнять) fuga [fuːka]aðio-t
Фудзия́ма	fFujiyama [futʃiꞋjaː-]с нескл.
фуже́р	m(stórt) vínglasс0о{a/ø}
фу́кать	ipf síфу́кнуть
фу́кнуть	фу́кн|у, ~ешь, ~утpf(ipfфу́кать)tlm.1.на что-л., что-л.(задувать) blásaur(t){á/æ}á o-t {o-t}2.что-л.(в шашках) drepaслнa-u-io-t(í damm)
фукси́н	mfuksin [-ˈsiːn]с0o{o<>i}
фу́ксия	f(Fuchsia) fuksiaжгл-a
фу́ксом	advtá høvi býðst, tá tað liggur fyri, tá so vil til (волей судеб); av tilvild, tilvildarliga, óvart áberandiкн.(случайно); óvæntað (неожиданно); ógrundað (без оснований); av órøttum (не по праву)
фу́кус	m(Fucus) tariмгл-i(av slektini Fucus)
фуля́р	m gml.foulard [fuˈlaɹt]с0о{0<>i}
Фунафу́ти	m indeclFunafuti [-Ꞌfuː-]м нескл.
фунда́мент	m1.(основание) fundament [-Ꞌmε-]ннкс0опроф.; fóturмнепр(undir standmynd o.tíl) (статуи и т.п.)2.fl.(база,опора) undirstøðiсгл-i, grundvøllur [kɹʊnvœtl-]мсогл-ir{ø/a}, grundarlagс0o{a/ø}{0<>i}=>заложи́ть2,подвести́2
фундаментали́зм	mfundamentalisma [-Ꞌlɪ-]жгл-a
фундаментали́ст	mfundamentalistur [-Ꞌlɪ-]мсогл-ar
фундамента́льный	stfфундамента́|лен, ~льна, ~льно, ~льныadj1.(солидный) sterkurсогл, hollur [-tl-]согл{+}; фундамента́льная постро́йка sterk bygging2.(основополагающий) grundleggjandi [kɹʊnl-]глandi, fundamentalur [-Ꞌtʰaː-]ннксогл; фундамента́льное зна́ние dyggurсоглkunnleiki, hollur [-tl-] kunnleiki; фундамента́льный труд eitt grundleggjandi arbeiði; фундамента́льное иссле́дование ein nágreinilig kanning3.bert lf(главный) høvuðs-; фундамента́льная библиоте́ка høvuðsbókasavn
фуникулёр	mtogbani [-paː-]мгл-i, kaðalbani [-paː-]мгл-i
функциона́льный	stfфункциона́лен, функциона́льн|а, ~о, ~ыadjfunktionellur [-Ꞌnεlː-]соглпроф., funktións- [-Ꞌʃɔu-]проф.; функциона́льное заболева́ние funktionell sjúka; функциона́льный ана́лиз funktiónsanalysa [-Ꞌʃɔun̊saːnalyː-]
функционе́р	matf.pampariмгл-ariпренебр.
функциони́ровать	функциони́ру|ю, ~ешь, ~ютipfvirkaaði, fungera [fʊŋꞋkeː-]ннкaði
фу́нкция	f1.(значение,назначение) funktión [fʊŋ̊kꞋʃɔun]ннкж0-ir; выполня́ть фу́нкцииGenvirkaaðisumИм; выполня́ть мно́го фу́нкций hava nógvar funktiónirннк2.(работа органа и др.) funktión [fʊŋ̊kꞋʃɔun]ннкж0-irпроф., virkiлпсгл-i; фу́нкции головно́го мо́зга funktiónirnarннкпроф.hjá [tʃʰ-] heilanum3.filos.(зависиомое явление) funktión [fʊŋ̊kꞋʃɔun]ж0-ir4.mat.(зависимость величин) funktión [fʊŋ̊kꞋʃɔun]ж0-ir, funkaлпжгл-a; тригонометри́ческие фу́нкции trigonometriskar [-Ꞌmeː-] funktiónir
фунт1	Im1.gml.(русская мера) pundс0о(russiskt,409,5 g)2.(английскаяа мера) pundс0о(bretskt pound,453,6 g, o.a.)@вот так {тебе́} фунт!óvkm.hetta var vorðið sum skil!;э́то (тебе́) не фунт изю́муtlm.,skemt.hetta er ikki smávegis, hetta er ikki hissini
фунт2	IIm(денежная единица) pundс0о(mynteind)
фу́нтик	m(кулёк) kramarhúsс0о
фу́ра	f óvkm.trailaralastbilur [tʰɹεil-] {treylaralastbilur}мсогл-ar
фура́ж	Genфуража́mfóðurс0осн(til kríatúr o.a.)
фуражи́р	m gml. maður, ið fæst við fóður til kríatúr(í herinum)
фура́жка	plurфура́ж|ки, ~ек, ~камfkaskett [-Ꞌʃεʰtː]ж0-ir=>фо́рменный1
фурго́н	m1.(автомобиль) vøruvognurмсогл-ar2.(крытая телега) yvirdekkaður vognurмсогл-ar
фу́рия	f1.myt.(богиня-мстительница) furiaжгл-a2.fl.(о женщине) illkvendiсгл-i, skarnskvendi [skan̊s-]сгл-i; grussaжгл-aпренебр.
фурниту́ра	mtilbehoyr [tʰɪl-]ннкс0опроф., tilhoyrнпс0о
фуро́р	mrokс0о, øsingж0-ar; произвести́ фуро́р skapa øsing, skapaar(t);aðirok
фуру́нкул	mkoynaжгл-a, pirraжгл-a(við vági í)
фурункулёз	m1.(у человека) furunkulosa [-Ꞌloː-]жгл-a(húðasjúka)2.(у рыб) furunkulosa [-Ꞌloː-]жгл-a(sjúka hjá fiski)
фут	mfóturмнепр(bretsk mát,30,48 cm)
футбо́л	mfótbólturмсогл-ar(spælið) =>игра́тьB 1,пе́рвенство2
футболи́ст	mfótbóltsspælariмгл-ari, fótbóltsleikariнпмгл-ari
футбо́лка	plurфутбо́л|ки, ~ок, ~камfsportstroyggjaжгл-a(við longum ermum)
футбо́льный	adjfótbólts-; футбо́льный мяч fótbóltur (bóltur til fótbóltsspæl); футбо́льная кома́нда fótbóltslið, fótbóltsholdннк=>по́ле2
футза́л	mfutsalмо{дат0}
футля́р	metui [eːtʰuꞋiː]ннкс0о, húsiмгл-i, hylsturс0осн, hylkiсгл-i; футля́р для очко́в brilluetuiннк, brilluhúsi@челове́к в футля́реfólk, ið óttast alt nýtt og óvanligt
футро́п	mfisk.(на трале) fiskilínaмгл-a, fótroppur [-rɔpː-]мсогл-arуст.(á troli); grunnketaжгл-a(цепь); grunnurмсогл-ar, grunnlínaжгл-a, blýlínaжгл-a(á gørnum) (на неводе)
футури́зм	mlist,bókm.futurisma [-Ꞌrɪ-]жгл-a
футури́ст	mlist,bókm.futuristur [-Ꞌrɪ-]мсогл-ar
футуристи́ческий	adjlist,bókm.futuristiskur [-Ꞌrɪ-]соглsk
футуро́лог	mframtíðargranskariмгл-ari, futurologur [-Ꞌloːk-]мсогл-ar
футурологи́ческий	adjfuturologiskur [-Ꞌloːk-]соглsk
футуроло́гия	fframtíðargranskingж0-ar, futurologi [-Ꞌkiː]ж0-ir
футшто́к	mskip.peilistokkurмсогл-ar
фуфа́йка	plurфуфа́|йки, ~ек, ~йкамf1.bundin (undir)troyggjaжгл-a2.óvkm.síва́тник
фуфло́	plurфу́фла, фуфлogфу́фел,фу́фламn jarg., vanv.1.(ложь) lygnж0-ir; svikс0o, lumpingж0ar(обман)2.(обманщик) snýtariмгл-ari, svikariмгл-ari3. (неуважаемый человек) spjaðс0о{o<>i}презр., vánamаðurмнепр4.(нечто дурное, некачественное) lortс0огрубо(о-t vánaligt); lorturмсогл-arгрубо(um fólk), lorthundurмсогл-arгрубо, lortendiмгл-iгрубо(о людях)
фуфу́	: на фуфу́tlm.fyrilitsleyst, tankaleyst [tʰaŋ̊k-], gáloysið (легкомысленное); sum best ber til (кое-как)
фы́рканье	n1.(кфы́ркать 1) físс0о, snýsс0о2.(смех) gnisс0о3.(брюзжание) knarrс0о, físс0о
фы́ркать	ipf(momentфы́ркнутьфы́ркн|у, ~ешь, ~ут)1.(выпускать воздух из ноздрей) froysair(t), físair(t), snýsair(t)2.tlm.(смеяться) gnisaaði3.tlm.(брюзгать) knarraaði; фы́ркатьна кого-л.knarrainn á o-n
фы́ркнуть	moment síфы́ркать
фьорд	[фьё-]mfjørðurмсогл-ir{ø/a/i}{+}(vík) (в + Prp - á + Дат;в отдельных фар. топонимах, где фьорд - пролив в + Prp - í + Дат)
фью́черс	m fíggj.future [fjʉutʃεɹ]мнепр{+}(чаще всего встречается в форме мнfutures)
ФЭЗ	[фэс]f indeclФаре́рская [-рэ́-] экономи́ческая зо́на føroyskt [føːɹɪst] búskaparøki; в ФЭЗ undir Føroyum [fœɹjʊn], í føroyskum [føːɹɪsk-] sjógvi; из ФЭЗ undan Føroyum [fœɹjʊn], úr føroyskum [føːɹɪsk-] sjógvi
фэн	m jarg. síфан
фэн-...	síфан-
фэ́нтази	n indeclfantasy [-si]с нескл.; литерату́ра фэ́нтази fantasybókmentir; фильм фэ́нтази fantasyfilmur
Фэ́рбенкс	[-бэ-]mFairbanks [fεaɹpεŋ̊ks]м нескл.
фюзеля́ж	mskrokkurмсогл-ar(á flogfari o.tíl.)
Фюн	mFyn [fyːn]ж нескл., Fjónс0окн.
фю́рер	msøg.Førarinмгл-ariопр.
