ч.	1.час tími; в 17 ч. 25 мин. kl. 17.252.часть partur3.síчел.4.число́ tal; dato [taːto]
чaсти́к	Genчастика́m1.(сеть,невод) smámeskað gørn [-tn]с мн, smámeskað nótж0-ir2.koll(рыба)fiskur, fingin í smámeskaðum gørnum(um annan fisk enn styrjufisk, laksafisk, sild og onkran annan)
чaстико́вый	adj: частико́вая ры́баfiskur, fingin í smámeskaðum gørnum(um annan fisk enn styrjufisk, laksafisk, sild og onkran annan)
чаба́н	Gen, Accчабан|а́;plur~ы́, ~о́в, ~а́мmseyðamaðurмнепр; hirðiмгл-iбибл.(и о нефареских условиях)
чабёр	Gen чабра́; plurчабр|ы́, ~о́в, ~а́мm síча́бер
ча́бер	Genча́бераogча́бра; plurча́берыogча́бры;ча́беровog ча́бров,ча́берамogча́брамm(род Satureja)planta av slektini Satureja(en.satureja; da:sar)
чабре́ц	Genчабрец||а́;plur~ы́,~о́в, ~а́мm(Thymus) timianс0о({0<>i})
Чава́ш респу́блики	f indecl síЧува́шскаяреспу́блика
ча́вканье	n1.(звуки губ и языка) smaskс0о2.(чмоканье) esjanж0-ir, slupsandi ljóð
ча́вкать	ipf1.(производить звуки губ и языка) smaskaaði2.(издавать чмокающие звуки) slupsaaði, esjaaði; грязь ча́вкала под нога́ми evjan esjaði undir fótunum
чаво́	dial., óvkm. síчего́
чавы́ча	f(Oncorhyncus tshawytscha {tschawytscha})fiskur av laksaættini(en.spring salmon,king salmon,chinook salmon,quinnat salmon,chinook; da.kongelaks)
чавыча́	plurчавыч|и́, ~е́й, ~а́мf síчавы́ча
Чад1	Im1.(государство) Kjad {Tchad} [tʃʰatː]с0{дат.0}2.(озеро) Kjadvatnið {Tchadvatnið} [tʃʰat-]с0оопр.
чад2	Prpо ча́де, в чаду́mII1.(дым) hjararoykur [tʃʰεa-]мсогл-s,-ir, hjari [tʃʰεa-]мгл-i, osiмгл-i; slímс0о(от лампы)2.fl.(о чём-л. обдурманивающем) rúsurмсогл-ir, ørskaжгл-a; как в чаду́ sum í ørsku
чади́ть	чажу́, чад|и́шь, ~я́тipf(pfначади́тьначажу́, начад|и́шь, ~я́т) hjara [tʃʰεa-]aði, osaaði; slímaaði(о лампе)
ча́дно	IadvosandiIIpredздесь ча́дно her er fult av osi
ча́дный	stfча́д|ен, ~на, ~но, ~ныadj1.(испускающий чад) osandiглandi2.fl.(одурманенный) ørligurглigur, sum er í ørviti, ørvitugurглugur
ча́до	ngml., skemt.barn [-tn]с0о{a/ø}@с ча́дами и домоча́дцамиvið allari [atl-] familjuni [-Ꞌmɪ-]
чадра́	f slør hjá muslimskum kvinnum
ча́дский	adjkjadiskur {tchadiskur} [tʃʰatː-]согл
чаёвник	m tlm. o-r, sum dámar at dreekka te,o-r, sum dámar at fáa sær ein góðan temunn
чаёвничать	ipftlm.drekkaслнa-u-ute, fáaслнe-i-især ein góðan temunn
чаево́д	mtebóndiмгл-ur;o-r, sum dyrkar te
чаево́дство	ntedyrkingж0-ar
чаевы́е	чаев|ы́х, ~ымm plurtlm.drykkjupengarмгл-iмн; 50 рубле́й чаевы́х 50 rublar í drykkjupengum
чаепи́тие	ntedrekkingж0-ar
чаи́нка	plurчаи́н|ки, ~ок, ~камfteblaðс0о{a/ø}{0<>i}
чай1	IGenча́я, ча́юm1.(Thea) teс0о{0<>i}(planta), terunnurмсогл-ar(куст)2.(продукт) teс0о{0<>i}(vøra,drykkur); па́чка ча́ю tepakki, ein pakki av te; за ча́шкой ча́я yvir ein temunn; за ча́ем við teborðið@дава́ть на чайgeva drykkjupengar;чай да са́хар!óvkm.væl gagnist (sagt við fólk, sum drekka te);чай пить - не дрова́ руби́тьtilt.≈ ein drekkamunnur er altíð góður (skemtandi svar,tá te verður boðið) =>пусто́й2,жи́дкий2,кре́пкий5,сла́бый5
чай2	IIparentóvkm.1.(вероятно, наверное) helst; tað er líkt til2.(всё-таки,ведь) hóast alt
Ча́йка1	IplurЧа́йки, Ча́ек, Ча́йкамfTjajka [tʃʰaika]м нескл.(bilmerki,luksusbilur við sjey setrum)
ча́йка2	IIplurча́йки, ча́ек, ча́йкамf1.(род Larus) másiмгл-i; skuriмгл-i(молодая нек. родов); морска́я ча́йка (L. marinus) svartbakur [svaɹp-], [svaɹ̥t-]мсогл-ar; поля́рная {исла́ндская} ча́йка (L. glaucoides) lítil valmási [valm-]; серебри́стая ча́йка (L. argentatus) fiskimási, mási; си́зая ча́йка (L. canus) skatumási, gneggjusм0-ar; обыкнове́нная {речна́я, озёрная} ча́йка (L. ridibundus) fransaterna [о́tna]жгл-a2. (другие роды): бе́лая ча́йка (Pagophila eburnea) ísmásiмгл-iвилохвостая ча́йка (Xema sabini) ternumási [tʰεtn-]мгл-i
чай-клу́б	mteklubbi (fyri fólk, ið dámar te)
чайлдфри́	n indeclsjálvvalt [ʃɔlval̥t barnloysi [panl-]сгл-i
Чайна-та́ун	mkinesiskur [kʰiˈneː-] býlingurмсогл-ar,kinesarabýlingur [kʰiˈneː-]мсогл-ar; Chinatown [tʃʰainatʰaun]м нескл неформ.
ча́йная	ftestovaжгл-a(har te og okkurt smávegis at eta fáast til keyps)
ча́йник	mtekannaжгл-a(для заваривания); (te)ketilм0осн(для кипячения воды) =>ста́вить1
ча́йница	fteblikkс0о
ча́йный	adjte-; ча́йная ча́шка tekoppur; ча́йный куст terunnur; ча́йная планта́ция teplantasja [-tʰaː-]@ча́йная ро́за(Rosa chinensis) terósa =>ло́жка1,серви́з
чако́на	fchaconne [ʃaˈkʰɔnˑ]ж0-ir
ча́кра	жrel.chakra [tʃʰaʰkɹa]ж0-ir(;гл-a)
чал	m síча́лка
ча́лить	ча́л|ю, ~ишь, ~ятipf что-л.skip.bindaслнa-u-uo-t(skip), fortoya [-Ꞌtʰœija-] (реже[-Ꞌtʰɔija-])aðio-tмор.,sí eis.прича́лить
ча́лка	plurча́л|ки, ~ок, ~камffortoyning [-Ꞌtʰœi-] (реже[-Ꞌtʰɔi-])ннкж0-arпроф, endiмгл-i(at binda við), trossiмгл-i(at binda við)
чалма́	fturban [-Ꞌpaːn]ж0-ir, vavhúgvaлпжгл-a
ча́лый	Iadjøgnuturсогл(serl. við hvítum øgnum í gráum liti), gráskjóruturсоглIImgráskjórut rossс0о, øgnut rossс0о
чан	Prpв ча́не, в чану́;plurчан|ы́, ~о́в, ~а́мel.ча́н|ы, ~ов, ~амm1.(кадка) karс0o{a/ø}, baljaжгл-a2.(железнобетонный,кирпичный резервуар) karс0o{a/ø}(av betong ella múrsteini)
ча́нский	adjtjaniskur [tʃʰaː-]соглsk; ча́нский язы́к tjanisktсприлskt
ча́ра	fgml.,skald.bikarс0о;0о{a/ø}, steypс0о, skálж0-ir; kalikurмсогл-arцерк., kálkurмсогл-arцерк.
ча́рдаш	m(венгерский танец) csardas {czardas} [tʃʰaɹtaʃ]м0-ar({0<>i})(ungarskur dansur)
ча́рка	plurча́р|ки, ~ок, ~камfgml.,skald.bikarс0о;0о{a/ø}, steypс0о
чарльсто́н	mchrarleston [tʃʰaɹlstʰɔn]м0-ar
чарова́ть	чару́|ю, ~ешь, ~ютipf(pfочарова́тьочару́|ю, ~ешь, ~ют)Acctølair(d)Вин, dáraaðiВин
чароде́й	mgandakallur [-tl-]мсогл-ar{a/ø}
чароде́йка	plurчароде́йки, чароде́ек, чароде́йкамf1.(волшебница) gandakelling [-tl-]ж0-ar2.bókl.(пленительная женщина) tølandi kvinnaжгл-a
чароде́йство	n1. (волшебство) gandurмсогл-ar2.fl., bókl.(чарующая сила) tað at rúnabindaслнa-u-uВин кн, tað bergtakaслнó-ó-iВин кн,tølanж0-irкн., выс.(очарование)
чарт	m1.búsk.(диаграмма, график) diagramm [tiːjaˈkɹamː]с0о(;0-ir)2.mus.(рейтинг) hittlistiмгл-i, topplistiмгл-i(við best umtóktu løgunum)
ча́ртер	[-тэр]mcharter [tʃʰaɹ̥tεɹ]м0-ar{0<>i}мор.
ча́ртерный	[-тэр]adjcharter- [tʃʰaɹ̥tεɹ-]ннкпроф., leigu-; ча́ртерный рейс charterflúgvingж0-ar, leiguflúgvingж0-ar; chartertúrurмсогл-ar;-ir, leigutúrurмсогл-ar;-ir
´чартс	m síчарт2
чару́ющий	partic/adjbergtakandiглandi, tølandiглandi, hugtakandiглandi; charmerandi [ʃaɹꞋmeː-]ннкглandi(обаятельный)
ча́ры	чар, ча́рамf plur1.gml.(колдовство) gandurмсогл-ar2.(обаяние) útstrálingж0-ar; charma [ʃa-] {sjarma}жгл-a
час	Genча́са, ча́су,saman viðполтора́, че́твертьog grundtølum, ið krevja Gen singчаса́, Prpо ча́се, в часу́;plurчас|ы́, ~о́в, ~а́мm1.(промежуток времени) tímiмгл-i(klokkutími), klokkutímiмгл-i; че́рез два часа́ a) (по прошествии) um tveir tímar; b) tveir tímar seinni [саi̯тнɪ](в прошлом): c)) (каждые два часа) annanhvønn tíma; с час umleið [-Ꞌlai-] ein tíma; час за ча́сом tíma eftir [εʰtː-] tíma; час тому́ наза́д fyri einum tíma síðani; рабо́ты на час arbeiði til ein tíma; опозда́ние на три часа́ seinkan í tríggjar tímar, tríggja tíma seinkanофиц.; два часа́ езды́ tveir tímar at koyra, tveir tímar at ferðast; получа́ть 50 рубле́й в час fáa 50 rublar um tíman; три́дцать киломе́тров в час tretivu kilometrar [kʰiː-] um tíman; в тече́ние ча́са í ein tíma; он был там о́коло ча́са hann var har í umleið [-Ꞌlai] ein tíma; полтора́ часа́ hálvurannar [-Ꞌanː-] tími, hálvanannan [-Ꞌanː-] tíma; на час ра́ньше ein tíma fyrr2.(время по часам): кото́рый час? hvat er klokkan?; hvussu nógv er klokkan?; семь часо́в klokkan er sjey; в кото́ром часу́? Nær?; hvat klokkan?; в час (дня) klokkan eitt (um dagin); в семь часо́в ве́чера klokkan sjey um kvøldið; часа́ в три við trítíðina, umleið [-Ꞌlai] klokkan trý; ро́вно в час presist [pʰɹeꞋsiːst]ннкklokkan eitt; тепе́рь без трёх (мину́т) час nú er klokkan tríggjar minuttir [mɪꞋnʊ-] í eitt; чита́ть до ча́су но́чи lesa til klokkan eitt um náttina; в четвёртом часу́ millum (klokkan) trý og fýra; (сейча́с) восьмо́й час klokkan er farin av sjey, hon er farin av sjey; он пришёл о́коло ча́су hann kom um eitttíðina3.(учёбы,работы) (undirvísingar)tímiмгл-i, skúlatímiмгл-i(в школе); на пе́рвом ча́се í fyrsta [fɪsta] tíma; 5 часо́в в неде́лю fimm tímar um vikuna; час геогра́фии tími í landalæru4.(время,посвящённое чему-л.) tíðж0-ir; часы́ приёма viðtalutíð; часы о́тды́ха hvílitímar; час обе́да døgurðatíð; часы́ обе́да døgurðatíð; свобо́дные часы́ frítíð; в вече́рний час um kvøldið; часы́ рабо́ты skrivstovutíð, avgreiðslutíð (учреждения); upp- og afturlatingartíð [aʰtː-], «opið er» (на надписях) (магазина и др.)@стоя́ть на часа́хhaldaслнe-i-ivakt, veraслнa-ó-eá varðhaldiнп; пришёл его́после́днийчас hansara deyðastund var komin, hansara síðsta stund er komin;час в часstundisliga, precist {presist} [pʰɹeꞋsiːst]ннк;час о́т ча́суfyri hvønn tíma;с ка́ждым ча́сомfyri hvønn tíma;час о́т часу не ле́гчеtilt.tað versnar [vεsn-] í hvørjum;в свой часtá tann tíð kemur;до э́того {сего́} ча́саinntil nú;с ча́су на часa) (вот-вот) hvørja løtu; b) (с каждым часом) fyri hvønn tíma (,sum gongur) =>би́тый@,деньI @,до́брый3,@,мёртвый@,по́здний1,ра́нний1,по9,ро́вный@,ско́рость1,сме́ртный1,че́тверть2,часы́@
часа́ми	adví tímar, í tímavís
часо́вня	fkapell [-Ꞌpʰεlː]с0о
часово́й1	Imherm.vaktж0-ir(vaktarmaður); выставля́ть часовы́х seta vaktir =>развести́I 1
часово́й2	IIadj(о времени)1.(длящийся один час) sum varir ein tíma; tímalangurсоглang(длящийся долго, многочасовой); часова́я бесе́да ein samrøða í ein tíma; его́ часовы́е разгово́ры по телефо́ну hansara tímalangu telefonsamtalur2.(рассчитанный на час,получаемый за час) tíma-; часова́я опла́та tímagjald3.(назначенный на час или на 13 часов) eitt-; часово́й по́езд eitttokið, tokið klokkan eitt@часово́й по́ясtíðarsonaжгл-a, tíðarøkiсгл-i
часово́й3	IIIadj(кчасы́ I) ur-, klokku-,sbr.часы́ I; часовы́е стре́лки klokkupinnar; vísari (á uri); по часово́й стре́лке við sólini, sólarrætt; про́тив часово́й стре́лки móti sólini, sólarrangt, andsølis [ans-] =>ма́стер1
часовщи́к	Gen, Accчасовщик/а́;plur~и́, ~о́в, ~а́мmurmakariмгл-ari, ursmiðurмсогл-s,-ir
часо́к	Genчаск|а́;plur~и́, ~о́в, ~амmtlm.eintími ella [εtla] so, umleið [-Ꞌlai] ein tími
часосло́в	m bók við bønum o.ø. fyri hvønn tíma(írus. ortodoksu kirkjuni); ≈ breviar [pɹeːviˈaːɹ]с0о
часте́нько	advtlm.rættiliga ofta, nokk so ofta, ikki so sjáldan
ча́стик	m síчaсти́к
ча́стиковый	adj síчастико́вый
части́ть	чащу́, част|и́шь, ~я́тipf1.tlm.(делать что-л. торопливо,чаще чем нужно) geraнепрo-tskjótt; títtaaði; не части́, говори́ ясне́й ver ikki so títtmæltur, tosa skilligari2.óvkm.(часто посещать) ofta vitjaaðio-n{o-t}, veraслнa-ó-etíður gestur
части́ца	f1.(небольшая часть) lítil parturмсогл-ar{a/ø}2.(материи) partikkul [-Ꞌtʰɪʰkː-]м0осн, bitilлпм0оснфиз.; части́цы пы́ли (støv)puс0о3.máll.(служебное слово) partikkul [-Ꞌtʰɪʰkː-]м0оснграм., bitilлпм0оснграм.4.fl.(крупица) vetс0о, sindurс0осн; в его́ слова́х не́ было и части́цы пра́вды tað var ikki minsta vet av sannheit í tí, hann segði [sεijɪ] =>элемента́рный6
части́чка	plurчасти́ч|ки, ~ек, ~камf dim avчасти́ца 1, 2, 4
части́чно	advpartvíst, fyri ein part, lutvíst
части́чный	stfчасти́ч|ен, ~на, ~но, ~ныadjpartvísurсогл, lutvísurсогл; части́чное улучше́ние nakað av bata, ein ávísur bati; части́чное со́лнечное затме́ние lutvís sólarmyrking
ча́стник	[-сн-]m1.(частный торговец) sjálvstøðugur [ʃɔls-] vinnurekandiмприл, privatur [pʰɹiꞋvaː-] vinnulívsmaðurмнепр2.(автомобилист) bileigariмгл-ari(privatur)
частновладе́льческий	[-сн-]adjprivatur [pʰɹiꞋvaː-]согл
ча́стное	[-сн-]n mat.kvotientur [kʰvoˈʃε-]интмсогл-arпроф., deildtalлпс0о{a/ø}
частнопрактику́ющий	[-сн-]m: privatpraktiserandi [pʰɹiꞋvaː-]глandi, í sjálvstøðugari [ʃɔl̥s-] vinnu; частнопрактику́ющий врач privatpraktiserandi lækni
частнопредпринима́тельский	[-сн-]adj(sum er) hjá [tʃʰ-] privatum [-ˈvaː-] vinnurekandi
ча́стность	[-сн-]fdetalja [teꞋtʰaʎja]ннкжгл-aпроф., stakluturнпмсогл-ir, smáluturнпмсогл-ir@в ча́стностиparentmillum [-tl-] annað,сокр.m.a. (между прочим); serstakliga [sεɹꞋstεa-] (особенно)
ча́стный	[-сн-]adj1.(отдельный) einstakurсогл{a/ø}; ávísurсогл, konkretur [-Ꞌkʰɹeː-]ннксогл(конкретный); serstakurсогл{a/ø}, serligurглigur(особый); в ча́стных слу́чаях í einstøkum førum; от ча́стного к о́бщему frá tí serstaka til tað almenna; сли́шком ча́стный вопро́с ein heldur speciellur {spesiellur} [speːsiꞋεlː-]ннкspurningur2.(личный;принадлежащий отдельному лицу; выполняеный для отдельного лица) privatur [pʰɹiꞋvaː-], privat- [pʰɹiꞋvaː-]; ча́стная жизнь privatlív [pʰɹiꞋvaː-]; ча́стная кварти́ра a) (собственная квартира) eigaraíbúð, ognaríbúðнп, eigaraleiligheitннк(в Дании, на Фарерах и др.); b) privatíbúð [pʰɹiꞋvaː-], privatleiligheit [pʰɹiꞋvaː-]ннк(в СССР,в России); она́ живёт на ча́стной кварти́ре hon býr til leigu (í verilsi í íbúðini hjá o-m), hon leigar (verilsi el. tíl. í íbúðini hjá o-m); ча́стная инициати́ва tað privata initiativið [iːnitʰiːjaꞋtʰiː-], tað privata fyritaksemið; ча́стный капита́л privatkapitalur [[pʰɹiꞋvaːtkʰaːpitʰaː-]; в ча́стных рука́х á privatum hondum; в ча́стном владе́нии á privatum hondum, í privatari ogn; ча́стное лицо́ privatpersónur [pʰɹiꞋvaː-]; по ча́стному де́лу viðvíkjandi einum privatum máli; ча́стный зака́з ein privatur ordriннк; ча́стная пра́ктика (у врача) privat praksisннкпроф.@ча́стное обвине́ниеprivat [pʰɹiꞋvaːt] sakarmál, egin lógsøknлпюр.=>со́бственность1
ча́сто	adv1.(кча́стый) ofta; дово́льно ча́сто rættiliga ofta, ikki so sjáldan; о́чень ча́сто ógviliga ofta, ofta og tíðum2.(плотно,густо) tætt; гу́сто поса́женные дере́вья tætt plantað trø
частоко́л	m(steyra)girðingж0-ar
частота́	plurчасто́т/ы, ~, ~амf1.(кча́стый 1) títtleikiмгл-iкн.2.fys.(число повторений чего-л.) frekvensur [fɹeꞋkʰvε-]мсолг-ar, tíðleikiлпмгл-i, tíddлпж0-ir; ни́зкая частота́ lágfrekvensur, lágtíddлп; высо́кая частота́ háfrekvensur, hátíddлп; частота́ ка́дровsjónv.myndafrekvensur, bílætfrekvensurннк=>полоса́3
часто́тность	ffrekvensur [fɹeꞋkʰvε-]мсолг-ar, tíddлпж0-ir, títtleikiмгл-iкн.
часто́тный	stfчасто́т|ен, ~на, ~но, ~ныadjfrekvens- [fɹeꞋkʰvε-]; часто́тный диапазо́н frekvensband [fɹeꞋkʰvε-]; часто́тный слова́рь frekvensorðabók [fɹeꞋkʰvε-]спец., tíddarorðabókлп
часту́шка	plurчасту́ш|ки, ~ек, ~камf(stutt) vísaжгл-a(oftast við fýra ella tveimum reglum við skemtiligum ella spottandi innihaldi);с0осн. (б.ч.детская и т.п.)
ча́стый	stfчаст, часта́, ча́сто, ча́стыadj1.(повторяющийся) sum hendir javnan, sum hendir ofta; tíðurгл; ча́стый гость tíður gestur; ча́стые встре́чи fundir, sum eru ofta2.(густой) tætturсогл{æ/ø}; ча́стый лес tøtt skóg; ча́стый гре́бень tættkambur, fínkambur; ча́стая сеть smámeskað net; ча́стый дождь samregn; ча́стая и́згородь tætt hegn3.(быстрый) skjóturсогл; ча́стый пульс títturсоглpulsur
часть	plurча́сти, част|е́й, ~я́мf1.(доля целого) parturмсогл-ar, luturмсогл-ir; avdrátturм0осн-ar,-ir;согл-ir, rata [raː-]ннкжгл-aпроф.(об оплате и т.п.); бо́льшая часть meginparturinsíбольшинство́, бо́льший; бо́льшею ча́стью {по бо́льшей ча́сти}síбо́льший@; тре́тья часть triðingur; дели́тьчто-л.на 5 часте́й býta sundur í fimm partar; одна́ часть у́ксуса на три ча́сти воды́ ein partur av etiki til tríggjar partar av vatni; опла́та по частя́м avbetalingннкж0-ar, avgjaldнпс0о{a/ø}; с опла́той по частя́м gjald í avdráttum, gjald í ratum [raː-]; разобра́тьчто-л.на ча́сти takao-tsundur; рома́н в трёх частя́х skaldsøga [skals-] í trimum pørtum; втора́я часть annar partur; за́падная часть vestari partur; сре́дняя часть доро́гитжmiðjan á vegnum [veːn-]; в пере́дней ча́стичего-л.frammarlagaí {á} o-m, fremstпревосх. í {á} o-m, í fremraсравн.partiav o-m; в за́дней ча́стичего-л.aftarlaga [aʰtː-]í {á} o-m, aftastпревосх. í {á} o-m, í aftara [aʰtː-]сравн.partiav o-m,sbr. eis.ни́жний2.(составной элемент) parturмсогл-ar{a/ø}, luturмсогл-ir; deilurннкмсогл-s,-irпроф.(ос. о деталях машины и т.п.); ча́сти маши́н maskindeilir [-Ꞌʃiːn-]3.(пай) parturмсогл-ar, luturмсогл-ir; получи́ть свою́ часть fáa sín part, fáa sín lut4.(отдел) deildж0-ir5. (область деятельности) virkisøkiсгл-i; рабо́тать по администрати́вной ча́сти hann arbeiðir í fyrisitingini6.herm.(войска) (her)deildж0-ir7. mus. (музыкального произведения) satsurмсогл-s,-ir(í musikkverki)@часть ре́чиmáll.orðaflokkurмсогл-ar;э́то по его́ ча́стиa) (это его область) hetta er hansara øki, hetta hoyrir undir hann; b) (это по нему) hetta er nakað fyri hann; знато́к по э́той ча́сти serfrøðingur í hesum, serkønur í hesum; э́то не по мое́й ча́сти hetta er ikki mítt øki, hetta er ikki mítt borðнеформ.;по ча́стичего-л.tá ræður umo-t=>вне́шний1,вы́плата1,запасно́йI,разрыва́ться@,рватьI @,светII 1,составно́й2,те́ло1,уче́бный1
ча́стью	advlutvíst, partvíst, fyri ein part; summpart
часы́1	Iчас|о́в, ~а́мm plurklokkaжгл-a; urс0о(б.ч. карманные и т.п.); ручны́е часы́ armbandsur [-pan̊s-]; ба́шенные часы́ tornklokka, tornur [-uːɹ]; я без часо́в eg havi einki ur; поста́вить часы́ seta klokkuna; перевести́ вперёд часы́ flyta klokkuna fram; перевести́ наза́д часы́ flyta klokkuna aftur [aʰtː-]; часы́ отстаю́т klokkan saktaraði,sí eis.отста́ть2; часы́ спеша́т klokkan fortaraði; ско́лько вре́мени на твои́х часа́х? hvussu nógv er klokkan á tínum uri?; мои́ часы́ иду́т пра́вильно urið hjá [tʃʰ-] mær gongur rætt; по мои́м часа́м три klokkan er trý á mínum uri@как часы́(работать и т.п.) sum klokkan;по часа́мávísar tíðir =>вперёд@,завести́3,карма́нный1,песо́чный1,со́лнечный@,ста́вить16
часы́2	IIm plur síчас
чат	mjarg.chat [tʃʰaʰtː] {kjatt}с0о{+}; вы́йти в чат fara út á chattið; встре́титься в ча́те møtast á chatti; обсуди́ть в ча́те kjakast umo-tá chatti
ча́хлый	stfчахл, ~а, ~о, ~ыadj1.(о растении) smáligurглigur(плохо растущий), berurсогл(нагой), berligurглigur(нагой), fátæksligurглigur(скудный) (vøkstur); ча́хлый куст ein følnaður runnur; ча́хлая расти́тельность berligur vøkstur2.(о человеке) neyðarsligurглigur, skirvisligurглigur; ча́хлый ребёнок ússaligt barn, mistrivningurмсогл-ar
ча́хнуть	ча́хн|у, ~ешь, ~утipf(pfзача́хнутьзача́хн|у, ~ешь, ~ут)1.(о растении) vantrívastслнei-i-i, trívastслнei-i-iilla [ɪtla] (um plantur)2.(о человеке) hjána [tʃʰ-]aði, tærastir(d)burtur, hímastaðiburtur
чахо́тка	fgml.teringurмсoгл-arуст.=>скороте́чный2
чахо́точный	Iadj1.(о больном человеке) sjúkurсоглav teringi2.fl.,tlm.(скудный,чахлый) ússaligurглigur, neyðarsligurглigurIImsjúkurмприлav teringi
ча́ча	f slag av rúsdrekka gjørt úr avlopi av pressaðum víndrúvum(serl. í Georgia o.a.)
ча́ша	fbolli [-tlɪ]мгл-i; skálж0-ir, bikarс0о;0о{a/ø}; kalikurмсогл-ar,церк., kálkurмсогл-arвыс., церк.; ча́ша весо́в vektskál, vágskálнп@да мину́ет меня́ ча́ша сия́lat hesa skál fara um meg, lat henda kalik fara frá mær;положи́ть на ча́шу весо́вleggja á vektskálina, leggja í vágskálina;дом у них - по́лная ча́шаtey liva í yvirflóð =>перепо́лнить@
чашели́стик	mplant.bikarblaðс0о{a/ø}{0<>i}
ча́шечка	plurча́шеч|ки, ~ек, ~камf1.dim(маленькая чашка) lítil koppurмсогл-ar2.plant.(цветка) (blómu)bikarс0о;0о{a/ø}=>коле́нный
ча́шка	plurча́ш|ки, ~ек, ~камf1.(сосуд) koppurмсогл-ar; ча́йная ча́шка tekoppur; ча́шка ча́ю koppur av te, temunnurмсогл-ar2.(миска) skálж0-ir(ílat); (лифчика) skálж0-ir(á brósthaldara)3.(весов) vektskálж0-ir, vágskálнпж0-ir=>надколе́нный
ча́ща	fskógartættiмгл-iкн., tøtt skógж0-ir, tættur skógurмсогл-ir;-arкн.
ча́ще	compIavча́стыйIIavча́сто; ча́ще всего́ oftast, sum oftast; как мо́жно ча́ще oftast gjørligt, so ofta sum møguligt
чащо́ба	fskógartættiмгл-iкн., tøtt skógж0-ir, tættur skógurмсогл-ir;-arкн.
ча́яние	nbókl.vónж0-ir, væntanж0-ir@па́че ча́янияgml.,bókl.betur enn væntað;сверх вся́кого ча́янияgml.betur enn væntað
ча́ять	ча́/ю, ~ешь, ~ютipf чего, + infgml.væntaaðio-t{+инф}, vónaaðio-t{+инф}; не ча́яла и в живы́х заста́ть hon hevði [hεijɪ] mist allar [atl-] vónir um at finna hann á lívi@души́ не ча́ятьв ком-л.vera sera góðurглvið o-n, vera býtturсоглav o-m; он в ней души́ не ча́ет hon er eygnasteinurin hjá [tʃʰ-] honum
чва́ниться	чва́н|юсь, ~ишься, ~ятсяipf чем-л.breggjaaðisærav o-m, geraнепрseg Ꞌ uppav o-m, erpaaðisærav o-m
чванли́вый	stfчванли́в, ~а, ~о, ~ыadj síчва́нный
чва́нный	stfчва́н|ен, ~на, ~но, ~ныadjstóraktigur [-Ꞌaʰkt-]энкглigurнеодобр., stórurсоглí ondini, hástórurсогл; erpinсоглосн(гордый)
чва́нство	nstóraktigheit [-Ꞌaʰkt-]энкж0-irнеодобр.; erpniсгл-i(гордость); stórlæti [stœɹ-]сгл-iкн.
ЧВК	[чэ-вэ-ка́]f indeclча́стная вое́нная компа́ния privat [-ˈvaːt] hernaðarfyritøkaофиц.
Чебокса́ры	Чебокса́р, ~амf plurTjeboksary [tʃʰeːpɔʰkꞋsaːɹy]м нескл.
чебре́ц	Genчебрец||а́;plur~ы́,~о́в, ~а́мm síчабре́ц
чебуре́к	m slag av deiggjlumma við fyllu av lambskjøti o.ø., sum verður stoktur í olju
чебуре́чная	f lítil restauratión el. tíl., harчебурекverða  seldir
чегло́к	Gen, Accчеглока́; plurчеглок|и́, ~о́в, ~а́мm(Falco subbuteo) vákasmyrilм0осн-s,-ar
чего́1	[чево́] IGen avчто I
чего́2	[чево́] IIpron interrog,conjóvkm.hvat? ha [haː]?
чей	fчья,nчьё;plurчьиpron1.interroghvør eigur; чьё э́то пальто́? hvør eigur henda frakkan?; чья э́та кни́га a) hvør eigur hesa bókina; b) (кто написал) hvør hevur skrivað hesa bókina?; hvønn er henda bókin eftir [εʰtː-]?; чья (э́то) вина́? hvør hevur skyldina?; ты чей? (ребёнку) hvør eigur teg?2.relatsum, hvørsнп; челове́к, чью кни́гу вы взя́ли, рабо́тает у нас maðurin, sum tit læntu bókina frá, arbeiðir hjá [tʃʰ-] okkum; челове́к, чьё и́мя мы все зна́ем maðurin, sum vit øll [œtl] kenna navnið á; maðurin, hvørsнпnavn vit øll [œtl kenna; учёные, чьи рабо́ты всем изве́стны vísindamenn , sum øll [œtl] kenna verkini hjá [tʃʰ-]; vísindamenn, hvørsнпverk øll [œtl] kenna@чья взяла́?hvør vann?
че́й-либо	pron síче́й-нибудь
че́й-нибудь	pronhjá [tʃʰ-]o-m; взять че́й-нибудь каранда́ш taka blýantin hjáo-m
че́й-то	pron síче́й-нибудь
чек1	Im1.(банковский)kekkur (режеtjekkur)мсогл-ar; чек на 1000 крон kekkur upp á túsund [tʰʉusɪn] krónur2.(кассовый) (kassa)bon [-pɔŋk]ннкж0-ir=>вы́бить6,предъяви́тель
чек2	IIm(рисовое поле) rísakurм0осн, rísveltaжгл-a
Чека́1	If indeclЧрезвыча́йная коми́ссия по борьбе́ с контрреволю́цией и сабота́жем Tann serliga nevndin til bardaga móti mótkollvelting og sabotasju [saːpoꞋtʰaː-], Tjeka [tʃʰeːka]ж0-ir;(0-ir), sí eis.ЧК(tann russiska og sovjettiska trygdartænastan 1918-1922)
чека́2	IIf tekn.splittaжгл-a; предохрани́тельная чека́ sikkringsstiftж0-ir(á granat)
чека́н	m: лугово́й чека́н (Saxicola rubetra) reyðstólpaжгл-a; черноголо́вый {черного́рлый} чека́н (Saxicola torquata) svartstólpa [svaɹ̥s-]жгл-a
чека́нить	чека́н|ю, ~ишь, ~ятipf что-л.1.pfвы́чеканитьвы́чекан|ю,~ишь, ~ят, отчека́нитьотчека́н|ю, ~ишь, ~атprega [pʰɹeːka]ннкaðiпроф.; sláaслнó-ó-i(монеты и т.п.); ciselera [siːsɪꞋleː-]aðio-tспец.(наносить декоративный рисунок); чека́нить моне́ту sláa ein mynt2.pfотчека́нитьотчека́н|ю, ~ишь, ~ят(чётко делать что-л.): чека́нить слова́ leggjaнепрdent á hvørt orðið; чека́нить шаг gangaслнe-i-ivið taktføstum fetum3.pfрасчека́нитьрасчека́н|ю, ~ишь, ~ятtekn.(обрабатывать соединения и т.п.) stemmaaði(boltar o.a.)
чека́нка	plurчека́н|ки, ~ок, ~камf1.(действие) tað at sláa (myntir o.a.), preging [pʰɹeːtʃɪŋk]ннкж0-arпроф.2.(рисунок) ciselering [siːsɪꞋleː-]ж0-ar(mynstur)
чека́нный	adj1.(изготовленный чеканкой) ciseleraður [siːsɪꞋleː-]глaður2.fl.(имеющий чёткие,резкие очертания) skarpleittur [skaɹl-]согл, skarpurсогл{a/ø}(о профиле, лице)3.(чёткий,выразительный,тщательно отделанный) taktfasturсогл{a/ø}(о шаге);согл{a/ø}; væl snøggaðurглaður(о стихе)
чека́ночный	adjpregnings- [pʰɹeːk-]проф.
чека́нщик	mciselørur [siːsɪꞋløː-]мсогл-ar
чеки́ст	mtjekistur [-Ꞌkʰɪ-]мсогл-ar(o-r,ið arbeiðir í Tjeka) (sbr. Чека́)
чек-ли́ст	mkekklisti {tjekklisti}мгл-i, checklisti [tʃʰεʰk-]ннкмгл-i
чекли́ст	m síчек-ли́ст
че́ковый	adjkekk-; че́ковая кни́жка kekkheftiсгл-i
чеку́шка	plurчеку́ш|ки, ~ек, ~камf óvkm.fjórðingsfløskaжгл-aav vodka (ið tekur ¼ l), kvartfløskaжгл-aav vodka(ið tekur ¼ l), peglafløska [pʰeːla-] av vodkaжгл-aуст.
чел.	челове́к persónur [-Ꞌsɔu-], fólk, maður
чёлка	plurчёл|ки, ~ок, ~камf1.(на лошади) doddurмсогл-ar(á rossi)2.(у людей) doddurмсогл-ar, frunturмсогл-ar(á fólki)
чёлн	Genчелн|а́;plur~ы́, ~о́в, ~а́мm1.(лодка,выдолбленная из одного куска) eikjaжгл-aист.2.gml.,skald.(судно) skipс0о, farс0о{a/ø}, floyс0обалл., snekkjaжгл-aбалл.
челно́к	Genчелнок|а́;plur~и́, ~о́в, ~а́мm1.síчёлн2.(ткацкий,на швейной машине) skjúttilм0осн(á vevi,seymimaskinu)3.óvkm.(торговец) (smá)handilsmaðurмнепр(ið keypir vøru uttanlands og førir hana um markið)
челно́чный	adj1.(связанный с регулярным движением) pendul- [pʰεnꞋtuːl-]; челно́чное движе́ние pendulferð [pʰεnꞋtuːl-]; pendulkoyring [pʰεnꞋtuːl-]; челно́чная диплома́тия penduldiplomati [pʰεnꞋtuːltɪʰplomatʰiː]2.óvkm.(отчелно́к 3): челно́чные пое́здки handilsferðir; челно́чные дохо́ды inntøkur av ferðahandli,síчелно́к3
чело́	plurчёл|а, ~, ~амngml.enniсгл-i, pannaжгл-a@бить чело́мкому-л.gml.el.skemt.biðjaслнa-ó-io-nso miriliga
челоби́тная	fgml.bønarbrævс0о{æ/ø}, bønarskrivс0о
челоби́тчик	mgml. umsøkjariмгл-ari
челове́к	aftan á grundtøl og orð, ið merkja tal, Gen plurчелове́кannarsgml.,skemt.plurлю́ди, люд|е́й, ~ямm1.(живое шущество) menniskja [mεnːɪʃtʃa]сгл-a{жгл-aкн.,выс.}, fólkс0о; persónur [-Ꞌsɔu-]мсогл-ar(особа); она́ - хоро́ший челове́к hon er eitt gott menniskja; почу́вствовать себя́ други́м челове́ком føla seg sum eitt annað menniskja; до после́днего челове́ка til síðsta [sʊʃta], [sʊi̯sta] mann; челове́к за борто́м! maður fyri borð!; молодо́й челове́к! (в обращении) tygum!ella verður ikki umsett/или не переводится(brúkt í tiltalu við ungan ella yngri mann av eldri fólki); нас бы́ло пять челове́к vit vóru fimm fólk, vit vóru fimm mans; у них семь челове́к дете́й tey eiga sjey børn [-tn]; ма́ло люде́й lítið fólk; мно́го люде́й nógv fólk; стол накры́т на 12 borðið er dekkað til 12 persónar; подразделе́ние чи́сленностью (в) 100 челове́к ein (her)deild upp á 100 mans; по 100 рубле́й с челове́ка hundrað rublar fyri hvønn; косми́ческий кора́бль с челове́ком на борту́ mannað rúmdarskip; когда́ ты ста́нешь челове́ком? nær verður tú fólk?; сде́лать изкого-л.челове́ка fáa fólk burtur úro-m2.(какой-то мужчина) maðurмнепр, harriмгл-iуст.; молодо́й челове́к ungur maður; там пришёл како́й-то челове́к и хо́чет поговори́ть с тобо́й ein maður er komin, sum vil fáa orðið á teg3.gml.(слуга) tænariмгл-ari@ма́ленький челове́кtann lítli maðurin; ≈ Pallibaм нескл.неформ.(простой фаререц);челове́к челове́ку волкmenniskjað er ein úlvur móti menniskjanum;я - челове́к, и ничто́ челове́ческое мне не чу́ждоeg eri eitt menniskja og einki menniskjansligt er mær fremmant =>ли́шний@,пра́воI 2,предполага́ть@,следI 2,футля́р@
челове́к-мото́р	Gen, Accчелове́ка-мото́ра; plur Gen, Accлюде́й-мото́ровmjarn [-tn]с0o{a/ø}, grevс0o(ágrýtið fólk)
челове́ко-де́нь	Genчелове́ко-|дня́;plur~дни́, ~дне́й, ~дня́мmdagsverkс0о(arbeiði,sum eitt fólk ger í ein dag)
человеколюби́вый	stfчеловеколюби́в, ~а, ~о, ~ыadjmenniskjansligur [mεnːɪʃtʃa-]глigur, manngóðurгл{+}кн.; humanur [huꞋmaː-]интсогл(гуманный)
человеколю́бие	nmenniskjakærleiki [mεnːɪʃtʃa-]мгл-i, mannakærleikiмгл-iкн.; humanitetur [huːmaːniꞋtʰeː-]интмсогл-ar
человеконенави́стник	[-сн-]mmenniskjahatari [mεnːɪʃtʃa-]мгл-ari, mannfíggindiмгл-iкн.; misantropur [miːsanꞋtʰɹoː-]интмсогл-ar(мизантроп)
человеконенави́стнический	[-сн-]adjmenniskjafíggindaligur [mεnːɪʃtʃa-]глigur, mannfíggindaligurглigurкн., mannvándurсоглкн.; misantropiskur [miːsanꞋtʰɹoː-]интсогл(мизантропический)
человеконенави́стничество	[-сн-]nmenniskjahatur [mεnːɪʃtʃa-]с0осн, mannahaturс0оснкн.; misantropi [miːsantʰɹoꞋpʰiː]интж0-ir(мизантропия)
человекообра́зный	stfчеловекообра́з|ен, ~на, ~но, ~ныadjmenniskjalíknandi [mεnːɪʃtʃa-]глandi, mannlíkurсоглкн.; antropomorfur [-ˈmɔ-]интсогл; человекообра́зная обезья́на menniskjaapaннк, mannapaнп, mannlík apaкн.
челове́ко-ча́с	mtímaverkс0оофиц.
челове́чек	Gen, Accчелове́чк|а;plur~и, ~ов, ~амm dim avчелове́к 1 manstandurс0осн, neyðarsligt mannfólkс0о
челове́ческий	adj1.(кчелове́к) manna-, menniskja- [mεnːɪʃtʃa-], fólka-; челове́ческая жизнь mannalív; челове́ческое те́ло mannakroppurin; челове́ческий ра́зум mannavit, mansvit, menniskjaforstand [mεnːɪʃtʃa-]ннк; челове́ческая па́мять minni; на челове́ческой па́мяти í manna minni; э́то в челове́ческих си́лах hetta stendur í menniskjans [mεnːɪʃtʃa-] mátti; э́то де́ло рук челове́ческих hetta er av mannaávum, hetta er av fólkavoldum; ничто́ челове́ческое ему́ не чу́ждо einki menniskjansligt [mεnːɪʃtʃa-] er honum fremmant2.síчелове́чный=>же́ртва5,приро́да2,рост4
челове́чество	nmannaættж0-ir(б.ч. опр.); menniskjaðсгл-aопр., menniskjanжгл-aопр.кн.
челове́чность	fmenniskjaligheit [mεnːɪʃtʃa-]ннкж0-ir; menniskjansleiki [mεnːɪʃtʃa-]нпмгл-i, menniskjansskapur [mεnːɪʃtʃa-]нпмсогл-ir; humanitetur [huːmaːniꞋtʰeː-]интмсогл-ar
челове́чный	stfчелове́ч|ен, ~на, ~но, ~ныadjmenniskjansligur [mεnːɪʃtʃa-]глigur; humanur [huꞋmaː-]интсогл(гуманный)
Челю́скин	мыс Tjeljuskinnesið [tʃʰeꞋʎjʊskɪn-]с0о{+}опр.
челюстно́й	[-сн-]adjanat.kjálka-
че́люсть	f1.anat.(кость) kjálkiмгл-i(kjálkabein), kjálkabeinс0о(нижняя),munnbeinс0о(верхняя), kjafturмсогл-ar(у животных); ве́рхняя че́люсть yvirkjaftur (у животных); ни́жняя че́люсть undirkjaftur (у животных), kjálkabein2.(вставная) gebiss [keꞋpɪsː]ннкс0о, forlornar [-Ꞌlɔ-]ннкtennж0о{+}мн, handilstennж0о{+}мнофиц.
Челя́бинск	mTjeljabinsk [tʃʰeꞋʎjaːpɪnsk]м нескл.
че́лядь	fkoll,gml.tænastufólkс0омн
чём	pron Prp avчто I
чем1	Iconj1.(aftan á comp av adj) enn; бо́льше, чем вчера́ meira enn í gjár; брат ста́рше, чем сестра́ beiggin er eldri enn systirin2.(скорее,лучшее) +инф.heldur; чем торопи́ться, вы́йдем лу́чше пора́ньше vit skulu heldur fara fyrr avstað [aꞋstεa] enn at skunda okkum, tað er betri at fara fyrr avstað [aꞋstεa] enn at skunda sær3.чем ... тем … tess... tess..., jú... jú...; чем бо́льше, тем лу́чше jú meira, jú betri =>да́льше@,пре́жде@,ра́ньше1,@,скоре́еII 1
чем2	IIpron1.Ins avчто2.Prp síнеII
чем3	IIIparthví, í hvønn máta; чем он лу́чше меня́? í hvønn máta er hann betri enn eg?; чем э́то пло́хо? hví skuldi tað verið so ringt?; чем он не поэ́т? hví skuldi hann ikki verið skald?
чемода́н	mkuffertс0о; уложи́ть чемода́н pakka kuffertið@сиде́ть на чемода́нахsita ferðabúgvin (og bíða), vera klárurсоглat fara =>собра́ть3
чемода́нный	adj: чемода́нное настрое́ниеtlm., skemt.fráfaringarhýrur, fráfaringarstemningurннк
чемода́нчик	mhondkuffert [hɔnk-]с0о, handkuffert [hank-]нпс0о
чемпио́н	mmeistariмгл-ari(í ítrótti); чемпио́н Росси́и russlandsmeistari [-lan̊s-], russiskur meistari; чемпио́н Фаре́рских [-рэ́-] острово́в føroyameistari [fœɹja-]; чемпио́н ми́ра по ша́хматам heimsmeistari í talvi; зва́ние чемпио́на Евро́пы evropameistaraheiti [εuꞋroː-]{europameistaraheiti [œuꞋroː-]}
чемпиона́т	mmeistaraskapurмсогл-ir; чемпиона́т Фаре́рских [-рэ́-] острово́в по футбо́лу føroyameistaraskapurin [fœɹja-] í fótbólti
чемпио́нка	plurчемпио́н|ки, ~ок, ~камfmeistariмгл-ari(í ítrótti, konufólk),síчемпио́н
чемпио́нский	adjmeistara-; чемпио́нский ти́тул meistaraheiti
чему́	pron Dat avчто I, II
чепе́	[-пэ́]n indecl síЧП
чепе́ц	Gen, Accчепц|а́;plur~ы́, ~о́в, ~а́мmkýsiмгл-i
чепра́к	Genчепрак|а́;plur~и́, ~о́в, ~а́мmsaðilklæðiсгл-i
чепуха́	f1.(ерунда) tvætlс0о, møsnс0о, svassс0о, tvassс0о, vøsс0о, sluturэнкс0осн, vrøvl {vrevl}энкс0о; говори́ть {нести́} чепуху́ tvætlaaði, møsnaaði, svassaaði, tvassaaði, vrøvla {vrevla}энкaði; чепуха́ на по́стном ма́слеskemt.tað rama tvætl2.(пустяк)o-t, sum einki hevur upp á [ʊꞋpʰɔa] seg;o-tsmávegis, bagatell [pakaꞋtʰεlː]ннкж0-ir;o-t, sum lítið er fyri (лёгкое дело);o-t, sum einki er fyri (лёгкое дело); он заплати́л за э́то соверше́нную чепуху́ hann keypti tað fyri lítið og lætt; тут идти́ совсе́м чепуху́ hesin teinurin hevur einki upp á seg, hesin teinurin er einki at snakkaннкum; э́то ве́сит чепуху́ hetta vigar einki; э́то чепуха́ (очень простая работа) hetta er púra einki fyri, hetta hevur ikki petti upp á seg
чепухо́вый	adj1.(являющийся ерундой) tvætluturсогл, býtturсогл(sum er tvætl)2.(пустяковый) sum lítið hevur upp á [ʊꞋpʰɔa] seg; sum einki er fyri (о задаче, проблеме)
че́пчик	mkýsiмгл-i
че́рва	f síче́рви
червеобра́зный	stfчервеобра́з|ен, ~на, ~но, ~ныadj(skapaður) sum maðkur [maʰkː-]; червеобра́зный отро́сток ágørn [-tn]ж0-ar{ø/a}мед.
че́рви	черв|е́й, ~я́мf plurkort.hjartari [ja-]мгл-ari; восьмёрка черве́й hjartaráttur [jaɹ̥taɹꞋɔʰtː-]; туз черве́й hjartaress [jaɹ̥taɹꞋεsː]; черви ко́зыри hjartari er trumfur; взять на свои́ че́рви fáa stikk við hjartarum
черви́веть	ipf(pfзачерви́веть, очерви́веть)bert 3. pers brúkturverða maðketin [maʰkː-]соглосн
черви́вый	stfчерви́в, ~а, ~о, ~ыadjmaðketin [maʰk:e-]соглосн
червлёный	adjgml.myrkareyðurгл
черво́нец	Genчерво́нц|а;plur~ы, ~ев, ~амm1.søg.(монета)gullmyntur við virði millum 3 og 10 rublar2.(кредитный билет в 10 рублей) tíggju rubla seðilс0осн-s,-ar(1922-1947)3.tlm.(сумма в десять рублей) tíggju rublar (upphædd)4.plurgml.(деньги) pengarмгл-iмн
черво́нный1	Iadjgml.,skald.reyðurгл@черво́нное зо́лотоreyðargull [-tl]
черво́нный2	IIadjkort.hjartar- [ja-]; черво́нный туз hjartaress [jaɹ̥taɹꞋεsː]
червото́чина	f1.(изъян) holс0оeftir [εʰtː-] maðki [maʰtʃ:ɪ], holс0оhjá [tʃʰ-] maðki [maʰtʃːɪ]2.fl.(испорченность) spilla [-tla-]жгл-a(moralsk o.a.), (moralskt [-raː-]) lýtiсгл-i
че́рвы	черв, ~амf plur síче́рви
червь	Gen, Accчервя́;plurче́рви, черв|е́й, ~я́мm1.(животное) maðkur [maʰkː-]мсогл-ar; ormurмсогл-ar(б.ч. глисты и т.п.); новозела́ндский пло́ский червь (Arthurduendyus triangualatus) (nýsælemdskur [-lεn̊sk-]) flatmaðkur ; кру́глые че́рви (тип Nematoda) rundormur, nematoda [-Ꞌtʰoː-]мгл-aспец.; в мя́се че́рви maðkur er í kjøtinum; уди́ть на червя́ fiska við maðki (sum agn)2.teld. (компьютерный вирус) ormurмсогл-ar(telduvirus)3.(о ничтожном человеке) kropс0опрезр., spjaðс0о{0<>i}презр.(um fólk)4.:червьтоски́ longsulsins ormur; его́ гло́жет червь сомне́ния ivin pínir hann sum ein ormur@кни́жный червьbókaormur =>дождево́й@,многощети́нковый,шелкови́чный
червя́к	plurчервяк|и́, ~о́в, ~а́мm1.Gen, Accчервяка́síчервь1-22.Genчервяка́tekn.(зубчатое колесо) snekkjaжгл-а(slag av tannhjóli)
червя́чный	adjsnekkju-; червя́чная переда́ча snekkjudrevннкс0опроф., snekkjudrivс0о; червя́чное колесо́ snekkjuhjul [-juːl]ннкс0опроф., snekkjuhjól [-tʃʰɔul]нпс0о
червячо́к	Gen, Accчервячк|а́;plur~и́, ~о́в, ~а́мm dim avчервь =>замори́ть@
черда́к	Genчердак|а́;plur~и́, ~о́в, ~а́мmovastaloftс0о, hanabjálkaloftс0о; loftс0о(б.ч. жилое помещение); ко́мната на чердаке́ loftskamar, loftsverilsiннк
черда́чный	adjlofts-; черда́чное окно́ loftsvindeyga [-vɪnta]; черда́чное помеще́ние loftс0о(rúm)
череви́ки	m plur høghælaðir konufólkahálvstivlar
череви́чки	m plur dim avчереви́ки
черёд	Genчереда́,Prpо череде́, в череду́mtlm.1.(очерёдность) túrurмсогл-ar;-s,-ir, tørnс0о; тепе́рь твой черёд nú eigur tú, tú eigur tørn; когда́ наста́нет мой черёд tá eg standi fyri túri, tá eg eigi, tá eg eigi tørn; твой черёд (ходи́ть) tú eigur leik (в шахматах)2.(время,пора) tíðж0-ir, løtaжгл-а; наста́л {пришёл} черёд отмени́ть э́то nú er tíðin komin at taka hetta av@идти́ свои́м чередо́мganga sína vanligu gongd
череда́1	Iplurчереды́, черёд. череда́мf1.óvkm.(очередь) túrurмсогл-ar;-s,-ir, tørnс0о2. (вереница)fraðс0о{a/ø}, røðж0-ir{ø/a}, rekkjaннкжгл-a
череда́2	IIplurчереды́, черёд. череда́мf plant. (растение)planta úr slektini Bidens(en.bidens; da.brøndsel)
чередова́ние	n1.(смена) skiftiсгл-i; чередова́ние моро́зов и о́ттепелей skifti millum [-tl-] frost og toybil2.mál.(звуков): чередова́ние зву́ков ljóðskifti; чередова́ние гла́сных avljóðс0о{0<>i}
чередова́ть	череду́|ю, ~ешь, ~ютipf что-л. с чем-л.skiftair(t)millum [-tl-]o-togo-t, geraнепрo-ttil skiftis; skiftair(t)o-tum viðo-t(сменить); чередова́ть рабо́ту с о́тдыхом skifta millum [-tl-] arbeiði og hvíld
чередова́ться	череду́/юсь, ~ешься, ~ютсяipf1.(с кем-л.) (поочерёдно заменяться) loysair(t)o-nav, skiftastir(t); сиде́лки череду́ются у посте́ли больно́го vøkukonurnar loysa hvørja aðra av við seingina hjá tí sjúka; они́ чередова́лись за рулём teir skiftust (um) at koyra2.bert 3. pers brúktur(сменять одно другим) skiftair(t); кра́сное чередова́лось с бе́лым hvítt skifti við reytt; в репертуа́ре череду́ются произведе́ния Остро́вского и Че́хова leikskráin skiftir millum [-tl-] verk hjá Оstrovskij [ɔꞋstɹɔfskiː] og Tjekhov [tʃʰεʰkːɔf]
че́рез	prep + Acc1.(поперёк;поверх) yvir um +Вин, tvørtur um +Вин; мост че́рез реку́ brúgvin tvørtur um ánna; перейти́ че́рез доро́гу fara yvir um vegin; пры́гнуть че́рез забо́р leypa upp um stikið; доро́га идёт че́рез го́ры vegurin gongur upp um fjøllini [-tl-]; смотре́ть че́рез плечо́ hyggja aftur [-tː-] um seg, hyggja aftur [aʰtː-] um bak; реме́нь че́рез плечо́ reim um økslina; он живёт че́рез доро́гу hann býr hinumegin vegin, hann býr yvir Ꞌ av mær2.(сквозь) gjøgnum +Вин; смотре́ть че́рез окно́ hyggja gjøgnum vindeygað [vɪntaijɪ] (ред.[vɪntεija]); че́рез весь го́род gjøgnum allan [atl-] býin; влезть че́рез окно́ krúpa inn gjøgnum vindeygað [vɪntaijɪ] (ред.[vɪntεija])3.(о пунктах следования) um +Вин, via [viːja]ннк+Вин; е́хать в Ри́гу че́рез Минск fara til Riga um Minsk, fara til Riga viaннкMinsk; доро́га идёт че́рез Смоле́нск vegurin gongur um Smolensk [-Ꞌlε-]4.(по прошествии) um +Вин(framtíð); seinni [sai̯tni], eftir [εʰtː-] (fortíð) (спустя); че́рез час a) (в будущем) um ein tíma; b) (в прошлом) ein tíma seinni; че́рез два дня он уе́дет hann fer um tveir dagar; че́рез два дня он уе́хал tveir dagar seinni fór hann; че́рез день a) (в прошлом) dagin eftir [εʰtː-]; b) (в будущем) í ovurmorgin [oːmɔɹtʃɪn](тж[oːvʊɹ-])5.: че́рез ка́ждые 5 минут fimta hvønn minutt [mɪꞋnʊʰtː]; че́рез час по ло́жке eina skeið hvønn tíma; че́рез день annanhvønn dag6.(при посредстве): писа́ть сло́во че́рез чёрточку skriva orðið við bindustriku; э́то сло́во пи́шется че́рез «а» hetta orðið verður stavað við "a"; посла́ть письмо́ че́рез Па́вла senda eitt bræv gjøgnum Pavel; я узна́л э́то че́рез сестру́ eg frætti tað gjøgnum systur mína; он доста́л э́то че́рез друзе́й hann fekk fatur á tí gjøgnum vinfólk; я знако́м с ним че́рез жену́ eg kenni hann gjøgnum konu mína; оповести́ть че́рез газе́ты kunngera gjøgnum bløðini; приговори́ть к сме́ртной ка́зни че́рез пове́шение døma til deyða við heinging7.(о пространственном интервале): я выхожу́ че́рез остано́вку eg fari av aftan [aʰtː-] á næsta steðgipláss [stεtʃːɪ-]; он живёт че́рез два до́ма hann býr tvey hús burturfrá [-Ꞌfɹɔa]; писа́ть че́рез две стро́чки skriva við dupultum reglugloppi, skriva við dupultum linjuavstandiннк, skriva við dupultum millumrúmi [mɪtlɪn-] =>си́ла@
че́резо	prep framman fyri einstøkum samansetingum av hjáljóðum síче́рез
череми́с	mgml.síма́ри
череми́сский	adjgml.síмари́йский
череми́ца	f planta úr slektini Veratum(en.veratum; da.foldblad)
черёмуха	fIplant.1.(Prunus padus) heggurмсогл-ar, heggtræс0о{æ/ø}2.(ягода) heggberс0о{+}IIherm.(газ) táragassс0о
черемша́	f(Allium ursinum) bjarnaleykur [-tn-]мсогл-s,-ir
черено́к	Genчеренк|а́;plur~и́, ~о́в, ~а́мm1.(рукоятка) skaftс0о{a/ø}, skeftiсгл-i, orvс0о(косы)2.plant.(отрезок) gróðursetingargreinж0-ar;irспец.(для прививки); avleggari [aul-]мгл-ari, setkvisturлпмсогл-ar(для посадки)3.(листа) blaðstelkurмсогл-ar4.djór. (моллюск): морско́й черено́к (Solen ensis) langfiskurмсогл-ar, langskelж0-ar{+}
че́реп	plurчереп|а́, ~о́в, ~а́мmskølturмсогл-ar, kranium [kʰɹaːniʊm]ннкс0-umпроф.; heysurмсогл-ar(о людях б.ч.пренебр.); skrovbein [skɹɔpain] (от овцы); skalli [-tlɪ]мгл-i(верхняя часть черепа); с го́лым {лы́сым} че́репом berskøllutur [-tl-]; изображе́ние че́репа deydningahøvd [-hœtː]ннк, skøltur (как эмблема смерти); перело́м че́репа kraniibrotннкпроф., skallabrot [-tl-]нп=>проломи́ть
черепа́ха	f1.(отряд Testudines) skildpadda [skɪl̥p-]ннкжгл-a, skjaldbøka [ʃalp-]нпжгл-a; морска́я черепа́ха havskildpaddaннк, havskjaldbøkaнп2.koll(материал) skildpadduskel [-skɪl̥p-]ннк, skjaldbøkuskel [-ʃalp-]нп(tilfar)@как черепа́ха {черепа́хой}við snigilsferð;плести́сь как черепа́хаgangaслнe-i-ifót fyri fót, daggaaði
черепа́ховый	adjskildpaddu- [skɪl̥p-]ннк, skjaldbøku- [ʃalp-]нп; черепа́ховый гре́бень kambur úr skildpadduskelннк, kambur úr skjaldbøkuskelнп; черепа́ховый суп skildpaddusuppaннк, skjaldbøkusuppaнп
черепа́ший	adjskildpaddu- [skɪl̥p-]ннк, skjaldbøku- [ʃalp-]нп: черепа́ший па́нцирь skildpadduskelннк, skjaldbøkuskelнп@идти́ черепа́шьим ша́гомganga við snigilsferð, ikki ganga fyri seiðпог., ikki ganga um fliðunaпог.
черепи́ца	ftaksteinurмсогл-ar, tigulsteinurмсогл-areis. koll(из обожжёной глины); кры́тый черепи́цей tigultaktur
черепи́чный	adjtigul-; черепи́чная кры́ша tigultak
черепно́й	adjskalla- [-tl-], kranii- [kʰɹaːniɪ-]ннкпроф.; черепна́я коро́бка høvuðsskálж0-ir, skalli [-tlɪ]мгл-i
черепо́к	Genчерепк|а́;plur~и́, ~о́в, ~а́мmpottabrotс0о; разби́ться на {в} черепки́ faraслнó-ó-aí smildur
чересполо́сица	f skipan,har teigar hjá ym. eigarum liggja hvør um annan
чересполо́сный	adj: чересполо́сные владе́нияsíчересполо́сица
чересчу́р	advalt ov (перед согласным, кромеh, [ɔ],перед согласными иh [oː]), alt for [fɔɹː]ннк; чересчу́р ма́ло alt forннк,alt ov lítið; чересчу́р мно́го alt forннкnógv, alt ov nógv; чересчу́р ... (для того,) что́бы alt forннк... til at .., alt ov ... til at ....; он да́же чересчу́р скро́мен hann er í so lítillátin; э́то уж чересчу́р! nú er ovboðið [ɔpoːjɪ]!; nú ber av!; tað er nakað nógv av tí góða!
чере́шня	plurчере́шни, чере́шен, чере́шнямf1.(Cerasus avium) kirsubertræ [kʰɪ-]ннкс0о{ø/ø}{0<>i}, kirsuberjatræ [tʃʰɪ-]нпс0о{ø/ø}{0<>i}2.(плоды) kirsuber [kʰɪ-]ннк(тж[tʃʰɪ-]нп)с0о{+}
черешо́к	Genчерешк|а́;plur~и́, ~о́в, ~а́мm síчерено́к1, 2
черка́ть	ipf что-л.tlm.(вычёркивать) strikaaðio-t(út)
чёркать	ipf síчерка́ть
черке́с	mtjerkessari [tʃʰεɹꞋkʰεsː-]мгл-ari
черке́ска	plurчерке́с|ки, ~ок, ~камf(одежда)síður, trongur jakki hjá kaukasarum o.ø.
Черке́сск	mTjerkessk [tʃʰεɹꞋkʰεsk]м нескл.
черке́сский	adjtjerkessiskur [tʃʰεɹꞋkʰεsː-]согл; кабарди́но-черке́сский язы́к kabardino-tjerkessiskt [kʰaːpaɹˌtiːnotʃʰeɹꞋkʰεsː-]сприлskt
черке́шенка	plurчерке́шен|ки, ~ок, ~камftjerkessari [tʃʰεɹꞋkʰεsː-]мгл-ari(konufólk)
черкну́ть	черкн|у́, ~ёшь, ~у́тmoment(ipfчерка́ть)что-л.tlm.(написать) ruslaaðio-t, klóraaðio-t(skriva); черкни́ мне не́сколько слов send mær nøkur orð
чернёный	adjanlopinсоглосн(um stál - til tað gerst blátt)
че́рнеть	f: морска́я че́рнеть (Aythya marila) grábøkut ontж0-ur{o/a/e}, grábøkaжгл-a; хохла́тая че́рнеть (Aythya fuligula) trøllont [-tl-]ж0-ur{o/a/e}
черне́ть	ipf1.pfпочерне́ть (стать чёрным) gerast svarturсогл{a/ø}, sortnaaði, myrkna [mʂna]aði2.bert 3. pers brúktur(виднеться) síggjastслнá-ó-æsvartur, standaслнó-ó-asvartur; за реко́й черне́ет бе́рег handan ánna hómast tann svarti áarbakkin, handan ánna stendur áarbakkin svartur, handan ánna breddar tann svarti áarbakkin
черне́ться	ipf bert 3. pers brúktur síчерне́ть2
черне́ц	Gen, Accчернеца́;plurчернец|ы́, ~о́в, ~а́мm gml.munkurмсогл-ar
черни́ка	f1.(Vaccinium myrtillis) aðalbláberс0о{+}(lyngur), aðalbláberjalyngurмсогл-ar2.(ягоды) aðalbláberс0о{+}мн
черни́ла	черни́л, ~амn plurblekkс0о@ещё не просо́хли черни́ла …blekkið var ikki turt... =>симпати́ческий@
черни́льница	fblekkglasс0о{a/ø}, blekkhúsс0о
черни́льный	adj1.(кчерни́ла) blekk-; черни́льный каранда́ш blekkblýantur2.(цвета чернил) svarturсогл{a/ø}sum blekk; черни́льный мешо́к {черни́льная железа́} blekkposi (hjá høguslokki o.tíl.)3.spott.(остающийся только на бумаге) sum bara er á papírunum [-Ꞌpʰʊi-], papírs- [-Ꞌpʰʊi-]@черни́льная война́skemt.,spott.,gml.blaðstríð;черни́льная душа́ {кры́са}tlm.,skemt.ogatf.,gml.bureaukratur [pyːɹoꞋkʰɹaː-]мсогл-ar;черни́льный оре́шекknykil á grein o.ø.
черни́ть	черн|ю́, ~и́шь, ~я́тipf Acc1.pfзачерни́тьзачерн|ю́, ~и́шь, ~я́т(делать чёрным) litaaðiВинsvartan, geraнепрВинsvartan, svertaaðiВин2.pfочерни́тьочерн|ю́, ~и́шь, ~я́т(позорить) spilla [-tla]ir(t)Винút, dálkaaðiВинút (baktala)
черни́чный	adj(aðal)bláberja-
чёрно-бе́лый	adj1.(состоящий из чёрного и белого) svarturсогл{a/ø}og hvíturсогл2.(фотография, кинофильм) svartсогл{a/ø}-hvíturсогл
черноборо́дый	черноборо́д, ~а, ~о, ~ыadjsvartskeggjuturсогл, við svørtum skeggi
чернобро́вый	чернобро́в, ~а, ~о, ~ыadjsvartbrýnturсогл, við svørtum eygnabrúm, sum hevur svartar eygnabrýr
чернобу́рка	plurчернобу́р|ки, ~ок, ~камftlm.1.(лиса) (dimmur) silvurrevurмсогл-ar2.(мех) skinnс0оav ( dimmum) silvurrevi
черно-бу́рый	чернобу́р, ~а, ~о, ~ыadjsvartbrúnurсогл, dimmbrúnurсогл; черно-бу́рая лиси́ца (dimmur) silvurrevur
Черно́быль	mTjernobyl [tʃʰεɹnopɪl] (реже[tʃʰεɹꞋnoːpyl])м0{дат.0}
чернобы́льник	m(Artemisia vulgaris)planta í malurtaslektini(en.mugwort; da.grå bynke)
черно́быльский	adjtjernobyl- [tʃʰεɹnopɪl-] (реже[tʃʰεɹꞋnoːpyl-]); Черно́быльская АЭС kjarnorkuverkið [-tn-] í Tjernobyl
чернова́тый	stfчернова́т, ~а, ~о, ~ыadjsum ber á svart
чернови́к	Genчерновик|а́;plur~и́, ~о́в, ~а́мmkladdaжгл-a; uppkastс0о{a/ø}(набросок); бума́га для черновико́в kladdupappír; тетра́дь для черновико́в kladdubók, kladduhefti
черново́й	adj1.(написанный,подготовленный начерно) kladdu-; чернова́я тетра́дь kladdubók, kladduhefti; черново́й вариа́нт kladda; в черново́м вариа́нте {в черново́й фо́рме} sum kladda2.: чернова́я рабо́та skitið arbeiði, tungt arbeiði
черноволо́сый	stfчерноволо́с, ~а, ~о, ~ыadjsvarthærdurсогл
черногла́зый	stfчерногла́з, ~а, ~о, ~ыadjsvartoygdurсогл
черноголо́вка	plurчерноголо́в|ки, ~ок, ~камf síсла́вка, черноголо́вая
черноголо́вый	stfчерноголо́в, ~а, ~о, ~ыadj(о человеке) svarthærdurсогл; høvuðsvarturсогл{a/ø}(о животных и др.)
черного́рец	Gen, Accчерного́рц|а;plur~ы, ~ев, ~амmmontenegrinari [mɔn̊tɪneꞋkɹiː-]мгл-ari, montenegri [mɔn̊tɪꞋneːkɹɪ]нпмгл-i
Черного́рия	fMontenegro [mɔn̊tɪꞋneːkɹo]с нескл.
черного́рка	plurчерного́р|ки, ~ок, ~камfmontenegrinari [mɔn̊tɪneꞋkɹiː-]мгл-ari, montenegri [mɔn̊tɪꞋneːkɹɪ]нпмгл-i(konufólk)
черного́рский	adjmontenegriskur [mɔn̊tɪꞋneːkɹ-]согл
черногри́вый	stfчерногри́в, ~а, ~о, ~ыadjvið svørtum faksi
Чёрное мо́ре	Svartahaviðс0оопр.
черножо́пый	adjvanv.um íbúgvar serl. í Transkaukasus
чернозём	m fruktagóð, dimmlitt jørð
чернозёмный	adj: чернозёмная полоса́belti við fruktagóðari, dimmlittari jørð(í Miðrusslandi o.a.),síчернозём
чернозо́бик	m(Calidris alpina) fjallmurraжгл-a
чернокни́жие	ngml.gandurмсогл-ar
чернокни́жник	mgml.gandakallur [-tl-]мсогл-ar{a/ø}
черноко́жий	Istfчерноко́ж, ~а, ~е, ~иadjdimmleitturсогл, døkkleitturсогл, døkkholdaðurглaður, við myrkari húð; svarturсогл{a/ø}(við svørtum holdi)IImsvarturмприл, nekariмгл-ari(негр)
черноле́сье	nleyvskógж0-ir, leyvskógurнпмсогл-ir;-ar
чернома́зый	stfчернома́з, ~а, ~о, ~ыadj1.tlm.(смуглый и черноволосый) svartleitturсоглog svarthærdurсогл2.(грязный) dálkaðurглaðurút
черномо́рский	adjsvartahavs- [-hafs-]; við Svartahavið (на берегу Чёрного моря), á Svartahavinum (на Чёрном море)
чернорабо́чий	m(ikki yrkislærdur) arbeiðariмгл-ari
черноруба́шечник	msvartskjúrtaжгл-aист.(italienskur fasistur)
черносли́в	m kollsviskurжгл-aмн.; из черносли́ва {с черносли́вом} svisku-
черносо́тенец	Gen, Accчерносо́тенц|а;plur~ы, ~ев, ~амm1.søg.limur av felagsskapinumЧёрная со́тня, síсо́тня@2.(крайний реакционер) svartur afturhaldsmaður [aʰtːʊɹhal̥s-]мнепр
чернота́	f1.(чёрный цвет) svartur liturмсогл-ir; sortiмгл-i, døkkiмгл-i(что-л. чёрное, тёмное)2.(темнота) dimmiсгл-i, myrkurс0осн@чернота́ под глаза́миmyrkir ringar undir eygunum
черну́ха	f kolltlm.bøkur, filmir o.a., ið einamest lýsa tær negativu síðirnar av lívinum
черну́шка	plurчерну́ш|ки, ~ек, ~камf1.tlm.(женщина, девушка)dimmleitt el. svarthærd kona el. genta2.(гриб) (Lactatus nectator)slag av soppi úr ættini Russulaceae
чёрный	Istfчёрен, черна́, черно́ogчёрно,черны́adj1.(о цвете) svarturсогл{a/ø}; ходи́ть в чёрном ganga í svørtum klæðum2.(тёмный) myrkurсогл; чёрная ночь kolsvørt [kʰœl̥-] (реже[kʰɔl̥-]) nátt, bølamyrk nátt3.(грязный) skitinсоглосн4.(дурной,низкий) brotsmanna-; óreinurсогл, óndurсогл, andstyggiligur [anꞋstɪ-]глigur; dimmurсоглперен., myrkurсоглперен.; чёрная изме́на skammiligt svik; чёрное де́ло illgerð, ógerð5.bert lf(курной) við ongum skorsteini; чёрная изба́ hús við ongum skorsteini6.(физически тяжёлый) tungurсогл(um arbeiði); чёрная рабо́та hart, tungt kropsligt arbeiði; arbeiði, sum ikki krevur yrkisútbúgving7.(безрадостный) dapurсогл{a/ø}(мрачный); чёрные мы́сли daprir tankar; чёрный день óeydnudagur, ein svartur dagur; отложи́тьчто-л.на чёрный день leggja til síðis til ringar tíðir; чёрный год óeydnuár, eitt svart ár, eitt ófýsiligt [-Ꞌfʊi-] árIIm1.(негр) svarturмприл{a/ø}, nekariмгл-ari2.niðr.(выходец с Кавказа,из Средней Азии)fólk úr Kaukasus el. Miðasia3.plur talv.(в шахматах) tað svarta talvfólkið,sí eis.бе́лыйII 3@чёрный ры́нокsvartabørsж0-ir; прода́ть на чёрном ры́нке selja á svørtubørs; занести́кого-л.вчёрный спи́сокsetao-ná svartalista;называ́ть бе́лое чёрным {принима́ть бе́лое за чёрное}geraнепрsvart til hvítt;чёрным по бе́ломуsvart upp á hvítt;ви́деть всё в чёрном све́теsíggja alt í einum døprum ljósi;«чёрная смерть»svartideyði (эпидемия чумы в средневековой Европе) =>дельфи́н,де́рево2,духове́нство@,за́висть@,зо́лото@,икра́I 2,ко́фе1,лес1,ле́стница,ма́гия,мета́лл1,металлурги́я,па́лтус,полI,пя́тница@,со́тня@,хлебА 1,ходB,ю́мор,я́щик@
черны́ш	Gen, Accчерныша́;plurчерныш|и́, ~е́й, ~а́мm(Tringa ochropus) flykrustelkurмсогл-ar
чернь1	Ifgml.oftastvanv.(простонародье) pøbilэнкм0осн-s,-arпрезр., pakkс0опренебр.
чернь2	IIflistniello [niꞋεlːo]с нескл.спец.
черпа́к	Genчерпак|а́;plur~и́, ~о́в, ~а́мmoysaжгл-a(на ручке,для супа и др.); eyskar [εs-]с0о{a/ø}(для лодки); (á gravimaskinu o.tíl.) skuffaжгл-a(землечерпаки); hóvurмсогл-ar(каплёр)
че́рпать	ipf(momentчерпну́тьчерпн|у́, ~ёшь, ~у́т)что-л.1.(из чего) (набирать,доставать) oysair(t)o-t(upp)úr o-m); gravaслнó-ó-i;aði{+}o-t(копать)2.fl.из чего-л.(приобретать,извлекать) heintaaðio-t, fáaслнe-i-io-t; че́рпать зна́ния heinta kunnskap fráo-m, heinta kunnskap úro-m, oysa kunnleika úro-m; че́рпать си́лы fáa kreftir fráo-m; че́рпать вдохнове́ние fáa inspiratión [inspiːɹaꞋʃɔun]инт
черпну́ть	moment síче́рпать
черстве́ть	ipf(pfпочерстве́ть)1.pf eis.зачерстве́тьbert 3. pers brúktur(о хлебе и др.) harðnaaði, skorpna [skɔɹ̥tna], [skɔʂna]aði, torna [-tna]aði(upp) (serliga um breyð o.tíl.)2.pf eis.очерстве́ть (о людях) gerastнепрharðhjartaður [haɹja-], forherða [-Ꞌheː-]aðiseg, herðastir(d)(gerast harðhjartaður)
чёрствость	f1.(несвежесть) tað at vera turrur, tað at vera harður,síчёрствый12.(о характере) tað at vera harðhjartaður [-ja-], kensluloysiсгл-iкн.,síчёрствый2
чёрствый	stfчёрств, черства́, чёрство, черствы́ogчёрствыadj1.(о хлебе) turrurсогл, harðurсогл{a/ø}, gamalсогл{a/o}(breyð o.tíl.)2.(о человеке) harðurсогл{a/ø}(harðhjartaður), harðhjartaður [haɹja-]глaður
чёрт	plurче́рти, черт|е́й, ~я́мmdevilм0осн-s,-ar, devulм0осн-s,-ar, djevulм0осн-s,-ar, faniмгл-i, illimaður [ɪtl-]мнепр, fjandinмгл-iопр.@морско́й чёрт(Lophius piscatorius) havtaska [hau-], [haf-]жгл-a;чёрт! {чёрт-те что!, что за чёрт!, чёрт зна́ет что!, э́то чёрт зна́ет что тако́е!}pínadoyð (ikki)!бран.; pínadoyð og sáligheit!бран.; pínadoyðirnar (ikki)!бран.;хоть чёрта лы́согоtlm.hvat sum er, alt;чёрт его́ зна́ет {одному́ чёрту изве́стно}tað viti faninбран.;вот чёрт!(выражает восхищение) hygg hasin gamli!; hygg hatta raska!;всё пошло́ к чёртуalt fór at [ɔa] fananum tilбран.;чёрт возьми́ {побери́tlm.}dekan fari!; fanin steiki!бран.,devilin steiki!бран.; fanin brenni!бран., devilin brenni!бран.; pína(sta) doyð (og sáligheit)!бран.;чёрт его дери́hav hann ein lortгрубо;что за чёртhvat faninбран.;на кой чёрт {на чёрта, како́го чёрта}hví faninбран.; {како́го чёрта, за каки́м чёртом} ты пошёл {попёрся} туда́? hví fanin fórt tú harбран.? hvat fanin fórt tú har til?бран.;посла́тького-л.к чёртуbiðjao-nfara at [ɔa] fananum tilбран.;(иди́ (ты), пошёл (ты), ну тебя) к чёрту {к чертя́м}far at [ɔa] tramanumбран.til (við tær)!; far at [ɔa] fananumбран., far at [ɔa] fjandanumбранtil (við tær)!; far at [ɔa] fjandanumбран.til (við tær)!; far tú niður og norður!; ну его́ к чёрту! bið hann hava ein lort!грубо; он посла́л меня́ к чёрту hann bað meg fara at [ɔa] fananum tilбран.;ни черта́a) (ничего, нисколько) ikki ein (helvitis) lortннк(einki); b) (не играет роли) tað ger einki;до чёртаa) (очень много): книг до чёрта ein helvitis rúgva av bókumбран.; b) (очень): мне до чёрта надое́ло eg eri so fanans móður av hesumбран.;к чёртуa) (вон, долой): к чёрту его́ til helvitis við honumбран.; b): всё лети́т {идёт} к чёрту alt gongur at [ɔa] tramanum tilбран.; мой о́тпуск лети́т {идёт} к чёрту tað gongur at [ɔa] helviti til við feriuni hjá mærбран.; c): куда́ он к чёрту запропасти́лся {де́лся}! hvar fanin er hann blivin av!бран.; d) како́й он к чёрту учи́тель! hann er fanin gali meg eingin lærari!бран.;чёрт с нимtil helvitis við honumбран.; э́тони к чёрту не годи́тсяhetta nyttar einki, hetta er út av lagi (ringt), hetta er óbrúkiligt [-Ꞌpɹʉu-];сам {ни оди́н} чёрт не разберётtað fæst ikki høvd [hœtː] upp á hetta;чёрт меня́ дёрнул сказа́ть тако́еhví hundin mundi eg siga hatta;злой как чёртleikar í sum illur [ɪtl-] tarvur;он рабо́тает как чёртarbeiða yvir háls og herðar;оди́н чёртtað er alt tað sama, tað er eitt feittэнкнеформ..;у чёрта на рога́хlangt av leið skotin, at [ɔa] tramanum tilбран., at [ɔa] hundinum tilбран.;хоть чёрта в сту́пеhvønn fanaбран.(hvørt mansbarn) =>брат@,два@,драть@,земля́@,кули́чки,ла́дан,лы́сый@,малева́ть@,о́мут@,полоса́тый2,сломи́ть@,шути́ть@
черта́	f1.(линия) strikaжгл-a, linjaжгл-a; провести́ черту́ tekna [-kna]aðieina striku, strikaaði; ;коса́я черта́ framskákс0о; обра́тная коса́я черта́ bakskákс0о2.(предел) markс0о({a/ø}); в черте́ го́рода innan fyri býarmarkið; мяч ушёл за черту́ (по́ля) bólturin fór útum [-Ꞌtʰʊmː]3.(особенность) eyðkenni [εʰtʃ-]сгл-i, dragс0о{a/ø}{0<>i}кн.; черта́ хара́ктера lyndiseyðkenni; основна́я черта́ høvuðseyðkenni; в основны́х черта́х í høvuðsheitum; в о́бщих черта́х í høvuðsheitum; отличи́тельная {специфи́ческая} черта́ sereyðkenni, serdrag; э́то семе́йная черта́ tað er ættarbregði [-pɹeːjɪ]сгл-i; характе́рная черта́чего-л.tað, sum serliga eyðkennir [εʰtʃ-]ir(d)o-t4.oftast plur: черты́ лица́ andlitsskapс0о, anlitssdrøgмнкн.; с гру́быми черта́ми лица́ stórskorin [stœɹ̥-]соглосн, grovskorin [kɹɔu-]соглосн, grovligurглigur, grefligurглigurí ásjón; с ре́зкими черта́ми лица́ skarpurсогл{a/ø}, skarpleitturсогл@подвести́ черту́под чем-л.(подытожить) takaслнó-ó-isaman Ꞌ umo-t; setaur(t);ir(t)punktumfyri o-t(поставить точку); geraнепрo-tliðugt (закончить) =>бе́дность,о́бщий6,осе́длость@,то́нкий3
чертёж	Genчертеж|а́;plur~и́, ~е́й, ~а́мmtekning [tʰεkn-]ж0-ar(at smíða, byggja eftir); чертёж зда́ния ein tekning av einum húsi, húsatekning =>расположе́ние1
чертёжник	fteknari [tʰεkn-]мгл-ari(tekniskur teknari o.tíl.)
чертёжник	mteknari [tʰεkn-]мгл-ari(tekniskur teknari o.tíl.)
чертёжница	fteknari [tʰεkn-]мгл-ari(tekniskur teknari o.tíl.;konufólk)
чертёжный	adjtekni- [tʰεknɪ-]; чертёжная доска́ teknibrettiсгл-i
чертёнок	Gen, Accчертёнк|а;plurчертеня́т|а, ~, ~амmtlm.1.(чёртик) lítil djevulм0осн2.(шалун) óargaungiмгл-i, ótangiмгл-i, forherðingur [-Ꞌheː-]мсогл-ar
чертеня́т…	síчертёнок
чёртик	m: до чёртиковtlm.sera nógv (очень); stór mongd, ørgrynna [œɹ-] (очень много); надое́ло до чёртиков eg var leiddur og keddur av tí; грибо́в в лесу́ до чёртиков har er ørgrynna av svampumннкí skógini@до чёртиков допи́тьсяdrekka, so ein fær delirium [teꞋliːɹiʊm]с0o
черти́ть	черчу́, че́рти́|шь, ~ятipf(pfначерти́тьначерчу́, наче́рти|шь, ~ят)что-л.1.(проводить черту) tekna [tʰεkna]aðieina striku, strikaaði2.(делать чертёж;рисовать) geraнепрeina tekning [tʰεkn-] (at smíða,byggja eftir), tekna [tʰεkna]aðio-t(tekning at smíða,byggja eftir)
чёртов	adjfanansбран., satans [saː-]бран., helvitisбран.;gudsdoyðs [kʊsˈtɔi̯sː]бран.beistaktigur [-ˑa-]глigur@к чёртовой ба́бушкеsíк чёрту =>дю́жина@
черто́вка	plurчерто́в|ки, ~ок, ~камfillb.kelling [-tl-]ж0-ar, gívurж0осн, britaжгл-a
черто́вски	advtlm.ólukksáliga [-Ꞌsɔa-]бран., forbankað [-Ꞌpa-], [-Ꞌpε-]бран., forbiðið [-Ꞌpiː-]бран., forbannað [-Ꞌpa-]бран.; у меня́ черто́вски боли́т голова́ eg havi so heilt ólukksáligaбран.ilt í høvdinum [hœtː-]; чёртовски хитёр ólukksáligaбран.snildur
черто́вский	adjtlm.1.(кчёрт 1) djevulsligurглigur, devulssetturсогл; черто́вский за́мысел devulssett ætlan2.(необычайный по силе и др.) ólukksáligur [-Ꞌsɔa-]глigurбран., forbankaður [-Ꞌpa-], [-Ꞌpε-]глaðurбран., forbiðin [-Ꞌpiː-]соглоснбран., forbannaður [-Ꞌpa-]глaðurбран.
чертовщи́на	ftlm.: что за чертовщи́на tað var sum faninбран.; вся э́та чертовщи́на heila lortiðвульг., heila fratiðвульг.; всегда́ с ним случа́ется кака́я-нибудь чертовщи́на tað hendir altíð okkurt lortвульг.við honum; мне присни́лась кака́я-то чертовщи́на eg droymdio-tpúra vitleyst [vɪʰt-], eg droymdio-theilt burturvið [-Ꞌviː]
черто́г	mgml.,hátíð.høllж0-ir{ø/a}(палата); borgж0-ir(дворец)
чертополо́х	m(Cirsium, Carduus) tistilм0осн-s,-ar
чёрточка	plurчёрточ|ки, ~ек, ~камf1.dim tilчерта́ 1, 32.(дефис) bindistrikaжгл-a; пи́шется че́рез чёрточку tað verður skrivað við bindistriku
чертыха́ться	ipf(momentчертыхну́тьсячертыхн|у́сь, ~ёшься, ~у́тся)tlm.bannastaði, bannaaðiog blótaaði
чертыхну́ться	moment síчертыха́ться
черче́ние	n1.(действие) tekning [tʰεkn-]ж0-ar(tað at tekna, síчерти́ть)2.(школьный предмет) tekning [tʰεkn-]ж0-ar(skúlafak)
чеса́льный	adj: чеса́льная маши́на karðiмгл-i(maskina), karðingarmaskina
чесану́ть	moment síчеса́ть
чеса́ть	чешу́, че́ш|ешь, ~утipf(momentчесану́тьчесан|у́, ~ёшь, ~у́т)1.pfпочеса́тьпочешу́, че́ш|ешь, ~ут Acc(скрести) klóraaðiДат(kláa); чеса́ть за у́хом klóra sær aftan [aʰtː-] fyri oyrað; чеса́ть в заты́лкеeis.fl.klóra sær í nakkanum2.pfрасчеса́тьрасчешу́, че́ш|ешь, ~ут Acctlm.(причёсывать) greiðair(d)o-t(неживое подлежащее), greiðair(d)o-m(живое подлежащее) (kemba)3.: чеса́ть шерсть karðaaðiull [-tl]; чеса́ть лён greiðair(d)hør4.óvkm.(быстро,энергично делать что-л.) drívaслнei-i-iávið o-m; чеши́ отсю́да! pilla av við tær!бран.@чеса́ть зу́бы {язы́к}skræðair(d)seg, mýkjair(t)geilatíkinaидиом., неодобр.
чеса́ться	чешу́сь, че́ш|ешься, ~утсяipf1.почеса́тьсяпочешу́сь, че́ш|ешься, ~утся(чесать себе какую-л. часть тела) klóraaðisær2.(зудеть) skríðaслнei-i-i, skriðaaði(hava skriða); у́хо че́шется у меня́ tað skríður í oyranum3.tlm.(причёсываться) greiðair(d)sær@у меня́ру́ки че́шутся+ infeg havi bestan hugat + инф., tað kitlar mær í gripat + инф.кн.,tað kriplarэнкнеформ.í fingrunumeftir[εʰtː-]at+инф.=>язы́кI @
чесно́к	Genчеснок|а́;plur~и́, ~о́в, ~а́мm(Allium sativum) hvítleykur [kʰvʊi̥ʰt-]мсогл-s,-ir; ди́кий чесно́кsíчеремша́=>зубо́к3
чесно́чный	adjhvítleyks- [kʰvʊi̯ʰt-]
чесо́тка	f1.lækn.(болезнь) skrubbс0о2.tlm.(зуд) skriðiмгл-i
чесо́точный	adjskrubb- =>клещ
че́ствование	n1.(действие) feiringннкж0-ar2.(торжественный акт) hátíðarhaldс0оtil heiðurs fyri; че́ствованиечьей-л.па́мяти minningarhátíðж0-irfyri o-m
че́ствовать	че́ству|ю, ~ешь, ~ютipf кого-л.feiraннкaðio-n(праздновать); heiðraaðio-n; fagnaaðio-mкн.,выс.(приветствовать)
чести́ть	чещу́, чeст|и́шь, ~я́тipf Accóvkm.skammaaðiВинút, skammdeilair(d)Вин, faraслнó-ó-ailla [ɪtla] viðДат(skelda, skamma út); чести́т меня́ и дурако́м и не́учем hann kallar [-tl-] meg bæði býttan og fávitskutan [-vɪsk-]
че́стно	[-сн-]adverligaннк, ærligaнп; heiðurliga, reiðiliga (порядочно тж); че́стно говоря́ skal eg vera erligur..., álvaratos..., skal eg siga sum er ..., tá alt skal sigast ...
честно́й	[-сн-]adj: при всём честно́м наро́де meðan øll [œtl] sóu, meðan øll [œtl] vóru hjá [tʃʰ-]; вся честна́я компа́нияtlm.,spott.allur [atl-] flokkurin, øll [œtl] gongan, allur [atl-] herurin =>мать@
че́стность	[-сн-]ferligheitннкж0-ir
че́стный	[-сн-]stfче́стен, честна́[-сн-], че́стно[-сн-], че́стны[-сн-] ogчестны́[-сн-]adjerligurннкглigur, ærligurнпглigur; reiðiligurглigur, heiðurligurглigur, rættiligurглigurкн.(порядочный); че́стный челове́к eitt heiðurligt menniskja@че́стное сло́воheiðursorð;че́стное сло́во!hond upp á [ʊꞋpʰɔa] tað!; hond upp á hjartað [j-]!; tað veit [tʰεava] Gud!; tað veit denn! [tʰεavatεnː]!неформ.; tað er álvara!;дать че́стное сло́воlovaaði, geraнепрeið uppá [ʊꞋpʰɔa];под {на} че́стное сло́воupp á heiðursorð
честолю́бец	Gen, Accчестолю́бц|а;plur~ы, ~ев, ~амmærusjúkur maður; strembariмгл-ari(карьерист)
честолюби́вый	stfчестолюби́в, ~а, ~о, ~ыadjærusjúkurсогл
честолю́бие	nærusjúkaжгл-a
честь	Prpо че́сти, в че́сти в чести́f1.(достойные уважения моральные качества) æraжгл-a, heiðurм0осн; sómiмгл-i, sømdж0-ir(достоинство,благопристойность); челове́к че́сти heiðursmaður; челове́к без че́сти æruleysur maður; защища́ть честьGenverja heiðurin hjá [tʃʰ-]Дат; де́ло че́сти heiðursmál; э́то больша́я честь для меня́ hetta er mær ein stórur heiður; заде́тьчью-л.честь særa heiðurinhjá[tʃʰ-]o-m; ва́ше посеще́ние бы́ло {яви́лось} для меня́ большо́й че́стью tað var ein stórur heiður fyri meg, at tit vitjaðu meg2.(целомудрие) kýskheitж0-irкн.; ≈ moydómurмсогл-ar(девственность); потеря́ть честь missa moydómin; лиши́ть че́сти taka moydómin@в честьGentil heiðurs fyriВин,Датtil heiðurs;к че́стиеё сле́дует сказа́ть… til hennara rós skal sigast, henni til rós skal sigast...;с че́стью {честь че́стью; честь по че́сти}sum seg sømir; вы́йти с че́стьюиз чего-л.koma heiðurligaburtur úr[-Ꞌʉuɹ]o-m;отда́ть честькому-л.a) (приложить руку к головному убору) gera honnør [hɔꞋnøːɹ]ннк; b)skemt.(отдать должное) latao-nfáa tað, hann eigur (hevur uppiborið); gevaслнa-ó-io-mtað rós, hann hevur uppiborið; отда́тькому-л.после́днюю честьfylgjair(d){+}o-mtil gravar;счита́ть за честьhalda tað vera ein heiður fyri seg;иметь честь(+ inf) hava tann heiður at +инф.; настоя́щим име́ю честь извести́ть вас eg havi hervið tann heiður at boða tygum frá;честь име́ю кла́нятьсяgml.farvæl [faɹꞋvεal]; э́тоде́лает ему́ честьhetta er honum til sóma;дорожи́ть свое́й че́стью {бере́чь свою́ честь}faraслнó-ó-avæl um sína æru;он на́зван в честького-л.hann er kallaður [-tl-] upp eftir [εʰtː-]o-m;была́ бы честь предло́женаnei, tað var bara eitt upskot;пора́ {на́до} и честь знатьnú er tíð at fara, nú er tíð at sleppa okkum avstað [aꞋstεa] =>вопро́с3,вы́пасть4,оказа́ть,отда́ние,смо́лоду@
чесуча́	ftussahsilki [tʰʊsːas-]сгл-i
чёт	mtlm.líka talс0о{a/ø}@чёт и не́четlíka og ólíka (í spæli)
чета́	fparс0о{a/ø}; fríggjaraparс0о{a/ø}(влюблённых); (супру́жеская) чета́ hjún [tʃʰ-]с0омн@не чета́Датikki kunna standa seg mótiДат, ikki kunna meta seg javnt [jan̊t], [jam̊t] viðВин; он ей не чета́ hann stendur seg ikki móti henni, hann kann ikki javnbjóða seg við hana, hann stendur henni ikki kurlидиом.
четве́рг	Genчетверг|а́;plur~и́, ~о́в, ~а́мmhósdagurмсогл-ar{+}; в четве́рг у́тром hósmorgunin; вели́кий {чи́стый} четве́рг skírisdagur, skírhósdagur [skʊiɹɪst-] ,síвоскресе́нье=>до́ждичек@,страстно́й
четвере́ньки	f plur: на четвере́ньках á øllum [œtl-] fýra, á fjórumкн.; на четвере́ньки á øll [œtl] fýra; по́лзать на четвере́ньках grulva; стать на четвере́ньки leggja seg á øll [œtl] fýra
четвери́к	Genчетверик|а́;plur~и́, ~о́в, ~а́мm gamalt russ. mát = 26,2 l.
четвёрка	plurчетвёр|ки, ~ок, ~камf1.(цифра) fýratalс0о{a/ø},sí eis.пятёрка2.(отметка) «fýra»с нескл.(næsthægsti karakterur í sovjet. og russiskum skúlum, «gott»)3.kort.fýru(r)сгл-aмн4.tlm.(трамвай, автобус и т.д.) fýrariмгл-ari(bussur o.a. við nummarinum fýra)5.sjóm.(судно и др., обозначенного цифрой, оканчивающей на 4)skip о.а. við nummari, ið endar við fýra6.(лодка) báturмсогл-arvið fýra røðarum; fýrariмгл-ari(útl. kappróðrarbátur); fýramannafarс0о{a/ø}(фарерская лодка)7.(лошадей) toymiсгл-ivið fýra rossum8.(команда из четырёх человек) (ítróttar)liðс0о{0<>i}við fýra fólkum
четверно́й	adjfýradupulturннксогл, fjórfaldurсоглкн.
четверня́	plurчетверни́|и́, ~е́й, ~я́мf tlm.1.(запряжка) toymiсгл-ivið fýra rossum2.(дети) fýrlingarмсогл-arмн
че́тверо	Acc,Gen, Prpчетверы́х,Datчетверы́м,Insчетверы́миnum coll1.subst í m sum merkja persónar og pers pron í plurfýra; че́тверо сынове́й fýra synir; их бы́ло че́тверо teir vóru fýra, teir vóru fýra mans2.summi subst,ið bert eru til í plur;oftast Nom og Accfýra; че́тверо су́ток fýra samdøgur3.summi subst,sum merkja sovorðið,sum er í pørum,oftast Nom og Accfýra; че́тверо но́жниц fýra saksar; че́тверо носко́в fýra pør av hosum
четверокла́ссник	mnæmingur í fjórða flokki
четверокла́шка	plurчетверокла́ш|ка, ~ек, ~камm, fnæmingurмсогл-arí fjórða flokki
четвероно́гие	m plurfýrføtt djórс0омн, ferføtt djórс0омн
четвероно́гий	adjfýrbeinturсогл; fýrføtturсогл, ferføtturсогл
четверости́шие	nbókm.1.(строфа) ørindiсгл-ivið fýra reglum2.(стихотворение) yrkingж0-arvið fýra reglum
четверою́родный	adj: четверою́родный брат {четверою́родная сестра́} fermenningur [fεɹmɪniŋk-]мсогл-ar; четверою́родный племя́нник sonurмнепрfermenning
четвёрт	num indecl síсам-
четверта́к	Genчетвертак|а́;plur~и́, ~о́в, ~а́мm1.gml., óvkm.(денежный знак,сумма) fimm og tjúgu kopekkar [-Ꞌpʰeː-]2.tlm.síчетвертно́йI
четвёртая	f: одна́ четвёртая ein fjórðingurмсогл-ar
четверти́нка	plurчетверти́н|ки, ~ок, ~камftlm.1.síчетверту́шка2.(бутылка) fjórðingsfløskaжгл-a(ið tekur ¼ l), kvartfløskaжгл-a(ið tekur ¼ l), peglafløska [pʰeːla-]жгл-aуст.(til brennivín,vín)
четверти́чный	adj:jarðf.четверти́чный пери́од kvartertíðin [kʰvaɹ̥Ꞌtʰeːɹ-]
четвертно́й	Imtlm.25 rublarIIadjfýradupulturннксогл, fjórfaldurсоглкн.
четвертова́ние	n søg.sundurhøgging (av o-m)ж0-ar(í fýra partar; sum revsing)
четвертова́ть	четверту́|ю, ~ешь, ~ютipf/pf o-n søg. høgggaur(d)кого-л.sundur (í fýra partar; sum revsing)
четверту́шка	plurчетверту́ш|ки, ~ек, ~камf dim tilче́тверть
четвёртый	num ordfjórði,sí eis.восьмо́й; четвёртая часть fjórðingurмсогл-ar; в четвёртую до́лю листа́ í kvart, in quarto [inꞋkʰvaɹ̥to]спец., í fjórðingsbrótiкн.; форма́т в четвёртую до́лю kvartformat [-maːt]ннкпроф.@ четвёртая властьfjórða valdið (fjølmiðlar)
че́тверть	plurче́тверти, четверт|е́й, ~я́мf1.(четвёртая часть) fjórðingurмсогл-ar, fjórði parturмсогл-ar; че́тверть го́да ársfjórðingur, fjórðingsárс0о, kvartal [kʰvaɹ̥tεal]с0о; че́тверть ме́тра ein kvartннкmetur, fjórði parturin av einum metri, fjórðingurin av einum metri; че́тверть килогра́мма eitt kvartннкkilo; mørkж0-ur{ø/a/e}(ос. как мера веса бараньего сала)2.(15 минут) korter [kʰɔɹ̥Ꞌtʰeːɹ]с0о(fimtan minuttir); три че́тверти ча́са trý korter; сейча́с без че́тверти шесть klokkan er trý korter til seks, klokkan er eitt korter í seks; че́тверть шесто́го eitt korter til seks, eitt korter yvir fimm3.(в школе) kvartal [kʰvaɹ̥tεal]с0о, ársfjórðingurмсогл-ar(ein av teimum fýra pørtunum,sum skúlaárið verður býtt sundur í)4.(нота) fjórðapartsnótiмгл-i5.(фаза луны) korter [kʰɔɹ̥Ꞌtʰeːɹ]с0о(um mánan)6.gamalt russ. mát flatumát = 40 x 30са́жень
четвертьфина́л	mkvartfinala [-naː-]жгл-a, fjórðingsfinala [-naː-]жгл-a
чётки	чёт|ок, ~камf plurrósinkransurмсогл-ar, rósukransurмсогл-ar(kransur við perlum til bønarhald)
чёткий	stfчёток, четка́ogчётка, чётко, чётки;compчётчеadj1.(ясный) týðiligurглigur, skilligurглigur; чёткое произноше́ние týðilig úttala; чёткий по́черк týðilig hondskrift [hɔns-], lesilig hondskrift [hɔns-]; чёткое разли́чие ein greiður munur2.(точный) neyvurсогл, noyaktigur [-Ꞌa-]ннкглigur, presisur [pʰɹeꞋsiː-]ннксогл; greiðurгл(ясный); чёткое изложе́ние greið framløga3.: чёткие шаги́ taktføst fótafet4.fl.(хорошо организованный) væl skipaðurглaður; gjørdurсоглvið nærlagni (аккуратно выполняемый); neyvt [nεft] gjørdurсогл(точно выполняемый)
чёткость	ftýðiligheitннкж0-ir, skilligheitннкж0-ir; greidleikiмгл-i(ясность); presisjón {precisión}[pʰɹeːsiꞋʃɔun]ннкж0-ir, noyaktigheit [-Ꞌa-]ннкж0-ir, neyvleikiнпмгл-i(точность)
чётный	adjlíkaннкнескл.проф., makaðurлпглaður(um tøl)
чётче	comp avчёткий
четы́ре	Genчетырёх,Datчетырём,Insчетырьмя́,Prpчетырёхnum card1.(число) fýra,síпять2.síчетвёрка2@игра́ть в четы́ре руки́spæla fýrhent;сиде́ть в четырёх стена́хsita innandura, sita innanveggja;отпусти́тького-л.на все четы́ре сто́роныlatao-nfara hagar hann vil
четы́режды	advfýra ferðir; четы́режды пять - два́дцать fýra ferðir fimm er tjúgu, fýra ganga [-aŋk-]ннкfimm er tjúgu
четы́реста	Genчетырёхсо́т,Datчетырёмста́м,Insчетырьмяста́ми,Prpчетырёхста́хnum cardfýra hundrað [fʊiɹhʊntɹa]; ты́сяча четы́реста eitt túsund [tʰʉusɪn] fýra hundrað; fjúrtan hundrað (в обозначении года обязательно); в ты́сяча четы́реста трина́дцатом году́ í fjúrtan hundrað og trettan
четырёхгоди́чный	adjfýra ára
четырёхголо́сный	adjfýrstemmigurннкглigur, fjórraddaðurнпглaður, fýrraddaðurнпглaður
четырёхгра́нник	mtetraedur [tʰeːtɹaꞋeːt-]с0осн
четырёхгра́нный	adjgeom.tetraediskur [tʰeːtɹaꞋeːt-]согл, fýrasíðaðurглaður
четырёхзна́чный	adjfýrasiffraðurглaður
четырёхкла́ссный	adj(о школе) fýra ára, við fýra klassum (um skúla)
четырёхколёсный	adjfýrahjulaður [-juː-]ннкглaður, fýrahjólaður [-tʃʰɔu-]нпглaður
четырёхкра́тный	adjfýradupulturннксогл, fjórfaldurсоглкн.
четырёхле́тний	adj1.(о сроке) fýra ára (tíðarskeið)2.(о возрасте) fýra ára gamalсоглосн{a/o}
четырёхме́рный	adjfýrdimensionalur {fýrdimensjonalur } [-mεn̊ʃonaː-]согл
четырёхме́стный	[-сн-]adjfýramans-; четырёхме́стная автомаши́на bilur við fýra setrum
четырёхме́сячный	adj1.(о сроке) fýra mánaða [mɔana] (реже[mɔanava]) (tíðarskeið)2.(о возрасте) fýra mánaðar [mɔanaɹ] (реже[mɔanajɪɹ]) gamalсоглосн{a/o}
четырёхсло́жный	adjfýrstavilsis-
четырёхсотле́тие	n1.(срок) fýra hundrað ára (tíðar)skeiðс0о, fýra hundrað árс0омн(tíðarskeið), fýra øldirж0-irмн(четыревека)2.(годовщина) fýra hundrað dagur
четырёхсотле́тний	adj adj1.(о возрасте) fýra  hundrað ára gamalсоглосн{+}2.(о сроке) fýra hundrað ára, sum var fýra hundrað ár
четырёхсо́тый	num ordfýra hundraðndi [fʊiɹhʊntɹɪnti] (реже[-hʊntɹantɪ])
четырёхсто́пный	adjbókm.við fýra (versa)fótum
четырёхсторо́нний	adj1.(имеющий четыре стороны) við fýra síðum2.(о договоре,союзе) við fýra pørtum, sum hevur fýra partar (um sáttmála o.tíl.)
четырёхта́ктный	adjfýratakts-; четырёхта́ктный мото́р fýrataktsmotorur
четырёхты́сячный	1.num ordfýra túsundi2.tlm.(о стоимости) sum kostar fýra túsund [tʰʉusɪn], [tʰʉusʊn] rublar, sum er fýra túsund [tʰʉusɪn], [tʰʉusʊn]rublar verdur3.tlm.(состоящий из 2000) sum er 4000 (mans o.s.fr.) stórur, sum er upp á 4000 (fólk,partar o.s.fr.); четырёхы́сячная толпа́ ein mannamúgva upp á 4000 fólk
четырёхуго́льник	mfýrkantur [fʊɹ̥-]мсогл-ar, fýrhyrningur [-tn-]нпмсогл-ar, ferhyrningur [-tn-]нпмсогл-ar
четырёхуго́льный	adjfýrkantaður [fʊɹ̥-]глaður, fýrhyrntur [-hɪn̊t-]нпсогл, ferhyrntur [-hɪn̊t-]нпсогл-
четырёхэта́жный	adjvið {í} fýra hæddum, við {í} fýra etasjum [-Ꞌtʰaː-]ннк
четы́рнадцати-	í samansfjúrtan
четырнадцатиле́тний	adj1.(о сроке и др.) fjúrtan ára (skeið o.tíl.)2.(о возрасте) fjúrtan ára gamalсоглосн{a/o}
четы́рнадцатый	num ordfjúrtandi [fjʏɹ̥tɪntɪ] (реже[fjʏɹ̥tantɪ])
четы́рнадцать	Gen, Dat, Prpчеты́рнадцати,Insчеты́рнадцатьюnum cardfjúrtan
чех	mkekki {tjekki}мгл-i
чехарда́	f1.(игра) tað at leypa bukk; игра́ть в чехарду́ leypaслнey-u-obukk2.fl.,tlm.,atf.(изменения) íðulig skiftiсгл-iмн, íðulig umskipanж0-ir, íðuligar broytingarж0-arмн; министе́рская чехарда́ íðulig stjórnaskifti [stjœtn-]
Че́хия	fKekkia {Tjekkia} [tʃʰεʰkːia]с нескл.
чехли́ть	чех|лю́, ~ли́шь, ~ля́тipf(pfзачехли́тьзачех|лю́, ~ли́шь, ~ля́т) что-л.fakm.setaur(t);ir(t)hylsturннкá o-t, koyrair(d)o-tí hylsturннк
чехо́л	Genчехл|а́;plur~ы́, ~о́в, ~а́мmhylsturс0осн(футляр); yvirtrekkс0о(на мебель); ме́бель в чехла́х møblar undir yvirtrekki; чехо́л (от) пери́ны dýnubetrekkннкс0о, dýnuvorс0о, dýnuvárс0о, dýnuverс0о
чехослова́к	msøg.tjekkoslovakari {kekkoslovakari} [-Ꞌvaː-]мгл-ari, tjekkoslovaki {kekkoslovaki} [-Ꞌvaː-]мгл-i
Чехослова́кия	fsøg.Tjekkoslovakia {Kekkoslovakia}[-Ꞌvaːki-]с нескл., Tjekkoslovakíið [-Ꞌkʰʊijɪ]ннкс0о{0<>i}опр.
Чехослова́цкая Социалисти́ческая Респу́блика	(ЧССР)søg.Tjekkoslovakiska {Kekkoslovakiska} [-Ꞌvaː-] sosialististiska [-Ꞌlɪ-] lýðveldið, Sosialistiska [-Ꞌlɪ-] lýðveldið Tjekkoslovakia {Kekkoslovakia}[-Ꞌvaː-] (1960-1990)
чехослова́цкий	adjsøg.tjekkoslovakiskur {kekkoslovakiskur} [-Ꞌvaːk-]согл
чечеви́ца	fIplant.(Lens esculenta) flatbønж0-ir, linsaжгл-a2.koll(зёрна) flatbønirж0-irмн, linsurжгл-aмнIIdjor. (птица) (обыкнове́нная) чечеви́ца (Carpodacus erythrinus) roðaígða [-ʊija]жгл-a
чечеви́чный	adjflаtbønar-, linsu- =>перворо́дство
чече́нец	Gen, Accчече́нц|а;plur~ы, ~ев, ~амmkekenari{tjetjenari} [tʃʰeꞋtʃʰeː-]мгл-ari, kekeni {tjetjeni} [tʃʰeꞋtʃʰeː-]мгл-i
чече́нка	plurчече́н|ки, ~ок, ~камfkekenari {tjetjenari} [tʃʰeꞋtʃʰeː-]мгл-ari, kekenit {tjetjeni [tʃʰeꞋtʃʰeː-]мгл-i(konufólk)
Чече́но-Ингуше́тия	fsovjet.Tjetjeno-Ingusjetia {Kekeno-Ingusjetia} [tʃʰeˌtʃʰeːnoɪnkʊꞋʃeː-]с нескл.
Чече́но-Ингу́шская Автоно́мная Сове́тская Социалисти́ческая Респу́блика	sovjet.Tjetjeno-Ingusjiska {Kekeno-Ingusjiska} [tʃʰeˌtʃʰeːnoɪnꞋʊꞋʃː-] sjálvstýrandi [ʃɔls-] sovjetska [-jεska] sosialistiska [-Ꞌlɪ-] lýðveldið, Sjálvstýrandi [ʃɔls-] sovjetska [-jεska] sosialistiska [-Ꞌlɪ-] lýðveldið Tjetjeno-Ingusjetia {Kekeno-Ingusjetia} [tʃʰeˌtʃʰeːnoɪnkʊꞋʃeː-]
Чече́нская Респу́блика	Kekenska {Tjetjenska}[tʃʰeꞋtʃʰeːn-] lýðveldið, lýðveldið Kekenia {Tjetjenia} [tʃʰeꞋtʃʰeːnia]
чече́нский	adjkekenskur {tjetjenskur} [tʃʰeꞋtʃʰeːn-]согл; чече́нский язы́к kekenskt {tjetjenskt} [tʃʰeꞋtʃʰeːn̊st]сприлskt
чечётка1	Iplʰurчечёт|ки, ~ок, ~камf: (обыкнове́нная) чечётка (Carduelis flammea) reyðkollur [rεkʰɔtl-]мсогл-ar; го́рная чечётка (Carduelis flavirostris) íriskurмсогл-ar; ту́ндровая {тундряна́я}{пе́пельная} чечётка (Carduelis hornemanni) reyðskalli [rεskatli] мгл-i
чечётка2	IIplurчечёт|ки, ~ок, ~камf1.tlm.(болтливая женщина) sussaжгл-a, hurrikannaжгл-a(konufólk)2.(танец) steppdansurмсогл-ar, steppс0о; отбива́ть чечётку steppaaði
чечме́к	móvkm.,vanv.síчучме́к
Чечня́	fKekenia {Tjetjenia } [tʃʰeꞋtʃʰeːnia]с нескл., Tjetjenien [tʃʰeꞋtʃʰeːn-]ннкс0{дат.0},sí eis.Ичке́рия
чечня́	fkollkekenarar {tjetjenarar} [tʃʰeꞋtʃʰeːn-]мгл-ariмн
че́шка	plurче́ш|ки, ~ек, ~камmkekki {tjekki}мгл-i(konufólk)
Че́шская и Слова́цкая федерати́вная респу́блика	(ЧСФР)søg.Sambandslýðveldið [-pan̊s-] Tjekkia {Kekkia} [tʃʰεʰkːia] og Slovakia [-Ꞌvaːkia]
Че́шская респу́блика	Kekkiska {Tjekkiska} lýðveldið, Lýðveldið Kekkia {Tjekkia} [tʃʰεʰkːia]
че́шский	adjkekkiskur {tjekkiskur} [tʃʰεʰkː-]согл; че́шский язы́к kekkiskt {tjekkiskt}сприлskt
чешу́йка	plurчешу́|йки, ~ек, ~йкамfskrubbс0о, roðslaжгл-a(einstøk beinklingra;á fiski o.ø.)
чешу́йница	f: са́харная чешу́йница (Lepisma saccharinum) silvurfiskurмсогл-ar, silvurkyktс0о
чешу́йчатый	stfчешу́йчат, ~a, ~o, ~ыadjvið roðslu, sum hevur roðslu =>лёд
чешуя́	froðslaжгл-a; ры́бья чешуя́ fiskaroðsla, skrubbс0оá fiski; сбро́сить чешую́ (о змее и т.п.) skiftair(t)hamin, skjótaслнey-u-ohamin (um slangu o.tíl.); снять чешую́ skava roðsluna av
чи́бис	m(Vanellus vanellus) vípaжгл-a
чиж	Gen, Accчиж|а́;plur~и́, ~е́й, ~а́мm(Carduelis spinus) barrígða [-ʊija]жгл-a
чи́жик	m1. (птица)dim. kel. tilчиж2.(детская игра)slag av pinnaspæli
чи́збургер	mcheeseburgari [tʃʰiːs-]мгл-ari
Чика́го	m indeclChicago [ʃiꞋkʰaːko]м нескл.
чи́кать	ipf(momentчи́кнутьчи́кн|у, ~ешь, ~ут)óvkm.1.(о звуке) klikkjair(t), glintaaði2.что-л.(отрезать) kvettair(t)o-tav, kutaaðio-tav, kappaaðio-tav
чи́кнуть	1.moment síчи́кать2.pfteld.(на клавишу и т.п.) klikkjair(t); чи́кнуть два ра́за dupultklikkja
Чи́ли	f indeclChile [tʃʰiːlε]с нескл., Kiliлпс нескл.
чили́ец	Gen, Accчили́йц|а;plur~ы, ~ев, ~амmchilenari [tʃʰiꞋleː-]мгл-ari, kiliлпмгл-i
чили́йка	plurчили́|йки, ~ек, ~йкамfchilenari [tʃʰiꞋleː-]мгл-ari, kiliлпмгл-i(konufólk)
чили́йский	adjchilenskur [tʃʰiꞋleː-]согл, kilskurлпсоглпубл.
чили́кать	ipf(momentчили́кнутьчили́кн|у, ~ешь, ~ут)tlm.látaслнæ-ó-a(fuglur), pippaaði
чили́кнуть	moment síчили́кать
чин1	Iplurчин|ы́, ~о́в, ~а́мm1.(разряд) tignж0-irкн., tignarstigс0о{0<>i}кн.,офиц., grad [kɹaː-]ннкж0-ir; (должность); быть в чина́х {име́ть высо́кий чин} vera í einum høgum starvi, hava høga tignкн., hava ein høgan gradннк; офице́рский чин heryvirmannatignarstigкн.; име́ть чин майо́ра hava tignкн.sum majorur [-Ꞌjoː-], hava eina gradннкsum majorur; в чи́не майо́ра sum majorur [-Ꞌjoː-]; ему́ был присво́ен чин майо́ра hann varð fluttur upp til majorstign [-Ꞌjoː-]кн.; он был пони́жен в чи́не до рядово́го hann varð degraderaður [-Ꞌteːɹ-]ннкtil meinigan, hann varð lækkaður í tignкн.til meinigan2.oftastplur,eis.spott.(о человеке) embætismaðurмнепр(чиновник); tignarfólkс0окн.(сановное лицо)@чин-чи́ном {чин по чи́ну}sum seg sømir, sum tað eigur at vera;без чино́вgml.uttan hóvasták, uttan nakað roks
чин2	IIm vatnrætt rað av ikonum á ikonveggi í ávísari raðfylgju oman á hvørji aðrari
чина́р	m síчина́ра
чина́ра	f(Platanus) platan [-Ꞌtʰaːn]ж0-ir, platantræ [-Ꞌtʰaːn]с0о{æ/ø}{0<>i}
чина́рик	mtlm.sigarettstubbi [siːkaꞋrεʰt-]мгл-i
Чингисха́н	mDjengis Khan [ˌtʃεŋkɪsꞋkʰaːn]м0{дат.0}
чинёный	adjtlm.bøtturсогл, afturgjørdur [aʰtː-]согл(klæðir, skógvar)
чини́ть1	Iчиню́, чи́н|ишь, ~ятipf что-л.1.pfпочини́тьпочиню́, почи́н|ишь, ~ят(ремонтировать) umvælair(d)o-t, reparera [-Ꞌreː-]ннкaðio-t, geraнепрo-taftur [aʰtː-] (часто меньшего объёма), setaur(t);ir(t)o-tí stand; bøtair(t)o-t(одежду,обувь); lappaaði(slangu o.tíl.) (шину и т.п.)2.pfочини́тьочиню́, очи́н|ишь, ~ят(карандаш) spíska [spʊʃka]aðio-t(blýant)
чини́ть2	IIчиню́, чин|и́шь, ~я́тipf(pfучини́тьучиню́, ~и́шь, ~я́т)gml.og í nøkrum samansetingumfremjaur(d){e/a}, útinnair(t); чини́тькому-л.препя́тствия darvaaðio-n, tarnaaðio-n{o-m}; чини́ть беззако́ния fremja ólógligheitir [-Ꞌlɔuli-]ннк, fremja lógarbrot; чини́ть суд и распра́вунад кем-л.haldaслнe-i-irættargangyvir o-n; чини́ть препя́тствиякому-л.leggjaнепрforðingarfyri o-n, leggjaнепрmeinbogarfyri o-n
чи́нно	advsámiliga, siðiliga; сиде́ть чи́нно sita ordiligaнеформ.
чи́нный	stfчи́нен, чинна́ogчи́нна, чи́нно, чи́нныadj(степенный) svinnurсогл, ansaligurглigur; sømiligurглigur, sámiligurглigur, siðiligurглigur(приличный); hátíðarligurглigur, formellur [-Ꞌmεlː-]согл(церемонный)
чино́вник	m1.(служащий) embætismaðurмнепр2.(бюрократ) bureaukratur [pyːɹoꞋkʰɹaː-]мсогл-ar
чино́внический	adj1.(кчино́вник 1) embætismanna-, embætis-2.(бюрократический) bureaukratiskur [pyːɹoꞋkʰɹaː-]соглsk
чино́вничество	n1.koll(служащие) embætismennмнепрмн, embætisfólk с0омн2.(бюрократизм) bureaukrati [pyːɹokʰɹaꞋtʰiː-]с0о{0<>i}
чино́вничий	adjembætismanna-
чино́вный	stfчино́в|ен, ~на, ~но, ~ныadjbókl.1.(кчино́вник 1) embætismanna-, embætis-2.bert lfgml.(состоящий на государственной службе) sum hevuro-tembæti; sum hevuro-ratignкн.(имеющий какой-л. чин)3.(имеющий высокий чин) sum hevur høga tignкн.
чинодра́л	mtlm.,vanv.bureaukratur [pyːɹoꞋkʰɹaː-]мсогл-ar
чинопочита́ние	ngml.,spott.virðingж0-arfyri yvirmonnum
чинопроизво́дство	ngml.framflutningurмсогл-arкн., uppflutningurмсогл-arкн.(í tign)
чину́ша	m/ftlm.,vanv.bureakratur [pyːɹoꞋkʰɹaː-]мсогл-ar
чин-чинарём	óvkm.síчинчи́ном
чип	m síмикросхе́ма
чипи́рование	nchipmerking [tʃʰɪʰp-]ж0-ar
чипи́ровать	чипи́ру|ю, ~ешь, ~ютipf/pf1.Acc(оснащать чипом) chipmerkja [tʃʰɪʰp-]ir(t)Вин2.кого-л.(имплантировать чип) implantera [-tʰeː-]aðichip [tʃʰɪʰp.]í o-n
чип-ка́рта	fchipkort [tʃʰɪʰp-]с0о, flískortлпс0о
чи́повый	adjchip- [tʃʰɪʰp-]
чипсе́т	[-сэ́т]m teld.chipset [tʃʰɪʰpsεʰt]с0о, chipsett[tʃʰɪʰpsεʰt]с0оинформ.
чи́псы	m plurchips [tʃʰɪʰps]с0омн, kipsс0омн
чи́рей	mtlm.svullur [-tl-]мсолг-s,-ir;-ar(troti), pirraжгл-a, búldннкж0-ir
чи́рик	mslangsíчерво́нец
чири́канье	n(fugla)látс0о, pippс0о
чири́кать	ipf(momentчири́кнутьчири́кн|у, ~ешь, ~ут) látaслнæ-ó-a(fuglur), pippaaði
чири́кнуть	moment síчири́кать
чирк	predtlm.bresti, brestir
чи́ркать	ipf síчи́ркнуть
чи́ркнуть	чи́ркн|у, ~ешь, ~утpf(ipfчи́ркать)tlm.1.чем-л.,по чему-л. (провести по чему-л.) strúkaслнey-u-o, takaслнó-ó-ieftir[εʰtː-]o-m; чи́ркнуть спи́чкой brestair(t)ein svávulpinn; чи́ркнуть ножо́мпо чему-л.strúka ein kníveftir[εʰtː-]o-m2.(издать резкий звук) brestaслнa-u-o(taka í og geva hvølt ljóð); пу́ля чи́ркнула о сте́ну kúlan brast í veggin
чиро́к	Gen, Accчирк|а́;plur~и́, ~о́в, ~а́мm: мра́морный чиро́к (Anas angustirostris)fuglur av antaættitini(en.marbled teal; da.marmorand); чиро́к-клокту́н (Anas formosa) glipursontж0-ur{o/a/e}; чиро́к-свистуно́к (Anas crecca) krikkontж0-ur{o/a/e}; чиро́к-трескуно́к (Anas querquedula) teymontж0-ur{o/a/e}
Чи́сла	n plurfjórða Mósebók [mɔusɪ-]ж0-ur{ó/ø}
чи́сленность	ftalс0о{a/ø}(mongd); чи́сленность населе́ния fólkatal; чи́сленность па́ртии limatalið í flokkinum; чи́сленностью в 200 челове́к 200 mans í tali; во́йско чи́сленностью в 100 000 челове́к ein herur upp á 100 000 menn; превосходи́ть врага́ по чи́сленности vera størri í tali enn fíggindin
чи́сленный	adjí tali; чи́сленное превосхо́дство yvirluti í tali; чи́сленно превосходя́щие си́лы проти́вника ein fíggindi, sum er størri í tali; чи́сленный соста́вherm.talið av (her)monnum, styrki; чи́сленный рост организа́ции vøksturin í limatali í felagsskapinum
числи́тель	mteljari (tal í brøki)мгл-ariмат.
числи́тельное	n: (и́мя) числи́тельное talorðс0о; коли́чественное числи́тельное grundtal [kɹʊnt-]с0о{a/ø}; поря́дковое числи́тельное raðtalс0о{a/ø}; собира́тельное числи́тельное skiftitalс0о{a/ø}
чи́слить	чи́сл|ю, ~ишь, ~ятipf кого-л. кем-л.alm.(считать в каком-л. состоянии) roknaaðio-n(sum)Вин; чи́слитького-л.в о́тпуске roknao-nsum verandi í feriu; чи́слитького-л.больны́м roknao-n(sum) sjúkan; чи́слить консульта́нтом rokna fyri konsulent [kʰɔn̊suꞋlεn̊t]ннкпроф.
чи́слиться	чи́сл|юсь, ~ишься, ~ятсяipfvera hildinсоглоснat veraИм, vera roknaðurглaðursumИм; чи́слиться больны́м vera metturсоглat vera sjúkur; чи́слиться в спи́ске standaслнó-ó-aá einum lista; за ней чи́слитсяNomhon er skrivað upp fyriДат; долг чи́слится за тобо́й tú stendur fyri skuldini, tú ert skrivaður upp sum skuldari; то́лько чи́слитьсягде-л. тжbara vera onkustaðni á pappírinum; он то́лько чи́слится в спи́скетжhann er bara á listanum sum eitt eiti
число́	plurчи́с|ла, ~ел, ~ламn1.mat.(величина) talс0о{a/ø}; це́лое число́ eitt heilt tal; систе́ма чи́сел talskipan, talsystem [-systeːm]ннкпроф.2.(дата) dato [taːto]с0гл, dagurмсогл-ar{+}(í mánaðinum); Кaко́е сего́дня число́? - Сего́дня тре́тье сентября́ Hvør dagur er (í mánaðinum [mɔananʊn] (редко[mɔanajɪnʊn])) í dag?- Í dag er triði september [-Ꞌtʰεmpʊɹ]; Hvat dato er í dag? - Í dag er triði september [-Ꞌtʰεmpʊɹ]; Како́го числа́ бу́дет конце́рт? - Конце́рт бу́дет второ́го октября́ Hvønn dag verður konsertin [-Ꞌsε-]?; - Konsertin [-Ꞌsε-] verður annan oktober [-Ꞌtʰoːpʊɹ]; в пе́рвых чи́слах ма́рта fyrst [fɪst] í mars, tíðliga [tʰʊʎja] í mars; с тре́тьего по деся́тое число́ frá triðja til fjórða; поста́вить число́ (на чём-л.) seta dato (á o-t), datera [-Ꞌtʰeː-]ннк(o-t), dagfesta [takf-]нпir(t)офиц.(o-t)3.(количество) talс0о{a/ø}; число́ студе́нтов talið av lesandi; число́м де́сять tíggju í tali; число́м в 500 челове́к upp á 500 mans; в большо́м числе́ слу́чаев í mongum førum; по числу́ чле́нов eftir [εʰtː-] limatalinum; кру́глым число́м við einum rundaðum tali4.(состав): быть в числе́Genvera millum [-tl-]Вин(Род с личн. мест., иначекн.,уст.), vera ein avДат; оди́н из их числа́ ein av teimum; он не принадлежи́т к их числу́ hann hoyrir ikki til millum [-tl-] teirra; в числе́ пе́рвых millum [-tl-] teir fyrstu [fɪstʊ]; ста́витького-л.в число́ лу́чших поэ́тов teljaur(d){е/а}o-nmillum [-tl-] tey bestu skaldini5.máll.(грамматическая категория) talс0о{a/ø}@без числа́óteljandi [-Ꞌtʰε-]глandi, ótaldurсогл;нет {нестьbókl.} числа́Datvit vita ikki tal áДат;в том числе́(в т.ч.) teirra millum [-tl-], millum [-tl-] teirra, og eisini; inklusiv [ɪŋ̊kʰlusiːv-]ннкВин(включая) =>еди́нственный@,за́дний@,мно́жественный@,принадлежа́ть4,сре́дний2,це́лый5
числово́й	adjtal-; numeriskur [-Ꞌmeː-]соглспец.; числова́я величина́ talstødd; числовы́е да́нные tøl, talupplýsingar
чи́стик	m: обыкнове́нный чи́стик (Cepphus grylle) teistiмгл-i
чи́стиковые	m plursvartfuglurмсогл-arсобир.
чисти́лище	nrel.,fl.skerseldur [ʃeːʂ-]ннкмсогл-arрел., перен, reinsanareldurлпмсогл-arрел., перен, reinsingareldurлпмсогл-arрел., перен.
чисти́льщик	m: чисти́льщик сапо́г skóbustariмгл-ari
чи́стить	чи́щу, чи́ст|ишь, ~ятipfApfвы́чиститьвы́чищу, вы́чист|ишь, ~ят, почи́ститьпочи́щу, почи́ст|ишь, ~ят AccreinsaaðiВин тж перен.; bustaaðiВин(щёткой тж); ruddaaðio-t(убирать); støvsúgvaaðio-t(пылесосом); pussaaðio-t(начищать); reinsaaðio-t(трубу); reinsaaðio-tupp (канал,дно); чи́стить оде́жду a) (щёткой) busta klæðir; b) (химически) reinsa klæðir (kemiskt); чи́стить зу́бы busta tenn; чи́стить о́бувь busta skógvar; чи́стить но́гти reinsa negl; чи́стить доро́гу (от снега) rudda (kava) burtur av vegnum [veːnʊn]; чи́стить коня́ kembair(d)rossi, strigla {strikla}aðirossiпроф.; чи́стить пол в хлеву́ sópaaðigólvið í fjósinumBpf síочи́стить1.что-л.(освобождать от кожуры и др.) flysaur(t){y/u}(фрукты,овощи со шкуркой); (по)чи́стить карто́шку flysa eplir; (о)чи́стить апельси́н flysa eina appilsin [-Ꞌsiːn]; чи́стить оре́хи knekkaaðinøddirнкк; чи́стить ры́бу reinsaaðifisk; skrædlaaðifisk (снимать кожу); sløgair(d){+}fisk (потрошить); чи́стить ку́рицу reinsa eina hønu; чи́стить пух reinsa dún; чи́стить креве́ток pilkaaðirækjur2.Acctlm.(освобождать от вредных элементов) reinsaaðiВинút3.óvkm.(грабить) røvaaðiВин, rænair(d)Вин
чи́ститься	чи́щусь, чи́ст|ишься, ~ятсяipf(pfвы́чиститьсявы́чищусь, вы́чист|ишься, ~ятся; почи́ститьсяпочи́щусь, почи́ст|ишься, ~ятся)1.(чистить себя,одежду и др.) hampaaðiseg, bustaaðiseg2.pass(быть очищенным) verða reinsaðurглaður; я́блоки легко́ чи́стятся súreplini eru løtt at flysa
чи́стка	plurчи́ст|ки, ~ок, ~камf1.(кчи́стить А) reinsingж0-ar; bustingж0-ar(щёткой); pussingж0-ar(начищение); uppruddingж0-ar(уборка); uppreinsingж0-ar(канала,дна); sópingж0-ar(лопаткой); хими́ческая чи́стка оде́жды kemisk [kʰeː-] reinsing av klæðum; отда́ть пла́тье в чи́стку lata kjólan inn til reinsing; сро́чная чи́стка snarreinsing;sbr.химчи́стка2.(от шелухи) flysingж0-ar; reinsingж0-ar(av fiski) (рыбы); skrædlingж0-ar(снятие кожи); sløgingж0-ar(потрошение)3.(мастерская) reinsarí [-Ꞌrʊi]с0о4.(организации,партии) útreinsingж0-ar(politisk o.a.); подвергну́ть чи́стке reinsa út; ста́линские чи́стки útreinsingarnar hjá [tʃʰ-] Stalin [staːlin]
чи́сто	Iadv: чи́сто вы́стиранный vaskaður reinur; чи́сто напи́санный pentннкskrivaður; чи́сто говори́ть по-ру́сски tosa reint russiskt; чи́сто бе́лый reint hvítur; чи́сто славя́нское лицо́ eitt ektað slaviskt [slaː-] andlit [anl-]IIpredtað er reint; здесь чи́сто her er reint =>случа́йноI
чистови́к	Genчистовик|а́;plur~и́, ~о́в, ~а́мmtlm.reinskrivað eintakс0о{a/ø}, reint eintakс0о{a/ø}
чистово́й	adjreinskrivaðurглaður(переписанный начисто); чистово́й экземпля́р reinskrivað eintak, reint eintak; чистова́я тетра́дь stílahefti til innføring
чистога́н	móvkm.reiðir pengarмгл-iмн, kontantir [-Ꞌtʰa-] pengarмгл-iмн, kontantir [-Ꞌtʰa-]ж0-irмн; чистога́ном kontant [-Ꞌtʰa-]
чистокро́вный	stfчистокро́в|ен, ~на, ~но, ~ныadjreinurсогл, av reinum slag; чистокро́вная ло́шадь ross av reinum slag
чистописа́ние	nfagurskriftж0-ir
чистопло́тность	freinføriсгл-i, reinligheitннкж0-ir
чистопло́тный	stfчистопло́т|ен, ~на, ~но, ~ныadj1.(содержащий себя в чистоте) reinligurглigur, reinførurсоглкн.2.fl.(честный,порядочный) reinurсогл, óspilturсогл
чистоплю́й	m tlm., atf.1. (человек, избегющий черной рабты)o-r.sum skýggjar hart, tungt arbeiði2. (чистюля)o-r, sum er í reinligur,o-r, sum er ovurhonds [-hɔn̊s] reimligur
чистоплю́йство	n tlm., vanv.
чистопоро́дный	stfчистопоо́д|ен, ~на, ~но, ~ныadjreinurсогл, av reinum slag;
чистосерде́чие	n síчистосерде́чность
чистосерде́чность	ftað at vera opin, tað at vera erligurннк, tað at vera ærligurнп(искренный); tað at vera opinskáraður (откровенный),síчистосерде́чный
чистосерде́чный	stfчистосерде́ч|ен, ~на, ~но, ~ныadjopinсоглосн, erligurннкглigur, ærligurнпглigur(искренный); opinskáraðurглaður(откровенный); чистосерде́чное призна́ние opinskárað játtan
чистосо́ртный	stfчистосо́рт|ен, ~на. ~но, ~ныadjreinurсогл(чистый), óblandaðurглaður(не смешаннтый), av sama (одного сорта) slag (um sáð o.tíl./
чистота́	ftað at vera reinur; nossligheitж0-ir(опрятность); reinleikiмгл-i(б.ч. перен.); сверка́ть чистото́ vera (so) gullreinur; наводи́ть чистоту́ gera reint =>соблюда́ть1
чистоте́л	m(Chelidonium majus) svaluurtж0-ir
чи́стый	stfчист, чиста́, чи́сто, чи́стыogчисты́;compчи́щеadj1.(незагрязнённый) reinurсогл, nossligurглigur; чи́стая руба́шка ein rein skjúrta; чи́стые ру́ки reinar hendur; чи́стая ко́мната reint verilsiннк; чи́стая рабо́та nossligt arbeiði, reinligt arbeiði,sí eis.52.lf(без примеси) reinurсогл, óblandaðurглaður; netto [nεʰtːo]нескл., netto- [nεʰtːo-] (не валовой); чи́стый во́здух rein luft; чи́стый спирт (неразбавленный) reint spritt; чи́стая ру́сская речь rein russisk tala, óblandað russisk tala; чи́стое произноше́ние rein úttala; чи́стый го́лос klárt mál, reint mál; чи́стая при́быль nettovinningur; чи́стый вес nettovekt3.lf(ничем не покрытый,не занятый) blankurсоглank(óskrivaður), berurсогл; reinurсогл; чи́стая тетра́дь eitt tómt hefti; чи́стый бланк eitt reint oyðublað; чи́стая страни́ца óskrivað síða, tóm síða, blank síða; чи́стое не́бо skýleyst loft, høgurглheiður, klárurсоглheiður; чи́стый фарва́тер (без подводных камней и т.п.) reint farvatn [faɹv-] (við ongum boðum o.tíl.)4.lf(настоящий) reinurсогл(og skærurсогл), berurсоглog blektaðurглaður; чи́стое безу́мие tann reini ørskapur [œʂk-]; э́то чисте́йший обма́н hetta er reinur svindilм0осннеодобр.; чи́стый вздор tað rama tvætl; чи́стая ложь tann svartasta lygn; чи́стая пра́вда tann reina (og skæra) sannheit; она́ чи́стый ребёнок (совсем ребёнок) hon er eitt reint barn [-tn]5.(тщательно выполненный) væl gjørdurсогл, væl úr hondum greiddurсогл, snøggurсогл, snotiligurглigur; чи́стая рабо́та snotiligt arbeiði, snøgt arbeiði, væl úr hondum greitt arbeiði,,sí eis.16.(высоконравственный) reinurсогл, óspilturсогл; kýskurсоглskкн.,выс.(целомудренный); чи́стые мы́сли reinir tankar [tʰaŋ̊k-]@чи́стая матема́тика(не прикладная) rein matematikk [maːtɪmaꞋtʰɪʰkː] (í mótsetning til gagnnýtta matematikk);чи́стое иску́сствоrein list;чи́стой {чисте́йшей} воды́út í æsir, hundrað prosent [-Ꞌsε-];вы́вестикого-л.на чи́стую во́дуavdúkaaðio-n;чи́стое по́леvíðilsiсгл-i;в чи́стом по́ле(úti) á víðilsi;чи́стая отста́вка {чи́стая}gml.tað at fara endaliga úr starvi;чи́стые листы́prent.síðsti rættlesturм0осн-s,-ar;-ar,-ar=>во́здух@,зо́лото1,моне́та@,се́рдце@,случа́йность1,со́весть,четве́рг
чистю́ля	f, m tlm. o-r, sum er í so reinligur,o-r, sum er ovurhonds [-hɔn̊s] reimligur
Чита́	fTjita [-Ꞌtʰaː]м нескл.
чита́льный	adj: чита́льный зал lesisalur
чита́льня	flesisalurмсогл-s,-ir(читальный зал); lesiverilsiсгл-i(небольшая)
чита́тель	mlesariмгл-ari; lánariмгл-ari, lænariннкмгл-ari(á bókasavni o.tíl.) (посетитель библиотеки)
чита́тельница	flesariмгл-ari(konufólk); lánariмгл-ari, lænariннкмгл-ari(á bókasavni o.tíl.) (konufólk) (посетительница библиотеки)
чита́тельский	adjlesara-; чита́тельский биле́т lánarakort
чита́ть	ipf(pfпрочита́ть, проче́стьпрочт|у́, ~ёшь, ~у́т; pret прочёл, прочл|а́, ~о́, ~и́)1.Acc(воспринимать написанное) lesaслнa-ó-iВин; чита́ть газе́ту lesa eitt blað; чита́ть Толсто́го lesa Tolstoj [tɔlꞋstɔi]; чита́ть по-фаре́рски [-рэ́-] lesa á føroyskum [føːɹɪsk-]; (duga at) lesa føroyskt [føːɹɪst] (уметь); чита́тьчьи-л.мы́сли lesa tankarnar [tʰaŋ̊k-]hjá[tʃʰ-]o-m; он не уме́ет чита́ть hann dugir ikki at lesa; ма́льчик уже́ чита́ет drongurin dugir longu at lesa; чита́ть корректу́ру lesa rættlestur; чита́ть но́ты (duga at) lesa nótar; чита́ть по губа́м lesa á munninum; э́то невозмо́жно чита́ть hetta er ikki lesandi; он лю́бит чита́ть honum dámar væl at lesa2.что-л.(декламировать) lesaслнa-ó-io-t(upp); чита́ть стихи́ lesa yrkingar (upp); чита́тьчто-л.наизу́сть lesa uttanat3.: чита́ть ле́кцию haldaслнe-i-iein fyrilestur (á lærustovni); чита́ть докла́д halda ein fyrilestur; чита́ть курс русско́й литерату́ры havaнепрeina fyrilestrarøð um russiskar bókmentir (á lærustovni); он чита́ет исто́рию Росси́и в университе́те hann heldur fyrilestrar um russiska søgu á universitetinum [ˌuːnivεʂiꞋtʰeː-]@чита́тькому-л.нота́ции {нравоуче́ние, наставле́ние}formana [-Ꞌmεa-]aðio-n, prædika [pʰɹεatɪʰka]aðifyri o-m=>вслух,складIII,строка́@
чита́ться	ipf bert 3. pers brúktur1.(восприниматься при чтении) at vera lesandi; кни́га легко́ чита́ется bókin er løtt at lesa, bókin er lættlisinсоглосн2.óp, кому-л.tlm.:мне не чита́ется eg havi ikki hugsku [hʊskʊ] til at lesa, eg eri ikki upplagdurннксогл{a/ø}at lesa; в тако́м шу́ме не чита́ется tað er ikki lesandi í sovorðnum gangi
чи́тка	plurчи́т|ки, ~ок, ~камf1.(чтение) lesturм0осн(lesing); чи́тка корректу́ры rættlestur2.(слух) upplesturм0осн3.sjónl.(чтение ролей) lesiprøviннкмгл-iпроф., lesiroyndнпжгл-ir(hjá sjónleikarum)
чифи́рь	móvkm.sera serkt teс0о{0<>i}
чих	mtlm.njósс0о, nosс0о, njósiмгл-i
чиха́ние	nnjósннкс0о, nosс0о, njósiмгл-i; (о моторе) hostс0о(um motor) =>наздра́вствоваться
чиха́тельный	adjnjósi-
чиха́ть	ipf(momentчихну́тьчихн|у́, ~ёшь, ~у́т)1.(с резким звуком выдыхать воздух) njósaaði;аr(t);слнey-u-o; hostaaði(um motor) (о моторе)2.на кого-л.fl.,óvkm.: чиха́ть мне на него́ {чиха́ть я на него́ хоте́л} líka leggi eg í hann, sektin liggur á honum, eg skíti á hannгрубо
чихну́ть	moment síчиха́ть
чистоплю́ство	n tlm., vanv.1. (человек, избегющий черной рабты)o-r.sum skýggjar hart, tungt arbeiði2. (чистюля) o-r, sum er í reinligur, o-r, sum er ovurhonds [-hɔn̊s] reimligur
чи́ще	comp avчи́стый
ЧК	[че-ка́]f indeclЧека́
Чка́лов	msovjet. Tjkalov [tʃʰkʰaːlɔu], [tʃʰkʰaːlɔf]м0{дат.0}síОренбу́рг
чл.	член limur
член	m1.чего-л.(организации и т.п.) limurсогл-ir, felagslimurсогл-ir; limalandс0о{a/o}(о стране); быть чле́номчего-л. vera limurav{í}o-m; чле́ны семьи́ húsfólkið [hʏs-]; чле́ны городско́го сове́та býráðslimir; чле́н комите́та nevndarlimur; избра́тького-л.чле́ном комите́та veljao-ní nevnd(ina); член суда́ meddómariмгл-ari; ты член клу́ба? ert tú limur av felagnum [-anʊn]?; э́та страна́ - член ООН hetta landið er limur av {í} ST2.(часть целого) liðс0о, liðurмсогл-s,-ir; член уравне́ния lið í líkning, liður í líkning; член предложе́ния setningslið, setningsliður3.máll.síарти́кль4.(часть тела) (út)limurмсогл-ir; мужско́й член (kyns)limurмсогл-irкн.,анат.(á manni), reður [reːv-], [rеːʊɹ]с0осн{+}(мужчины, животного) =>ассоции́рованный,кандида́т@,экипа́жII
чле́ник	mdjór.liðurмсогл-s,-ir
членистоно́гие	adj plur(тип Arthropoda) liðadýrс0омн
члени́ть	член|ю́, ~и́шь, ~я́тipf(pfрасчлени́тьрасчлен|ю́, ~и́шь, ~я́т)что-л.býtair(t)o-tsundur, takaслнó-ó-io-tsundur í partar
члени́ться	член|и́тся, ~я́тсяipf(pfрасчлени́тьрасчлен|и́тся, ~я́тся) verða býtturсоглsundur, verða tikinсоглоснsundur í partar
член-корреспонде́нт	m-m(чего-л.) korresponderandi [kʰɔɹːɪspɔnꞋteː-] limurмсогл-ir(av o-m)
членово́з	mtlm.,skemt.stjórnarbilur [-tn-]мсогл-ar
членовреди́тельство	nalm.meiðslс0о, likamsløsturмсогл-s,-ir
членоразде́льно	adjskilliga, týðiliga (ясно); forstáiliga [-Ꞌstɔaj-]ннк, lætt at skilja (понятно)
членоразде́льность	fartikulatión [ˌaɹ̥tɪkʰuːlaꞋʃɔun]ж0-irспец.
членоразде́льный	stfчленоразде́лен, членоразде́льн|а, ~о, ~ыadjartikuleraður [aɹ̥tɪkʰuꞋleː-]глaðurспец.
чле́нский	adjlima-;sbr.член 1 =>биле́т2,взнос,кни́жка2
чле́нство	nlimaskapurмсогл-ir=>ассоции́рованный
чл.-кор(р).	síчлен-корреспонде́нт
чмо́кать	ipf(momentчмо́кнутьчмо́кн|у, ~ешь, ~ут)1.(губами) smaskaaði2.(издавать чмокающий звук) slupsaaði, esjaaði; грязь чмо́кает под нога́ми evjan esjar undir fótunum3.tlm.(целовать) mussaaði; чмо́кнутького-л.в щёку smekka ein muss á kjálkaná o-m
чмо́кнуть	moment síчмо́кать
ЧМТ	[че-эм-тэ́]f indecl: че́репно-мозгова́я тра́вма traumatiskur [tɹauˈmaː-] heilaskaðiмед.
чо́глок	síчегло́к
чо́каться	ipf(momentчо́кнутьсячо́кн|усь, ~ешься, ~утся)с кем-л.skálaaðivið o-n(рюмками)
чо́кнутый	adjóvkm.klikkaðurглaðurнеформ.,шутл.,пренебр., ikki rættsiktaðurглaður, ikki í ordanнеформ., пренебр.
чо́кнуться	чо́кн|усь, ~ешься, ~утсяmoment1.síчо́каться2.pfóvkm.(свихнуться) klikkaaðiнеформ.,пренебр., blíva klikkaðurглaðutнеформ.,шутл.,пренебр., verða óðurглí høvdinum [hœtː-]пренебр., verða svakurсогл{a/ø}пренебр.
чо́мга	f síпога́нка, больша́я I
чо́порность	ftað at vera stívur, tað at vera svinnur; tað at vera ansaligur
чо́порный	stfчо́пор|ен, ~на, ~но, ~ныadjstívurсогл, svinnurсогл; ansaligurглigur
чо́ппер	mchoppari [tʃʰɔ-]жгл-ari(motorsúkkla)
чо́хом	advóvkm.undir einum
ЧП	[че-пэ́] In indecl(чрезвыча́йное положе́ние) undantaksstøðaжгл-a
ЧП	[че-пэ́] IIn indecl síчепе́
чрева́тый	stfчрева́т, ~а, ~о, ~ыadj чем-л.bókl.fullur [-tl-]соглav o-m, sum ber í sær; чрева́тый несча́стьями vanlukkuligur [-Ꞌlʊʰkː-]глigur, ófrættakendurсогл; чрева́тый опа́сностью sum hevur stóran vanda við sær, sum hevur stóran vanda í sær; собы́тия, чрева́тые тяжёлыми после́дствиями hendingar, ið boða frá álvarsligum avleiðingum; ófrættahendingar; э́то чрева́то войно́й hetta ber krígsvanda [kʰɹʊi̯ʰks-], [kʰɹʊʰks-] við sær; э́то чрева́то опа́сными после́дствиями tað kann hava hættisligar avleiðingar
чре́во	ngml.búkurмсогл-ar, kviðurмсогл-irуст.; во чре́ве ма́тери í móðurlívi
чревовеща́ние	nbúktalaríс0о
чревовеща́тель	mbúktalariмгл-ari
чревоуго́дие	novát [oːɔat]с0о, óhógvс0оí áti
чревоуго́дник	mátariмгл-ari, áturoppaжгл-aпренебр.
чревоуго́дничать	ipf gml.oveta[oːeː-]слнá-ó-eseg, etaслнá-ó-eseg um ryggидиом.
чреда́	plurчреды́, чред, чреда́мf gml., skald. síчереда́I 1
чрез	prepgml.síче́рез
чрезвыча́йно	advserstakliga [sεʂꞋstεa-], sjáldsama [ʃɔl̥s-]; avbæra (тж[aup-], [apːεa-]), avbera (тж[aup-], [apːeː-]), sera; út av lagi (о чём-л. отрицательном); чрезвыча́йно мила́ óalmindiliga [-Ꞌmɪ-]энкfitt; чрезвыча́йно интере́сно ómetaliga [-Ꞌmeː-] interessant [in̊tɪɹɪꞋsan̊t]ннк
чрезвыча́йный	stfчрезвыча́ен, чрезвыча́йн|а, ~о, ~ыadj1.(исключительный) serstakurсогл{a/ø}; ómetaligur [-Ꞌmeː-]глigur, sera stórurсогл{+}(очень большой); произвести́ чрезвыча́йный эффе́кт hava eina óvanliga ávirkan, hava eina sjáldsama [ʃɔl̥s-] ávirkan; чрезвыча́йная ро́бость sjáldsamt [ʃɔl̥s-] smædni; чрезвыча́йная быстрота́ ómetalig ferð2.bert lf(специальный,особый) serligurглigur, serstakurсогл{a/ø}, undantaks-; чрезвыча́йное происше́ствие serlig hending, sertilburður, eindømiсгл-i; чрезвыча́йные ме́ры serlig tiltøk; чрезвыча́йные полномо́чия serligar heimildir; чрезвыча́йное собра́ние eykafundur; ввести́ чрезвыча́йное положе́ние lýsair(t)undantaksstøðu =>КЧС
чрезме́рно	advalt ov (перед сосгласным, кромеh, [ɔ],перед согласными иh [oː]), alt for [fɔɹː]ннк; ovurhonds [-hɔn̊s], ómetaliga [-Ꞌmeː-] (чрезвычайно)
чрезме́рный	stfчрезме́р|ен, ~на, ~но, ~ныadjovurhonds [-hɔn̊s] +пол., ómetaligur [-Ꞌmeː-]глigur, ómetaliga [-Ꞌmeː-] +пол.; чрезме́рное коли́чество ovurhonds stór nøgd
чре́сла	чресл, ~амn plurgml.,bókl.lendarж0-arмн
чс	[че-э́с] findeclчрезвыча́йная ситуа́ция neyðstøða [-støːva]
ЧССР	[че-эс-эс-э́р]f indeclsøg.síЧехослова́цкаяСоциалисти́ческая Респу́блика
ЧСФР	[че-эс-эф-э́р]f indeclsøg.síЧе́шскаяи Слова́цкая федерати́вная респу́блика
чтв.	четве́рг
чте́ние	n1.(действие) lesingж0-ar, lesturм0осн-ar,-ar(tað at lesa); чте́ние вслух upplestur; кни́га чля чте́ния lesibók; чте́ние ка́рты kortlesing, lesing av korti; чте́ние мы́слей tankalesing [tʰaŋ̊k-], lesing av tankum [tʰaŋ̊k-]2.: чте́ние ле́кции tað at halda fyrilestur, fyrilesturм0осн-ar,-ar; чте́ние стихо́в upplestur av yrkingum3.(читаемый текст) lesturм0осн-ar,-ar; lesitilfarс0о(lisnir tekstir)4.plur(цикл докладов) fyrilestrarøðж0-ir({ø/a}); «Пу́шкинские чте́ния» fyrilestrar um Pusjkin5.teld.(о базе данных и др.) lesingж0-ar; чте́ние за́писей ба́зы да́нных heintingж0-arav upplýsingum frá databasu [taːtapaː-], lesingж0-arav upplýsingum frá databasu [taːtapaː-]6.(закона) viðgerð [vɪtʃ-]ж0-ir(av lógaruppskoti o.tíl.); во вре́мя второ́го чте́ния (закона) undir aðru viðgerð (av lóg)
чтец	Gen, Accчтец|а́;plur~ы́, ~о́в, ~а́мm1.(читающий вслух, артист) upplesariмгл-ari2.gml.(читатель) lesariмгл-ari
чти́во	ntlm.,niðr.lættisoppalesturм0осн-ar,-ar
чтить	чт|у, ~ишь, -ятog~утipf Accærair(d);aðiВин; чтитьчью-л.па́мять {па́мятького-л.} æra minniðum o-n, æraпосс.minni
чти́ца	f(читающая вслух,артистка) upplesariмгл-ari(konufólk)
что	[што] IIpron(Genчего́,Datчему́,Accчто,Insчем,Prpо чём)1.interrog, relathvat; что э́то? hvat er hetta?; я не зна́ю, что э́то eg veit ikki, hvat tað er; что мне де́лать? hvat skal eg gera?; чего́ они́ ждут? hvørjum bíða tey eftir? [εʰtː-]; чему́ он так ра́дуется? hví er hann so glaður?; hvat er hann so glaður um?; чем э́то вы́звано? hvørjum kemst hetta av?; с чем ты бу́дешь пить чай? hvat vilt tú hava aftur [aʰtː-] við drekkamunninum?; о чём ты ду́маешь? hvat hugsar tú um?; ну и что да́льше? Og hvat so?; что с тобо́й? hvat bagir tær?2.tlm.(сколько) hvussu nógv, hvat (hvussu nógv); что сто́ит кни́га? hvat kostar bókin?; что то́лку? hvat nyttar tað?; что хоро́шего в э́том {что тут хоро́шего}? hvat skal tað vera gott fyri?3.relat(который) sum, ið [ʊi]; я не понима́ю, о чём вы говори́те eg forstandi [-Ꞌsta-]ннкikki, hvat tit tosa um; э́то всё, что я зна́ю hetta er alt, (sum) eg veit; то, что он сказа́л, чушь tað (sum) hann segði [sεijɪ], er nakað tvætl; что сде́лано, то сде́лано gjørt er gjørt; э́то гла́вное, что на́до знать hetta er tað, sum er mest umráðandi at vita; дом, что на углу́, о́чень ста́рый húsið(, sum stendur) á horninum [-tn-],) er ógviliga gamalt; кни́га, что ты чита́ешь, моя́ eg eigi bókina, sum tú lesur4.(в присоединительном предложении): он стал врачо́м, чего́ никто́ не ждал hann gjørdist lækni, og tað hevði [hεijɪ] eingin væntað; пого́да была прекра́сная, чему́ все обра́довались veðrið [-kɹɪ] var av tí allarfagrasta, og øll [œtl] vóru fegin um tað; ре́зко похолода́ло, из-за чего́ нам пришло́сь верну́ться tað kólnaði knappliga, og tí máttu vit venda Ꞌ við aftur [aʰtː-]5.tlm.(что-нибудь) okkurt; ты бы пое́л чего́ tú átti at etið eitt sindur; ты ждёшь чего́? bíðar tú eftir [εʰtː-] nøkrum?6.(при переспрашивании) hvat?; ha?IIadv(почему) hví, hvat... til; что {чего́óvkm.} ты смеёшься? hví grínur tú?; hvørjum grínur tú at?; что (же) ты не е́дешь? hví fert tú ikki?; что (же) так? hví ikki?IIIpred: что па́па? hvussu hevur pápi tað?; что больно́й? hvussu livir tann sjúki?@что-что, а ру́сский он зна́ет tú kanst siga, hvat tú vilt, men russiskt tað dugir hann;чего́-чего́ он то́лько не ви́делhvat hevur hann ikki sæð; чего́-чего́, а э́того я от тебя́ не ждал nógv kundi eg væntað mær av tær, men hetta, nei;чему́-чему́, a э́тому я тебя́ не учи́лtú kanst siga hvat tú vilt, men hetta hevur tú ikki lært av mær;а что?hvussu tá?; hvat meinar tú?;ну и что?og hvat so?; og hvat um tað?;ну что ж(е)íðan meðni;не́ за что(ответ на благодарность) einki at takka fyri;к чему́?: к чему́ э́то? a) (что это сулит) hvat skal hetta til?; b) (что это значит) hvat skal hetta betýða [-Ꞌtʰʊija]ннк?;(а) что е́слиhvat nú (vissннк), um nú;что ты!nei, veitst [vai̯st] tú hvat!; что ты! ert tú púra galin!неформ.;что за ... ?: что э́то за па́рень hvør er hesin fýrurinнеформ.; что за чай ты пьёшь? hvat er tað fyri te, tú drekkur?; что за пого́да! tað er eitt veður!;ни за что(ни в коем случае) ikki talan um, so kortanei;ни за что{ни про что; ни за́ что ни про́ что}tlm.uttan grund, av ongum;что тако́е?hvat?;что ж(е) тако́го {тако́е}?a) (не играет роли) hvat hevur tað at siga?; b) (в этом нет ничего плохого) tað er einki galið í tí;что из того́ {с того́}?og hvat so?;что лиella [εtla] hvat (или не переводится); он сви́хнулся, что ли? er hann blivin spinnandi ørur(, ella hvat)?; пойти́ в кино́, что ли? skulu vit fara í biograf [piːoꞋkɹaːf](, ella hvat?);с чего́ ты э́то взял?hvaðani hevur tú hatta?;что с того́?hvat ger tað?;чемже онневрач? er hann ikki nóg góður lækni?; hvat bagir honum sum lækni?; он опозда́л,вот что: он опозда́л, вот что, позвони́ ему сра́зу же jú, men hann var for [fɔɹː]ннкseinur, sært tú, ring til hansara beinanvegin;что до меня́hvat mær viðvíkir; что до меня́, я согла́сен eg sigi fyri meg, at eg eri samdur; что до меня́, пусть он придёт hann kann koma fyri mær; он зна́ет,что к чему́hann veit, hvat skal gerast; hann veit, hvussu vorðið er;что нисло́во, то ложь hvørt orð er lygn; что ни день, то дождь tað er ikki dagur, at tað ikki regnar; tað regnar hvønn Guds skapta dag;на что ужон упря́м, но его всё-таки уговори́ли so treiskur hann er, so yvirtalaðu tey hann kortini =>бытьА 3,B2,@,говори́ть@,до́брый@,естьII @,мочьII,неI @,по́льза,статьI @,тако́й3,хоро́шийII
что	[што] IIpron(Genчего́,Datчему́,Accчто,Insчем,Prpо чём)síничто́, ко́е-что, не II; нам не́ о чем говори́ть vit hava einki at tosa um
что	[што] IIIconj1.at; я зна́ю, что он ско́ро прийдёт eg veit, (at) hann kemur skjótt; я рад, что ты здесь eg eri glaður fyri, at tú ert her; они́ ду́мали, что он у́мный челове́к tey hildu hann vera ein klókan mann; то, что он э́то сде́лал tað, at hann gjørdi hetta2.(ли…ли) что ... что ...; что ты пойдёшь, что я - всё равно́ um tú ella [εtla] eg fari, kann gera tað sama; что он, что она́ - оба́ немо́лоды hvørki hann ella [εtla] hon eru ung, hvørki av teimum er ungt; hvørgin teirra er ungur@что быsíлишьбы лишь =>такIII @,тот@
что́б	[шт-]síчто́бы
что́бы	[што-]I 1.(цели) fyri at, so (at); он встал, что́бы все ви́дели его́ hann reisti seg upp, fyri at øll [œtl] skuldu síggja hann; hann reisti seg upp, so (at) øll [œtl] kundu síggja hann; я сде́лаю всё (для того́), что́бы помо́чь ему́ eg skal gera alt fyri at hjálpa [j-] honum; я записа́л э́то, что́бы не забы́ть eg skrivaði tað upp fyri ikki at gloyma tað; eg skrivaði tað upp, so eg ikki skuldi gloyma tað2.expatили не переводитсяt; он хо́чет, что́бы они́ сде́лали э́то hann vil hava tey at gera tað; hann vil hava, at tey gera tað; он сказа́л (им), что́бы они́ сде́лали э́то hann bað tey gera tað; hann segði [sεijɪ], (at) tey skuldu gera tað; гла́вное, что́бы все сда́ли экза́мен tað, sum umræður, er, at allir klára eksamiuna [-Ꞌsaː-]ннк; жела́тельно, что́бы ... tað er eftirynskjandi [εʰtː-], at ...; на́до, что́бы он по́нял э́то hann má skilja hetta; hann má fáast til at skilja hetta; я никогда́ не ви́дел, что́бы она́ серди́лась eg havi ongantíð sæð hana blíva óða; я не нашёл никого́, что́бы сде́лать э́то eg fann ongan at gera hetta; не быва́ет дня, что́бы он не написа́л ей tað er ikki dagur, at hann ikki skrivar til hennara; на́ша цель не та, что́бы… málið hjá [tʃʰ-] okkum er ikki at...; он не мог удержа́ться, что́бы не засмея́ться hann kundi ikki lata vera við at grínaIIpart: что́б(ы) он был здесь че́рез де́сять мину́т! hann má vera her um tíggju minuttir [-Ꞌnʊ-]!; что́бы э́того бо́льше не́ было! hetta má ikki henda aftur [aʰtː-]!; что́бы ему́ повезло́! gævi tað lukkast hjá [tʃʰ-] honum!; что́бы я тако́е сказа́л! at eg skuldi havt sagt sovorðið!@не то {так} что́быsíтот@,sí eis.насто́лько, незаме́тнo II, нет @, сли́шком
что́-либо	[што-] (Genчего́-либо,Datчему́-либо,Accчто́-либо,Insче́м-либо,Prpо чём-либо)pronokkurt; nakað; не могу́ сообщи́ть чего́-либо утеши́тельнофо eg kann ikki siga frá nøkrum at ugga við; eg kann ikki ugga við nøkrum
что́-нибудь	[што-] (Genчего́-нибудь,Datчему́-нибудь,Accчто́-нибудь,Insче́м-нибудь,Prpо чём-либо)pronokkurt; nakað; да́йте мне что́-нибудь! gev mær okkurt!; ты что́-нибудь ви́дишь? sært tí nakað?; не ли чего́-нибудь почита́ть? hevur tú einki at lesa?; hevur tú ikki okkurt at lesa?
что́-то	[што-] (Genчего́-то,Datчему́-то,Accчто́-то,Insче́м-то,Prpо чём-то)Ipronokkurt; случи́лось что́-то неприя́тное her er okkurt keðiligt hent; тут что́-то не так her er okkurt galið, her er okkurt, sum tað ikki eigur at vera; her er ikki rætt vorðið,IIadv1.(слегка) eitt sindur; он что́-то стра́нен hann er eitt sindur løgin2.(почему-то) av onkrari grund; мне что́-то не ве́рится eg havi ilt við at trúgva tí; мне что́-то не хо́чется eg havi ikki rættiliga hug; eg tími ikki ordiligaннк; что́-то ру́ки трясу́тся onkursvegna so ristist eg á hondunum3.(примерно) umleið [-Ꞌlai-]; что-то о́коло ста рубле́й einir hundrað rublar, okkurt um hundrað rublar, umleið hundrað rublar; что́-то мно́го a) nokk so nógv; b) (многовато) í so nógv, í meira lagi =>вро́деI
чу	interlurta; hoyr
чуб	plurчуб|ы́, ~о́в, ~а́мm1.(прядь волос) doddurмсогл-ar2.síоселе́дец
чуба́рый	stfчуба́р, ~а, ~о, ~ыadjflekkuturсогл, (dimm)digluturсогл(um lit á djórum og fuglum)
чуба́тый	stfчуба́т, ~а, ~о, ~ыadjtlm.við doddi
чубу́к1	IGenчубук|а́;plur~и́, ~о́в, ~а́мm1.(стержень трубки) pípuleggurмсогл-ir2.(длинная трубка) long pípaжгл-a
чубу́к2	IIGenчубук|а́;plur~и́, ~о́в, ~а́мm(черенок винограда) gróðursetingargreinж0-ar;irспец.(av víntræi)
чува́к	Gen, Accчувак|а́;plur ~и́, ~о́в, ~а́мm1.jarg.(парень) fýrurмсогл-arнеформ., stavnurмсогл-ar2.(баран) geldseyður [tʃεls-]мсогл-ir; geldur kamelur [-ˈmeː-]мсогл--ar(верблюд)
чува́ш	Gen, Accчуваш|а́;plur~и́, ~е́й, ~а́мmtjuvasjari [tʃʰuꞋvaʃː-]мгл-ari, tjuvasji [tʃʰuꞋvaʃː-]мгл-i
Чува́шия	fTjuvasjia [tʃʰuꞋvaʃːia]с нескл.
чува́шка	plurчува́ш|ки, ~ек, ~камftjuvasjari [tʃʰuꞋvaʃː-]мгл-ari, tjuvasji [tʃʰuꞋvaʃː-]мгл-i(konufólk)
Чува́шская Автоно́мная Сове́тская Социалисти́ческая Респу́блика	sovjet.Tjuvasjiska [tʃʰuꞋvaʃː-] sjálvstýrandi [ʃɔl̥s-] sovjetska [sɔu-] sosialistiska [-Ꞌlɪ-] lýðveldið
Чува́шская Респу́блика	Lýðveldið Tjuvasjia [tʃʰuꞋvaʃːia]
чува́шский	adjtjuvasjiskur [tʃʰuꞋvaʃː-]; чува́шкий язы́к tjuvasjiskt [tʃʰuꞋvaʃːɪst]сприлskt
чу́вственность	[чуств-]f1.(восприяте) sansingж0-ar2.(сладострастие) (holdslig) girndж0-ir, lostiмгл-iкн.; sansaligheitж0-ir
чу́вственный	[чуств-]stfчу́вствен, ~на, ~но, ~ныadj1.lf(воспринимаемый органами чувств) sansa-, uppfataðar av sansunum; чу́вственное восприя́тие sansingж0-ar2.(плотский) holdsligurглigurкн., kynsligurглigur(половой), sansaligurннкглigur(сладострастный)
чувстви́тельность	[чуств-]f1.(обидчивость) erkvisniсгл-i; smásæriсгл-i, tykniсгл-i2.(восприимчивость) viðkvæmi [vɪʰk-], [viː-]сгл-i; па́лец потеря́л чувстви́тельность einki følilsi er í fingrinum3.(сентиментальность) sentimentalitetur [sεn̊timεn̊taːliꞋtʰeː-]интмсогл-ar4.(о приборе и т.п.) følsamheitннкж0-irпроф.(um instrument o.a.)
чувстви́тельный	[чуств-]stfчувстви́телен, чувстви́тельн|а, ~о, ~ыadj1.(к чему-л.) (впечатлительный) erkvisinсоглосн; smásárurсогл, tykkinсоглосн(обидчивый); она́ чувстви́тельна к хо́лоду hon tolir illa [ɪtla] kulda, hon er krillut [-tl-]; чувстви́тельный нерв viðkvom [vɪʰk-], [viː-] nerv2.(восприимчивый) viðkvæmur [vɪʰk-], [viː-]согл{æ/o}; чувстви́тельный челове́к viðkvæmt menniskja; чувстви́тельная ко́жа eym húð, sartннкhúð3.(сентиментальный) sentimentalur [sεn̊timεnꞋtʰaː-]интсогл4.(о приборе и т.п.) følsamurннксогл{a/o} проф(um instrument o.a.); чувстви́тельный прибо́р følsamtннкпроф.instrument [instɹuꞋmε-]5.tlm.(ощутимый) sum merkist; чувстви́тельная поте́ря eitt stórt tap; чувстви́тельная ра́зница ein týðiligur munur
чу́вство	[чуств-]n1.(способность ощущения) sansurмсогл-ar;-ir; чу́вство вку́са smakkurмсогл-s,-ir, smakksansur; пять чу́вств челове́ка: зре́ние, слух, обоня́ние, вкус, осяза́ние teir fimm sansirnir eru: sjón, hoyrn, luktur, smakkur, kensla2.(ощущение) følilsiсгл-i, kenslaжгл-a; чу́вство жа́жды tostiмгл-i; чу́вство бо́ли pínaжгл-a; чу́вство стыда́ skommж0-ir{o/a}; неприя́тное чу́вство óhugalig kensla, óbehagiligt [-Ꞌhεa-]ннкfølilsi; твои́ чу́вства к ней tínar kenslur fyri henni; челове́к чу́вства viðkvæmt [vɪʰk-], [viː-] fólk, kensluligt menniskja, følilsismenniskjaннк; у меня́ (тако́е) чу́вство, сло́вно {что}...eg havi ein varhuga av, at...3.mest plur(сознание) vitс0о(tað at vita til sín); лиши́ться чувств svímaaði, missair(t)vitið, falla [-tla]слнa-u-a(niður) í óvit; без чувств í óviti, svímaðurглaður, uttan vit; прийти́ в чу́вство raknaaðivið, fáaслнe-i-ivitið aftur [aʰtː-]4.(любовь) kærleikiмгл-i, kerligheitннкж0-ir=>долг1,досто́инство1,избы́ток2,ме́ра5,недо́брый1,обма́н4,о́рган,оскорби́ть,отве́тственность,ритм,справедли́вость1,шесто́й@,ю́мор
чу́вствовать	[чуств-]чу́вству|ю, ~ешь, ~ютipf(pfпочу́вствоватьпочу́вству|ю, ~ешь, ~ют)что-л.1.(испытывать чувсвто) følair(d)o-t, kennair(d)o-t; merkjair(t)o-t(ощущать); я чу́вствую, что уста́л eg føli, at eg eri blivin móður; чу́встовать ра́дость føla gleði; чу́вствовать на себе́чей-л.взгляд føla eyguni hjá [tʃʰ-]o-má sær2.(предчувствовать) følair(d)o-tá sær, vitaнепрo-tá sær3.(осознавать) skiljaur(d)o-t, síggjaслнá-ó-æo-t; чу́вствовать свои́ недоста́тки viðurkennair(d)egin brek4.: как ты себя́ чу́вствуешь? hvussu hevur tú tað?; hvussu livir tú?; hvussu veit við?; я чу́вствовал себя́ хорошо́ eg hevði [hεijɪ] tað gott; eg føldi meg væl; он пло́хо чу́вствовал себя́ в столи́це hann hevði [hεijɪ] tað ikki gott í høvuðsstaðnum; livdi illa [itla] í høvuðsstaðnum; hann føldi seg illa [itla] í høvuðsstaðnum@дава́ть себя́ чу́вствоватьmerkjastir(t)=>до́ма,нога́@,симпа́тия1,сострада́ние
чу́вствоваться	[чуств-]чу́вству|ется, ~ютсяipf(pfпочу́вствоватьпочу́вству|ется, ~ются) følastir(d), kennastir(d); merkjastir(t)(ощущаться)
чугу́н	Genчугуна́m1.(материал) stoypijarn [-tn]с0о{a/ø}, rájarn [-tn]с0о{a/ø}2.(сосуд) stoypijarnsgrýta [-jan̊s-]жгл-a, stoypijarnspottur [-jan̊s-]мсогл-ar
чугу́нка	plurчугу́н|ки. ~ок, ~камf1.tlm. (печка) ovnurмсогл-arúr stoypijarni [-jatnɪ]2.gml., óvkm. (Железная дорога) jarnbani [janpaː-]ннкмгл-i,jarnbreyt[janp-]нпж0-ir
чугу́нный	adj1.(кчугу́н) stoypijarns- [-jan̊s-]2.fl.(тяжёлый) jarn- [-tn-], [jan-]; -tungur; чугу́нная тя́жестьo-t,ið er tungt sum blýggj; чугу́нный кула́к jarnnevi [jann-]
чугунолите́йный	adj: чугунолите́йный заво́д jarnstoypivirki [jans-], [jatn-]
чуда́к	Gen, Accчудак|а́;plur~и́, ~о́в, ~а́мmserlingurмсогл-ar, serskøltur [sεʂk-]мсогл-ar, ein serur knokkurмсогл-ar, originalur [ɔɹkiꞋnaː-]энкмсогл-ar
чудакова́тый	stfчудакова́т, ~а, ~о, ~ыadjserurсогл, undarligurглigur, snedigur [sneːt-]энкглigur
чуда́чество	n1.(качество) serheitж0-ir, snedigheit [sneːt-]энкж0-ir, serlætiсгл-iмн кн.2.oftast plur(поступок) løgin gerðж0-ir
чуда́чка	plurчуда́ч|ки, ~ек, ~камfserlingurмсогл-ar, serskøltur [sεʂk-]мсогл-ar, ein serur knokkurмсогл-ar, originalur [ɔɹkiꞋnaː-]энкмсогл-ar(konufólk)
чудеса́	plur avчу́до
чуде́сный	stfчуде́с|ен, ~на, ~но, ~ныadj1.(являющийся чудом) undurfullur [-tl-]согл, undursamurсогл{a/o},mirakuløsur [-kʰuꞋløː-]ннксогл; чуде́сное исцеле́ние undurfull leking; чуде́сный за́мок ævintýrborg,2.(замечательный) frálíkurсогл, frálíka +пол., praktfullur [-tl-]ннксогл; чуде́сная пого́да dýrdarveður, fagnarveður; чуде́сной красоты́ undurfagurсоглосн{a/ø}, undurvakurсоглосн{a/ø}
чу́дик	móvkm.síчуда́к
чуди́ла	fóvkm.síчуда́к
чуди́ть	1. pers ikki brúkturчуди́|шь, ~я́тipftlm.1.(вести себя странно) havaнепрløgna medferð2.(шутить) skemtaaði
чу́диться	1. pers ikki brúkturчу́д|ишься, ~ятсяipf(pfпочу́дитьсяпочу́д|ишься, ~ятся, причу́дитьсяпричу́д|ишься, ~ятся)кому-л. oftast óphaldaслнe-i-i; gyklastaðiкн.; мне чу́дится стук eg haldi, tað bankar; мне чу́дится свет eg haldi meg síggja ljós, ljós gyklast fyri mærкн.; мне {тебе́o.s.fr.} э́то то́лько чу́дится hetta er bara innbilningur; мне чу́дилось, что я нахожу́сь в… eg helt meg vera í..., tað tóktist mær, at eg var í...; tað barst mær fyriкн., at eg var í...,
чу́дище	ngml.síчудо́вище
чу́дненько	advtlm.fínt, fínar greiður [kɹεi-], [kɹai-]неформ.
чудно́	Iadv tlm.undarliga, margháttliga [-Ꞌkʰɔʰt-], snediga [sneːt-]ннк; láturliga, komisktэнк(смешно)IIóp predtað er løgið, tað er undarligt, tað er snedigt [sneːt-]ннк
чудно́й	stfчудён, чудн|а́, ~о́, ~ы́adjtlm.undarligurглigur, løginсоглосн, margháttligur [-Ꞌkʰɔʰt-]глigur, snedigur [sneːt-]энкглigur; láturligurглigur, komiskurннксогл(смешной)
чу́дный	stfчу́ден, чу́д|на, ~но, ~ныadj1.(прелестный,очаровательный) undurfullur [-tl-]соглкн.,поэт.; чу́дное виде́ние ein undurfullкн.,поэт.sjón; чу́дные зву́ки undurfullкн.,поэт.ljóð2.bert lftlm.(прекрасный) frálíka +пол., frálíkur, óføra +пол.; чу́дный хара́ктер eitt so eigiligt sinnalag
чу́до	plurчудес|а́, ~, ~а́мnI 1.(сверхъестественное явление) undurverkс0о, undurс0осн, mirakul [miꞋraʰkː-]с0осн; твори́ть {де́лать, соверша́ть} чудеса́ gera undurverk2.(нечто небывалое) undurс0осн; соверши́лось чу́до har hendi eitt undur; чу́до, что он ещё жив tað er eitt undur, at hann er á lívi enn; чу́до, что мы не поги́бли tað er eitt Guds undur, at vit ikki fórust; э́то чу́дом удало́сь tað var (sum) eitt undur, at tað lukkaðist3.(нечто достойное восхищения) undurverkс0о; семь чуде́с све́та heimsins sjey undurverk; чудеса́ приро́ды náttúrunnar undurverk; твори́ть {де́лать} чудеса́fl.gera undurverk@не чу́до, что…ei dáni í at..., ei undur í at...IIpredtað er fantastiskt [-Ꞌtʰa-]энк, tað er fantastiska [-Ꞌtʰa-]энк+пол.; пого́да сего́дня - чу́до! veðrið [vεkɹɪ] er av tí alrafagrasta í dag; чу́до, как она́ хороша́ hon er fantastiska [-Ꞌtʰa-]энкpenннк=>решето́@
чудо́вище	n1.(фантастическое существо) skrímslс0о, ódjórс0о, ófriskiсгл-i; морско́е чудо́вище sjótrøll [-tl]с0о2.(о человеке) vittuggi [vɪʰttʰ-]сгл-i, dýrс0о, ódjórс0о(um fólk)
чудо́вищный	stfчудо́вищ|ен, ~на, ~но, ~ныadj1.lf(устращающий) andskræmiligur [anꞋskɹεa-]глigur2.(гигантский) ovurstórurсогл, risastórurсогл, risa-, ónatúrliga [-Ꞌtʰʏɹ-] stórur3.(отвратительный) andstyggiligur [anꞋstɪ-]глigur
чудоде́й	mtlm.,skemt.undurmakariмгл-ari;o-r, sum ger undurverk
чудоде́йственный	stfчудоде́йствен, ~на, ~но, ~ныadjbókl.undurgerandiглandi, undursamurсогл{a/o}
чудотво́рец	Gen, Accчудотво́рц|а;plur~ы, ~ев, ~амm1.rel.(в религиозных представлениях)o-r, sum ger undurverk2.fl.(о челеовеке) undurmakariмгл-ari
чудотво́рный	stfчудотво́р|ен, ~на, ~но, ~ныadj1.rel.(в религиозных представлениях) undurgerandiглandi2.fl.,bókl.(достойное удивления) undurgerandiглandi, undur-
чудо-ю́до	n-n fólk.skrímslс0о, ófriskiсгл-i
Чудско́е о́зеро	Peipusvatniðс0оопр.
чудь	f koll, søg. russ. navn á ym. finskum-ugriskum stammum vestanfyri og norðanfyri
чужа́к	Gen, Accчужак|а́;plur~и́, ~о́в, ~а́мm1.(посторонний человек) fremmandamaðurмнепр; fremmandurмприл(um djór,fuglar o.a.)2.fl.(о чужом человеке)o-r, sum ikki hoyrir til; чу́вствовать себя́ чужако́м føla seg uttanfyri
чужби́на	fútlondс0о{a/o}мн; на чужби́не í útlondum, uttanlands, í fremmandum londum
чужда́ться	ipf1.Gen(сторониться) skýggjaaðiВин, haldaслнe-i-iseg burtur fráДат2.чего-л.(не проявлять интереса) firnastaðio-t, skýggjaaðio-t
чу́ждый	stfчу́жд, чужда́, чу́ждо, чу́ждыogчужды́adj1.кому-л.,для кого-л. (несвойственный)fremmandurсогл; (далёкий по духу) fjarurсогл; мне всё э́то чу́ждо (по духу) alt hetta liggur mær fjart; чу́ждый действи́тельности veruleikafjarur; чу́ждый наро́ду fremmant fyri fólkið; чу́ждая идеоло́гия ein fremmand ideologi [iteːoloꞋkiː]инт; я не чужд мы́сли…{мне не чужда́ мысль…} eg eri ikki fremmandur fyri tankanum.2.чего-л.(лишённый) sørurсоглfyri o-t; он чужд за́висти hann kennir ikki til avundsjúku [εavin-], hann er sørur fyri avundsjúku [εavin-] =>челове́ческий1
чужезе́мец	Gen, Accчужезе́мц|а;plur~ы, ~ев, ~амmgml.útlendingur [ʏʰt-]мсогл-ar
чужезе́мка	plurчужезе́м|ки, ~ок, ~камfgml.útlendingur [ʏʰt-]мсогл-ar(konufólk)
чужезе́мный	adjgml.útlendskur [ʏʰtlεn̊sk-]соглndsk, fremmandurсоглndsk
чужестра́нец	Gen, Accчужестра́нц|а;plur~ы, ~ев, ~амmgml.útlendingur [ʏʰt-]мсогл-ar
чужо́й	Iadj1.(принадлежащий другим) sum onnur eiga; sumo-rannar eigur; sum ein einki eigur í; hjá [tʃʰ-]o-møðrum; annar (enn ein sjálvur eigur); чужо́й чемода́н kuffertið hjáo-møðrum; eitt kuffert, sum onkur annar eigur; он наде́л чужо́е пальто́ hann fór í skeivan frakka (hjá o-m øðrum), hann fór í frakkan hjáo-møðrum; на чужо́й счёт fyri rokningina hjáo-møðrum; сова́ться в чужи́е дела́ leggja seg út ío-t, einum ikki kemur við2.кому-л.(для Gen) (посторонний) fremmandurсогл; чужо́й челове́к fremmandamaður, fremmandafólk; он стал ей чужи́м hann bleiv fremmandur fyri hana, hon kendi hann ikki aftur [aʰtː-]3.(не являющийся родной) fremmandurсогл; чужо́й язы́к eitt fremmant mál; чужи́е стра́ны fremmand lond@знатьчто-л.с чужи́х словvitao-tfrá øðrum; расска́зывать с чужи́х слов fortelja [-Ꞌtʰε-] frá øðrum;говори́ть {повторя́ть} с чужо́го го́лосаtaka upp eftir [εʰtː-] øðrum;в чужи́е ру́киøðrum upp í hendur, fremmandum upp í hendur;де́латьчто-л.чужи́ми рука́миlata onnur gerao-tfyri segIImfremmandamaðurмнепр, fremmandafólkс0о, fremmandurмприл; стесня́ться чужи́х smæðast fremmandafólk =>естьI @,жар@
Чуко́тка	fTjukotka [tʃʰuꞋkʰɔʰtkʰa]с нескл.
чуко́тский	adjtjuktjiskurсогл; чуко́тский язы́к tjuktjisktсприлskt
Чуко́тский автоно́мный о́круг	Tjuktjiska sjálvstýrandi [ʃɔl-] økið
Чуко́тский полуо́стров	Tjuktjiska hálvoygginж0-ar{+}опр., Tjuktjahálvoygginж0-ar{+}опр.
Чуко́тское мо́ре	Tjuktjiska haviðс0оопр., Tjuktjahaviðс0оопр.
чу́кча	m, ftjuktjiмгл-i, tjuktjariмгл-ari
чукча́нка	plurчукча́н|ки, ~ок, ~камftjuktjiмгл-i(konufólk), tjuktjariмгл-ari(konufólk)
чула́н	mspískamarс0о{a/ø}{+}, (mat)koviмгл-iуст.(для продуктов); pulturkamarннкс0{+}, ovastaloftс0о(на чердаке) (для старых вещей); rúmс0оtil amboð (для инструментов)
чуло́к	Genчул|ка́;plur~ки́, ~о́к, ~ка́мmsokkurмсогл-ar; в одни́х чулка́х á leistum@в чулка́х(um djór) sokkuturсогл(б.ч. об овцах);кра́сный чуло́кreyðsokkur [rεs-];си́ний чуло́кblásokkur;снять шку́рус кого-л.чулко́мfakm.flettair(t)o-ní bjølg =>па́ра1,самодержа́щийся,спусти́ться1
чуло́чник	marbeiðariмгл-ari, í framleiðslu av sokkum
чуло́чный	adjsokka-
чум	mteltннкс0о, tjaldнпс0о{a/ø}(hjá samum o.ø. norðanfyri)
чума́	fpestж0-ir, pesturмсогл-s,-ir; svartideyðiмгл-i(об эпидемии чумы в Европе в середине XIV в.); африка́нская чума́ свине́й afrikansk [aːfɹiˈkʰaː-] svínasóttж0-ir, , afrikansk [aːfɹiˈkʰaː-] svínapest; лёгочная чума́ lungapest@боя́тьсякого-л.как чумы́skýggjaaðio-nsum pestina
чума́зый	stfчума́з, ~а, ~о, ~ыadjtlm.skitinсоглосн
чума́к	Gen, Accчумак|а́; plur~и́, ~о́в, ~а́мmsøg.bóndi, ið førdi og seldi salt, fisk o.a.(í Ukraina og Suðurrusslandi)
чуми́чка	plurчуми́ч|ки, ~ек, ~кам1.f(ложка) oysaжгл-a2.f, móvkm.(замарашка) ótrivavættiсгл-i; grísurмсогл-ar, svínс0о(грязнуля); skitsúgv [ʃɪʰt-]жнепр(грязнуля,тк о женщине)
чумово́й	adj óvkm.ørurСОГЛпренебр, óðurглí høvdinum [hœtː-]пренебр, svakurСОГЛ{A/Ø}пренебр; прибеежа́л как чумово́й hann kom rennandi sum eitt ørt
Чунци́н	mChongqing [tʃʰɔŋkꞋkʰɪŋk]м0{дат.0}, Chungking [tʃʰʊŋkꞋkʰɪŋk]м0{дат.0}
чупри́на	f1.(прядь) doddurмсогл-ar2.síоселе́дец
чур	inter1.gml.(в заклинаниях и т.п.) ≈ vík frá mær2.(в играх): чур меня́! frí! (í barnaspæli)3.:чур я пе́рвый! hetta er mítt!; eg sá tað fyrst [fɪst]!; чур молча́ть! (tú mást) ikki gretta um tað!; чур не тро́гать! ikki nerta!; то́лько чур, я не пойду́! illanstíð [ɪtl-] fari eg!
чура́ться	ipf Gentlm.síчужда́ться
чурба́к	Genчурбак|а́; ~и́, ~о́в, ~а́мm síчурба́н1
чурба́н	m1.(кусок бревна) stabbiмгл-i, kubbiмгл-i(av viði); høggustabbiмгл-i, blokkurмсогл-ar(для колки дров и т.п.)2.tlm.,illb.(глупый человек) neytс0о, dylhøvd [-hœtː]с0о
чу́рка1	Iplurчу́р|ки, ~ок, ~камf(обрубок дерева) stabbiмгл-i, kubbiмгл-i(av viði)
чу́рка2	IIplurчу́р|ки, ~ок, ~камfóf.(кавказец,житель средней Азии)vanvirðisligt heiti fyri fólk út Kaukasus og Miðasia
чур-чура́	inter síчур2
чу́ткий	stfчу́ток, чутка́, чу́тко, чу́ткиogчутки́;compчу́тчеadj1.(о слухе,нюхе) fínurсогл, góðurгл{+}(um hoyrn,tev); чу́ткое у́хо eitt gott oyra2.(о приборах) følsamurннксогл{a/o}проф.(um instrument); чу́ткие прибо́ры følsomннкпроф.instrument [-Ꞌmε-]3.(к) (отзывчивый) viðkvæmur [vɪʰk-], [viː-]согл{æ/o}; varligurглigur(осмотрительный); umhygginсоглосн, hensynsfullur [hεnsyːnsfʊtl-]ннк(внимательный); чу́ткий на несправедли́вость órættvísi rínur lætt við hann, hann tekur sær órættvísi nær; она́ чутка́ к тре́бованиям вре́мени hon tekur lættliga við tíðarinnar krøvum@чу́ткий сонlætturсогл{æ/ø}svøvnur
чу́тко	adv1.: чу́тко относи́тьсяк кому-л. vera hensynsfullur [hεnsyːnsfʊtl-]ннксоглmóti o-m, hava fyrilitfyri o-m2.: чу́тко спать vera lættsvøvntur [-svœn̊t-]согл
чу́ткость	f1.(о слухе,нюхе) tað at vera fínur, tað at vera góður (hoyrn,tev)2.(чувствительность,о приборе и т.п.) følsamheitннкж0-irпроф.(um instrument o.tíl.)3.(отзывчивость) viðkvæmi [vɪʰk-], [viːkʰ-]сгл-i, følsamheitннкж0-ir; проявля́ть чу́ткостьк кому-л.vísair(t)o-mhensyn [-syːn]ннк
чуто́к	adv tlm. síчу́точку
чу́точка	ftlm.: ни чу́точки ikki eitt vet, ikki minsta vetið
чу́точку	adveitt (lítið) sindur
чу́тче	comp avчу́ткий
чуть	Iadv(едва) valla [-tla], neyvan, neppaннк; eitt sindur (немного); чуть слы́шно tað hoyrist valla, tað hoyrist neyvan; tað er so, tað hoyrist; он говори́л чуть слы́шно tað var ikki meira, enn hann hoyrdist, tá hann tosaði; чуть бо́льше eitt sindur meira, eitt sindur afturat [aꞋtʰɹεat]; чуть живо́й meira deyður enn livandi, hálvdeyður [hɔlt-]IIconjso skjótt sum, beinanvegin; чуть то́лько взошло́ со́лнце, мы отпра́вились в путь so skjótt sólin var komin upp, fóru vit avstað [aꞋstεa]; чуть кто войдёт, услы́шу eg hoyri beinanvegin, um onkur kemur inn; чуть я вошёл, как он на́чал расспра́шивать меня́ eg var nóg illa komin innum [-Ꞌʊmː], tá hann fór at tráspyrja meg@ чуть ли неnærum, næstan; э́то произошло́ чуть ли не в про́шлом году́ hetta mundi henda í fjør; hann viti, um hetta ikki hendi í fjør; eg haldi næstan, hetta hendi í fjør;чуть (ли) не+ sagnorð í pretmundi +суп., líka við; я чуть не упа́л eg mundi dottið, eg var um at detta, eg var líka við at detta;чуть-чутьeitt (pinkulítið [pʰɪʰkːʊ-], [pʰɪŋ̊kʊ-]) sindur, eitt (lítið) vet, eitt sløð;чуть что- он се́рдится tað skal einki til fyri at hann blívur óður; (вы́пить)по чуть-чу́тьóvkm.fáaслнe-i-især ein lítlan =>бы́ло@,светI @
чутьё	n1.(у животных) snoddс0о2.(у человека) sansurмсогл-ar;-ir; име́ть полити́ческое чутьё hann hevur nøsнеформ.fyri politikki [-Ꞌtʰɪ-]; языково́е чутьё málkensla, málsansur; худо́жественное чутьё sansur fyri list; име́ть чутьёк чему-л.hava sansfyri o-m
чухо́нец	Gen, Accчухо́нц|а;plur~ы, ~ев, ~амmgml.russ. navn á estarum og finskum-karelskum fólki nærhendis Sankta Pætursborg
чухо́нка	plurчухо́н|ки, ~ок, ~камfgml.(konufólk)síчухо́нец
чухо́нский	adjgml.estiskurсоглog finskurсогл,síчухо́нец
чу́чело	n1.(воспроизведение животного) útstappað djórс0о(животного); útstappaður fuglurмсогл-ar(птицы)2.(пугало) (fugla)ræða [-rεava]жгл-a, fuglaskrímslс0оeis.fl.=>наби́ть1
чучме́к	móf.vanvirðisligt heiti á fólki, ið ikki er russari, serliga fólki úr Miðasia og Kaukasus
чучхе́	[-хэ́]n indecljuche [tʃʊˈtʃʰeː]ж нескл.(norðurkoreansk ideologi)
чу́шка1	Iplurчу́ш|ки, ~ек, ~камf1.óvkm.(поросёнок) svínс0о, grísurмсогл-ar2.óvkm.(морда свиньи) trýniсгл-iá svíni, rennilм0оснред.(svínstrýni)3.fl., óvkm. (грязный человек) grísurмсогл-ar(skitið fólk)
чу́шка2	IIplurчу́ш|ки, ~ек, ~камf(слиток) (metall)barraжгл-a, kubbiнпмгл-i
чушь	ftlm.tvætlс0о, møsnс0о, svassс0о, vrøvl {vrevl}энкс0о; говори́ть чушь tvætlaaði, møsnaaði, svassaaði, vrøvla {vrevla}энкaði
чу́ять	чу́|ю, ~ешь, ~ютipf(pfпочу́ятьпочу́|ю, ~ешь, ~ют)1.Acc(о животных) kennair(d)snoddav Дат, kennair(d)tevav Дат2.Acctlm.(ощущать,чувствовать) følair(d)Вин, kennair(d)Вин3.что-л.(интуитивно чувствовать,предчувствовать) følair(d)o-tá sær, óraaðio-t, grunaaðio-t; чу́яло моё се́рдце eg havi følt tað á mær, eg havi havt varhuga av tí, eg havi grunað tað =>нога́@
чу́яться	чу́|ется, ~ютсяipfóvkm.følastir(d), kennastir(d); merkjastir(t)(ощущаться)
ЧФ	[че-э́ф] Черномо́рский флот Svartahavsflotinмгл-iопр.
чь…	чьёo.s.fr. síчей
чьё	síчей
чьи	síчей
чья	síчей
