ш.	síшоссе́
ша	interóvkm.nú er nokk!неформ.; nú kann vera well [vεlː]энк!неформ.
шаба́ш	predóvkm.nú er nokk!неформ.; nú kann vera well [vεlː]энк!неформ.
ша́баш1	IGenша́башаogшабаша́mrel.(субботный отдых) sabbatж0-ir, sabbaturмсогл-ar(í jødiskari trúgv)
ша́баш2	IIm1.fólk.(сборище ведьм)náttarfundur hjá trøllkonum, trøllmonnum o.ø.2.tlm.(разгул) ballingж0-ar, ballarí [-Ꞌrʊi]с0о{0<>i}
шаба́шить	шаба́ш|у, ~ишь, ~атipf(pfпошаба́шитьпошаба́ш|у, ~ишь, ~ат)óvkm.(кончать работу) gevastслнa-ó-ivið arbeiðinum; haldaслнe-i-ipausu [pʰausʊ]ннк(делать перерыв)
шаба́шка	plurшаба́ш|ки, ~ек, ~камmóvkm.(левый заработок) svart arbeiðiсгл-i
шаба́шник	móvkm.,atf.o-r, sum arbeiðir svart
шаба́шничать	ipfóvkm.,atf.arbeiðair(d)svart
ша́бер	mskavariмгл-ari
шабло́н	m1.tekn.(образец,приспособление) skabelón [skaːpɪꞋlɔun]ннкж0-irпроф.,skabelónur [skaːpɪꞋlɔu-]ннкмсогл-arпроф.; kúgvжнепрспец.(деревянная форма); по шабло́ну eftir [εʰtː-] skabelóni2.fl.(трафарет,штамп) klisjé [kʰlɪꞋʃeː]энкж0-irпренебр., skabelónur [skaːpɪꞋlɔu-]ннкмсогл-ar; де́йствовать по шабло́ну gangaслнe-i-itroddar gøturидиом., geraнепрeftir [εʰtː-] somu uppskrif{tнеформ.
шабло́нность	ftað at vera banalur [-Ꞌnaː-] (банальный), tað at vera fortugdur [-Ꞌtʰʊ-] (избитый, о высказываниаях и др.), tað at vera klisjékendur [kʰlɪꞋʃeː]энкпренебр.
шабло́нный	stfшабло́н|ен, ~на, ~но, ~ныadj1.bert lftekn.(кшабло́н 1) skabelón- [skaːpɪꞋlɔu-]ннкпроф.,(gjørdur) eftir [εʰtː-] skabelóni [skaːpɪꞋlɔu-]ннкпроф.2.fl.(трафаретный) banalur [-Ꞌnaː-]ннксогл(банальный), fortugdur [-Ꞌtʰʊ-]согл(избитый,о высказываниаях и др.), klisjékendur [kʰlɪꞋʃeː-]энксоглпренебр.; шабло́нная фра́за klisjé [kʰlɪꞋʃeː]энкж0-irпренебр.
шава́рма	f síшау́рма
шаве́рма	f síшау́рма
ша́вка	plurша́в|ки, ~ок, ~камf1.tlm.(о собаке) bastardur [-Ꞌsta-]мсогл-ar(hundur av blandaðum slag)2.fl.,óvkm.,vanv.(о человеке) rópholс0онеодобр., skrólс0онеодобр., munnvargurмсогл-arпренебр.
шаг1	IGenша́га, ша́гу(aftan á tølini tvey, trý og fýraшага́ogша́га),Prpо ша́ге, на {в} шагу́;plurшаг|и́, ~о́в, ~а́мm1.(движение ногой) fetс0о, skrittннкс0о(б.ч. в переносмом смысле), stigс0о{0<>i}(тж в переносном смысле), sporс0об.ч. мн(следы илиперен.), fótafetс0о(часто о звуке); сде́лать шаг вперёд faraслнó-ó-aeitt fet fram; сде́лать {пройти́} не́сколько шаго́в ganga nøkur (fóta)fet; изме́рить шага́ми fetaaði(máta í fótafetum); идти́ кру́пными шага́ми ginaaði; идти́ ме́лкими шага́ми titaaði; приба́вить ша́гу {уско́рить ша́г {уча́стить ша́г}} gangaслнe-i-iskjótari;тжtítta; заме́длить ша́г {уба́вить ша́гу} gangaслнe-i-ispakuligari, saktaaðigonguna; приба́вь ша́гу! skunda tær!; тяжёлые шаги́ tung fótafet; услы́шатьчьи-л.шаги́ hoyrao-nganga, hoyra fótafetinihjá[tʃʰ-]o-m; с ка́ждым ша́гом fyri hvørt fótaspor, fyri hvørt sporið2.(поступок) stigс0о{0<>i}; э́то но́вый шаг вперёд hetta er eitt nýtt stig frameftir [εʰtː-]; сде́лать ва́жный шаг gera eitt umráðandi stig; ло́жный шаг mistakс0о{a/ø}; сде́лать ло́жный шаг gera eitt mistak3.(у брюк и т.п.) klovс0о, gongdж0-ir(á buksum); брю́ки узки́ в шагу́ buksurnar eru for [fɔɹː]ннкtrongar í klovinum, buksurnar eru for [fɔɹː]ннкtrongar í gongdini@отчего-л.дочего-л.оди́н шагfráo-mtilo-ter bara eitt fet;шаг вперёдeitt stig frameftir [-tː-], eitt stig tann rætta vegin;шаг наза́дafturstig [aʰtː-];шаг за ша́гомstig fyri stig;на ка́ждом шагу́ { что ни шаг{шагу́ ступи́ть нельзя́, что́бы не встре́тить}}fyri hvørt spor, fyri hvørt fótafet; allastaðni [atl-]; á hvørjum geilarhorni [-tnɪ]идиом.;в не́скольких шага́х {в двух шага́х}от чего-л.beint viðo-t; он живёт в двух шага́х от шко́лы hann býr eitt hanagleiv frá skúlanum;ни на шаг: он из до́му ни на шаг hann fer ikki út um gáttina;ни ша́гу!rør teg ikki!;не отходи́ть отGenни на шагikki víkjair(t);слнei-i-ifráДат;ни на шаг не отстава́тьот кого-л.veraслнa-ó-eí hølunumá o-m;не отступа́ть ни на шагот чего-л.ikki víkjair(t);слнei-i-ifrá o-m=>гига́нтский@,печа́тать@,семими́льный,ступи́ть@,чека́нить2,широ́кий1
шаг2	IIGenша́га, ша́гу(aftan á tølini tvey, trý og fýraшага́ogша́га),Prpо ша́ге, на {в} шагу́; plurшаг|и́, ~о́в, ~а́мm tekn.:шаг винта́ (воздушного, гребного) skrúvustigningur [-stiːn-]мсогл-arспец.; винт переме́нного ша́га skrúva við umstýringспец., skrúva við vendbarum bløðumспец.
шаг3	IIIGenша́га, ша́гу(aftan á tølini tvey, trý og fýraшага́ogша́га),Prpо ша́ге, на {в} шагу́; plurшаг|и́, ~о́в, ~а́мm fisk.:шаг ячеи́ leggurсогл-ir(á meski)
шага́ть	ipf1.(идти) gangaслнe-i-i; широко́ шага́ть ginaaði, fetaaði, gleivaaði(stíga stórum), stígaслнei-i-istórum; он беспоко́йно шага́л по комна́те hann gekk óróliga [-Ꞌrɔu-] aftur [aʰtː-] og fram í verilsinumннк2.через что-л.(переступать) gleivaaðitvørtur um o-t; шага́ть че́рез две ступе́ньки taka tvey (trappu)trin í senn
шага́ющий	Iparticшага́тьIIadjtekn.: шага́ющий экскава́тор gravimaskina á beinum, eiturkoppurмсогл-arжарг.
шаги́стика	fatf.marsjvenjingж0-ar(ið verður gjørd fram um aðrar meira týðandi venjingar)
шагну́ть	moment(ipfшага́ть) geraнепрeitt fet@далеко́ шагну́тьgeraнепрstór framstig
ша́гом	adv1.(не бегом): идти́ ша́гом ganga (í mótsetning tilrenna); он пошёл ша́гом hann fór til gongu; ша́гом марш! (команда) framá [fɹamːɔa] marsj!; ша́гом! (команда) gongd!; на ме́сте ша́гом марш! marsj á staðnum!2.(аллюром) í feti (um ríðing o.a.); он е́хал ша́гом hann reið í feti; ло́шадь пошла́ ша́гом rossið gekk í feti3.(медленно) spakuliga (seint); е́хать ша́гом koyra spakuliga
шагоме́р	mfetmátariмгл-ari, fetteljariмгл-ari
шагре́нь	fchagrin [ʃaꞋkɹεŋk]с0о(leður)
шажко́м	advtritlandi, trippandiннк
шажо́к	Genшажк|а́;plur~и́, ~о́в, ~амm dim tilшаг 1
ша́йба	f1.tekn.(плоское колцьо) skivaжгл-a(í ym. týdn.)2.ítr.(в хоккее) pukkurмсогл-ar(í íshockey); забро́сить ша́йбу geraнепрmál, skoraaði(í íshockey); ша́йбу! kom nú!; koyrið á! (í íshockey)
ша́йка1	Iplurша́йки, ша́ек, ша́йкамf(банда) bandiмгл-i, harkaliðс0о{0<>i}
ша́йка2	IIplurша́йки, ша́ек, ша́йкамf(для мытья) (vaski)baljaжгл-a
шайта́н	m1.rel.(дьявол) d(j)evilм0осн, fjandiмгл-i(í islam)2.óvkm.(бранное) d(j)evilм0осн, faniмгл-i; шайта́н тебя́ побери́! fanin turki!; fanin brenni!
шака́л	m(Canis aureus) sjakalur [ʃaꞋkʰaː-]мсогл-ar, sjakálur [ʃaꞋkʰɔaː-]лпмсогл-arтжперен.
шала́ва	fillb. merж0-arпренебр.,horaжгл-aпренебр., грубо
шала́нда	f1.(вид баржи) (lítil) prámurмсогл-ar2.(рыболовная) flatbotnaður útróðrarbáturмсогл-ar(við Svartahavið)
шала́ш	Genшалаш|а́;plur~и́, ~е́й, ~а́мmleyvsmáttaжгл-a, greinasmáttaжгл-a
ша́левый	adj: ша́левый воротни́к sjalskragi
шале́ть	ipf(pfошале́ть)tlm.blíva ørurсогл, blíva óðurглí høvdinum [hœtː-]
шали́ть	шал|ю́, ~и́шь, ~я́тipf1.(баловаться) spælair(d)sær, geraнепрskálkabrøgd; skikkaaðisær illa [ɪtla], vera óskikkiligur [-Ꞌʃɪ-]глigur(вести себя плохо); gartera [-Ꞌtʰeː-]aði, gartaaði, beistastaði(резвиться); не шали́! ver nú ordiligur!; skikka tær nú væl!2.bert 3. pers brúkturtlm.(плохо работать) veraслнa-ó-oí ólagi, virkaaðiilla [ɪtla]; мои́ часы́ шаля́т okkurt er galið við urinum hjá mær; здоро́вье что-то шали́т heilsan er farin at bila3.gml.,tlm.(грабить,разбойничать) røvaaði, rænair(d); здесь шаля́т ≈ her er vandi á ferð4.: шали́шь nei, hin gamli; nei, mangt kanst tú billa [-tla] mær inn; tú lýgur; меня́ не проведёшь, шали́шь! tvætl, meg lumpar tú ikki!
шалма́н	móvkm.bulaжгл-aнеодобр.(vertshús)
шаловли́вость	f(веселие) kætiсгл-i; skálkheitж0-ir(проделка)
шаловли́вый	stfшаловли́в, ~а, ~о, ~ыadj1.(склонный к шалостям) villur [-tl-]согл, ovurkáturсогл, ovfarakátur [ɔfːa-]согл; bannsetturсогл; káturсогл(весёлый)2.(игривый) skálkaligurглigur; шаловли́вая улы́бка skálkabros
шалопа́й	mletivættiсгл-i, letingurмсогл-ar, letingiмгл-i
шалопа́йничать	ipf tlm. dovnastaði, letasaðit, gangae-i-i-Ifyri einki
шалопу́тный	stfшалопу́т|ен, ~на, ~но, ~ныadj óvkm.ørvitisligurглigur, forstýraður [-Ꞌstʊi]энкглaðurпренебр.; tankaleysur [tʰaŋ̊k-]согл(легкомысленный); sum lítið skil er í (бестолковый,безалаберный)
ша́лость	fskálkabragdс0о{a/ø}, pussс0о; де́тская ша́лость óvitalótirж0-irмн
шалу́н	mkúllurмсогл-ar, jassurмсогл-ar, gavstrikkur [kafs-]энкмсогл-ar; forherðingur [-Ꞌheː-]мсогл-ar(проказник,разбойник);
шалу́нья	mkúllurмсогл-ar, jassurмсогл-ar, gavstrikkur [kafs-]энкмсогл-ar; forherðingur [-Ꞌheː-]мсогл-ar(проказник,разбойник) (genta)
шалфе́й	m(Salvia) salviaжгл-a
ша́лый	stFшал, ~а, ~о, ~ыadj, óvkm.1. (сумасбродный) óðurглí høvdinum [hœtː-]пренебр., svakurсогл{a/ø}пренебр.2.(случайный) tilvildarligurглigur, tilfallandi [-tl-]глandiкн., óvart áberandiкн., tilfeldigur [-Ꞌfε-]ннкглigur; hendiligurглigur; (;(непостоянный)skiftandiглandi, óstøðugurглugur; umleypandiглandi(о погоде,ветре)
шаль	fsjal [ʃalː] (тж[ʃεal])с0о, sjálс0окн.; воротни́к ша́лью sjalskragi
шально́й	adj1.(сумасбродный) óðurглí høvdinum [hœtː-]пренебр., svakurсогл{a/ø}пренебр.2.(безрассудный) ørvitisligurглigur, ørvitis-; шально́й посту́пок о́ðamannaverkс0о@шальна́я пу́ляóvart áberandi kúla;шальна́я голова́ørvitisknokkur;шальны́е де́ньгиlætttjentir pengar
шаля́й-валя́й	adv óvkm.sum best ber til. onkursvegna
шама́н	msjamanur {shamanur} [ʃaꞋmaː-]мсогл-ar
шамани́зм	msjamanisma {shamanisma} [ʃaːmaꞋnɪ-]жгл-a
шама́нить	шама́н|ю, ~ишь, ~ятipfvera sjamanur {shamanur} [ʃaꞋmaː-], fást við sjamanismu {shamanismu} [ʃaːmaꞋnɪ-]
шама́нство	n1.(деятельность шамана)gandur o.a. virksemi hjá sjamani2.síшамани́зм
Ша́мбала	f rel.Shambhala [ʃampala]с нескл
ша́мкать	ipf(pfпроша́мкать) (говорить невнятно) balla [-tla]aði, bulla [-tla]aði(mest um tannleys fólk); lespaaði(говорить пришепётывая)
шамо́т	mchamotte [ʃaˈmɔʰtːɪ]сгл-i
шампа́нское	nsjampanja {champagna} [ʃamꞋpʰaɲja]жгл-a, kampavínлпс0о@кто не риску́ет, тот не пьёт шампа́нскогоorðt.,skemt.vágin vinnurпог.
шампиньо́н	m(Agaricus) champignon {sjampinjong} [ʃam̊pɪɲjɔŋk]ж0-ir;м0-ar{0<>i}; kampasoppurмсогл-arбот.
шампу́нь	mshampoo {sjampo} [ʃam̊po]с0гл(-inum){0<>i}
шампу́р	mspritaжгл-a(at steikja kjøtbitar o.a. á), (steiki)teinurмсогл-ar, sneisж0-ar(at steikja kjøtbitar o.a. á)
ша́нец	Genша́нц|а; ~ы, ~ев, ~амmtlm.,skemt.шанс
шанкр	mchanker [ʃaŋ̊kεɹ]м0-ar{дат.0}мед.; мя́гкий ша́нкр bleytur chanker; твёрдый ша́нкр harður chanker
шанс	mkjansurмсогл-s,-ir; ша́нсына что-л.kjansirfyri o-m; име́ть все ша́нсы hava góðar kjansir; нет никаки́х ша́нсов har eru eingir kjansir; нет ни мале́йшего ша́нса har er ikki ein kjansur; ша́нсы 1 про́тив 10 kjansirnir eru ein móti tíggju
шансо́н	m1.(французская песня) chanson [ʃanˈsɔŋk]мсогл-s,-ir2.(эстрадная песня) vísaжгл-a, sangur [saŋg-]мсогл-s,-ir
шансоне́тка	plurшансоне́т|ки, ~ок, ~камf1.(песня) vísaжгл-a(sangur)2.(певица) vísusangarinna [-saŋkaɹɪnta]жгл-a
шансонье́	m indeclvísusangari [-saŋk-]мгл-ari
шанта́ж	Genшантажа́mavpressingннкж0-ar, útpressingннкж0-ar; pengaavpressingннкж0-ar, penganoyðslaнпжгл-aпубл.(с целью получения денег)
шантажи́ровать	шантажи́ру|ю, ~ешь, ~ютipf AccavpressaннкaðiВин; hóttair(t)Вин til o-t(угрозами заставлять)
шантажи́ст	mavpressariннкмгл-ari; pengaavpressariннкмгл-ari, penganoyðariлпмгл-ari(с целью получения денег)
шантрапа́	f, m óvkm., illb.óvættiсгл-i;eis. kollpakkс0опрезр., harkaliðс0о{0<>i}, partaníggjс0о{0<>i}пренебр.
Шанха́й1	ImShanghai [ʃaŋkꞋhai]м0{дат.0}
шанха́й2	IImtlm., skemt.(об окраинном посёлке)slumm í útjaðri í býi
ша́пка	plurша́п|ки, ~ок, ~камf1.(головной убор) húgvaжгл-a; без ша́пки hattleysurсогл; в ша́пке í húgvu; мехова́я ша́пка pelshúgva, skinnhúgva2.fl.(то, что покрывает что-л.) kollur [-tl-]мсогл-ar; ша́пка воло́с stórt hár; ледо́вая ша́пка ískollur; сне́жная ша́пка kavafonn (t.d. ovast á fjalli); ша́пка пе́ны на молоке́ froða [fɹuːwa]жгл-aoman á mjólkini3.(заголовок) fleirteigað yvirskriftж0-ir@лома́ть ша́пкуперед кому-л.gml.. tlm.bukkaaðifyri o-m;датькому-л.по ша́пкеa) sláaслнó-ó-io-n; b) (прогнать, уволить) gevaслнa-ó-io-msekkin; получи́ть по ша́пкеóvkm.а) (получить нагоняй) fáaслнe-i-iꞋ av at vita; b) (быть уволенным) fáaслнe-i-isekkinнеформ.;ша́пками закида́тьkláraaðisum ein royk =>вор@,невиди́мка@
шапова́л	mgml.hattamakariмгл-ari
ша́почка	plurша́поч|ки, ~ек, ~камf dim avша́пка@Кра́сная Ша́почкаReyðhettaжгл-a
ша́почник	[-шн-]mhattamakariмгл-ari
ша́почный	[-шн-]adjhúgvu-@ша́почное знако́мствоleysligur [lεsl-] kennskapur; у меня́ с ним ша́почное знако́мство vit kennast leysliga;прийти́ к ша́почному разбо́руtilt.≈ liggjaслнá-ó-isjóvarfallið [-tl-] av særпог.
шар	Genша́ра(aftan á 2,3, og 4 Genшара́);plurшар|ы́, ~о́в, ~а́мm1.(предмет) kúlaжгл-a; возду́шный шар luftballón [-palɔun]ж0-ir2.pluróvkm.(глаза) eygurсгл-aмн@выпуска́тьпро́бный шарroynair(d)at skatta dýpið frammanundan;хоть шаро́м покати́tilt. tlm.tey eiga ikki matartugguna =>земно́й1
шараба́н	m charabanc [ʃaːɹaˈpaŋk]м0-ar
шара́га	f1.sovjet., jarg.(конструкторское бюро тюремного режима) teknistova [tʰεknɪ-]жгл-a(í fongsli, legu o.a.)2.(жульническое предприятие) svindilfyritøkaжгл-aнеодобр., fuppfyritøkaжгл-aнеодобр.3.(предприятие и др., занимающееся чем-л. ненужным)fyritøka, ið fæst við óneyðugt arbeiði
шара́да	forðagátaжгл-a, stavingargátaжгл-a
шара́хать	ipf síшара́хнуть
шара́хаться	ipf1.síшара́хнуться2.от кого-л.fl.(сторониться) skýggjaaðio-n; шара́хатьсяот кого-л.как от чумы́ skýggjao-nsum hin versta [vεsta]3.fl.: шара́хаться из одно́й кра́йности в другу́ю fara frá einum ekstremi [-Ꞌstɹe-ː]ннкtil annan
шара́хнуть	шара́хн|у, ~ешь, ~утpf(ipfшара́хать)óvkm.1.(швырнуть) sleingjair(d)Вин; шара́хнуть ка́мнем в забо́р hirðaaðiein stein móti garðinum, ripaaðiein stein móti garðinum2.(ударить) sláaслнó-ó-iВин; шара́хнутького-л.lammaaðitil o-n
шара́хнуться	шара́хн|усь, ~ешься, ~утсяpf(ipfшара́хаться)1.(неожиданно тронуться с места и т.п.) brennair(d) +доп., faraслнó-ó-aí skundi; шара́хнуться наза́д støkkaслнa{ø}-u-oaftur [aʰtː-] eftir[εʰtː-] hæli; шара́хнуться в сто́рону leypaслнey-u-otil viks ; (о лошади)eis.blíva styggurсогл(um ross)2.(броситься) tuskaaði, tvísporaaði, stórleypaслнey-u-o; tveitair(t)seg3.(удариться) rennair(d)seg ímóti [-Ꞌmɔu-], smekkaaðiseg í; шара́хнутьсяобо что-л.renna segímóti o-m, smekka segí o-t; шара́хнуться голово́й в шкаф sláaслнó-ó-ihøvdið [hœtːɪ] móti skápinum
шара́шка	plurшара́ш|ки, ~ек, ~камf1.(неофициальный заработок) lønж0-ir(sum ikki er almenn)2.síшара́га1
шара́шкин	adj: шара́шкина конто́раóvkm., niðr.fuppfyritøkaжгл-aнеодобр., svindilfyritøkaжгл-aнеодобр.
шарж	mskemtitekning [-tʰεkn-]ж0-ar, karikaturur [kʰaːɹikaꞋtʰuː-]интмсогл-ar
шаржи́ровать	шаржи́ру|ю, ~ешь, ~ютipf Аccgeraнепрskemtitekningav Дат, karikera [kʰaːɹiꞋkʰeː-]aðiВин
шариа́т	msharia [ʃaːɹia]с нескл.
шариа́тский	adjeftir [εʰtː-] sharia [ʃaːɹia-], sambært sharia [ʃaːɹia-], sharia- [ʃaːɹia-] (síшариа́т)
шарива́ри	n indecl.1.gml.(пение) kattamusikkurмсогл-arпренебр.; levindс0о(гам); goragangurмсогл-s,-ir(кутерьма); spektakkul [spetʰaʰkː-]с0осннеформ.(галдёж)2.(номер в цирке)serligt slag av akrobatikknummari í sirkus
ша́рик	m dim avшар@бе́лые кровяны́е ша́рикиhvít blóðlikamннкс0омнпроф., hvítir blóðkropparнпмсогл-arмн, hvít blóðkorn [-tn]нпс0омн;кра́сные кровяны́е ша́рикиreyð blóðlikamннкс0омнпроф., reyðir blóðkropparнпмсогл-arмн, reyð blóðkorn [-tn]с0омн;у него́ ша́риков не хвата́етóvkm.har er lágt millum syllar(nar) [-tl-]пог.,шутл., hann hevur lítið til
ша́риковый	adjkúlu-; ша́риковы́й подши́пникsíшарикоподши́пник=>подши́пник,ру́чка4
шарикоподши́пник	mkúluleigiннксгл-iпроф., kúlulega [-leːva]нпжгл-a, knattlega [-leːva]лпжгл-a
ша́рить	ша́р|ю, ~ишь, ~ятipf1.(искать ощупью) trilvaaði2.(искать) leitaaði
ша́рканье	nskavanж0-ir
ша́ркать	ipf(momentша́ркнутьша́ркн|у, ~ешь, ~ут)1.(производить шорох) skavaaði; идти́, ша́ркая нога́ми dragaслнó-ó-iføturnar; сапоги́ ша́ркали tað skróvaði í stivlunum; он ша́ркал ту́флями hann skavaði við skónum2.: ша́ркать но́жкой {ного́й}gml.sláaслнó-ó-ihælarnar saman3.óvkm.Acc(ударять) sláaслнó-ó-iВин, lammaaðitil Вин(сильнее)
ша́ркнуть	moment síша́ркать
шарлата́н	mcharlatanur {sjarlatanur} [ʃaɹlaꞋtʰaː-]интмсогл-ar
шарлата́нство	ncharlatanarí {sjarlatanarí} [ʃaɹlatʰaːnaꞋrʊi]интс0о
шарло́тка	plurшарло́т|ки, ~ок, ~камfcharlottekøka [ʃaɹˈlɔ-]жгл-a
шарм	m sjarma {charma [ʃa-]}жгл-a
шарма́нка	plurшарма́н|ка, ~ки, ~окflirukassiмгл-i; игра́ть на шарма́нке spæla á lirukassa@завести́ шарма́нкуkomaслнo-o-ovið tí sama gamla sjangrinum
шарма́нщик	mlirukassamaðurмнепр
шарни́р	mliðurмсогл-s,-ir=>шарово́й
шарова́ры	шарова́р, ~амf plurvíðar buksurжгл-aдистр(brøkurnar samanryktar í neðra,brúktar t.d. í eystanlondum)
шарови́дный	stfшарови́д|ен, ~на, ~ныadjkúluskapaðurглaður
шарово́й	adjkúlu-; шарово́й кла́пан kúluventilur; шарова́я мо́лния kúlusnarljós [-snaɹ-]; шарово́й шарни́р kúluliður
шароголо́вый	adj síдельфи́н
шаромы́га	f, móvkm.snultariмгл-ari, snultigesturмсогл-s,-ir
шаромы́жник	móvkm.snultariмгл-ari, snultigesturмсогл-s,-ir
шарообра́зный	stfшарообра́з|ен, ~на, ~ныadj síшарови́дный
шарф	m(háls)turriklæðiсгл-i, (háls)turrklæðiсгл-i(б.ч. склоняется по произношению[tʰʊɹklεa]с0о{a/ø}{0<>i}), hálsklúturмсогл-arуст.
шасси́	n indecl(автомобиля) undirstellс0о(á bili); landingsstellс0о(á flogfari) (самолёта); berandi rammaжгл-a(á radiomóttakara) (радиоприёмника); колесо́ шасси́ (самолёта) landingshjul [-juːl]ннкпроф.с0о, lendingarhjól [-tʃʰɔul]нпс0о
ша́стать	ipfóvkm.,atf.gangaслнe-i-iog malaслнó-ó-a, gangaслнe-i-iog dreivaaði
шата́ние	n1.(действие) riðanж0-ir, vagganж0-ir2.fl.(колебание) vinglс0о, vingulс0осн
шата́ть	ipf(momentшатну́тьшатн|у́, ~ёшь, ~у́т)Acc1.(раскачивать) riðaaðiВин; vaggaaðiДат; ristair(t)Дат(трясти); шата́ть столб riða pelan; ваго́н шата́ло (из стороны́ в сто́рону)ópvognurin slongdist2.: его́ шата́етóphann sløðraraði, hann vinglaraði
шата́ться	ipf(momentшатну́тьсяшатн|у́сь, ~ёшься, ~у́тся)1.(качаться) ridlaaði; vaggaaði, sveiggjaði; skinklaaði; (um tonn, nagla o.a.) vera leysur (о зубе, гвозде и т.п.); skinklaaði; стул шата́ется stólurin skinklar; болт шата́ется bolturin er leysur2.(при ходьбе) sløðraaði, vinglaaði3.fl.(колебаться) vinglaaði(draga á bæði)4.(слоняться) malaслнó-ó-aaftur [aʰtː-] og fram, rekastслнa-ó-i
шате́н	[-тэ́н]mmannfólkс0оvið ljóst brúnum hári, mannfólkс0оvið jørpumкн.hári; он шате́н hann er brúnhærdur, hann hevur jarpt [jaɹ̥t]кн.hár
шате́нка	[-тэ́н]plurшате́н|ки, ~ок, ~камfkonufólkс0о(ljóst) brúnum hári, konfólkс0оvið jørpum hári; она́ шате́нка hon er brúnhærd, hon hevur jarpt [jaɹ̥t]кнhár
шатёр	Genшатр|а́;plur~ы́, ~о́в, ~а́мm1.(палатка) (stórt) teltннкс0о, (stórt) tjaldнпс0о{a/ø}2.arkit.(крыша)pyramiduskapað tak við fýra ella fleiri síðum(í russ. bygging 16.-18. øld)
ша́тия	fóvkm.pakkс0опрезр., harkaliðс0о{0<>i}, partaníggjс0о{0<>i}пренебр.
ша́ткий	stfша́т|ок, ~ка, ~ко, ~киadj1.(неустойчивый,шатающий) óstøðugurглugur, ridluturсогл, óstútturсогл, skinkluturсогл; ша́ткий стул skinklutur stólur; ша́ткие шаги́ óstútt gongulag, sløðrut gongulag2.(ненадёжный) svikaligurглigur, vøkkultтк с; ша́ткое основа́ние svikaligt grundarlag, vøkkult grundarlag; ша́ткое положе́ние ein svikalig støða, ein ótrygg støða; ша́ткое здоро́вье ring heilsa; ша́ткое доказа́тельство ivasamt prógv
ша́тко	adv avша́ткий@ни ша́тко ни ва́лкоtilt.(so) nøkulunda, so dánt; де́ло идёт ни ша́тко ни ва́лко tað gongur so nøkulunda, tað gongur so dánt
шатну́ть	moment síшата́ть
шатну́ться	moment síшата́ться
шатро́вый	adj1.(кшатёр 1) telt-ннк, tjald-нп2.(кшатёр 2)dánaður sum pyramida,síшатёр2
шаттл	m1.(косми\ескийкорабль) rúmdarferjaжгл-a2.(танспортное средство)shuttlebussur [ʃɔʰtːɪl-]мсогл-ar
шату́н	Genшатун|а́;plur~ы́, ~о́в, ~а́мmpleylstongж0-ur{o/e}
шау́рма	fshawarma [ʃaꞋva-]ж нескл.;с нескл.
ша́фер	plurшафер|а́, ~о́в, ~а́мm≈ brúðmaður [pɹʏm-]мнепр(sum undir vígslu í russ. ortodoksari kirkju heldur ein krans yvir høvdinum á brúður ella brúðgómi)
шафра́н	m1.plant.(Crocus sativus) safranlilja [saꞋfɹaːn-]жгл-a2.(пряность) safran [saꞋfɹaːn]с0о
шафра́нный	adjsafran- [saꞋfɹaːn-]; safrangulur [saꞋfɹaːn-]согл(о цвете)
шафра́новый	adj síшафра́нный
шах1	Im(титул) shahur [ʃaːʊɹ]мсогл-ar
шах2	IImtalvskákс0о; шах! skák!; шах королю́ kongurin er skákaður; объяви́ть шах skákaaði; под ша́хом skák; ве́чный шах ævigt skák; шах и мат skák og mát
ша́хер-ма́хер	m mest plurtlm.,atf.rossahandilм0осн; sovorðið, sum ikki tolir dagsins ljós; sovorðið, sum fer fram í skúmaskotum
шахи́д	msjálvmorðsbumbari [ʃɔlm-]мгл-ari=>по́яс1
шахи́дка	plurшахи́д|ки, ~ок, ~камfsjálvmorðsbumbariмгл-ari(konufólk),síшахи́д
шахи́ня	fdrotningж0-ar(kona shah)
шахмати́ст	mtelvariмгл-ari
шахмати́стка	plurшахмати́ст|ки, ~ок, ~камftelvariмгл-ari(konufólk)
ша́хматный	adjtalv-; ша́хматная зада́ча talvuppgáva; ша́хматная па́ртия talvс0о; ша́хматные фигу́ры talvfólkс0омн; ша́хматная олимпиа́да talvolympiada [-olym̊piaːta]; ша́хматный сто́лик borð at telva á; ша́хматный ход leikur (í talvi)@быть располо́женнымв ша́хматномпоря́дкеvera puntuturсогл(sum talvborð), vera sum eitt talvborð =>доска́2
ша́хматы	f plur1.(игра) talvс0о; игра́ть в ша́хматы telvaaði2.(фигуры) talvfólkс0омн=>хорошо́I
ша́хта	f1.(место подземной добычи) minaннкжгл-aпроф., námнпс0о; каменноуго́льная ша́хта kolaminaннкпроф., kolanámнп2.(удлиннённая полость) skaktж0-irспец.; ша́хта турби́ны turbinuskakt [-Ꞌpiː-]спец; ша́хта ли́фта elevatorskakt [-Ꞌvaː-] спец.; ша́хта для вы́борки я́русаfisk.dragibrunnurмсогл-arмор., moon-pool [muːnpʰuːl]м0-arмор.
ша́хтенный	adjminu-ннкпроф., náms-нп
шахтёр	mminuarbeiðariннкмгл-ari, námsarbeiðariнпмгл-ari, námsarbeiðsmaðurнпмнепр; kolamaðurмнепр(в каменноугольной шахте)
шахтёрский	minu-ннкпроф., náms-нп; minuarbeiðara-ннк, námsarbeiðara-нп; шахтёрский труд arbeiði í minum, arbeiði í námum; шахтёрская жизнь lívið hjá [tʃʰ-] minuarbeiðarum, lívið hjá [tʃʰ-] námsarbeiðarum
ша́хтный	adj1.(кша́хта 1) minu-ннкпроф ., náms-нп2.(кша́хта 1) skakt-спец.
ша́шечка	f: в ша́шечку rútamynstraðurглaður, rútuturсогл
ша́шечница	1.(доска) dammbrettiсгл-i2.(коробка) eskjaжгл-аtil dammfólk
ша́шечный	adjdamm-; ша́шечная доска́ dammborð
шаши́ст	mdammspælariмгл-ari
ша́шка1	Iplurша́ш|ки, ~ек, ~камf1.plur(игра) dammс0о; игра́ть в ша́шки spæla damm2.(фигуры) dammfólkс0о; dammspælс0о{æ/ø}(фигуры с доской)@в ша́шку {ша́шкой}rútuturсогл, puntuturсогл(sum talvborð)
ша́шка2	IIplurша́ш|ки, ~ек, ~камf: дымова́я ша́шка roykbumba; подрывна́я ша́шка dynamittpatrón [tyːnaꞋmɪʰt-]
ша́шка3	IIIplurша́ш|ки, ~ек, ~камf(сабля) sápilм0осн
шашлы́к	Genшашлык|а́;plur~и́, ~о́в, ~а́мm spritustokt lambskjøt
шашлы́чная	f sølubúð, har spritustokt lambskjøt verður selt(síшашлы́к)
ша́шни	ша́шн|ей, ~ямm pluróvkm.,atf.1.(козни) ráð с0омн(ráðagerð), ráðagerðж0-ir, loynibrøgd с0о{a/ø}мнкн., loyniráð с0о{0<>i}мнкн.2.(любовные) fríggj с0о{0<>i}, fjas с0о, kærleiksævintýrннкс0о; завести́ ша́шнис кем-л.faraслнó-ó-aat fjasastvið o-n(fríggja)
шва́бра	fmoppaжгл-a, vaskikusturмсогл-ar, dveylurмсогл-arмор.
шваль	fóvkm,atf..1.(о людях)eis. kollpakk с0о, harkalið с0о{0<>i}2.(хлам) rusl с0о, rusk с0о, skrambulс0осн
шва́льня	plurшва́льни, шва́лен, шва́льнямf gml.skraddaraverkstað (тж[-vεʂta])с0о{a/ø}{0<>i}; seymistovaжгл-a
шварто́в	mfortoyning [-Ꞌtʰœi-]ннкж0-arпроф., endiмгл-i, trossiмгл-i(at fortoya við); sabburмсогл-ar; сня́ться со шварто́вов loysair(t)
швартова́ть	шварту́|ю, ~ешь, ~ютipf(pfпришвартова́тьпришварту́|ю, ~ешь, ~ют, ошвартова́тьошварту́|ю, ~ешь, ~ют)что-л.fortoya [-Ꞌtʰœija]aðio-t, bindaслнa-u-uo-t(skip)
швартова́ться	ipf(pfпришвартова́тьсяпришварту́|юсь, ~ешься, ~ются, ошвартова́тьсяошварту́|юсь, ~ешься, ~ются) leggjaнепрꞋ at (skip), fortoya [-Ꞌtʰœija]aðiмор.
шварто́вка	plurшварто́в|ки, ~ок, ~камf(действие) fortoyning [-Ꞌtʰœi-]ннкж0-arпроф., tað at leggja at; ме́сто шварто́вки fortoyningspláss [-Ꞌtʰœi-]ннкпроф.
шварто́вный	adjfortoynings- [-Ꞌtʰœi-]ннкпроф.=>щит2
швах	pred tlm.1.(несведущ): в матема́тике он швах hann er ikki stinnur í matematikk [maːtɪmaꞋtʰɪʰkː], hann dugir lítið í matematikk [maːtɪmaꞋtʰɪʰkː], hann dugir illa [ɪtla] í matematikk [maːtɪmaꞋtʰɪʰkː]2.(плохо): де́ло швах her stendur ikki væl til; с бензи́ном швах tað stendur illa [ɪtla] til við bensini [-ˈsiː-]; бензи́ном швах
швед	msvenskariмгл-ari, sviiмгл-iкн., svíiмгл-iкн.,выс.
шве́дка	plurшве́д|ки, ~ок, ~камfsvenskariмгл-ari, sviiмгл-iкн., svíiмгл-iкн.,выс.(konufólk)
шве́дский	adjsvenskurсоглnsk; шве́дский язы́к svenskt [svεŋ̊kst]сприлskt@шве́дский столtað kalda borðið =>сте́нка5
шве́йник	marbeiðariмгл-arií klædnaidnaðinum
шве́йный	adjseymi-; шве́йная игла́ seyminál; шве́йная маши́на seymimaskina; шве́йная промы́шленность klædnaídnaður; шве́йная фа́брика klædnavirki
швейца́р	mportier [pʰɔɹ̥Ꞌtʰjeː]мгл-гл(в гостинице); duravaktariмгл-ari, duravørðurмсогл-ir{ø/a}офиц.(в кафе, ресторане); portnariмгл-ari(в доме)
швейца́рец	Gen, Accшвейца́р|ца;plur~цы, ~цев, ~цамmschweizari [svais-] {sveisari}мгл-ari
Швейца́рия	fSchweiz [svais]с0{дат.0}, Sveisс0{дат.0}
швейца́рка	plurшвейца́р|ки, ~ок, ~камfschweizari [svais-] {sveisari}мгл-ari(konufólk)
швейца́рская	fportnararúmс0о
швейца́рский1	Iadj(кШвейца́рия) schweiziskur [svais-]соглsk, sveisiskurсоглsk
швейца́рский2	IIadj(кшвейца́р) portier- [pʰɔɹ̥Ꞌtʰjeː-]; duravaktara-, duravarðar-; portnara-;sí eis.швейца́р
шве́ллерный	adj: шве́ллерное желе́зо kanalstál [-Ꞌnaːl-], U-jarn [-tn]
швертбо́т	mseglbáturмсогл-arvið søkkkjøli
швец	Gen, Accшвец|а́;plur~ы́, ~о́в, ~а́мmgml.skraddariмгл-ari@и швец, и жнец, и в дуду́ {на дуде́} игре́цorðt.allahandamaður [alːanta-]мнепр; túsundkunstnari [tʰʉusɪnk-]мгл-ari
Шве́ция	fSvøríkiсгл-i, Sviaríkiсгл-iкн.,ред.
швея́	f1.gml.(портниха) syirska [syːɪ-]ннкжгл-a, seymikonaжгл-a2.(работница) seymigentaжгл-a(á fabrikk o.a.)
шво́рень	Genшво́рн|я;plur~и, ~ей, ~ямm síшкво́рень
шво́рка	plurшво́р|ки, ~ок, ~камffisk.leysingж0-arрыб.(tað at leysa)
швырну́ть	швырн|у́, ~ёшь, ~у́тmoment(ipfшвыря́ть)АccblakaaðiВин, tveitair(t)Вин; hivaaðiВин(бросить); sendair(d)Вин, ripaaðiВин, sipaaðiВин(с силой); hirðair(d)Вин, grýtair(t)Вин(камни, а тж. вообще); швырну́ть ка́мень (в кого-л.;во что-л.) steinaaðiВин, kastaaðigróteftir[εʰtː-]Дат, grýta gróteftir[εʰtː-]Дат; швырну́ть снежки́ {снежка́ми}в кого-л.blaka kavabløkeftir[εʰtː-]o-m; швырну́тькому-л. что-л.blakao-m o-t; маши́ну швырну́ло в сто́ронуópbilurin bleiv tveittur til síðuna
швыро́к	Genшвырока́; plurшвырок|и́. ~о́в, ~а́мm1.tlm. (движение) kastс0o{a/ø}, tað at balka2.fakm.(дрова) pinnabrenniсгл-i(stutt pettir)
швыря́ть	ipf Acc,чем-л. síшвырну́ть; судьба́ его́ швыря́ла {ópего́ швы́ряло} из го́рода в го́род lagnan rak hann úr einum býi í annan; нас швыря́ло в ваго́не из стороны́ в сто́ронуópvit blivu slongd aftur [aʰtː-] og fram inni í vogninum; швыря́ть камня́мив AccsteinaaðiВин, kastaaðigróteftir[εʰtː-]Дат, grýta gróteftir[εʰtː-]Дат; ло́дку швыря́ло из стороны́ в сто́ронуópbáturin kastaðist á ymsar kjálkar; кора́бль швыря́лоópskipið lá og kjálkaðist@швыря́ть деньга́миblakaaðium seg við pengum
швыря́ться	ipf1.чем-л.: швыря́ться снежка́ми kastaaðikavabløk; швыря́ться камня́ми steinaaði, blakaaðigrót2.Ins(щедро раздавать;растрачивать) oyðslaaðiВин, blakaaðium seg viðДат; швыря́тся обеща́ниями blaka um set við lyftum; швыря́ться людьми́ oyðsla við fólki
шевели́ть	шевел|ю́, ~и́шь, ~я́тogшеве́л|ишь, ~ятipf1.moment(по)шевельну́тьчто-л.(трогая,проводить в движение) rørair(d)o-t, beveka [-Ꞌveː-]ннкaðio-t; шевели́ть се́но vendair(d)hoyggi2.чем-л.(слегка двигать) látaслнæ-ó-avið o-m, rørair(d)o-t; шевели́ть губа́ми láta við varrunum; шевели́ть руко́й røra hondina, beveka [-Ꞌveː-]ннкhondina =>мозг@
шевели́ться	шевел|ю́сь, ~и́шься, ~я́тсяogшеве́л|ишься, ~ятсяipf(momentшевельну́тьсяшевельн|у́сь, ~ёшься, ~у́тся,pfпошевельну́тьсяпошевельн|у́сь, ~ёшься, ~у́тся) rørair(d)seg, beveka [-Ꞌveː-]ннкaðiseg,; он лежа́л и не шевели́лся hann lá og rørdi seg ikki; стой и не шевели́сь! statt púra stillur [-tl-]!; не шевеля́сь uttan at røra seg, pinnastillur [-tl-]@шевели́сь {шевели́тесь}!skunda tær!
шевельну́ть	moment síшевели́ть
шевельну́ться	moment síшевели́ться
шевелю́ра	ftlm.tjúkt og stórt hár
шевио́т	mcheviot [ʃeːvjɔʰtː]с0o({0<>})
шевио́товый	cheviot- [ʃeːvjɔʰt-]
шевро́	n indeclchevrau [ʃeːꞋvɹoː]с0гл({0<>}), getaskinn [keː-]ннкс0о, geitarskinnнпс0о
шевро́вый	adjchevrau- [ʃeːꞋvɹoː-], getaskins- [keː-]ннк, geitarskins-нп
шевро́н	mvinkulм0осн(á uniformsjakka o.tíl.)
шеде́вр	[-дэ́-]mmeistaraverkс0о, meistarastykkiсгл-i
шезло́нг	m(раздвижной стул) liggistólurмсогл-ar; chaiselongue {sjeselong} [ʃeːsɪꞋlɔŋk]ж0-ir(вид дивана)
шей...	шей, ше́йтеimper avшить
ше́йка	plurше́йки, ше́ек, ше́йкамf1.dim avше́я2.(узкая часть чего-л.): ше́йка бедра́ lærleggjarhálsurмсогл-ar; ше́йка ва́ла aksiltappurмсогл-ar; ше́йка ма́тки lívmóðurhálsurмсогл-ar
ше́йкер	m(сосуд) shakari [ʃεik-]мгл-ari
ше́йный	adjháls-; ше́йный плато́к hálsturriklæði =>позвоно́к
ше́йпинг	m(гимнастика) bodyshaping [pɔtːiʃεip-]ж0-ar
шейх	msjeikurмсогл-ar(tittul í arabiskum o.ø. londum)
шёл	pret m avидти́
ше́лест	mskróvanж0-ir, skavс0о
шелесте́ть	шелест|и́шь, ~я́тipfskróvaaði, skavaaði; ли́стья шелестя́т bløðini skróva; шелесте́ть газе́той skava við avísini [-Ꞌvʊi-]
шёлк	Genшёлка, шёлку,Prpо шёлке, на (в) шелку́;plurшелк|а́, ~о́в, ~а́мmsilkiсгл-i; шёлк-сыре́ц rásilki; иску́сственный шёлк kunstsilkiннкпроф.; на шелку́ silkifóðraður; ходи́ть в шелка́х ganga í silki(klæðum) =>долг@
шелкови́нка	plurшелкови́н|ки, ~ок, ~камfsilkitráðurм0осн-ar,-ir{á/æ}{0<>i}{+}
шелкови́стый	stfшелкови́ст, ~а, ~о, ~ыadjsilkimjúkurсогл, sum silki
шелкови́ца	f(Morus) morberjatræс0о{æ/ø}
шелкови́чный	adj: шелкови́чный червь (Bombyx mori) silkiormurмсогл-ar
шелково́д	msilkialariмгл-ari
шелково́дство	nsilkialingж0-ar
шелково́дческий	adjsilkialing-
шёлковый	adj1.(кшёлк) silki-; шёлковые чулки́ silkisokkar2.síшелкови́стый3.tlm.(кроткий): он стал (как) шёлковый hann varð sum lambið
шелкопря́д	m: ту́товый шелкопря́д (Bombyx mori) silkisummarfuglurмсогл-ar, silkifirvaldurмсогл-ar
шелкопряде́ние	nsilkispinningж0-ar
шелохну́ться	шелохн|у́сь, ~ёшься, ~у́тсяpfrørastir(d), rørair(d)seg, beveka [-Ꞌveː-]ннкaðiseg
шелуди́вый	stfшелуди́в, ~а, ~о, ~ыadjóvkm.við skrubbi, við kláðumкн.,ред.
шелупо́нь	f1.koll, tlm., niðr.(никчёмные люди) vánafólkс00мн, собир; pakkс0особир пренебр., partaníggjс0о{0<>i}{+}собир, пренебр.(сброд)2.(незначительный человек) óvættiсгл-iпренебр., tandurсооснпренебр., lortendiгрубо
шелуха́	f1.(фруктов,овощей) skalс0о{a/ø}(тж семян,орехов); flusс0о(от картофеля и др.); карто́фельная шелуха́ eplaflus2.(от кожи) flusс0о(av húð); roðslaжгл-a(turr,sum rusk) (чешуя)3.fl.(что-л. несущественное) frasс0о(ónyttugt fyribrigdi o.a.)
шелуше́ние	n1.(кшелуши́ть) flysingж0-ar2.(кшелуши́ться) avskallingж0-ar, flusnanж0-ir
шелуши́ть	шелуш|у́, ~и́шь, ~а́тipf что-л.flysaur(t){y/u}o-t
шелуши́ться	шелуш|у́сь, ~и́шься, ~а́тсяipfskallaннкaðiav, flusnaaðiav
ше́льма	m/fóvkm.skálkurмсогл-ar, kúllurмсогл-arпренебр.
шельмова́ть	шельму́|ю, ~ешь, ~ютipf(pfошельмова́тьошельму́|ю, ~ешь, ~ют)Acckomaслнo-o-oДатí ringt orð, dálkaaðiВинút, spilla [-tla]ir(t)Винút
шельтерде́к	mshelterdekk [ʃεl̥tε-]с0омор.
шельф	m: континента́льный шельф meginlandsstøðiмгл-iгеол., landgrunnur [lank-], [laŋk-]мсогл-ar
ше́льфовый	adjmeginlandsstøðis-геол., landgruns- [lank-], [laŋk-]
шемя́кин	adj: шемя́кин суд (несправедливый) órættvísurсоглdómur; partískur [-Ꞌtʰʊi-]соглskdómur (произвольный)
ше́нгенский	adj: ше́нгенская ви́за Schengen-visum [ʃεŋkεn-]; ше́нгенский сою́з Schengen-samarbeiðið [ʃεŋkεn-]сгл-iопр., Schengen-avtalan [ʃεŋkεn-]жгл-aопр.
ше́нкель	m beinið frá knænum niður á økilin(á reiðmanni)
шепеля́вить	шепеля́в|лю, ~ишь, ~ятipflespaaði
шепеля́вость	flespingж0-ar, lespandi úttalaжгл-a
шепеля́вый	stfшепеля́в, ~а, ~о, ~ыadjlespandiглandi; он шепеля́вый hann lespar
шепну́ть	moment avшепта́ть
шёпот	mteskс0о, teskanж0-ir
шёпотом	advteskandi
шептала́	f koll. sólturkaðar abrikosir og ferskunar[fεʂkɪn-]ннк
шепта́ть	шепчу́, ше́пч|ешь, ~утipf(moment.шепну́тьшепн|у́, ~ёшь, ~у́т) teskaaði, lýðair(d); tutlaaði(тихо говорить и т.п.); шепта́тькому-л. что-л.на́ ухо lýðao-m o-tí oyrað
шепта́ться	шепчу́сь, ше́пч|ешься, ~утсяlýðastir(d), teskaaðisínámillum [sʊinamɪtl-]; tutlaaðisínámillum [sʊinamɪtl-] (тихо говорить и т.п)
шепту́н	Gen, Accшептун|а́;plur~ы́, ~о́в, ~а́мmtlm.,atf.(распространитель слухов) søgusmettaжгл-a; smettariмгл-ari(доносчик)
шербе́т	msorbet [sɔɹꞋpeː]с0глкул.
шере́нга	fraðс0о{a/ø}(har fólk standa lið um lið)
шери́ф1	Imsheriffur {sjeriffur} [ʃeꞋrɪ-]мсогл-ar(í USA o.a.)
шери́ф2	IIm heiðurstittul hjá muslimum
шерохова́тость	f1.(неровность) tað at vera óslættur, tað at vera ójavnur,síшерохова́тый; óslættiмгл-i, ójavniмгл-i; hólpurмсогл-ar, knortilм0осн(шероховатое место)2.(стиля) knortlс0о(í stíli)3.plur(трения) illstøðaжгл-a
шерохова́тый	stfшерохова́т, ~а, ~о, ~ыadjóslætturсогл{æ/ø}, ójavnurсогл{a/ø}; rufluturсогл; knortluturсогл(um stíl) (о стиле)
шерп	1.m/f(fólkaslag) indeclsherpa [ʃεɹ̥pа] {sjerpa}м нескл.2.adj indeclsherpa- [ʃε-] {sjerpa}; sherpa [ʃεɹ̥pа] {sjerpa}с нескл.(málið) (язык)
шерпа́	Iplur indecl(представители народности)fólk av fólkaslagnum sherpaIIm, f indecl fólk av fólkaslagnum sherpaIIIadj indeclsherpa- [ʃεɹ̥pa] {sjerpa-}
шерсти́нка	plurшерсти́н|ки, ~ок, ~камf(волосок) ullarhár [ʊtl-]с0о; ulltráðurм0осн-ar,-ir{á/æ}{0<>i}{+}(нитка)
шерсти́стый	stfшерсти́ст, ~а, ~о, ~ыadj1.(об овцах и др.) loðinсоглоснð/d; ullarríkur [ʊtl-]согл; væl ullaður [ʊtl-]глaður, ullprúðurгл(с густой и длинной шерстью)2.(о ткани) loðinсоглоснð/d(um klæði o.a.)
шерсти́ть	шерст|и́т, ~я́тipf1.(раздражать кожу) skríðaслнei-i-i(um ullint klæðir); шарф шерсти́т ше́ю tað skríður á hálsinum av turriklæðnum2.что-л.fl. óvkm.(обыскивать) rannvæla [-Ꞌvεa-]aðio-t, rótaaðiо-t(upp)3.tlm.Acc(выговаривать) gevaслнa-ó-iДатeina yvirháling [-Ꞌhɔa-]энкнеформ., skeldaaðiВинút
шерстопряде́ние	nspinningж0-arav ull [ʊtl]
шерстопряди́льный	adjspuna-; шерстопряди́льная фа́брика ullvirki, spunavirkiофиц., spinnarí [-Ꞌrʊi]ннкс0о{0<>i}
шерстотка́чество	nvevingж0-arav ull [ʊtl]
шерсть	(plurfakm.ше́рсти, шерст|е́й, ~я́м)f1.(волосяной покров) ull [ʊtl]ж0-ir2.(покров,остриженный с животного) ull [ʊtl]ж0-ir(heil ull av seyði o.ø.), royviсгл-i(с овцы)3.(материал) ull [ʊtl]ж0-ir(tilfar)4.(ткань) ullint [ʊtl-] klæðiсгл-i=>гла́дить@
шерстяно́й	adjull- [ʊtl-], [ʊl-], ullintur [ʊtl-]; шерстяна́я пря́жа tógv; шерстяны́е изде́лия ullvøra [ʊlv-]; шерстяно́е пла́тье ullintur kjóli
шерша́веть	ipf(pfзашерша́веть)bert 3. pers brúkturverða óslætturсогл{æ/ø}, verða rúðruturсогл
шерша́вый	stfшерша́в, ~а, ~о, ~ыadjhvassurсогл{a/ø}(rúðrutur, skrubbutur), rúðruturсогл
ше́ршень	Gen, Accше́ршн|я;plur~и, ~ей, ~ямm(Vespa crabro)slag av insekti í vespuættini(en.hornet; da.gedehams)
шест	Genшест|а́;plur~ы́, ~о́в, ~а́мm1.(палка,жердь) stongж0-ur{o/a/e}2.ítr.(спортивный снаряд) stongж0-ur{o/a/e}; прыжо́к с шесто́м stangarlop; прыгу́н с шесто́м stangarleypariмгл-ari; пры́гать с шесто́м gera stangarlop
шёст	num indecl síсам-
шеста́я	f: одна́ шеста́я ein sættingurмсогл-ar, ein sætti parturмсогл-ar{a/ø}
ше́ствие	ngongaжгл-a(av fólki í skipaðum fylki); торже́ственное {пра́здничное} ше́ствие skrúðgongaжгл-a; погреба́льное ше́ствие líkfylgiсгл-i; сва́дебное ше́ствие brúðarskariмгл-i, brúðarfylgiсгл-i=>тра́урный1,фа́кельный
ше́ствовать	ше́ству|ю, ~ешь, ~ютipf1.skemt.,spott.(следовать куда-л.) komaслнo-o-ospankulárandi [spaŋ̊kʊꞋlɔa-]шутл.,ирон.2.bókl.(участвовать в шествии) gangaслнe-i-iskrúðgongu
шестёра	ftlm.síшестёрка7
шестерёнка	plurшестерён|ки, ~ок, ~камf dim avшестерня́
шестери́к	Genшетерика́;plurшестерик|и́, ~~о́в, ~а́мm1.søg.(мера)gamalt russiskt mál um o-t, sum tað eru seks av2.gml. (упряжка) toymiсгл-ivið seks rossum
шестёрка	plurшестёр|ки, ~ок, ~камf1.(цифра) sekstalс0о{a/ø}2.kort.(карта) seksu(r)сгл-aмн3.tlm.(трамвай,автобус и т.п.) seksariмгл-ari(bussur o.a. við nummarinum seks)4.sjóm.(судно и др., обозначенное цифрой,оканчивающейся на 6)skip við nummari, ið endar við seks5.(упряжка) sekstoymiсгл-i6.(лодка) báturмсогл-arvið seks røðarum; seksmannafarс0о{a/ø}(фарерская лодка)7.tlm.(автомобиль): ВАЗ 2106 Lada [laː-] 21068.argot(подручный) ørindrekiмгл-i, skutilsveinurмсогл-ar(fangi,sum er hjálparmaður hjá fanga,ið er hægri í tign)
шестерно́й	adj1.(из шести однородных частей) seks-; шестерно́й но́жик knívur við seks bløðum2.(в шесть раз больше) seksdupulturсогл, seksfaldurсогл, seks ferðir størri, seks ferðir longri; шестерно́е коли́чество seksfald nøgd
шестерня́1	Iplurшестер|ни́, ~ён, ~ня́мf(зубчатое колесо) tannhjul [-juːl]ннкс0о, tannhjól [-tʃʰɔul]нпс0о
шестерня́2	IIplurшестер|ни́, ~не́й, ~ня́мf(упряжка)síшестёрка5
ше́стеро	Acc,Gen, Prpшестеры́х,Datшестеры́м,Insшестеры́миnum coll1.subst í m,sum merkja persónar og pers pron í plurseks; ше́стеро сынове́й seks synir; их бы́ло ше́стеро teir vóru seks (mans)2.summi subst,ið bert eru til í plur;oftast Nom og Accseks; ше́стеро су́ток seks samdøgur3.summi subst,sum merkja sovorðið,sum er í pørum, oftast Nom og Accseks pør; шесть рукави́ц seks pør av vøttum@за шестеры́хfyri seks; рабо́тает за шестеры́х hann arbeiðir fyri seks
шести...	í samansseks-
шестигра́нный	adjvið seks síðum
шестидесяти...	í samanstrýss- [tʰɹʊʃ-], seksti- [sεʰkstʰiː-]нп
шестидесятиле́тие	n1.(о сроке) trýss [tʰɹʊʃː] ár, seksti [sεʰkstʰiː]нпár (tíðarskeið)2.(годовщина) trýss [tʰɹʊʃː] ára dagur, seksti [sεʰkstʰiː]нпára dagur3.(день рождения) trýss [tʰɹʊʃː] ára føðingardagur, seksti [sεʰkstʰiː]нпára føðingardagur
шестидесятиле́тний	adj1.(о сроке) trýss [tʰɹʊʃː] ára, seksti [sεʰkstʰiː]нпára (tíðarskeið)2.(о возрасте) trýss [tʰɹʊʃː] ára gamal, seksti [sεʰkstʰiː]нпára gamal
шестидеся́тник	m1.søg.framburðsmaður o.tíl í Russlandi í 1860-árunum2.frælsishugsandi fólk,ið bardist fyri mannarættindum o.ø. í Sovjetsamveldinum í 1960-árunum
шестидеся́тый	num ordtrýssinstjúgundi [tʰɹʊʃː-], sekstiundi [sεʰkstiː-]нп
шестидне́вный	adjseks daga
шестизна́чный	adjsekssiffraður {seksciffraður} [-sɪ-]соглaður
шестикла́ссник	mnæmingurмсогл-arí sætta flokki
шестиле́тие	n1.(о сроке) seks árс0омн(tíðarskeið)2.(годовщина) seks ára dagurмсогл-ar(+}3.(день рождения) seks ára føðingardagurмсогл-ar(+}
шестиле́тний	adj1.(о сроке) seks ára (tíðarskeið)2.(о возрасте) seks ára gamalсоглосн{a/o}
шестиме́сячный	adj1.(о сроке) seks mánaða [mɔana] (ред.[mɔanava]) (tíðarskeið)2.(о возрасте) seks mánaðir [mɔanaɹ] (ред.[mɔanajɪɹ]) gamalсоглосн{a/o}
шестинеде́льный	adj1.(о сроке) í seks vikur, seks vikurннк(tíðarskeið)2.(о возрасте) seks vikur gamalсоглосн{a/o}
шестипа́лый	stfшестипа́л, ~а, ~о, ~ыadjvið seks fingrum; við seks tóm (на ноге)
шестисотле́тие	n1.(срок) seks hundrað ár,  hundrað ára tíðarskeiðс0о{0<>i}2.(годовщина) seks hundrað ára dagurмсогл-ar{+}fyri Вин, seks hundrað ára jubileum [juːpiꞋleː-]ннкс0-eumfyri Датпубл.
шестисотле́тний	adj1.(о сроке) seks hundrað ára (tíðarskeið)2.(о возрасте) seks hundrað ára gamalсоглосн{а/о}3.(о годовщине) seks hundrað ára (jubileum o.a.)
шестисо́тый	num ordseks hundraðndi [hʊntɹɪnti] (реже[hʊntɹantɪ])
шестисто́пный	adjvið seks (ørindis)fótum, seksfótaðurглaður; шестисто́пный стих heksametur [-Ꞌmeː-]с0осн
шестиуго́льник	msekskanturмсогл-ar, sekshyrningur [-tn-]лпмсогл-ar
шестиуго́льный	adjsekskantaðurглaður, sekshyrntur [-hɪn̊t-]лпсогл
шестичасово́й	adj1.(продолжительностью в шесть часов) seks tíma; шестичасово́й рабо́чий день seks tíma arbeiðsdagur2.tlm.(назначенный на шесть часов) (sum fer, sum er ásett til) klokkan seks; шестичасово́й по́езд tokið klokkan seks, sekstokið
шестиэта́жный	adj(sum er) í seks hæddum, (sum er) í seks etasjum [-Ꞌtʰaː-]ннк
шестна́дцати-	í samanssekstan
шестна́дцатый	num ordsekstandi [sεʰkstɪnti] (реже[sεʰkstantɪ])
шестна́дцать	Gen, Dat, Prpшесттна́дцати,Insшестна́дцатьюnum cardsekstan@шестна́дцать круго́мóvkm.tað er hopleyst, tað er ikki bøn, her gerst einki
шестови́к	Genшестовик|а́;plur~и́, ~о́в, ~а́мmstangarleypariмгл-ari
шесто́й	num ordsætti@шесто́е чу́вствоsætti sansur
шесто́к	Genшестка́; plurшестк|и́, ~о́в, ~а́м1.(в русской печи) árnurмсогл-arуст.(í russ. ovni)2.dim avшест3. (насест) vaglс0о
шесть	Gen, Dat, Prpшести́,Insшестью́num cardseks
шестьдеся́т	Gen, Dat, Prpшести́десяти,Insшестью́десятьюnum cardtrýss [tʰɹʊʃː], seksti [sεʰkstiː]нп(употребляется,однако, широко на письменных поздравлениях,квитанциях,чеках и т.п.)
шестьсо́т	Genшестисо́т,Datшестиста́м,Insшестьюста́ми,Prpшестиста́хnum cardseks hundrað [sεʰkshʊntɹa]
ше́стью	advseks ferðir
Шетла́ндские острова́	síШетле́ндскиеострова́
Шетле́ндские острова́	Hetlandс0о{a/o}, Shetlandsoyggjarnar [ʃεʰtlan̊s-]ннкж0-ar{+}мн опр.
шеф	m1.søgel.um útlond(в царской России,в нек. странах) ovastiмгл-i, stjóri [stj-]мгл-i; шеф поли́ции politistjóri [pʰoːliꞋtʰiː-], løgreglustjóri2.tlm.(руководитель) yvirmaðurмнепр(stjóri o.tíl.), chefur [ʃeː-]энкмсогл-arнеформ.3.шефствующая организация) stuðulsfelagс0о{a/ø}{0<>i}(felagsskapur o.a.,ið átekur sær at hjálpa felag el.ø. á ávísum øki,síше́фство)4.tlm.síшеф-по́вар5.slang(таксист) taksаsjaførurннкмсогл-ar(serliga í tiltalu)
шеф-	í samanshøvuðs-, yvir; шеф-по́вар høvuðskokkur; шеф-пило́т chefpilotur [ʃeː-]ннкпроф., høvuðspiloturннк, høvuðsflogskipariнп
ше́фский	adjstuðuls-, hjálpar-;síшеф3, ше́фство
ше́фство	m: взять ше́фствонад Insa) (об организации) veitair(t)Датstuðul,síшеф3 (um felagsskap); b) (о человеке) vegleiðair(d)Вин, takaслнó-ó-især avДат(um fólk)
ше́фствовать	ше́фству|ю, ~ешь, ~ютipf над Insveitair(t)Датstuðul, hjálpa [j-]ir(t){+}Дат,síшеф3
ше́я	fhálsurмсогл-ar; svíriмгл-i(толстая,у скота и людей); krikiмгл-i(у птиц); бы́чья ше́яbeinl.,fl.tarvssvíri [tʰaʂs-]прям., перен.; лебеди́ная {лебя́жья} ше́я hálsur á svana,fl.svanahálsur (klænur og vakur hálsur); бро́ситься на ше́юкому-л.tveita seg um hálsiná o-m, leypa um hálsiná o-m;@слома́ть {сверну́ть} себе́ ше́юа)beinl.bróta hálsinпрям.; b)fl.(действовать неосмотрительно) faraслнó-ó-afram eftir [εʰtː-] fummum; c) (потерпеть неудачу) gangaслнe-i-iúr hond;сверну́тькому-л.ше́юbrótaслнey-u-ohálsiná o-m,síсверну́ть@;висе́ть на ше́еу кого-л.a) (быть на иждивении) liggjaслнá-ó-iinni áo-m, veraслнa-ó-eo-mein kleppur; b) (пристаивать) amastaðiupp á Вин, nálgastaðiuppi í Дат, hangaслнe-i-iuppi á Дат(amast);вы́гнать {вы́толкать}кого-л.в ше́ю {в три ше́и}blakaaðio-nút, blakaaðio-ná dyr, gevaслнa-ó-io-mdurafjórðinginидиом.;посади́тького-л.на ше́юкому-л.lataслнæ-ó-ao-nblíva einа byrðu fyrio-n, leggjaнепрeina byrðu áo-n;сиде́ть {жить, быть} на ше́еу кого-л.liggjaслнá-ó-iinni áo-m, veraслнa-ó-eo-mein kleppur; livair(d)(að)av o-m, snultaaði; у него́ на ше́е тро́е дете́й hann hevur trý børn [-tn] at síggja til;сади́тьсякому-л.на ше́юleggjastнепрinn áo-n, gerastнепрein byrða fyrio-n, gerastнепрein kleppur fyrio-n;получи́ть по ше́еfáaслнe-i-iꞋ av at vita, fáaслнe-i-itoyggið;датькому-л.по ше́еlatao-nfáa Ꞌ av at vita, gevao-meina skortfleingju [skɔɹ̥f-] =>ве́шаться@,ви́снуть@,гнатьA 2,гнуть@,кида́ться@
ши́бздик	móvkm.tøppurмсогл-ar(lítil drongur), avnor [au-]с0о(um drong)
ши́бкий	stfши́бок, шибка́, шибко́, ши́бки; compши́бчеadjóvkm. skjóturсогл. kvikurсогл
ши́бко	advóvkm.1.(быстро) skjótt2.(очень) øgiliga nógv, øgiliga, ógviliga
ши́бче	comp síши́бкий
Ши́ва	mmyt.Shiva [ʃiː-]м нескл.
ши́ворот	m: взятького-л.за ши́ворот a) taka í kragan; b)fl.taka í herðatoppiná o-m идиом.
ши́ворот-навы́ворот	advøvut, rangvørgt [rεnvœɹ̥t]; де́лать всё ши́ворот-навы́ворот gera alt øvut, gera alt rangvørgt
ши́зик	móvkm.o-r, sum er klikkaðurнеформ.,пшутл.,пренебр.; eitt svakt apparat [-Ꞌraːt]энкс0онеформ.,пренебр.
шизофрени́ческий	adjschizofrenur {skisofrenur} [skiːsoꞋfɹeː-]согл, hugklovinлпсоглосн, sinnisklovinлпсоглосн
шизофрени́я	fschizofreni {skisofreni} [skiːsofɹeꞋni]ж0-ir, hugklovningurлпмсогл-ar
шизофре́нник	mschizofrenikari {skisofrenikari} [skiːsoꞋfɹeː-]мгл-ari
шии́т	mshiittur {sjiittur} [ʃiꞋɪʰtː-]мсогл-ar, shiamuslimur {sjiamuslimur} [ʃiːja-]мсогл-ar
шик	Genши́ка, ши́куmtlm.(reypandi) smartheitж0-ir, flottheitж0-ir; таки́е ту́фли сейча́с са́мый шик sovorðnir skógvar eru ordiliga innжарг.nú, sovorðnir skógvar eru síðsta skríggjнеформ.nú; для ши́ку fyri at reypa, fyri at vísa seg; зада́ть ши́ку vísair(t)seg, geraнепрseg upp; с ши́ком erpisliga, flott; он с ши́ком закури́л hann festi sær erpisliga í
шикану́ть	moment síшикова́ть
ши́канье	n1(кши́кать 1) hússjanж0-ir2.(кши́кать 2) pípanж0-ir
шика́рный	stfшика́р|ен, ~на, ~но, ~ныadjtlm.1.(элегантный,модный) smarturсогл; flotturсогл(роскошный, эффектный)2.(отличный) fínurсогл(frálíkur), óførurсогл, frálíkurсогл
ши́кать	1.momentши́кнуть Iши́кн|у, ~ешь, ~ут на кого-л.(заставлять замолчать) hússjaaðiá o-n2.pfоши́кать (освистивать)кому-л.pípaaðio-nniður (í sjónleikarhúsi o.tíl.)
ши́кнуть1	Imoment síши́кать
ши́кнуть2	IImoment síшикова́ть
шикова́ть	шику́|ю, ~ешь, ~ютipftlm.(momentшикану́тьшикан|у́, ~ёшь, ~у́тog ши́кнуть IIшикн|у́, ~ёшь, ~у́т) vísair(t)seg, geraнепрseg upp
ши́ллинг	msøg.(английская монета) shillingur} [ʃɪlː-]мсогл-ar(bretskur myntur);søg.schillingur [ʃɪlː-]мсогл-ar(денежная монета в Австрии и др.) (eysturríkskt gjaldoyra);søg.skillingurмсогл-arист.(денежная монета в Дании)
ши́ло	nsýlж0-ir@ши́ла в мешке́ не утаи́шьorðt.út kemur innispunnið tógvпосл.(tað sum roynt verður at fjala);ши́ло на мы́ло сменя́тьorðt.gera spógvabýtiпог.
шилохво́стка	plurшилохво́ст|ки, ~ок, ~камf síшилохво́сть
шилохво́сть	f(Anas acuta) snælduontж0-ur{o/e}, stikkontж0-ur{o/e}
ши́льдик	mtlm. skeltiсгл-i
шимпанзе́	[-зэ́]m indecl(Pan troglodytes) sjimpansa [-Ꞌpʰa-]жгл-a
ши́на	f1.(обруч) dekkс0о(gummiringur);gml.hjulringur [juː-]ннкмсогл-ar2.lækn.(на ноге и т.п.) skinnariмгл-ari, spjálkiмгл-iред., кн.; наложи́ть ши́ну на но́гу leggja skinnara á beinið3.el.(устройство) skinnariмгл-ari4.teld.(магистраль) bussurмсогл-arэвм=>спусти́ться4
шине́ль	ж1.(soldata)kappiмгл-i2.søg.slag av frakka við skinnkraga
шинка́рь	Gen,Accшинкаря́; plurшинкари́, ~е́й, ~я́мm gml.vertshúshaldari [vεʂ-]мгл-ari
шинкова́ть	шинку́|ю, ~ешь, ~ютipf(pfнашинкова́тьнашинку́|ю, ~ешь, ~ют)что-л.skeraслнa-ó-oo-t(sundur í smalar leingjur)
ши́нный	adjdekk- (síши́на1)
шино́к	Genшинк|а́;plur~и́, ~о́в, ~а́мmgml.lítil drykkjustovaжгл-a, vertshús [vεʂ-]с0о(serl. í sunnara parti av Russlandi og Ukraina)
шинши́лла	f1.djór.(Chinchilla laniger) chinchilla [tʃʰɪnꞋtʃʰɪlːa]жгл-a(;0-ir)2.(мех) chinchilla [tʃʰɪnꞋtʃʰɪlːa]с нескл.(skinn), chinchillaskinn [tʃʰɪnꞋtʃʰɪlːa-]с0о
шиньо́н	ftoppurмсогл-ar(av hári), frisura [-Ꞌsyː-]жгл-avið toppi
шип	Genшип|а́;plur~ы́, ~о́в, ~а́мm1.(у растения) tornж0-ir; broddurмсогл-ar2.(у животного) tindurмсогл-ar(á djóri,fiski o.ø.), broddurмсогл-ar3.(на обуви,шинах и т.п.) píkurмсогл-ar(á skóm o.ø.); ту́фли с шипа́ми {на шипа́х} píkaskógvar; ши́на с шипа́ми píkadekk4.tekn.(выступ) tappurмсогл-ar=>ро́за
шипе́ние	nfísс0о, froysс0о; brúsс0о(о напитках и др.)
шипе́ть	шип|лю́, ~и́шь, ~я́тipf1.(о глухом звуке) físair(t); froysair(t); brúsaaði(um drykkir) (о напитках)2.fl.,tlm.(сдавленным от злости голосом) mutlaaði, mølmaaði3.fl.,tlm.(ворчать) knarraaði, grenjaaði, gangaслнe-i-iog físair(t)
шипо́вка	plurшипо́в|ки, ~ок, ~камfítr.,tlm.píkaskógvurмсогл-ar{+}
шипо́вник	m1.(куст) (Rosa) (vill [-tl]) rósaжгл-a2.(плод) hypin [hyː-]ннкж0-ar, hjúpa [tʃʰ-]лпжгл-aбот., rósuberс0о{+}бот.
шипу́чий	adj1.(издающий шипение) físandiглandi2.(о напитках,вине) brúsandiглandi, mousserandi [mʊꞋseː-]ннкглandiпроф.(о вине)
шипу́чка	ftlm.brúsandi drykkurмсогл-ir;согл-s,-ir
шипча́ндлер	m síшипша́ндлер
шипша́ндлер	mskipshandlari [-hanl-]мгл-ari
шипя́щий	Iadj: шипя́щий звукIImhvæsiljóðс0олингв., físiljóðс0олингв., sibilantur [siːpiꞋla-]мсогл-arпроф.
ши́ре	comp av adjширо́кийog advшироко́
ширина́	fbreiddж0-ir(mát tvørturum); víddж0-ir(um klæðir) (об одежде); ширина́ зали́ва breiddin á víkini; ширина́ рукаво́в víddin á ermunum; оди́н метр в ширину́ {ширино́й в оди́н метр} ein metur breiður =>двойно́й2,колея́2
шири́нка	plurшири́н|ки, ~ок, ~камf1.(полоса ткани) klaffurмсогл-ar, smekkaжгл-a(framman á buksum)2.tlm.(передний разрез) splittaжгл-a(í buksum)
ши́рить	ши́р|юсь, ~ ится, ~ятсяipf что-л.1.(делать более широким) víðkaaðio-t2.(делать более массовым) geraнепрo-tbreiðari (um rørslur o.tíl.), víðkaaðium o-t(sambond o.a.)
ши́риться	ши́р|ится, ~ятсяipfbreiðkaaði, breiðkastaði
ши́рма	(plurgml.ши́рмы, ширм, ши́рмамí týdn 1)f1.(перегородка) skermurмсогл-ar(at seta upp í kamari o.a.)2.bert singfl.служи́тькому-л.ши́рмой vera skálkaskjólhjá[tʃʰ-]o-m
ширну́ться	pf momentslangsíширя́ться
широ́кий	stfширо́к, широка́, широко́ogширо́ко, широ́киogшироки́;compши́реadj1.(имеющий большую ширину) breiðurгл; víðurгл(б.ч. об одежде,обуви и др.); широ́кое уще́лье ein breið gjógv; широ́кая река́ ein breið á; широ́кие пле́чи breiðir herðar; на широ́ком фро́нте á einum breiðum frontiннк; широ́кая улы́бка eitt stórt smíl; широ́кое пальто́ víður frakki; идти́ широ́ким ша́гом stígaслнei-i-istórum, ginaaði2.(шире чем нужно) for [fɔɹː]ннкvíðurгл, ov [oː] víðurгл; широ́кий в плеча́х (forннк) víður um herðarnar, (ov) víður um herðarnar; пла́тье широко́ kjólin er forннкvíður, kjólin er ov víður3.(просторный) víðurгл(sum røkkur langt); широ́кие сте́пи víðar steppur4.(большой по охвату) umfatandiглandi, breiðurгл; в са́мом широ́ком смы́сле сло́ва í orðsins breiðasta týdningi; широ́кие пла́ны umfatandi ætlanir; широ́кое примене́ние umfatandi brúk; получи́ть широ́кое распростране́ние fáa stóra útbreiðslu; широ́кие полномо́чия víðfevndar heimildir; широ́кие возмо́жности stórir møguleikar; широ́кий кругозо́р víður sjónarringur5.(массовый) breiðurгл(viðv. fjøldini); широ́кие ма́ссы fjøldinж0-irопр.; широ́кий чита́тельkolleina breiður lesaraskari; широ́кая подде́ржка breið undirtøka6. (о душевных качествах) víð-; gávumildurсогл(щедрый); широ́кие взгля́ды víðskygni [vʊʃ-]; широ́кое се́рдце eitt stórt hjarta [j-]; широ́кая нату́ра stórtøkið [stœɹ̥-] fólk, rummiskt fólkкн., ред.@широ́к в кости́breiðvaksinсоглосн;на широ́кую но́гу(поставлено и т.д.) stórfingið [stœɹ̥-];жить на широ́кую но́гуliva flott, liva glæsiliga =>жест2,кругB 2,потребле́ние,разме́р3,смысл@,экра́н@
широко-	í samansbreið-
широ́ко	advsjálds.síшироко́
широко́	adv1.(кширо́кий) breitt, vítt; широко́ отркы́тые глаза́ víðopin eygur; смотре́ть с широко́ раскры́тыми глаза́ми hyggja við stórum eygum, gløair(d); две́ри бы́ли широко́ откры́ты hurðarnar stóðu víðopnar; широко́ улыба́ться stórflenna [stœɹ̥f-]2.(во многих местах,далеко) víða, víða um; широко́ изве́стен víðagitin3.: широко́ образо́ванный челове́к maður við fjølbroyttari útbúgving4.(в больших размерах) í stóran stílнеформ.@широко́ смотре́ть на ве́щиvera frílynturсогл;жить широко́liva flott, liva glæsiliga
широкова́тый	stfширокова́т, ~а, ~о, ~ыadjheldur víðurгл, í víðara lagi
широковеща́тельный	adj1.útv.(относящийся к широковещанию) kringvarps- (til stóra fjøld av lurtum)2.spott.(о рекламе,заявлении и т.п.) sum lovar nógv (um reklamur o.a.)
широкогру́дый	stfширокогру́д, ~а, ~о, ~ыadjbringubreiðurгл
ширококоле́йный	adjjarnb.breiðsporaðurглaður
широколи́стый	adjvið breiðum blað (um plantur), breiðbløðkuturсоглбот.
широколи́цый	stfшироколи́ц, ~а, ~е, ~ыadjbreidleitturсогл, breiðleitturсогл
широконо́ска	plurшироконо́с|ки, ~ок, ~камf(Anas clypeata) spónontж0-ur{o/a-e}
широкопле́чий	stfшироkoпле́ч, ~а. ~о, ~иadjherðabreiðurгл
широкополо́сный	adjteld.breiðbands- [-pan̊s-] =>сеть3
широкопо́лый	stfширокопо́л, ~а, ~о, ~ыadj1.(о шляпе) breiðskuggaðurглaður2.(о сюртуке и т.п.) við breiðum veli, við breiðum flippiуст.
широкоформа́тный	adj70 mm (um film)
широкоэкра́нный	adjwidescreen- [vaitskɹiːn-]ннкпроф., breiðtjald-лп
широта́	plurширо́т|ы, ~, ~амf1.(об интересах, уме и т.п.) víddж0-ir; breiddж0-ir; широта́ взгля́дов {воззре́ний} víðskygniсгл-i, víður sjónarringurмсогл-ar; широта́ интере́сов breidd í áhugamálumнп2.geogr.(координата) breiddж0-ir(breiddarstig), breiddigrad [-kɹaːt]ннкж0-irпроф., breiddarstigнпс0о; на ю́жных широ́тах á breiddigradumннкпроф.sunnandyri, á suðurbreiddumнп; на како́й широте́ лежи́т…? á hvørjari breiddigradннкпроф.liggur...?; 62осе́верной широты́ 62 gradirннкпроф.norður, 62 stigнпnorður =>гра́дус1
ширпотре́б	m1.(потребление) forbrúk [-Ꞌpɹʉuk]ннкс0о, brúkс0о, nýtsla [nʊi̯sla]нпжгл-a; това́ры ширпотре́ба forbrúksvarur [-Ꞌpɹʉu-]ннк, brúksvøra [pɹʏʰks-], nýtsluvøra [nʊi̯sl-]нп2.(о чём-л. малоценном) vánalig vøraжгл-a, bíligt krammс0о
ширь	fvíddж0-ir@во всю ширьso breiðuro-rer, so stóruro-rer (в полном объёме); av øllum [œtl-] alvi (в полную силу)
ширя́ться	ipf(momentширну́тьсяширн|у́сь, ~ёшься, ~у́тся)slangsproyta [spɹœi-] (реже[spɹɔi-])aðiseg (um narkoman), fiksaaðiарго
ши́тый	partic/adjbroderaður [-Ꞌteː-]глaður
шить	шь|ю, ~ёшь, ~ют;imperшей, ше́йтеipf(pfсшитьсошь|ю, ~ёшь, ~ют;imperсшей, сше́йте)что-л.1.(изготовлять шитьём) seymaaðio-t; шить на маши́нке seyma á maskinu [-Ꞌʃiː-]; шить о́бувь seyma skógvar2.(заказывать себе) lataслнæ-ó-aseyma3.bert ipf(вышивать) brodera [-Ꞌteː-]aðio-t; шить шёлком seyma við silki@он ни шьёт, ни по́ретtilt.hann er so gjánkasligur; всёши́то-кры́то(alt fer fram) í duldum, í loyndum =>ни́тка@
шитьё	n1.(действие) seymingж0-ar2.(то,что шьётся или сшито) seymiklæðirсгл-iмн, seymiarbeiðiсгл-i3.(вышивание) brodering [-Ꞌteː-]ж0-ar4.(вышивка) broderí [pɹoːtɪꞋrʊi]с0о, seymiklæðirсгл-iмн
ши́фер	m(порода;материал) skifur [skiː-]с0осн, talvusteinurлпмсогл-ar; fløgugrótс0огеол.(порода)
ши́ферный	adjskifur [skiː-]; fløgugróts-
шифо́н	mchiffon [ʃɪꞋfɔŋk]с0о
шифонье́р	mklæðisskápс0о, klædnaskápс0о
шифонье́рка	plurшифонье́р|ки, ~ок, ~камfhøg kommoda [kʰoꞋmoː-]жгл-a, chiffoniere [ʃɪfoːniꞋeːɹ]ж0-ir
шифр	m1.(код) loynistavurмсогл-s,-ir;-ar{a/ø};-ar, loynitekn [-tʰεkn]с0о(знак); loyniskriftж0-ir, koduskriftж0-ir(письмо)2.(библиотечный) skrásetingarnummarс0о{+}(á bókum, handritum o.ø. á bókasavni)3.gml.(вензель) navnamerkiсгл-i,monogramm [-Ꞌkɹamː]интс0о(;0-ir)=>ключI 4
шифрова́льный	adjloynitekns- [-tʰεkns-], loyniskrift-
шифрова́льщик	mloyniskriftserfrøðingurмсогл-ar
шифро́ванный	adjskrivaðurглaðurvið loyniskrift
шифрова́ть	шифру́|ю, ~ешь, ~ютipf(pfзашифрова́тьзашифру́|ю, ~ешь, ~ют)что-л.skrivaaðio-tvið loyniskrift;teld., útv.kryptera [kʰɹʏʰpꞋtʰeː-]aðio-tэвм
шифро́вка	plurшифро́в|ки, ~ок, ~камf1.(действие) skrivingж0-arvið loyniskrift2.tlm.(текст) telegramm [tʰeːlɪꞋkɹamː]с0о(;0-ir)í loyniskrift (телеграмма), brævс0о{æ/ø}í loyniskrift (письмо)
шифрогра́мма	ftelegramm [tʰeːlɪꞋkɹamː]с0о{(;0-ir)}í loyniskrift
ши́хта	f nám. blandingur av rávøru (í metallurgi o.a.)
шиш	Genшиш|а́;plur~и́, ~е́й, ~а́мmóvkm.1.síку́киш2.: шиш ikki eitt vet; ни шиша́ ikki eitt vet; шиш с ма́слом ikki eitt viðursvet; шиш он полу́чит! hann fær ikki inn í eygað!идиом.@на каки́е шиши́ я куплю́ э́то?hvussu í allari [atl-] víðu verð skal eg fáa ráð til tað?
шиша́к	Genшишака́: plurшишак|и́, ~о́в, ~а́мm1.søg.(шлем) hjálmur [tʃʰɔ-]мсогл-arvið píki2.jarg.(мужской член) murturмсогл-arтабу, fansurмсогл-arтабу
ши́шка	plurши́ш|ки, ~ек, ~камf1.(на теле) kúlaжгл-a, kýliсгл-i(á kroppinum av stoyti o.ø.); у него́ на лбу вскочи́ла ши́шка hann fekk eina kúlu í pannuna2.(шарик на конце чего-л.) knappurмсогл-ar(ovast á stavi o.tíl.), knøtturмсогл-ir{ø/a};-ar(ovast á o-m)3.(на дереве) kongulм0осн4.óvkm.(важная персона) stór kanón [-Ꞌnɔun]ж0-irнеформ., pingurмсогл-arшутл.; pampariмгл-ariпренебр.(в профсоюзе и т.п.)@ши́шка на ро́вном ме́стеtlm.,spott.síши́шка4;все ши́шки ва́лятсяна кого-л. o-rfær skyldina fyri alt;o-rfær alt oman Ꞌ yvir seg =>наби́ть5,Мака́р@
шишкова́тый	stfшишкова́т, ~а, ~о, ~ыadjbunguturсогл, við kúlum, við kýlum,síши́шка1
шишкови́дный	stfшишкови́д|ен, ~на, ~но, ~ныadjav skapi sum kongul,síши́шка3
шк.	шко́ла skúli
шкала́	plurшка́л|ы, ~, амf1.(линейка,таблица) skali [skaː-]ннкмгл-i, skala [skaː-]ннкжгл-a;0-ir(talva el. tíl.); шкала́ термо́метра termometurskali [-Ꞌmeː-]ннк; шкала́ приёмника skaliннкá radioapparati [raːtioaʰpːaraː-]ннк2.(цифры) skali [skaː-]ннкмгл-i, skala [skaː-]ннкжгл-a(;0-ir); stigiнпмгл-i(rað av tølum); шкала́ зарабо́тной пла́ты lønarskali, lønarstigiмгл-i; скользя́щая шкала́ glíðiskalaннк, glíðistigiнп; 9 ба́ллов по шкале́ Бо́форта 9 stig eftir [εʰtː-] Beaufortstiganum [poː-]нп, 9 stig eftir [εʰtː-] Beaufortskalanumннкпроф.[poːfɔɹ̥tskaː-]
шка́лик	m gml.1. (мера)gamalt russ. rúmmál, serl. til brennivín og vín,= o,06 l.2. (посуда) ílat (fløska, glas), ið tekur o,6 l.
шкандыба́ть	ipf(pfпрошкандыба́ть)óvkm.komaслнo-o-ohaltandi (ковылять), skjølkaaði, hólkaaði(плестись)
шка́нцы	m plurskansiмгл-i(á skipi)
шкату́лка	plurшкату́л|ки, ~ок, ~камfskrínс0о; музыка́льная шкату́лка spælidósж0-ir
шкаф	о шка́фе, в {на} шкафу́; шкаф|ы́, ~о́в, ~а́мmskápс0о=>стенно́й
шквал	m1.(порыв ветра) vindblak [vɪnp-]с0о{a/ø}, hvirlaжгл-a, kastс0о{a/ø}, bylurмсогл-arред.(сильный)2.:fl.шквал огня́ ríðж0-irav skotum, granatregn [-Ꞌnaː-]с0о; шквал возмуще́ния aldaжгл-aav øsing
шква́листый	stfшква́лист, ~а, ~о, ~ыadj(sum er) við hvirlum
шква́льный	adj: шква́льный ого́ньsíшквалогня́
шква́рки	шква́рок, шква́ркамf plurstokt pettirсгл-iмнav (fleska)svørði; ≈ kroturжгл-aмн(от печени,нутряного сала и др.)
шкво́рень	Genшко́рн|я;plur~и, ~ей, ~ямm(dreyi)tappurмсогл-ar, (dreyi)pinnurмсогл-ar
шке́рить	шке́р|ю, ~ишь, ~ятipf что-л.sløgair(d){+}o-t
шке́рочный	adjsløgingar-
шке́рщик	adjsløgariмгл-ari
шкет	m óvkm.drongurмсогл-ir{+}, ungur drongurмсогл-ir{+}
шкив	mblokkurмсогл-ar(hjól), skivaжгл-a(hjól)
шки́пер	plurшки́пер|ы, ~ов, ~амogшкипер|а́, ~о́в, ~а́мm1.gml.(коммерческого судна) skipariмгл-ari(á farmaskipi)2.(речного судна) skipariмгл-ari(á áarprámi)3.(боцман) bátsmaðurмнепр
шки́рка	f tlm.: взятького-л.за шки́ркуtlm.a) taka í kraganá o-m; b) taka í herðatoppiná o-m
шко́дить	шко́д|ишь,~ятipfóvkm.veraслнa-ó-oat meini, geraнепрfortreð [-Ꞌtʰɹeː]неформ.
шко́дник	mtlm.skaðagripurмсогл-s,-ir
шко́ла	f1.(учебное учреждение,здание) skúliмгл-i(stovnur,bygningur); нача́льная шко́ла barnaskúli [-tn-] (1.-4. klassi í Russlandi); сре́дняя шко́ла a) (десятилетка) tíggju ára skúli (í Russlandi); b) 5.-10. klassi í Russlandi; c) millumskúli [-tl-]ист.(на Фарерах до 1962 г. для 12-16 летних учеников); музыка́льная шко́ла musikkskúli [-Ꞌsɪʰk-] (í Russlandi serskúli fyri børn við serligum musikalskum gávum); шко́ла с преподава́нием ря́да предме́тов на англи́йском языке́ enskmæltur skúli (í Russlandi skúli,har meginparturin av undirvísingini er á enskum); англи́йская шко́лаtlm.skúli við serligum denti á undirvísing í enskum; математи́ческая шко́ла støddfrøðiligurнпstudentaskúli [-Ꞌtε-], matematiskur [maːtɪꞋmaː-] studentaskúli [-Ꞌtε-]; шко́ла продлённого дня skúli við longdari upplatingartíð (har næmingarnir kunnu vera allan dagin); поступи́ть в шко́лу fara í skúla, byrja í skúlanum; ходи́ть в шко́лу ganga í skúla; учи́ться в шко́ле ganga í skúla; пропуска́ть шко́лу {не ходи́ть в шко́лу} forsøma [-Ꞌsøː-]ir(d)skúlan, skulkaaði2.(выучка) læraжгл-a, skúliмгл-i(roynd); шко́ла жи́зни lívsins skúli; он челове́к ста́рой шко́лы hann er av tí gamla slagnum [slεanʊn]3.(направление в искусстве и др.) skúliмгл-i(í vísindum,list o.tíl.); созда́ть {основа́ть} шко́лу skapa ein skúla4.ítr.(упражнения) raðс0о{a/ø}{0<>}av tvungnum øvilsum (í listskoyting)
шко́ла-интерна́т	[-тэ-]f-mkostskúliмгл-i
шко́лить	шко́л|ю, ~ишь, ~ятipf(pfвы́школитьвы́шко́л|ю, ~ишь, ~ят)кого-л.tlm.skúlaaðio-n(методично учить); agaaðio-n, venjaслнa-a-ao-n, tyktaaðio-n(муштровать)
школота́	f bert sing koll niðr.skúlabørn [-tn]с0о{a/ø}мн; skúlaungdómurмсогл-arсобир
шко́льник	mskúladrongurмсогл-ir;-s,-ir{+};plur(обоего пола) skúlabørn [-tn]с0о{a/ø}мн, skúlanæmingarмсогл-arмн
шко́льница	fskúlagentaжгл-a, skúlanæmingurжгл-a(genta)
шко́льный	adjskúla-; шко́льный това́рищ skúlakammeratur [-raː-]ннк, skúlavinur; де́ти шко́льного во́зраста børn [-tn] í skúlaaldri
школя́р	Gen, Accшколяр|а́;plur~ы́, ~о́в, ~а́мmgml.,tlm.skúladrongurмсогл-ir;-s,-ir{+}
шкот	mskip.skjøtiсгл-i(на парусных судах), skeytabandс0о{a/о}(на фар. лодке)
шку́ра	f1.(снятая с животного кожа) skinnс0о, húðж0-ir(кожа животного с волосами); roðс0о{0<>i}(овечья кожа без шерсти); bjølgurмсогл-ir,-ar(снятая чулком); бы́чья шку́ра neytahúð; снять шку́руsíдрать22.óvkm..(кожа человека) húðж0-ir(á fólki)3.tlm.síкожура́4.m, fóvkm.,atf.(о человеке)o-r, ið sætar sær, egoistur [eːkoꞋist-]интмсогл-ar@спаса́ть свою́ шку́руsleppaслнa-u-osær heilskapaður burturúr [-Ꞌʉuɹ];быть вчьей-л.шку́реvera í brókunumhjá[tʃʰ-]o-mперен., идиом.; я не хоте́л бы быть в его́ шку́ре eg hevði [hεijɪ] ikki viljað verið í hansara brókum;(со)дратьс кого-л.шку́ру {семь шкур}fláaaðio-n, púrgaaðio-n;спусти́ть шку́рус кого-л. bukaaðio-nav (избить), faraслнó-ó-ailla [ɪtla]við o-m(плохо обойтись);испы́тывать {почу́вствовать}что-л.на свое́й шку́реfølao-tupp á sín egna kropp =>дели́ть@,медве́жий,ове́чий@
шку́рить	шку́р|ю, ~ишь, ~ятipf что-л.slípaaðio-tvið sandpappíri [san̊p-]
шку́рка	plurшку́р|ки, ~ок, ~камf1.dim avшку́ра 1; бе́личья шку́рка ekernskinn [eːkεɹn-]ннк, íkornaskinn [ʊikʰɔtn-]нп2.(наждачная) sandpappír [san̊p-]с0о3.tlm.(кожица плода) skalс0о{a/ø}(á summum fruktum o.ø.)
шку́рник	mtlm.,vanv.o-r, ið sætar sær, egoistur [eːkoꞋɪst-]интмсогл-ar
шку́рничество	megoisma [eːkoꞋɪ-]интжгл-а, sjálvsøkni [ʃɔl̥s-]сгл-iкн.
шку́рный1	Iadj(Кшку́ра) skinn-
шку́рный2	IIstfшку́р|ен, ~на, но, ~ныadj tlm.sum (bara) er til egnan fyrimun; egoistiskur [eːkoꞋɪst-]интсоглsk;шку́рные интере́сы ≈ hugurмсогл-ar;-irat sæta sær; ≈ hugurмсогл-ar;-irat nøra ˈ at sær
шкуросъёмный	adj: шкуросъёмная маши́на skrædlimaskina, skrædlariмгл-ari
шл…	1. шла, шло, шлиpret avидти́2.шлю, шлёшьo.s.fr. pres avслать3.шли, шли́теimper avслать
шла	pret f avидти́
шлагба́ум	mvegbummurмсогл-ar(на дороге); jarnbanabummur [janpaː-]ннкмсогл-ar, jarnbreytarbummur [janpɹεi-]нпмсогл-ar(на железнодорожном переезде)
шлак	m1. (расплавленная масса) slaggaжгл-аспец.2.oftast plur (остатки в организме)ótørvс0омн спец.,avfalsstoffннкс0опроф.
шлакобето́н	mslaggabetongс0оспец.
шланг	mslanga [slaŋka]жгл-а(amboð); пожа́рный шланг brandslanga [pɹanslaŋka]
Шле́звиг-Го́льштейн	[-тэйн]m-mSchleswig-Holstein [sleːsviːk-]с0{дат.0}, Slesvík-Holstein [sleːs-]нпс0{дат.0}
шле́йка	plurшле́йки, шле́ек, шле́йкамf1.dim avшлея́2.(лямка)breitt bringuband(á rossi)
шлейф	msleipс0о, slepс0о(á kjóla o.tíl.)
шлем1	Imhjelmur [jε-]ннкмсогл-ar, hjálmur [tʃʰɔ-]нпмсогл-ar; водола́зный шлем dúkkarahjelmurннк, kavarahjálmurнп; мотоцикле́тный шлем stúrthjelmurннк, fallhjálmur [-tl-]нп
шлем2	IImkort.(в карточной игре) slemmс0о; большо́й шлем stóraslemm
шлёп	Ipredtlm.: он шлёп в грязь og hann tjumsandi niður í rununa, hann tjumsaði niður í rununa, hann dumsaði niður í rununaIIintertjums!; bums!
шлёпанец	Genшлёпанц|а;plur~ы, ~ев, ~амmtlm.inniskógvurмсогл-ar{+}(oftast opin aftan)
шлёпать	ipf1.(pf momentшлёпнутьшлёпн|у, ~ешь, ~ут) (ударять) klamsaaði; skvamblaaði(по воде)2.pfотшлёпать (бить) gevaслнa-ó-iein klams3.tlm.(брести) tvassaaði, tøssaaði; шлёпать по гря́зи tøssa í rununi;óvkm.gangaслнe-i-i(ходить)4.(о туфлях) slafsaaði(um skógvar); он шлёпал ту́флями tað slafsaði í skónum hjá [tʃʰ-] honum
шлёпаться	ipf(pf momentшлёпнутьсяшлёпн|усь, ~ешься, ~утся)tlm.pumsaaði, dumsaaði(с шумом); dettaслнa-u-obarðlangur, dettaслнa-u-ofram eftir [εʰtː-] rommum (всем телом)
шлёпнуть	pf1.moment síшлёпать2.ipfшлёпатьАccóvkm.(убить,застрелить) skjótaслнey-u-oВин, drepaслнa-u-iВин
шлёпнуться	pf moment síшлёпаться
шлепо́к	Genшлепк|а́;plur~и́, ~о́в, ~а́мmklamsс0о, klamsurмсогл-ar; bresturмсогл-s,-ir
шлея́	f reim frá bógtrænum í týggjum
шли1	Iimper sing avслать
шли2	IIpret plur. avидти́
Шлиссельбу́рг	mSchlüsselburg [ʃlʏsːεlpʊɹk]м0{дат.0}(1944-1992Петрокре́пость)
шлифова́льный	adjslípi-; шлифова́льный круг slípiskiva; шлифова́льный стано́к slípimaskina
шлифова́льщик	mslípariмсогл-ari
шлифова́ние	n síшлифо́вка
шлифова́ть	шлифу́|ю, ~ешь, ~ютipf(pfотшлифова́тьотшлифу́|ю, ~ешь, ~ют)что-л.1.(обрабатывать поверхность) slípaaðio-t, pussaaðio-t(шкуркой); fílaaðio-t(напильником); fínpussaaðio-t(тщательно)2.fl.(совершенствовать) fínpussaaðiо-t
шлифо́вка	f1.(кшлифова́ть 1) slípingж0-ar, fíling (напильником); fínpussingж0-ar(тщательно)2.fl.(совершенствование) fínpussingж0-ar
шлифо́вщик	m síшлифова́льщик
шло	pret n avидти́
шлюз	m1.(гидротехническое сооружение) slúsaжгл-a(í á o.a.); воро́та шлю́за slúsuportur; открыва́ть шлюз lata slúsu upp; закрыва́ть шлюз lata slúsu aftur [aʰtː-]2.(переход между зонами) slúsaжгл-a(milum økir o.a.)3.teld.(в эвм): (межсетево́й) шлюз gateway [kεitvεi]м0-ar(опр-ur){дат.0}
шлюзова́ть	шлюзу́|ю, ~ешь, ~ютipf что-л.(суда) slúsaaðio-t(skip)
шлюзово́й	adjslúsu-; шлюзова́я ка́мера slúsukamar; шлюзовы́е воро́та slúsuportur
шлюпба́лка	plurшлюпба́л|ки, ~ок, ~камfdavidur [taːv-]мсогл-arмор.
шлю́пка	plurшлю́п|ки, ~ок, ~камf(stór)bátur [stœɹ-]мсогл-ar; sjalupp [-Ꞌlʊʰpː]ж0-ir(ос. на военных судах); спаса́тельная шлю́пка redningsbáturннкпроф., bjargingarbáturнп; дежу́рная спаса́тельная шлю́пка mob-báturмор.=>спусти́тьА 2
шлю́почный	adj(stór)báts- [stœɹ-]
шлю́ха	fóvkm.,illb.horaжгл-a
шля́гер	mslagari [slaːk-]ннкмгл-ari
шля́па	f1.(головной убор) hatturмсогл-ar; да́мская шля́па damuhattur [taː-]; наде́ть шля́пу fara í hatt; снять шля́пу fara úr hattinum, taka hattin av; приподня́ть шля́пу heilsaaði(við at lyfta hattin uppfrá); он без шля́пы hann er hattleysur2.fl., niðr.(о человеке) deydaжгл-a@де́ло в шля́пеhatta er í lagi
шля́пка	plurшля́п|ки, ~ок, ~камf1.dim avшля́па 12.(женская шляпа) (lítil) damuhattur [taː-]мсогл-ar3.(верхняя часть): шля́пка гвоздя́ høvd [hœtː]с0о{+}á seymi, høvd [hœtː]с0о{+}á nagla, seymhøvd [-œtː]с0о{+}, naglahøvd [-œtː]с0о{+}; шля́пка гриба́ hatturмсогл-ará hundalandi; шля́пка ги́льзы hólkurмсогл-ar(á patrónhylki)
шля́пник	mhattamakariмгл-ari
шля́пница	fhattamakariмгл-ari(konufólk)
шля́пный	adjhatta-; шля́пный магази́н hattahandil
шля́почный	adj: шля́почные грибы́ hattasopparбот.
шля́ться	ipfóvkm.rekastслнa-ó-i, sleingjastir(d), malaслнó-ó-a
шлях	m gml. Prpо шля́хе, на шляху́; plurшлях|и́, ~о́в, ~а́м(eis.шля́х|и, ~ов, ~ам) høvuðsvegurмсогл-ir, landsvegur [lan̊s-]мсогл-ir(í Ukraina og Suðurrusslandi)
шля́хта	fsøg.polskur (lág)aðalм0-ir
шля́хтич	msøg.polskur (lág)aðalsmaðurмнепр
шмат	plurшмат|ы́,~о́в, ~а́мm óvkm.bitiмгл-i, pettiсгл-i(ofta av o-m etandi)
шмато́к	Genшматк|а́; plur~и́, ~о́в, ~а́мm óvkm.bitiмгл-i, pettiсгл-i(ofta av o-m etandi)
шмель	Genшмел|я́;plur~и́, ~е́й, ~я́мm(Bombus) humlubiж0-ir
шмон	margotsíо́быск
шмона́ть	ipf(pfобшмона́ть)argotsíобыска́ть
шмо́тки	шмо́т|ок, ~камf plur kollóvkm.klæðir (одежда)сгл-iмн; óruddс0о(rusk)
шмотьё	nóvkm.síшмо́тки
шму́тки	шму́т|ок, ~камf plur kollóvkm.síшмо́тки
шмутьё	n síóvkm.шмо́тки
шмуцти́тул	msmussblaðс0о{a/ø}{0<>i}(ið verjir tittulblaðið í bók)
шмыг	predtlm.: он шмыг в дверь og so var hann uttanduraður; hann smeyg sær útum [-Ꞌtʰʊmː]
шмы́гать	ipf(pf momentшмы́гнутьшмы́гн|у, ~ешь, ~ут)tlm.1.(двигаться) smettaслнa-u-o(smúgva), smúgvaслнey-u-o; шмы́гнуть в дверь smoyggjair(d)sær útum [-Ꞌtʰʊmː]2.: шмы́гать но́сом snýsair(t)(hart)
шмы́гнуть	pf moment avшмы́гать 1
шмя́кать	ipf síшмя́кнуть
шмя́каться	ipf síшмя́кнуться
шмя́кнуть	шмя́кн|у, ~ешь, ~утpf(ipfшмя́кать)Acc óvkm.lorkaaðiВинniður (við slafsandi ljóði), lataслнæ-ó-aВинdumsa niður (við slafsandi ljóði)
шмя́кнуться	шмя́кн|усь, ~ешься, ~утсяpf(ipfшмя́каться)óvkm.aðiniður (við slafsandi ljóði) dumsaaðiniður (við slafsandi ljóði)
шнитт-лу́к	m(Allium schoenoprasum) grønleykurмсогл-s,-ir
шни́цель	mschnitzel {snitsil} [snɪʰtsɪl]м0осн
шно́бель	m jarg.(stór) nøsж0-ar{ø/a}, klyvariмгл-ariшутл.,пренебр. (nøs)
шно́ркель	msnorkil [snɔɹ̥kɪl]м0осн-s,-ar(á undirvatnsbáti)
шно́рхель	m síшно́ркель
шнур	Genшнур|а́;plur~ы́, ~о́в, ~а́мm1.(тонкая верёвка) snórurмсогл-ar, bandс0о{a/o}(бечёвка)2.el.(провод) leidningurмсогл-ar3.(запальный) fjúsс0о4.fisk.(подпуска и др.) uppstandariмгл-ari(áпо́дпуск (sí)o.tíl.) =>бикфо́рдов
шнурова́ть	шнуру́|ю, ~ешь, ~ютipf что-л1.pfзашнурова́тьзашнуру́|ю, ~ешь, ~ют(стягивать шнуром) bindaслнa-u-uo-t; шнурова́ть боти́нки binda lissur (í skóm)2.pfпрошнурова́тьпрошнуру́|ю, ~ешь, ~ют(прошивать) seymaaðio-tsaman (við at koyra band ígjøgnum)
шнуро́вка	plurшнуро́в|ки, ~ок, ~камf1.(действие;место) tað at binda (síшнурова́ть1, 2), snøringж0-ar2.(верёвочка) snórurмсогл-ar, band (бечёвка)с0о{a/o}; lissaжгл-a(á skóm) (на ботинке)
шнуро́к	Genшнурк|а́;plur~и́, ~о́в, ~а́мmsnórurмсогл-ar, (ботиночный) lissaжгл-a(á skóm); шнурки́ развяза́лись lissurnar eru farnar upp; завяза́ть шнурки́ (на ботинках) binda lissurnar
шныря́ть	ipftlm.vimsaaði, titaaði, snittaaði, snirraaði; шныря́ть глаза́ми kveitair(t)higar og hagar, skjótaслнey-u-oeyguni, rennaслнa-u-ueyguni
шов	Genшва;plurшвы́, швов, швамmseymurмсогл-s,-ir(samankoming), samankomingж0-ar(место соединения); сварно́й шов sveisiseymur; ло́пнуть по швам sprotna upp; чулки́ без шва seymaleysir sokkar;наложи́ть шов seymaaðisaman, setaur(t);ir(t)pentur í (sár); снять швы taka tráðin úr (sári), taka pentur úr sári@держа́ть ру́ки по швамstandaслнó-ó-arætt, standaслнó-ó-aí rættstøðuспорт.;трещи́т по всем швамtað losnar í súðunumперен.
шовини́зм	mchauvinisma [ʃoːviꞋnɪ-]интжгл-a; мужско́й шовини́зм manschauvinisma
шовини́ст	mchauvinistur [ʃoːviꞋnɪ-]интмсогл-ar
шовинисти́ческий	adjchauvinistiskur [ʃoːviꞋnɪ-]интсоглsk
шок	mskelkurмсогл-s,-ir, sjokkннкпроф.с0о; hvøkkurмсогл-s,-ir(от испуга и др.); не́рвный шок nervasjokkннк, nervaskelkurнп; э́то для неё большо́й шок hetta var eitt stórt sjokkннкfyri hana, hon fekk ein skelk av hesum; лече́ние шо́ком sjokkbehandling [-hanl-]ннкпроф., skelkviðgerð [-vɪtʃ-]лп
шо́кер	melektrosjokkvápn [-ˈlε-]с0о; ≈ streympistólurмсогл-ar, streympistólж0-ir
шоки́ровать	шоки́ру|ю, ~ешь, ~ютipf/pf Accsjokera [-Ꞌkʰeː-]ннкaðiВин, skelkaaðiВин
шо́ковый	adjsjokk-ннкпроф., skelk-лп=>терапи́я
шокола́д	m1.(изделие) sjokuláta [ʃoꞋklaː-], [ʃoːkʊꞋlaː-]жгл-a, sukurláta [-Ꞌlɔa-]жгл-aкн.,ред.; пли́тка шокола́да ein pláta av sjokulátu; шокола́да в пли́тках sjokuláta í plátum2.(напиток) kakao [kʰaꞋkʰaː]с0гл(drykkur)
шокола́дка	plurшокола́д|ки, ~ок, ~камmpetti av sjokulátu [ʃoꞋklaː-]; konfekt [-Ꞌfεʰkt]ж0-ir
шокола́дный	adj1.(кшокола́д) sjokulátu- [ʃoꞋklaː-], sjokuláta- [ʃoꞋklaː-]2.(о цвете) sjokulátatbrúnur [ʃoꞋklaː-]согл, sjokulátubrúnur [ʃoꞋklaː-]согл, sjokulátafarvaðurннкглaður@шокола́дное де́рево(Theobroma cacao) kakaotræ [kʰaꞋkʰaːo-]
шокотерапи́я	f síтерапи́я, шо́ковая
шо́мпол	plurшомпол|а́, ~о́в, ~а́мmlaðarstokkurмсогл-arуст.
шоп	mhandilм0осн-s,-ar(oftast við vesturlendskum sniði og vesturlendskum vørum)
шо́пинг	mshopping [ʃɔʰpː-]ж0-arнеформ.
шопинг-ту́р	minnkeypstúrurмсогл-ar;-s,-ir
шопинг-це́нтр	mshoppingcentur [ʃɔʰpːɪŋksε-]с0осннеформ.(ос. о нефарерских условиях), sølumiðstøðж0-ir
шо́ппинг	m síшо́пинг
шоппинг-ту́р	m síшопинг-ту́р
шоппинг-це́нтр	m síшопинг-це́нтр
шо́рник	msaðilmakariмгл-ari
шо́рный	adjsaðilmakara-
шо́рох	mskróvс0о
шорт-ли́ст	[шо-]Genшорт-листа́,plurшорт-лист|ы́, ~о́в, ~а́мm stuttur listi, stutt yvirlit yvir eitt úrval av fólki (í kapping o.ø.)
шо́рты	шорт, шо́ртамf plurshorts [ʃɔʂː]с0омн
шо́ры	шор, шо́рамf plurbotnurмсогл-ar(klaffur fyri eygum á rossum o.ø.); у него́ шо́ры на глаза́хfl.hann hevur botn fyri eygunumидиом.@держа́тького-л.в шо́рах {взятького-л.в шо́ры}gevaслнa-ó-io-mstutt boðидиом., havaнепрfast tamarhald áo-m
ШОС	[шос]m indeclШанха́йская организа́ция сотру́дничестваупотребляется англ. сокращениеSCO [εsː seː ˈoː]с нескл.(англ. Shanghai Cooperation Organisation) Shanghaisamarbeiðsfelagsskapurin [ʃaŋkhai-]
шоссе́	[-сэ́]n indeclhøvuðsvegurмсогл-ir{+}, landsvegur [lan̊sv-]мсогл-ir{+}
шоссе́йный	[-сэ́-]adj: шоссе́йная доро́гаsíшоссе́
шотла́ндец	Gen, Accшотла́нд|ца[-нц-];plur~цы , ~цев, ~цамmskotiмгл-i, skottariннкмгл-ari
Шотла́ндия	fSkotlandс0о{a/o}=>Но́вая
шотла́ндка	[-нк-] Iplurшотла́нд|ки, ~ок, ~камfskotiмгл-i, skottariннкмгл-ar(konufólk)
шотла́ндка	[-нк-] IIf(материя) (skotsk)ternut toy [tʰœi] (реже[tʰɔi])
шотла́ндский	[-нск-]adjskotskur [skɔsk-], [skɔʰtsk-]соглsk
шо́у	n indecl1.(представление) show [ʃɔu]ннкс0о{0<>i}проф.(sýning)2.fl.,atf.(нечто показное) show [ʃɔu]энкс0онеодобр.; полити́ческое шо́у eitt politiskt [-Ꞌlɪʰtː-] show
шоу-би́з	indecl-m tlm.showbusiness [ʃɔupɪsnɪs]ннкс0опроф.
шо́у-би́знес	indecl-mshowbusiness [ʃɔupɪsnɪs]ннкс0опроф.
шоуву́мен	[-мэн]f indeclsjónvarpsverturмсогл-ar(konufólk)
шоуме́н	[-мэ́н]mshowmaður [ʃɔʊm-]мнепр.публ.
шофёр	plurшофёр|ы, ~ов, ~амogóvkm.шофер|а́, ~о́в, ~а́мmsjaførur [-Ꞌføː-]ннкмсогл-ar, (bil)førariмгл-ari; шофёр такси́ taksasjaførur, hýruvognsførari
шофёрский	adjsjafør- [-Ꞌføː-]ннк, bilførara-
шпа́га	fkorðaжгл-а=>скрести́ть@
шпага́т	f1.(бечёвка) seglgarn [sεlkatn]с0о2.:ítr.(де́лать) шпага́т gera spagat [-Ꞌkaːt], fara niður í spagat [-Ꞌkaːt]
шпагоглота́тель	msvørðslúkariмгл-ari, sápilslúkariмгл-ari
шпа́жник	m síгладио́лус
шпаклева́ть	шпаклю́|ю, ~ешь, ~ютipf(pfзашпаклева́тьзашпаклю́|ю, ~ешь, ~ют)что-л.spartla [spaʂla]aðio-t, kitta [kʰɪ-]aðio-t(замазкой)
шпаклёвка	f1.(действие) spartling [spaʂl-]ж0-ar, kitting [kʰɪ-]ж0-ar2.(вещество) spartilс0осн; kitt [kʰɪ-]с0о(для окон)
шпа́ла	f1.(брус) timburstokkurмсогл-arundir jarnbanaskinnarum [janpaː-]2.tlm.(знак «въезд возпрещён»)ferðsluskeltið «innkoyring bannað»
шпале́ры	шпале́р, ~амf plur1.(решётки) espalier [εspaꞋʎjeː]с0гл(trærimar upp eftir veggi)2.(шеренги войск) espalier [εspaꞋʎjeː]0гл(rekkjur av hermonnum);выстра́иваться шпале́рами stilla upp í espalier3.(деревья,кусты по сторонам дороги)røð av trøum el. runnum fram við vegi4.gml.(обои) tapet [-Ꞌpʰeːt]с0о
шпана́	f oftast kollóvkm.,vanv.(хулиганы) vittuggirсгл-iмн, búllarмгл-iмн; pakkс0особир., harkaliðс0о{0<>i}собир., partaníggjс0о{0<>i}собир.(сброд,чернь)пренебр.
шпанго́ут	mspantмор.с0о
шпа́нский	adj: шпа́нская му́ха {му́шка} a) (Lytta vesicatoria) sponsk fluga; b) (пластырь) sponsk fluga (plástur)
шпарга́лка	plurшпарга́л|ки, ~ок, ~камftlm.1.(у учащихся)seðil at svika til próvtøku(við upplýsingum);по́льзоваться шпарга́лкой на экза́мене svikaaðitil próvtøku (við at brúka seðil har upplýsingar eru skrivaðir upp)2.(бумажка)pappír við røðu el.ø. skrivaðum frammandundan
шпа́рить	шпа́р|ю, ~ишь, ~ятipf1.Accошпа́ритьошпа́р|ю, ~ишь, ~ят(кипятком) skáldaаðiВин2.óvkm.(об быстром,энергичном дейтвии) drívaслнei-i-iá, koyrair(d)á; шпа́рить на гармо́шке spenna seg út at spæla upp á harmoniku; он так и шпа́рит по-ру́сски tað stendur ikki Ꞌ á at snakkaннкrussiskt hjá [tʃʰɔa]honum, hann snakkarннкrussiskt sum brentнеформ.; шпарь домо́й! skunda tær til hús!
шпа́риться	шпа́р|юсь, ~ишься, ~ятсяipf(pfошпа́ритьсяошпа́р|юсь, ~ишься, ~ятся) skáldaаðiseg
шпат	mspattс0огеол.; исла́ндский шпат íslendskt [-lεn̊st] tvíspatt; полево́й шпат feltspatt; плавико́вый шпат flusspatt
шпа́тель	m1.lækn.(медицинский инструмент) spatil [spaː-]м0осн-s,-ar2.(для шпаклёвки) spartilм0осн-s,-ar
шпенёк	Genшпенька́; plurшпеньк|и́, ~о́в, ~а́мmstiftж0-ir
шпига́т	mspygatt [spyː-]с0омор.
шпигова́ть	шпигу́|ю, ~ешь, ~ютipf(pfнашпигова́тьнашпигу́|ю, ~ешь, ~ют)1.что-л.(салом)síнашпигова́ть(салом)2.кого-л.fl.,tlm.(внушать) tyggjair(d){y/u}{+}niður í o-n, prentaaðiinn í o-n
шпик1	Im(сало) (saltað) svínafeittс0о
шпик2	IIGen, Accшпик|а́;plur~и́, ~о́в, ~а́мmtlm.,vanv.politispiónur [pʰoːliꞋtʰiː-]ннкмсогл-ar, sneytariмгл-ari(um politi); uppdagari [-Ꞌtεa-]мгл-ari, detektivur [teːtεʰkꞋtʰiː-]мсогл-ar(сыщик)
шпиль1	Imarkit.(на зданиях) spírс0о
шпиль2	IImskip.(лебёдка) spælс0о{æ/ø}(vinda við loddrøttum aksli), kappstanur [-staː-]мсогл-arмор.
шпи́лька	plurшпи́льки, шпи́лек, шпи́лькамf1.(для волос) hárnálж0-ir2.gml.(для шляп) hattanálж0-ir; prónurмсогл-ar(til hatt) (с головкой)3.(гвоздь) stiftж0-ir, stiftskrúvaжгл-a4.(вид каблука) stiletthælur [stiꞋlεʰtː-]мсогл-s,-ir;-ar5.(колкость) glósaжгл-а; отпуска́ть шпи́льки (в а́дреского-л.) skjótaслнey-u-o(o-n viðo-m), glósaaðio-n
шпина́т	(Spinacia oleracea) spinat [spiꞋnaːt]с0о
шпингале́т	m1.(оконный) sláж0-ir(til vindeygu, hurðar)2.óvkm.(о человеке) manstandurс0оснпрезр.
шпи́ндель	mtekn.spinnilм0осн
шпио́н	mnjósnariмгл-ari, spiónur [spiꞋɔun-]ннкмсогл-ar
шпиона́ж	mnjósningж0-ar, spionasja [spiːoꞋnaː-]ннкжгл-a(в пoльзу Gen - fyri Вин); промы́шленный шпиона́ж ídnaðarnjósning, industrispionasja [-Ꞌstɹiːspiːonaː-]ннк
шпио́нить	шпио́н|ю, ~ишь, ~ятipf1.(заниматься шпионажем) njósnastaði, spionera [spiːoꞋneː-]ннкaði2.за кем -л.óvkm.(выслеживать) skuggaннкaðio-n, njósnastнпaðiumo-n, útspioneraннкaðio-n
шпио́нка	plurшпио́н|ки, ~ок, ~камfnjósnariмгл-ari, spiónur [spiꞋɔun-]ннкмсогл-ar(konufólk)
шпио́нский	adjnjósnara-, spión- [spiꞋɔun-]ннк
шпио́нство	nnjósningж0-ar, spionasja [spiːoꞋnaː-]ннкжгл-a
шпиц1	Im(собака) spísshundurмсогл-ar
шпиц2	IImgml.síшпильI
Шпицбе́рген	mSvalbardс0{дат.0}, Spitsbergen [-kεn]с0{дат.0}, Svalbarð [svalpεaɹ]с0{дат.0}кн.
шпицру́тен	[-тэн]mgml.bargeilж0-arист.
шплинт	Genшпли́нтаogшплинта́msplittaжгл-aтехн., stiftж0-irтехн.
шпо́кнуть	шпо́кн|у, ~ешь, ~утpf кого-л.óvkm.1.(застрелить) skjótaслнey-u-oo-n2.(иметь половое сношение с кем-л.) fríggjaaðivið o-m, moggaaðio-mвульг., табу(um mannfólk)
шпон	m1.tekn.(лист древесины) finer [-Ꞌneːɹ]с0о(ikki samanlímað)2.prent.(в типографии) skjótingж0-arполиг.
шпо́на	f síшпон
шпо́нка	plurшпо́н|ки, ~ок, ~камf(rundur) tappurмсогл-ar, (rundur) naddiмгл-i; dyvil [tyː-]м0оснспец.(для соединеня предметов), blindnagliмгл-iспец., ред.(для соединеня предметов)
шпо́ра	f1.(металлический стержень) sporiмгл-i; дать шпо́ры коню́ spora ross, seta sporarnar í ross2.(у петуха и др.) hekilм0осн-s,-ar, hekl [hεkl]с0о, heglс0о(hjá hana)
шпо́рить	шпо́р|ю, ~ишь, ~ятipf AccsporaaðiВин, setaur(t);ir(t)sporan íВин
шпринг	mskip.springс0омор.(endi) =>постано́вка
шприц	plurшпри́ц|ы, ~ев, ~амogtlm.шприц|ы́, ~о́в, ~а́мmlækn.,tekn.sproyta [spɹœi-] (реже[spɹɔi-])жгл-a
шприцева́ть	шприцу́|ю, ~ешь, ~ютipf что.л.1.(вводить под кожу, в вену и др.) sproyta [spɹœi-] (реже[spɹɔi-])aðio-t(inn í æðr o.a.)2.(начинять) sproyta [spɹœi-] (реже[spɹɔi-])aðio-t (inn í kaku o.tíl),fylla [fɪtla]ir(t)o-t(við onkrum, kaku o.tíl.)
шприцева́ться	шприцу́|юсь, ~ешься, ~ютсяipfverða sproytaður [spɹœi-] (реже[spɹɔi-])глaður
шпрот	m(Sprattus) brislingurмсогл-ar
шпро́та	f síшпрот
шпу́лька	plurшпу́льки, шпу́лек, шпу́лькамfspoliмгл-i; нама́тывать на шпу́льку spolaaði
шпунт	Genшпунт|а́;plur~ы́, ~о́в, ~а́мm1.(выступ) plógkamburмсогл-ar; pløgingж0-ar, plógvс0о{+}(соединение)2.(свая) spunsс0о(peli o.tíl.)3.(пробка) spunsс0о, spunslс0о(í víntunnu)
шпунтово́й	adj: шпунтова́я сва́я spunspeli; шпунтова́я сте́нка spunsveggur
шпур	Genшпу́ра; plurшпу́рыogGenшпур|а́; plur~ы́, ~о́в, ~а́мmholс0о(til perlu o.a. at spreingja við), borihol [poːɹh-]с0о; бури́ть шпур bora hol (til spreinging)
шпыня́ть	ipf1.óvkm.(толкать)Acckoyrair(ir)ˈ undirВин, stumpaaðiˈ undirВин, skumpaaðiˈ undirВин2.fl., tlm.(укорять)кого-л.brigslaaðio-m o-t, kastaaðio-m o-t fyri; rýðair(d)o-m o-tum nasarидиом.(тыкать носом)
шрам	marrс0о
шрапне́ль	f1.(снаряд) shrapnel [ʃɹaʰpnεl]ж0-ir(slag av granat)2.koll(пули) shrapnel [ʃɹaʰpnεl]ж0-irсобир, granatflísar [-Ꞌnaː-]ж0-arмн3.tlm.(перловая крупа) perlugrýnс0о
Шри-Ла́нка	f1.(остров) Sri Lanka [sɹiꞋlaŋ̊ka]ж нескл.(oyggj)2.(государство) Sri Lanka [sɹiꞋlaŋ̊ka]с нескл.(land)
Шри-Ланка́	síШри-Ла́нка
шрифт	plurшрифт|ы́, ~о́в, ~а́мogшри́фт|ы, ~ов, ~амm1.(графическая форма букв) skriftж0-ir; све́тлый шрифт kløn skrift; жи́рный шрифт feit skrift; ме́лким шри́фтом við lítlari skrift; типографи́ческий шрифт prentaðir stavir; выдели́тельный шрифт tand skrift; разме́р шри́фта skriftstødd; набра́тьчто-л.жи́рным шри́фтом setao-tvið feitari skrift; выделе́ние шри́фтом tenjing av skrift2.koll(типографические литеры) skriftж0-ir, typur [tʰyː-]жгл-aмн; fonturмсогл-ar(ЭВМ)
шрифтово́й	adjskrift-; шрифтово́е выделе́ние tenjing av skrift
шт.	шту́ка stk., stykki
штаб	plurштаб|ы́, ~о́в, ~а́мogшта́б|ы, ~ов, ~амmstápurмсогл-arспец.(herleiðsla); leiðslaжгл-a, stápurмсогл-arпроф.(felag, flokkur o.a.)
штабели́ровать	штабели́ру|ю, ~ешь, ~ютpf/ipf что-л.stakkaaðio-t, stáplaaðio-t
шта́бель	plurштабел|я́, ~е́й, ~я́мogшта́бел|и, ~ей, ~ямmstápilм0осн, (fiska)stakkurмсогл-ar(солёной рыбы), (torv)luturмсогл-ir(торфа), (viðar)rankiмгл-i(древесины)
штаби́ст	m tlm.stápsoffiserurмсогл-ar
штаб-кварти́ра	f1.herm.(военного штаба) høvuðskvarterннкс0о, høvuðsstøðнпж0-ir2.fl.(главный пункт) høvuðssætiсгл-i, høvuðsstøðж0-ir, høvuðskvarterннкс0о
штабни́к	Gen, Accштабнка́; plurштабник|и́, ~о́в, ~а́мm tlm.stápsoffiserurмсогл-ar
штабно́й	Iadjstáps-IImstápsoffiserurмсогл-ar
штаб-офице́р	mgml.stápsoffiserurмсогл-ar(yvirmaður við tign frá majori og uppeftir)
штабс-капита́н	m gml.stápskapteinurмсогл-ar(yvirmaður í tign niðan fyri kaptein)
штаг	mstak [staːk]мор.с0о
штаке́тник	m1.koll(доски) stakittfjalar [-Ꞌkʰɪʰt-]ннкж0-ir{ø/a};-ar{ø/a}мнпроф., stakittrimar [-Ꞌkʰɪʰt-]ннкж0-arмнпроф.2.(забор) stakitt [-Ꞌkʰɪʰtː]ннкж0опроф., rimagarðurмсогл-ar{a/ø}кн.
шта́мбовый	adjvið longum stelki, langstelkaðurглaður; шта́мбовые ро́зы langstelkaðar rósur, rósur við longum stelki
штамм	mbiol.stammaжгл-a(av bakterium,virus o.ø.); штамм лосо́ся laksastamma
штамп	m1.(штемпель) stempulс0осн2.(форма) stansaжгл-a3.fl.(шаблон) klisjé [kʰlɪꞋʃeː]энкж0-irпренебр.(fortugd hugmynd)
штампова́льный	adjstansi-;
штампо́ванный	Ipartic avштампова́тьIIadj1.tekn.(изготовленный штамповкой) stansaðurглaður2.fl.(шаблонный) banalur [-Ꞌnaː-]ннксогл(банальный), fortugdur [-Ꞌtʰʊ-]согл(избитый, о высказываниаях и др.), klisjékendur [kʰlɪꞋʃeː-]энксоглпренебр.
штампова́ть	штампу́|ю, ~ешь, ~ютipf что-л.1.pfзаштампова́тьзаштампу́|ю, ~ешь, ~ют,pfпроштампова́тьпроштампу́|ю, ~ешь, ~ют(штемпелевать) stemplaaðio-t2.pfнаштампова́тьотштампу́|ю, ~ешь, ~ют, отштампова́тьотштампу́|ю, ~ешь, ~ют(изготовлять при помощи штампа) stansaaðio-t3.pfзаштампова́тьзаштампу́|ю, ~ешь, ~ютfl.(делать по трафарету) geraнепрo-tá samlibandi, spýtair(t)o-tút
штампо́вщик	m arbeiðariмгл-ari, ið fæst við stansing
шта́нга	f1.tekn.(стержень) stongж0-ur{o/e}2.(атлетическая) vektstongж0-ir(jarnstong við vektum); занима́ться шта́нгой íðka vektlyfting [-lɪʰtː-]3.(футбольная) tvørliggjariмгл-ari,tvørstongж0-ur{o/e}(горизонтальная) (í máli); málstongж0-ur{o/e}(вертикальная)
штангенци́ркуль	mskjótilæraжгл-a
штанги́ст	mvektlyftari [-lɪʰtː-]мгл-ari
штанда́рт	f1.(флаг главы государства) flaggс0о{a/ø}hjá ríkisleiðara (kongi,forseta)2.søg.(знамя кавалерийского полка) fániмгл-ihjá reiðliði
штани́на	fbrókж0-ur{ó/ø}
штани́шки	штани́ш|ек, ~камfstuttar buksurжгл-aдистр
штаны́	штан|о́в, ~а́мm plurbuksurжгл-aдистр; две па́ры штано́в tvinnar buksur; дли́нные штаны́ langar buksur; коро́ткие штаны́ stuttar buksur; наложи́ть {класть} в штаны́óvkm., óf.a) (испражняться в штаны) geraнепрí buksurnar, skítaслнei-i-ií buksгрубо, kukkaaðií buksдетск.;b) (от страха) veraслнa-ó-eum at skíta í buksurnarгрубо(av ótta)
шта́пель	m slag av syntetiskum tægrstoffi
штат1	Im(часть государства) statur [staː-]мсогл-s,-ir(partur av einum landi); штат Пенджа́б staturin Pundjab [pʰʊɲtʃap]; штат Теха́с staturin Texas [tʰεʰksas]; Шта́ты (США)tlm.USA [uː εsː Ꞌaː], Amerika [-Ꞌmeː-]@генера́льные шта́тыsøg.generalstatirnir [keːniꞋraːlstaː-]мсогл-s,-irмн(stættating í summum londum í miðøld og seinni) =>коле́блющийся
штат2	IIm1.(личный состав) starvsfólk(ið) с0о(опр), personali(ð) [pʰεʂːˈˈaː-]ннксгл-i(опр), stápurмсогл-arпроф.(ос. о постоянной или особой группе); arbeiðsfólkið с0омн опр(б.ч. рабочие на заводах и т.п.); быть в шта́те vera í føstum starvi, vera fastansetturннк; быть не в шта́тетжvera freelancari [fɹiːlan̊s-], arbeiða freelance [fɹiːlan̊s-] (о журналистах и др.); зачи́слитького-л.в штат setaur(t);ir(t)o-ní fast starv, fastansetaннкur(t);ir(t)o-n; с це́лым шта́томGenvið einum heilum hópiav Дат2.oftast plur síшта́тноерасписа́ние (síшта́тный1)@ ему́ по шта́ту поло́жено...hann hevur rætt til ... =>сократи́ть2,сократи́ться2,сокраще́ние2
штати́в	mstativ [staꞋtʰiːv]ннкс0о; fóturмнепр(ножка,подставка)
шта́тник	mslangamerikanari [ameːɹiꞋkʰa-]мгл-ari
шта́тный	adj1.(кштат II 1) fasturсогл{a/ø}(um starvssetan), fastansetturннксогл; шта́тный сотру́дник fastur medarbeiðari; на шта́тной до́лжности í føstum starvi, fastansetturннк; шта́тное расписа́ние starvsfólkayvirlit; шта́тный идео́логatf.breyðideologur [-iteːoloːk-]2.fakm.: шта́тная ситуа́ция reglulig støða, vanlig støða; рабо́тать б шта́тном режи́ме arbeiða sum ætlað, arbeiða eftir ætlanini
шта́тский	Iadjsivilur [siꞋviː-]согл; в шта́тском {пла́тье} sivilklæddur [siꞋviː-], í sivil, í vanligum klæðum (ikki í herklæðum)IImsivilur [siꞋviː-]мприл(ikki hermaður)
шта́тское	с: в шта́тском sivilklæddur [siꞋviː-], í sivil [siꞋviː-], í vanligum klæðum (ikki í herklæðum)@искусствове́д {экономи́стo.s.fr.} в шта́тскомsivilklæddur KGB-agentur,ið letst vera listafrøðingur,búskaparfrøðingur o.s.fr.
ште́вень	[штэ́-]Genште́вн|я;plur.~и, ~ей, ~ямmstevniсгл-i
ште́кер	[штэ́-]mel.stikkariмгл-ari
ште́ккер	[штэ́-]m síште́кер
штемпелева́ть	[штэ́-]штемпелю́|ю, ~ешь, ~ютipf(pfпроштемпелева́тьпроштемпелю́|ю, ~ешь, ~ют)что-л.(ставить штамп) stemplaaðio-t
ште́мпель	[штэ́-]plurштемпел|я́, ~е́й, ~я́мogште́мпел|и, ~ей, ~ямmstempulс0оснпочто́вый ште́мпель poststempul
ште́мпельный	[штэ́-]adjstempul-; ште́мпельная поду́шка stempulpúta
ште́псель	[штэ́-]plurштепсел|я́, ~е́й, ~я́мogште́псел|и, ~ей, ~ямm1.el.(вилка) stikkс0о, stikkproppurмсогл-ar2.tlm., el.(розетка) stikkkontaktж0-ir
ште́псельный	adj: ште́псельная коро́бка stikkdósж0-ir, stungudósлпж0-ir
штибле́ты	штибле́т, ~амf1.gml.(полуботинки) hálvstivlar [hɔls-]мгл-iмн(upp um øklar)2.skemt.(ботинки) skógvarмсогл-ar{+}мн
шти́вка	fstúvingж0-ar(av farmi o.ø.)
штилево́й	adj: штилева́я пого́да stilli [-tlɪ]; штилева́я полоса́ {зо́на} kalmabeltiмор., lognarbeltiлпгеогр.
штиль	mlognж0-ir(тжмет0 баллов;0,0-0,2 м/сек); stilli [-tlɪ]сгл-i; kyrraжгл-a(о состоянии моря); мёртвый штиль blikalogn, deyðastilli [-tlɪ]; silvitniсгл-i; dýrdarkyrra, deyðakyrra (о состоянии моря)
штифт	Genштифта́,Prpо штифте́, на штифту́;plurштифт|ы́, ~о́в, ~а́мmtekn.stiftж0-ir, pinnurмсогл-ar
штифтово́й	adj: stift-; штифтово́й зуб stifttonn
шти́хель	mgravernál [-Ꞌveː-]ж0-ir, radernál [-Ꞌteː-]ж0-ir
шток	m1.tekn.(деталть поршневой машины и др.) stongж0-ur{o/e}; шток по́ршня stempulstong2.(якоря) akkersstokkurмсогл-ar
што́льня	fminugongdннкж0-ir(vatnrøtt), námsgongdнпж0-ir(vatnrøtt)
што́пальный	adjstoppi-; што́пальная игла́ stoppinál
што́паный	adjstoppaðurглaður
што́пать	ipf(pfзашто́пать)1.что-л.(заделывать дырку) stoppaaðio-t(bøta hol)2.кого-л.tlm.(зашивать раны и т.п. - о хирурге) seymaaðio-nsaman (um skurðlækna o.tíl.)
што́пка	plurшто́п|ки, ~ок, ~камf1.(действие) stoppingж0-ar2.(нитки) stoppigarn [-tn]с0о3.(заштопанное место) stoppс0о(stoppað stað á plaggi)
што́пор	m1.(пробочник) propptrekkjariмгл-ari2.flog.(о самолёте и др.) spinnс0оав.; войти́ в што́пор koma í spinnав.
што́порить	што́пор|ю, ~ишь, ~ятipfflog.spinnaслнa-u-uав.
што́пором	advflog.: идти́ што́пором komaслнo-o-oí spinnав.
што́ра	fgardina [-Ꞌtiː-]жгл-a; rullugardina [-tl-]жгл-a(поднимающаяся); stores [stoːɹɪs]ж нескл. мн(прозрачная раздвижная)
шторм	plurшто́рмы, ~ов, ~амogшторм|а́, ~о́в, ~а́мmstormurмсогл-ar(тжмет9 баллов; 20,8-24,4 м/с); жесто́кий шторм kolandi stormur (тжмет11 баллов; 28,5-32,6 м/с); си́льный шторм hvassur stormur (тжмет10 баллов; 24,5-28,4 м/с)
штормова́ть	шторму́|ю, ~ешь, ~етipfskip.ríðaслнei-i-istormin av
штормо́вка	plurштормо́в|ки, ~ок, ~камfvindjakki [vɪnj-]мгл-i
штормово́й	adjstorm-; штормова́я пого́да harðveður [haɹveːv-], stormveður [-veːv-]; штормово́е мо́ре ódnж0-irí sjónum, sjóvarilskaжгл-a; штормова́я ку́рткаsíштормо́вка=>пла́нка1,предупрежде́ние1
штормтра́п	m(skips)leytariмгл-ari(ið hongur eftir síðuni á skipi)
штоф1	Im søg.1.(мера)gml. russ. mát = 1/10 avведро́ (sí)2.(сосуд)ílat (fløska p.a), ið tekur 1 штоф
штоф2	IIm (ткань) svert klæði úr ull ella silki
штраф	mbótж0-ur{ó/ø}(sekt), sektж0-ir; заплати́ть ты́сячу рубле́й штра́фа {заплати́ть штраф (в) ты́сячу рубле́й}за что-л.gjalda túsund [tʰʉusɪn] rublar í bót, gjalda eina bót upp á túsund [tʰʉusɪn] rublar =>наложи́тьB,присуди́ть1,угро́за2
штрафна́я	adj stórt glas av víni, sum tann má drekka, ið kemur ov seint fyri at "fáa hini aftur"
штрафно́й	adj1.(кштраф) sektar-, bótar-2.:ítr.штрафно́й уда́р straffiннксгл-i, brotsspark (в футболе и т.п.); straffikast, brotskast (бросок); штрафна́я площа́дка brotsteigur; штрафна́я скамья́ (в хоккее) útvísingarbonkur (í íshockey); штрафно́й круг brotsumfarс0о{a/ø}3. :herm.штрафно́й батальо́н straffibatаljón =>назна́чить2
штрафова́ть	штрафу́|ю, ~ешь, ~ютipf(pfоштрафова́тьоштрафу́|ю, ~ешь, ~ют)кого-л.(на что-л. - við o-m) gevaслнa-ó-io-mbót, leggjaнепрbótá o-n, sektaaðio-n
штрейкбре́хер	mstreikubrótari [stɹεi-], [stɹai-]ннкмгл-ari, verkfalsbrótariнпмгл-ari
штрейкбре́херство	nstreikubrot [stɹεi-], [stɹai-]ннкс0о, verkfalsbrotнпс0о
штрек	mminugongdннкж0-ir(vatnrøtt), námsgongdнпж0-ir(vatnrøtt)
штри́пка	plurштри́п|ки, ~ок, ~камfstroppurмсогл-ar(á gamasjum o.ø. undir ilina)
штрих	Genштрих|а́;plur~и́, ~о́в, ~а́мm1.(линия) strikaжгл-a, linjaжгл-a(strika)2.(отдельная подробность) dragс0о{a/ø} (eyðkenni)
штри́хкод	mstrikukota {strikukoda}жгл-a, grindilлпм0осн
штрих-ко́д	m síштрихко́д
штрихова́ть	штриху́|ю, ~ешь, ~ютipf(pfзаштрихова́тьзаштриху́|ю, ~ешь, ~ют)что-л.strikaaðio-t, skravera [-Ꞌveː-]ннкaðiпроф.o-t, leggjaнепрskugga áo-t
штрихо́вка	plurштрихо́в|ки, ~ок, ~камf1.(действие) strikingж0-ar, skravering [-Ꞌveː-]ннкж0-ar, tað at leggja skugga á (síштрихова́ть)2.(штрихи) strikingж0-ar, skravering [-Ꞌveː-]ннкж0-ar, skuggiмгл-i(síштрихова́ть)
штрихово́й	adjstriku-; штрихово́й кодsíштри́хкод
штуди́ровать	штуди́ру|ю, ~ешь, ~ютipf(pfпроштуди́роватьпроштуди́ру|ю, ~ешь, ~ют)Accbókl.kannaaðiВин(gjølla [-tla]), studera [-Ꞌteː-]ннкaðiВин(gjølla [-tla])
шту́ка	f1.(отдельный предмет - часто не переводится;skal ofta ikki umsetast) stykkiсгл-i(часто сокращаетсяstk.торг.), по ты́сяче шту́ка túsund (rublar) stykkið; 5 штук яи́ц 5 egg; 5 stk. eggторг.2.tlm.(нечто) okkurt; málс0о; søgaжгл-a(mál); что э́то за шту́ка? hvat er hetta fyri nakað?; така́я автомаши́на - дорога́я шту́ка ein sovorðin bilur er eitt dýrt fornoyilsi [-Ꞌnœi-]ннк; зима́ - серьёзная шту́ка veturin er ikki at spæla við; така́я ру́чка - отли́чная шту́ка ein sovorðin pennur er eitt fínt ting at hava; неприя́тная шту́ка ein keðilig søga; э́то не (хи́трая) шту́ка hetta er einki fyri; кни́ги, газе́ты и вся́кая така́я шту́ка bøkur, bløð og alt (møguligt) sovorðið3.tlm.(проделка) pussс0о, skálkabragdс0о{а/ю}; сыгра́тьс кем-л.шту́ку spælao-meitt puss; э́то его́ обы́чные шту́ки hetta eru tey vanligu knepiniннкhjá honum4.(целый рулон) rull [-tl]с0о5.slang(тысяча рублей) túsund rublarмсоглосн-s,-arмн@вот так шту́ка!tað er vorðið sum skil!;в том-то и шту́каtað er nettupp tað;вся шту́ка в том, что́бы...tað er nettupp har, hundurin er grivinпог.,неформ.,шутл.
штукату́р	mstukkatørur [-Ꞌtʰøː-]мсогл-ar, stukkarbeiðariмгл-ari
штукату́рить	штукату́р|ю, ~ишь, ~ятipf(pfоштукату́ритьоштукату́р|ю, ~ишь, ~ят)что-л.pussaaðio-t(vegg o.tíl. við pussi); spekkaaðio-t(заполнить дырки, щели и т.п.)
штукату́рка	f1.(действие) pussingж0-ar; spekkingж0-ar(наполнение дырок,щелей и т.п.)2.(раствор) pussс0о, stukkс0о(тж о лепке)
штукату́рный	adjstukk-, pussi-
штуке́нция	fskemt.síшту́ка2
штуко́вина	fóvkm.síшту́ка2
штурва́л	mstýriсгл-i, róðurс0осн
штурва́льный	Iadjstýris-, róður-; штурва́льное колесо́ róðurс0осн, rattс0омор.IIm(рулевой) róðursmaðurмнепр
штурм	m(stór)álopс0о, stormurмсогл-ar(álop); взятьчто-л.шту́рмом takao-tí stórálopi, takao-tvið stormi; идти́ на штурмчего-л.stormaaðio-t; мозгово́й штурм brainstormur [pɹεin-]неформ.
шту́рман	plurшту́рман|ы, ~ов, ~амogtlm.штурман|а́, ~о́в, ~а́мmstýrimaðurмнепр, bestimaðurмнепруст. (б.ч. на рыболовном судне); navigatiónsoffiserur [naːvikaꞋʃɔun-]мсогл-ar(в военном флоте); stýrimaðurмнепр, navigatørurмсогл-ar(в авиации); kortlesariмгл-ari(на ралли и т.п.)
шту́рманский	adjstýrimans-; navigatións- [naːvikaꞋʃɔuns-]; шту́рманская ру́бка kortrúm; шту́рманский столsíпрокла́дочныйстол =>распи́ска2
штурмова́ть	штuрму́|ю, ~ешь, ~етipf AccstormaaðiВин, leypaслнey-u-oáВин, herjaaðiáВин
штурмови́к	Genштурмовик|а́;plur~и́, ~о́в, ~а́мm1.(военный самолёт) álopsflogfarнпс0о{a/ø}2.(в гитлеровской Германии) SA-maður [εsːꞋaː-]мнепр(í Hitlertýsklandi)
штурмово́й	adjálops-, storm-; штурмова́я авиа́ция lágtflúgvandi álopsfogførнп
штурмовщи́на	fatf.ruspс0о, arbeiðiсгл-ií herðindum; рабо́тать без штурмовщи́ны arbeiða javnt [jan̊t], [-jam̊t]
шту́цер	plurштуцер|а́, ~о́в, ~а́мmstussurмсогл-ar
шту́чка	plurшту́ч|ки, ~ек, ~камf1.dim avшту́ка 1-32.(о человеке) revurмсогл-ar(lúrið fólk), besnissað [-Ꞌsnɪ-] fólkс0онеформ.
шту́чно	adv síпошту́чно
шту́чный	adj1.(изготовленный индивидуально) sergjørdurсогл; шту́чная ме́бель sergjørdir møplar2.(представлющий собой отдельную вещь) stykkja-; шту́чная цена́ stykkjaprísur; шту́чная прода́жа leysasøla; шту́чная опла́та gjald pr. stk. [pʰεɹꞋstʏʰkː], gjald fyri stykkið3.fakm.,gml.(сборный) til at seta saman, sum kann setast saman =>замора́живание1
штык1	IGenштык|а́;plur~и́, ~о́в, ~а́мm1.(оружие) bajonett [paijoꞋnεʰtː]ж0-ir; примкну́ть штык seta bajonettina á; отомкну́ть штык taka bajonettina av; примкну́ть штыки́! (команда) bajonettirnar á! (kommando); отомкну́ть штыки́! (команда) bajonettirnar av! (kommando); идти́ в штыки́ leypaслнey-u-oá við bajonettum; отря́д в ты́сячу штыко́в eitt herlið upp á 1000 mans (gonguherlið)2.skip.(узел) stikkс0о(knútur)мор.@встре́тить {приня́ть}кого-л.в штыки́taka ímóti [-Ꞌmɔu-]o-mvið illvild;как штыкtlm.púra vist, heilt sikkurtннк; akkurát [-Ꞌrɔat] til tíðina (точно вовремя)
штык2	IIGenштык|а́;plur~и́, ~о́в, ~а́мm(слой земли) spakadýpiсгл-i
штыково́й	adj1.(кштык I 1) bajonett- [paijoꞋnεʰt-]; штыкова́я ата́ка bajonettálop [paijoꞋnεʰt-]; штыково́й бой bajonettbardagi [paijoꞋnεʰt-]2.: штыково́й затво́р bajonettlás [paijoꞋnεʰt-]; штыково́е соедине́ние bajonettfatningur [paijoꞋnεʰt-]
штырь	Genштыр|я́;plur~и́, ~е́й, ~я́мmtekn.tappurмсогл-ar, pinnurмсогл-ar; stelling [-tl-]ж0-ar(дверная)
шу́ба	f1.(меховая) pelsurмсогл-ar; skinnfrakkiмгл-i(кожаное,меховое пальто)2.tlm.(зимнее пальто) vetrarfrakkiмгл-i3.(покров шерсти) (tøtt) ulling [ʊtl-]ж0-ar4.(покров льда и т.п.) skónж0-irav ísi (í køliskápi o.tíl.)
шубе́йка	plurшубе́йки, шубе́ек, шубе́йкамf tlm.stuttur, slitin pelsjаkkiмгл-i
шуга́	fkrapiмгл-i(á áum og vøtnum)
шугану́ть	moment síшуга́ть
шуга́ть	ipf(momentшугану́тьшуган|у́, ~ёшь, ~у́т, шугну́тьшугн|у́, ~ёшь, ~у́т)Accóvkm.styggjair(d)Винburtur
шугну́ть	moment síшуга́ть
шу́лер	plurшулер|а́, ~о́в, ~а́мm(в карточной игре) falskspælariмгл-ari, svikariмгл-ari(í kortum); svindlari [svɪnl-]энкмгл-ariнеодобр.
шу́лерство	nfalskspælс0о{æ/ø}, svikс0о(í kortum); svindilм0осннеодобр.
шум	Genшу́ма, шу́муm1.(громкие звуки) gangurмсогл-s,-ir, larmurмсогл-ar; óljóðс0о{0<>i}(тж помехи); а́дский шум helvitisбран.gangur, ræðuligur gangur, fanansбран.gangur; без шу́ма ljódliga; шум в за́ле málаgeip í salinum; шум ли́стьев suðið av bløðum; шум водопа́да fossadunс0о; шум засто́лья veitslurómur [vai̯sl-]мсогл-ar; шум бо́я dunс0оav bardaga; шум ве́тра suðið av vindi; шум машин buldurс0оснav bilum, skrambulс0оснav bilum2.(толки) rokс0о, upplopс0о, háviмгл-i, uppstandilsi [-Ꞌsta-]сгл-i; uppstigс0о{0<>i}; ófriðurмсогл-ir{0<>i}, rumbulс0осн; вы́звать шум {наде́лать шу́му} gera háva; подня́ть шум (из-за/около/вокруг чего-л.) gera háva (av o-m); газе́ты по́дняли (из-за э́того) шум bløðini gjørdu nógv burtur úr hesum, bløðini gjørdu nógv hóvasták burtur úr hesum; без шу́ма {шу́му} uttan nakað hóvasták3.: шум в уша́х sjóðanж0-airfyri oyrunum; шу́мы в се́рдце hjartaóljóð [j-]с0о{0<>i}@мно́го шу́му из ничего́stórt rok av ongum;шу́му мно́го, а то́лку ма́лоroykur og eingin grindпог.;что за шум, а дра́ки нет?orðt., skemt.hvat er á vási? =>информацио́нный2
шуме́рский	adjsøg.sumeriskur [-Ꞌmeː-]согл
шуме́ры	шуме́р|ов, ~амm plursøg.sumerar [-Ꞌmeː-]мгл-iмн
шуме́ть	шум|лю́, ~и́шь, ~я́тipf1.(издавать шум) haldaслнe-i-igang, larmaaði; vasaaði(б.ч. о шумном человеке); suðaaði(о ветре,листве,реке и.др.); brúsaaði(о волнах); dunaaði(о водопаде); самова́р шуми́т tað bullar [-tl-]aðií samovarinum [saːmoꞋvaː-]2.(о чём-л.) (скандалить) geraнепрrok, geraнепрrumbul, geraнепрnógv burtur Ꞌ úro-m, haldaслнe-i-imiklan háva (av o-m); шуме́ть из-за пустяко́в gera stóran háva av lítlum verkiпог.3.(привлекать внимание) vekjaur(t){e/a};ir(t){e/a}ans; шуми́т но́вый фильм nógv hóvasták stendst stεn̊st] av tí nýggja filminum, tann nýggi filmurin er á øllum [œtl-] varrum4.: у меня́ шуми́т в уша́х tað sjóðar fyri oyrunum á mær
шуми́ха	ftlm., atf.rokс0о, háviмгл-i; подня́ть шуми́ху (вокру́гчего-л.) blásaur(t){á/æ}o-tupp, geraнепрháva avo-m; газе́тная шуми́ха blaðrumbul
шумли́вый	stfшумли́в, ~а, ~о, ~ыadjlarmandiглandi, sum heldur gang
шу́мно	Iadv tilшу́мныйIIpred: здесь шу́мно her er (nógvur) gangur; как шу́мно! her er eitt øgiligt spetakkul [-Ꞌtʰa-]энк!
шу́мный	stfшу́мен, шумна́, шу́мно, шумны́ogшу́мныadj1.(производящий шум(в зн.1)) larmandiглandi, sum heldur gang2.(производящий шум(в зн.2)) sum nógv rok stendst [stεn̊st] av; шу́мный успе́х ein dundrandi succes [sʏʰkꞋseː]ннк
шумови́к	Gen, Accшумовика́; plurшумовик|и́, ~о́в, ~а́мm tlm.skapariмгл-ariav ljóðeffktum )í sjónleiki o.ø.)
шумо́вка	plurшумо́в|ки, ~ок, ~камfsoðspónur [sɔs-]мсогл-ar;согл-ir{ó/ø}{+}
шумово́й	adj: шумовы́е эффе́кты ljóðeffektirж0-irмнспец.; шумовы́е поме́хи óljóðс0о{0<>i}(í móttakara)
шумо́к	Genшумка́;plur~и́, ~о́в, ~а́мmsuðс0о{0<>i}, suðanж0-ir; шумо́к в за́ле ein suðan í salinum@под шумо́кóansaðurглaður, í duldum; ljódliga
шунт	mshuntur {sjuntur} [ʃʊ-]мсогл-ar
шунти́рование	n: шунти́рование се́рдца bypassoperatión [paipʰasːoːpɪraʃɔun]ж0-ir, bypassskurðviðgerð [paipʰasskuːɹvɪtʃ-]нпж0-ir
шунти́ровать	шунти́ру|ю, ~ешь, ~ютipf/pf: шунти́ровать се́рдце geraнепрeina bypassoperatión [paipʰasːoːpɪraʃɔun], geraнепрein bypassskurð [paipʰas-]нп
шу́рин	plurшу́рин|ы, ~ов, ~амmsvágurм0осн{+};согл-ir(beiggi konuna)
шурова́ть	шуру́|ю, ~ешь, ~ютipf1.что-л.(в топке) rakaaðií o-m, skaraaðií o-m(í eldinum o.a.)2.óvkm.(действовать энергично) drívaслнei-i-iá, liggjaслнá-ó-iá takinumидиом.
шуру́п	mskrúvaжгл-a(nagli við skrúvugangi)
шурф	Genшу́рфа;plurшу́рф|ы, ~ов, ~амogGenшурф|а́;plur~ы́, ~о́в, ~а́мmroyndarbrunnurмсогл-ar
шурша́ние	nskróvс0о
шурша́ть	шурш|у́, ~и́шь, ~а́тipfskróvaaði
шу́ры-му́ры	einki Gen, Datшу́рам-му́рамplurtlm.fríggj с0о{0<>i}, fjas с0о, kærleiksævintýrннкс0о; завести́ шу́ры-му́рыс кем-л.faraслнó-ó-aat fjasastvið o-n(fríggja)
шу́стрый	stfшустёрogшустр, шустра́, шу́стро, шу́стрыogшустры́adjkvikurсогл, skjóturсогл(быстрый); raskurсогл{a/ø}(проворный); gløggurсогл, skjóttonkturсогл(сообразительный); шу́стрый парни́шка ein raskur drongur
шут	Gen, Accшут|а́;plur~ы́, ~о́в, ~а́мm1.søg.(лицо при дворце и т.п.) gekkurмсогл-ar, íspegilм0осн-s,-arист., fívilм0осн-s,-arист.; придво́рный шут hovgekkurист.2.(балаганщик) klovnurмсогл-ar, bajassur [-Ꞌja-]мсогл-arред., íspegilм0осн-s,-ar, fívilм0осн-s,-arкн.3.tlm., atf.(тот,кто балагурит,кривляется) íspegilм0осн-s,-ar, narrс0о, spottс0о; разы́грывать {стро́ить} (из себя́) шута́ spæla býtt; де́лать шута́ изкого-л.haldaслнe-i-io-nfyri gjøldur, havaнепрo-ntil rukku@шут с ним!óvkm.skít í hann!вульг.;на кой шут?óvkm.hvat fanin?бран.,hví fanin?бран;како́го шута́?óvkm.hvat fanin?бран., hví fanin?бран.;ни шута́ нетóvkm.ikki ein (helvitis) lortвульг.;шут его́ зна́етfanin vitiбран.=>горо́ховый@
шу́тер	[-тэр]mteld.skjótispælс0о{æ/ø}
шути́ть	шучу́, шу́т|ишь, ~ятipf1.pfпошути́тьпошучу́, шу́т|ишь, ~ят(весело говорить) skemtaaði; я не шучу́ eg meini tað í álvara; ты шу́тишь! tað er ikki sannheitннк!; nei, nú lýgur tú!; nei, álvara!2.над кем-л.(смеяться над кем-л.) havaнепрo-nfyri gjøldur3.(с)чем-л.(относиться несерьёзно) skemtaaðivið o-m; с ним не шути́! hann er ikki at spæla við!; hann er ikki at skemta við!; нельзя́ шути́ть свои́м здоро́вьем heilsan er ikki at spæla við@шути́ть с огнёмfl.spælair(d)við eldinперен.;чем чёрт не шу́титhvør veit; hví ikki;шу́тки шути́ть со мно́ю взду́малgert tú grin við mær?; heldur tú meg fyri gjøldur?
шути́ха	f1. (шут) íspegilм0осн-s,-ar(konufólk)2.gml.(ракета) rakett [-ˈkʰεʰtː]ж0-ir(fýrverkarí)
шу́тка	plurшу́т|ки, ~ок, ~камf1.(то,что говорится не всерьёз и т.п.) skemtс0о, joke [tʃɔuk]м нескл., сленг; vittigheitннкж0-ir(анекдот); неви́нная шу́тка óskyldigt [-Ꞌʃɪ-] skemt; обрати́ть {преврати́ть}что-л.в шу́тку sláaслнó-ó-io-tupp í glens; свести́что-л.в шу́тку sláaслнó-ó-io-tupp í glens; он не понима́ет шу́ток hann forstendur [-Ꞌstε]ннкikki skemt; приня́тьчто-л.за шу́тку takao-tsum skemt; э́то не шу́тка hetta er ikki gamansleikur, hetta er ikki at skemta við2.(проделки): сыгра́ть {поде́лать}с кем-л.шу́тку spælao-meitt puss3.(юмореска) skemtileikurмсогл-s,-ir@в шу́ткуtil stuttleikarннк, til stuttleikaнп;шу́тки ра́диtil stuttleikarннк, til stuttleikaнп, í spølni;с ним шу́тки пло́хиhann er ikki at spæla við;не на шу́ткуí álvara, virkuligaннк; не на шу́тку испуга́лся hann bleiv ordiligaннкbangin ;шу́тки в сто́рону!skemt til síðis!; álvaratos;кро́ме шу́токa) (говоря всерьёз) álvaratos; b) (серьёзно?) tað sigur tú ikki?;шу́тка (ли)сказа́ть, два миллио́на tvær milliónir [mɪʎꞋjɔun-], tað er ikki smápengar; э́то не шу́тка {шу́тка ли} сде́лать это tað er eingin stuttleiki at gera hetta; э́то не шу́тка {шу́тка ли} потра́тить сто́лько вре́мени tað er ikki stuttligt at hava spilt so nógva tíð burtur =>шути́ть@
шутли́вость	fskemtingarsemiсгл-i
шутли́вый	stfшутли́в, ~а, ~о, ~ыadj1.(склонный к шуткам) skemtingarsamurсогл{a/o}, skemtiligurглigur2.(шуточный) skemtandiглandi
шутни́к	Gen, Accшутник|а́;plur~и́, ~о́в, ~а́мmskemtariмгл-ari
шутовско́й	adjgekka-, íspegils-; шутовско́й колпа́к gekkahúgva; шутовско́е поведе́ние fjákuturсоглatburður [apː-]
шутовство́	nfjantс0о, fjákalótirж0-irмн
шу́точный	stfшу́точ|ен, ~на, ~но, ~ныadj1.(являющийся шуткой) skemti-; шу́точное стихотворе́ние skemtiyrking2.(лёгкий) lætturсогл{æ/ø}, smáurгл(oftast við neg); де́ньги не шу́точные ikki smávegis pengar; э́то не шу́точное де́ло tað er ikki bara sum at siga tað; шу́точное (ли) де́лоsíшу́тка(ли) сказа́ть, шу́тка
шутя́	adv1.(в шутку) til stuttleikarннк, til stuttleikaнп, í spølni2.(без усилий) so spælandi, leikandi lætt, sum ein royk@не шутя́av álvara
шу́хер	m1.(шумиха)óvkm.rokс0о, háviмгл-i2.:шу́хер!skúlaargotvarskó [-Ꞌskɔu]!; ansa eftir [εʰtː-]!3.: стоя́ть на шу́хереargothalda vakt, halda útkikk [-kʰɪʰkː]ннк(meðan brotið verður inn o.a.)
Шу́шенское	nSjusjenskoje [ʃʊʃːεnskɔijε]ж нескл.
шу́шера	f koll,óvkm., vanv.pakkс0о; ónytturжгл-aмн, nullс0омн
шушу́канье	ntlm.tutlс0о, teskс0о
шушу́каться	ipftlm.lýðastir(d), tutlaaði, teskaaði
шхе́ры	шхер, ~амf plurskergarðurмсогл-ar, skerс0о{+}мн
шху́на	fskonnartж0-ir(парусное судно с двумя и более мачтами и косыми парусами); sluppж0-ir(парусное судно с двумя мачтами и косыми парусами;ос. о типе судов великобританского происхождения,купленных фарерцами с конца XIX в.); skútaжгл-a(небольшое судно вообще)
шш	interhússj
шь...	шьюo.s.fr. pres avшить
Шэнья́н	m(fyrrМукде́н (sí)) Shenyang [ʃεnꞋjaŋk]м0{дат.0}(раньшеMukden [mʊʰktεn]м0{дат.0})
