ЕАБМ	[йэ-а-бэ-э́м]n indecl(stytt. fyriЕвропе́йское аге́нтство по безопа́сности в мо́ре) EMSA [e: εm: εs: ˈa:]м нескл(stytt. fyriEuropean Maritime Safety Agency) Europeiski [œuɹoꞋpʰeː-] maritimi [maːɹitʰiː] trygdarstovnurinмсогл-arопр
ЕАСТ	[еа́ст]f indeclЕвропе́йская ассоциа́ция свобо́дной торго́вли EFTA [εfta], European Free Trade Associationангл., Europeiski [œuɹoꞋpʰeː-] fríhandilssfelagsskapurinмсогл-irопр., Evropeiski [εvɹoꞋpʰeː-] fríhandilssfelagsskapurinмсогл-irопр.
ЕАЭС	[йе-а-э́с]m indeclЕврази́йский экономи́ческий сою́з EABS [ˈeː a pe ˈεsː] Eurasiatiska [œuɹaːsiˈaː-] búskaparsamgongan
ёб	tabu!:pret avеба́ть@ёб твою́ мать!(tann grovasta illbønin á russiskum,kann alt eftir tónalag sipa til vreiði, forargilsi o.s.fr.)Kann umsetast ymisliga, sum t.d.tað var sum faninбран.(bilsni); for helvitiбран., for faninбран.(øði)
ёбаный	adjtabu!fanansбран.нескл., fjandansбран.нескл.; ну его́ к ёбаной ма́тери! far hann at [ɔa] fjandanum tilбран.!
ёбарь	mtabu!fríggjariмгл-ari
еба́ть	еб|у́, ~ёшь, ~у́т; pretёб, ебл|а́, ~о́, ~и́(eis. pretеба́л, ~а, ~о, ~и)ipf кого-л.tabu!1.(совокупляться с кем-л.) (um mannfólk) moggaaðio-mвульг., табу(б.ч. о мужчине), moggaaðiviðo-mвульг., табу, fáaслнe-i-ieitt lítið fráo-mэвфем., fáaслнe-i-ieitt nummar fráo-mэвфем.2.(плевать на кого-л.) skítaслнei-i-iáo-nперен.,вульг.; еба́л я его́! eg leggi ein lort í hann!вульг..@еби́ {ети́}твою́ матьsíёбтвою́ мать
еба́ться	еб|у́сь, ~ёшься, ~у́тся;pretёбся, ебл|а́сь, ~о́сь, ~и́сьogеба́лсяo.s.fr.ipftabu!1.(совокупляться) moggaaðiвульг., табу2.pfпроеба́тьсяпроеб|у́сь, ~ёшься, ~у́тся; pret проёбся, ебл|а́сь, ~о́сь, ~и́сьogпроеба́лсяo.s.fr.tabu! atf.(возиться с чем-л.) fokkastaði, baksastaði, stríðastir(d); це́лый час я (про)еба́лся {проёбся} с замко́м eg bollaðist ein heilan tíma við lásið
ебёна:	ебёна мать!intertabu!síёбтвою́ мать
ебе́не:	ну его́ к ебе́не ма́тери {фе́не}!illb.tabu!far hann at [ɔa] fjandanum tilбран.!
е́бля	ftabu!1.(совокупление) moggingж0-arвульг., табу.2.(возня) baksс0о, stríðс0о
ёбнуть	ёбн|у, ~ешь, ~ут;pret~л, ~а, ~о, ~иpftabu!1.Acc(ударить) lammaaðitilВин2.что-л.(украсть) stjala [stjεa-] (редко[ʃεa-])слнó-ó-oo-t
ёбнуться	ёбн|усь, ~ешься, ~утся;pretёбнул|ся, ~ась, ~ось, ~исьpftabu!sláaслнó-ó-i, smekkaaði; он ёбнулся голово́й о сте́ну hann smekkaði høvdið [hœtːɪ] móti vegginum
Е́ва	fbíbl.Evaжгл-a@в костю́ме Е́выspilnakin [spɪl-]соглосн(um konufólk)
ева́нгелие	nevangelium [evanꞋtʃeːlijʊm], [evaŋꞋkeːlijʊm]с0-um; ева́нгелие от Иоа́нна evangeliið eftir [εʰtː-] Jóhannes [-Ꞌhanːɪs], Jóhannesevangeliið [-Ꞌhanːɪsevantʃeːl-]; ева́нгелие от Луки́ evangeliið eftir [εʰtː-] Lukas [lʊʰkːas], Lukasevangeliið [lʊʰkːasevantʃeːl-]; ева́нгелие от Ма́рка evangeliið eftir [εʰtː-] Markus, Markusevangeliið [-evantʃeːl-]; ева́нгелие от Матфе́я evangeliið eftir [εʰtː-] Matteus [maꞋtʰeːʊs], Matteusevangeliið [maꞋtʰeːʊsevantʃeːl-]
евангелиза́ция	fevangelisering [evaŋkeːliˈseː-]ж0-ar
евангели́ст	m1.(автор евангелия) evangelistur [evantʃɪꞋlɪ-]мсогл-ar2.(член евангелической общины) limur í evangeliskari [evanꞋtʃeːl-] samkomu
евангели́ческий	adjevangeliskur [evanꞋtʃeːl-]соглsk(kirkja, samkoma)
ева́нгельский	adjevangelii- [eːvanꞋtʃeːl-], evangeliskur [eːvanꞋtʃeːl-]соглsk(viðv. evangelium)
евге́ника	feugenikk [œukeꞋnɪʰkː]интж0-irспец., ættarrøktлпж0-ir
е́внух	ngeldingurмсогл-ar, eunukkur [εuꞋnʊʰkː-]интмсогл-ar(serl. um geldar haremsvaktarmenn)
еврази́ец	Gen, Accеврази́йца; plurеврази́цц|ы, ~ев, ~амmI(житель Евразии) eurasiatur [œuɹa:siꞋaː-]мсогл-arII(представитель евразийство) eurasianistur [œuɹa:siaˈnɪ-]-]мсогл-ar(viðhaldsmaður hjá eurasianismu, síевразийство)
еврази́йский	adjeurasiskur [œuɹꞋaː-]соглsk, evrasiskur [εuɹꞋaː-]соглsk=>ЕАЭС
еврази́йство	neurasianisma [œuɹaːsiaꞋnɪ-]жгл-a(filosofiskt rák,ið hevdar,at bæði vesturlendsk og eysturlendsk drøg eru saman í russ. mentan;kom upp í 1920-1930-árunum,serl. millum russ. útisetar ; hevur fingið undirtøku aftur í Russlandi síðst í 20. øld)
Евра́зия	fEurasia [œuɹꞋaː-] {Evrasia [εuɹꞋaː-]}с нескл.
ЕврАзЭс	[йевр-аз-э́с]m indeclЕврази́йское экономи́ческое соо́бщество Eurasiatiski [œuɹaːsiˈaː-] búskaparfelagsskapurin (var virkin 2001-2014/
Евра́том	mEuratom [œuɹaꞋtʰoːm]с0{дат.0}
евре́й	mjødiмгл-i, gýðingurмсогл-arкн.; hebreari [-Ꞌpɹeː-]мгл-ariист.,библ., hebrei [-Ꞌpɹeːjɪ]мгл-iист.,библ.
евре́йка	plurевре́йки, евре́ек, евре́йкамfjødinna [jøːtꞋɪnta] ([jøːtꞋɪnːa]кн.)жгл-a, jødagentaжгл-a, jødakonaжгл-a; gýðingagentaжгл-aкн., gýðingakonaжгл-aкн.; hebraisk [-Ꞌpɹaːɪsk] konaжгл-aист., библ., hebraisk [-Ꞌpɹaːɪsk] gentaжгл-aист., библ.
Евре́йская автоно́мная о́бласть	Jødiska sjálvstýrandi [ʃɔl̥s-] økiðсгл-iопр.
евре́йский	adjjødiskurсогл, gýðinga-кн.; hebraiskur [heꞋpɹaːɪsk-]соглист., библ.; евре́йский язы́к a) (древнееврейский язык,иврит) hebraiskt [heꞋpɹaːɪst]сприлskt(málið); b) (идиш) jiddisch [jɪtːɪʃ]с нескл., jiddisktсприл
евре́йство	n kolljødarмгл-iмн
е́врик	m tlm.evraжгл-a, euro [œuɹo]ннкж0-ir
е́вро	m indeclevraжгл-a, euro [œuɹo]ннкж0-ir
евро...	í samansa) (европейский) euro- [œuɹo- ]{evro-}, europeiskur [œuɹoꞋpʰeː- ]{evropeiskur [-Ꞌpʰeː- ]}; b) (по западным стандартам)eftir vestureuropeiskum krøvum(í bygging o.tíl.), t.d. евроваго́нка, евроремо́нт
евробюрокра́тия	f kol)ES- bureaukratar [e: εsːpyːɹokɹaː-]мсогл-arмн
Еврови́дение	nEurovision [œuɹoviꞋʃɔun], [jʉuɹoviꞋʃɔun]с0{дат.0}
еврозо́на	fevruøkiðсгл-iопр.
евроинтегра́ция	feuropeisk [œuɹoˈpʰeː-] {evropeisk [εvɹoˈpʰeː-]} integratión [-ˈʃɔun]ж0-ir, evropisk [εvˈroː-]лпintegratión [-ˈʃɔun]ж0-ir
Еврокоми́ссия	fKommissiónin [-Ꞌʃɔun-]ж0-irопр.(í ES), ES-kommissiónin [-ʃɔun-]
Евро́па	fEuropa [œuꞋroː-]с нескл., Evropa [εvꞋroː-]с нескл.; За́падная Евро́па Vestureuropa, Vesturevropa; Восто́чная Евро́па Eystureuropa, Eysturevropa; жи́тель Ю́жной Евро́пы suðureuropeari [-œuɹopʰeː-], suðurevropeari [-εvropʰeː-] =>гало́пом@
Европарла́мент	mEuropatingið [œuꞋroː-]с0оопр., Evropatingið [evꞋroː-]с0оопр.
европе́ец	Gen, Accевропе́йц|а;plur~ы, ~ев, ~амmeuropeari [œuɹoꞋpʰeː-]мгл-ari, evropeari [εvroꞋpʰeː-]мгл-ari
европеиза́ция	feurpeisering [œuɹopʰeːiˈse:-]ж0-ar, evropeisering [εvɹopʰeːiˈse:-]ж0-ar, evropalaging [-ˈroː-]лпж0-ar, evropagerð [-ˈroː-]лпжo-ir
европеизи́ровать	европеизи́ру|ю, ~ешь, ~ютipf/pf Acceurpeisera [œuɹopʰeːiˈse:-]aðiВин, evropeisera [εvɹopʰeːiˈse:-]aðiВин,evropalaga [-ˈroː-]aлпaðiВин
европе́йка	plurевропе́йки, европе́ек, европе́йкамfeuropeari [œuɹoꞋpʰeː-]мгл-ari, evropeari [εvroꞋpʰeː-]мгл-ari(konufólk)
Европе́йская экономи́ческая зо́на	(ЕЭЗ) Evropeiska [-Ꞌpʰeː-] búskaparsamstarvið (EBS [eː peː Ꞌεsː])
европе́йский	adjeuropeiskur [œuɹoꞋpʰeː-]соглsk, evropeiskur [εvɹoꞋpʰeː-]соглsk, evropiskur [εvˈroː-]лпсоглsk=>краб
Европе́йский Сове́т	mEuroparáðið [œuꞋroː-]с0оопр., Evroparáðið [εvꞋroː-]с0оопр.=>Комите́т
Европе́йский Сою́з	(ЕС [йе-э́с])mEuropeiska [œuɹoꞋpʰeː-] samveldiðсгл-iопр, Evropeiska [εvɹoꞋpʰeː-] samveldiðсгл-iопр., Evropasamveldið [εvꞋroː-]сгл-iопр. (сокр.ES [eː εsː], EU [eː uː]ннк)
Европе́йский суд	ES-dómstólurin [ˈeː ˈεsː -]мсогл-arопр
Европе́йский центра́льный банк	Europeiski [εvɹoˈpʰeː-] miðbankin [miːpaɲ̊tʃ-]
Европе́йское объедине́ние у́гля и ста́ли	søg.Europeiski [œuɹoꞋpʰeː-] kol-og stálfelagsskapurinмсогл-irопр.
евро́пий	meuropium [œuꞋroːpi-]с0o({0<>i})
европоддо́н	meuroplattur [œuɹo-]мсогл-arспец.
евроремо́нт	m umvæling el. umbygging eftir vestureuropeiskum krøvum
Евросою́з	m síЕвропе́йскийСою́з
евростанда́рт	meuropeiskur  [œuɹoꞋpʰeː-] {evropeiskur εvɹoꞋpʰeː-]} standardurм
евростанда́ртно	advsambært europeiskum [œuɹoꞋpʰeː-] {evropeiskum εvɹoꞋpʰeː-]} standardum, í samsvar við euopeiskar [œuɹoꞋpʰeː-]↨evropeiskar εvɹoꞋpʰeː-]} standardar
евростанда́ртный	adjsum er sambært europeiskum [œuɹoꞋpʰeː-] {evropeiskum εvɹoꞋpʰeː-]} standardum, sum er í samsvar við euopeiskar [œuɹoꞋpʰeː-]↨evropeiskar εvɹoꞋpʰeː-]} standardar
еврострои́тельство	n fjm.uppbyggingж0-arav sameindum Vestureuropa [-œuрoː-], {Vesturevropa [-εvroː-] }
евроту́р	mrundferrð [rʊnf-]ж0-irí Vestureuropa [-œuрoː-], {Vesturevropa [-εvroː-] } /sum feräfólk)
евроэнтузиа́зм	m fjm.eldhugiмгл-ifyri uppbygging av sameindum Vestureuropa [-œuрoː-], {Vesturevropa [-εvroː-] }
евроэнтузиа́ст	m fjm.o-r, sum ereldhugaður fyri uppbygging av sameindum Vestureuropa [-œuрoː-], {Vesturevropa [-εvroː-] }
евста́хиев	adj: евста́хиева труба́anat.tað eustachiska [œuꞋstaːkɪska] røriðс0оопр., gómapípaлпжгл-a
Евфра́т	mEufrat {Evfrat} [œufɹaʰtː]ж нескл.
евхаристи́ческий	adj kirkj.: евхаристи́ческое обще́ниеsamlag millum ym. kirkjur um viðurkenning av altarsins sakramenti o.ø. hvør hjá aðrari
евхари́стия	f kirk.(причащение) altarsins sakramenti [saːkɹaˈmε-]сгл-iцерк.; altargangurмсогл-s,-ir(обрряд)
е́вший	partic pret avесть 1
е́герский	adj1.(ке́герь 1) veiðimanna-кн., byrsumanna- (охотничии с ружьём), jekara-ннк(б.ч. в нефарерских условиях)2.(ке́герь 2) jekara-ист
е́герь	plurе́гер|и, ~ей, ~ямogегер|я́, ~е́й, ~я́мm1.(охотник) veiðimaðurмнепркн., byrsumaðurмнепр(с ружьём), jekariннкмгл-ari(б.ч. в нефарерских условиях)2.(солдат) jekariмгл-ariист.(soldatur)
Еги́пет	GenЕги́пт|а,Dat~у,Ins~ом,Prp~теmEgyptaland [-Ꞌtʃɪ-]с0о
еги́петский	adjegyptiskur [-Ꞌtʃɪ-] ( [-Ꞌtʃʏ-]ннк)согл@еги́петская рабо́та {еги́петский труд}gml.trælaarbeiði (hart og tungt arbeiði);ка́зни еги́петскиеgml.tær tíggju plágurnar;тьма еги́петскаяgml.bølaniða
египто́лог	megyptologur [ekYʰptoˈloːk-]интмсогл-ar
египтоло́гия	fegyptologi [ekYʰptoloˈkiː]интжo-ir
египтя́нин	plurегиптя́н|е, ~, ~амmegyptari [-Ꞌtʃʏ-]ннк( [-Ꞌtʃɪ-])мгл-ari, egypti [-Ꞌtʃɪ-]нпмгл-i
египтя́нка	plurегиптя́н|ки, ~ок, ~камfegyptari [-Ꞌtʃɪ-] ([-Ꞌtʃʏ-])ннкмгл-ari, egypti [-Ꞌtʃɪ-]нпмгл-i(konufólk)
его́	[ево́]IGen, Acc síонogоно́IIpron poss переводится разн. конструкциями, в т.ч.hansaraи конструкциями сhjá [tʃʰ-]; Ю́рий и его́ сестра́ Jurij og systir hansara; го́род и его́ у́лицы býurin og gøturnar í honum; ребёнок и его́ роди́тели barnið [-tnɪ] og foreldrini [-Ꞌεlt-] hjá [tʃʰ-] tí; он сказа́л, что его́ кни́га пропа́ла a) hann segði [sεijɪ], at bókin hjá [tʃʰ-]sær var blivin burtur; b) hann segði [sεijɪ], at bókin hjá [tʃʰ-] honum var blivin burtur (другого лица)
егоза́	m/ftlm.flogс0о{0<>i}(o-r,ið ikki hevur frið á sær); он ужа́сный егоза́ tað er kviksilvur [kʰvɪʰk-] í reyvini á honumидиом.,вульг., hann er sum ein loppusekkurидиом., hann hevur stertидиом.
егози́ть	егожу́, егоз|и́шь, ~я́тipf tlm.1. (быть беспокойным) ikki havaнепрfrið á sær; havaнепрófrið á sær; havaнепрkviksilvur [kʰvɪʰk-] í reyviniидиом.,вульг., veraслнa-ó-esum ein loppusekkurидиом., havaнепрstertидиом.2.перед Ins(лебезить) lifrаaðifyri Дат, sleiskaaðifyri Дат
егозли́вый	stfегозлив, ~а, ~о, ~ыadjum ikki situr í frið, sum ikki hevir frið á sær; ófriðarligur [-Ꞌfɹiːjal-]глigur(беспокойный)
ЕГЭ	[егэ́]m indeclеди́ный госуда́рственный (sí) экза́мен
ед…1	I е́дуo.s.fr. pres avе́хать
ед…2	II еди́м, еди́те, едятpres plur avесть I
еда́	f1.(трапеза) máltíðж0-ir; etingж0-ar, átс0о(действие);sí eis.естьI (русскому отглагольному сущ. в переводе часто или предпочтительно соответствует глагольная форма); вре́мя еды́ mattíð; skaffitíðмор.; принима́ть лека́рство до еды́ taka medisin [meːtɪꞋsiːn] framman undan eini máltíð; за едо́й við borðið, til borðs2.(пища) maturмсогл-ir; føðiжгл-i(питание); kosturмсогл-ir; еда́ в доро́гу ferðamatur, ferðavistirж0-irмнкн.; еда́ и питьё matur og drekka, kostur; э́то не еда́ hetta er ikki fólkamatur
еда́ть	frekv что-л.tlm.,síесть1; ты еда́л когда́-нибудь …? hevur tú nakrantíð smakkað ...?
едва́	Iadv1.(с трудом) valla [-tla], ikki meira enn; tað var so, at...; við neyð og deyð; næstan ikki; он едва́ по́днял ка́мень tað var ikki meira, enn hann lyfti [-tːɪ] steininum; hann lyfti [-tːɪ] valla steininum; я едва́ добра́лся дочего-лtað var so, at eg kom fram tilo-t(Род с нек. геогр. названиями, иначекн.,уст.); я едва́ удержа́лся от сме́ха eg fekk næstan ikki hildið mær at grína; он едва́ удержа́лся от слёз hann mundi skorið í grát; он едва́ спа́сся tað var ikki meira enn hann bjargaðist; tað var um at gera, at hann ikki bjargaðist; hann mundi ikki bjargast2.(чуть,немного) slakurсогл{a/ø}, knappurсогл{a/ø}; nóg illa [ɪtla], ikki meira enn; едва́ 1000 рубле́й knappir túsund rublar; он едва́ уме́ет чита́ть hann dugir neyvan at lesa, hann dugir nóg illa at lesa; tað er ikki meira, enn hann dugir at lesa; едва́ жив meira deyður enn livandi; едва́ освещённый illa [ɪtla] upplýstur3.(только что) beint nú, beint tá; ей едва́ испо́лнилось де́сять лет hon var knappliga tíggju ár; он тогда́ едва́ начина́л говори́ть по-ру́сски hann var akkurát [-Ꞌrɔat]неформ.farin at tosa russiskt táIIconjikki meira enn, nóg illa [ɪtla]; едва́ (то́лько) он вы́шел на у́лицу, как начался́ дождь hann var ikki meira enn komin útum [ʉuꞋtʰʊmː], tá tað fór at regna; hann var nóg illa komin útum [ʉuꞋtʰʊmː], tá tað fór at regna; едва́ (лишь) он уе́хал, как… hann var ikki meira enn farin avstað [aꞋstεa], tá...;@едва́ - едва́ikki meira enn, nóg illa [ɪtla]; он едва́-едва́ дви́гался tað var so, at hann rørdi seg; tað var ikki meira, enn hann rørdi seg,sí eis.е́ле-еле;едва́ лиneyvan, neppaннк; едва́ ли он здесь hann er neyvan her, hann man ikki vera her; едва́ ли он ско́ро придёт hann kemur neyvan skjótt, hann man neyvan fara at koma skjótt, hann verður neyvan skjótur;едва́ неnæstan, nærum; mundi +суп.; он едва́ не упа́л hann mundi dottið;едва́ ли неhelst; kanska (может быть); он сде́лал едва́ ли не бо́льше всех hann hevur helst gjørt mest av øllum [œtl-]; он счита́ется едва́ ли не лу́чшим ученико́м hann verður hildin at vera kanska tann besti næmingurin, hann verður næstan hildin at vera tann besti næmingurin; tað man vera um at gera, at hann ikki verður hildin at vera tann besti næmingurin
едине́ние	nhátíð.samanhaldс0о, samhaldс0о; semjaжгл-a(согласие)@в едине́нии си́лаsamanhald gevur styrki
едини́ца	fA 1.(величина) eindж0-ir; едини́ца измере́ния mátieind; едини́ца вре́мени tíðareind; де́нежная едини́ца mynteind, peningaeind2.(часть состава) deildж0-ir3.(цифра 1) eittс нескл., eittalс0о{a/ø}4.(отметка «очень плохо») karakterurin «eitt» (sera vánaligt) (verður ikki brúktur alment longur),sí eis.пятёрка2; получи́ть едини́цу по геогра́фии fáa «eitt» í landalæruB 1.(разряд чисел) einariмгл-ari; деся́тки и едини́цы tíggjarar og einarar2.plur(немногие) ørfáглс мн, ørfáirглм мн; то́лько едини́цы спосо́бны э́то поня́ть bert einstakir duga at skilja hetta, bert heilt fáir duga at skilja hetta; teir kunnu teljast, sum duga at skilja hetta =>усло́вный7
едини́чный	stfедини́ч|ен, ~на, ~но, ~ныadj1.(отдельный) einstakurсогл{a/ø}; едини́чные слу́чаи заболева́ния einstakir sjúkutilburðir; в едини́чных слу́чаях í einstøkum førum2.(единственный) einstakurсогл{a/ø}(einastur), einkulturсогл, einastiсоглпревосх.; едини́чный слу́чай einkulttilfeldiннксгл-i, eindømiсгл-i; едини́чное употребле́ние сло́ва einasta ferð, orðið er brúkt
единобо́жие	nmonoteisma [ˌmoːnotʰeꞋi-]интжгл-a, eingudalæraлпжгл-a
единобо́рство	neinvíggiсгл-iист., балл., hólmgongaжгл-aист.; вы́йти на единобо́рствос кем-л.berjastir(d){e/a}viðo-ní einvíggi
единобра́чие	nmonogami [moːnokaꞋmiː]интс0-ir, eingiftaлпжгл-a
единове́рец	Gen, Accединове́рц|а;plur~ы, ~ев, ~амmtrúarfelagiмгл-i
единовла́стие	neinaræðiсгл-i, einaveldiсгл-i
единовла́стный	stfединовла́ст|ен, ~на, ~но, ~ныadjeinvaldurсогл, einræðis-; единовла́стный прави́тель einavaldsharriмгл-i, einræðisharriмгл-i
единовре́менный	stfединовре́мен, ~на, ~но, ~ныadj1.(происходящий, производимый только один раз)eingangs-ннк, sum verður gjørt eina ferð; единовре́менное посо́бие eingangsstuðulннк 2. gml.2. tlm. (проиходящий в одмо время) sum hendir í senn
единогла́сие	nfull [-tl] semjaжгл-a
единогла́сно	adveinmælt; при́нято единогла́сно einmælt viðtikið
единогла́сный	stfединогла́с|ен, ~на, ~но, ~ныadjeinmælturсогл; единогла́сное реше́ние einmælt samtykt
единоду́шие	nsemjaжгл-a, samlyndiсгл-i, sáttж0-ir
единоду́шно	advsamt
единоду́шный	stfединоду́ш|ен, ~на, ~но, ~ныadjsamsinturсогл, samdurсогл
еди́ножды	adv1.(один раз) eina ferð2. gml.(однажды,как-то раз) einaferð
единокро́вный	stfединокро́в|ен, ~на, ~но, ~ныadjgml.1.hálv- (от одного отца); единокро́вный брат hálvbeiggi [hɔlp-], hálvbróðir [hɔlp-] (sum hava sama pápa,men hvør sína mammu)2.(единоплеменный) brøðra-; единокро́вный наро́д brøðrafólk, brøðratjóð
единоли́чник	m1.søg.,sovjet.(крестьянин) ognarbóndiмгл-ur(ið ikki er uppi í kollektivi o.ø.)2.fl.,atf.(эгоистичный человек) individualistur [ɪntiviːtuaꞋlɪ-]ннкмсогл-ar
единоли́чный	adj1.(одного лица) persónligur [-Ꞌsɔu-]глigur; единоли́чная власть einaveldi; э́то его́ единоли́чное реше́ние hetta er hansara egna avgerð; его́ единоли́чное мне́ние hansara persónliga meining2.(о хозяйстве) privatur [pʰɹiꞋvaː-]согл, í privatogn [pʰɹiꞋvaː-]; единоли́чное крестья́нское хозя́йство ognargarður; óðalsgarður (б.ч. на Фарерах,в Норвегии и др.)
единомы́слие	ntað at vera á einum máli, semjaжгл-a(í áskoðanum)
единомы́шленник	m1.(человек одинаковых мыслей) partamaðurмнепр, viðhaldsmaður [-hal̥s-]мнепр;o-r, ið heldur tað sama2.(сообщник) samsekurмприл; medsamansvorinмприл
единонача́лие	neinmansleiðslaжгл-a
единообра́зие	ntað at vera einsháttaður, tað at vera fábroyttur
единообра́зный	stfединобра́з|ен, ~на, ~но, ~ныadjeinsháttaðurглaður, fábroytturсогл
единоплеме́нник	m1.hát.(человек одного племени) ættfrændiм0-urвыс.2.gml.,hátíð.(соотечественник) landsmaður [lan̊sm-]мнепр, landiмгл-iкн., выс.
единоро́г	m1.djór.(кит) (Monodon monoceros) náhvalurмсогл-s,-ir({a/ø}),sí eis.нарва́л2.myt.(фантастическое животное) einhyrningur [-tn-]мсогл-ar
единоро́сс	m limur av flokkinumЕди́ная Росси́я
единоутро́бный	adjgml.: hálv-; единоутро́бный брат hálvbeiggi [hɔlp-], hálvbróðir [hɔlp-] (sum hava somu mammu,men hvør sín pápa); она́ его́ единоутро́бная сестра́ hon er hálvsystir [hɔls-] hansara (somu mammu,men hvør sín pápa)
еди́нственно	Iadveinasti; еди́нственно возмо́жный спо́соб tann einasti møguligi mátin, tann einasti møguleikin; еди́нственно пра́вильное реше́ние tann einasta rætta loysninIIpartbara, bert, einans; еди́нственно потому́, что… bara tí at; мы обя́заны еди́нственно ему́ vit hava bara honum at takka fyri
еди́нственное	ntað einasta; еди́нственное, о чём говоря́т tað einasta, tey tosa um
еди́нственный	stfеди́нствен|ен, ~на, ~но, ~ныadj1.(только один) einastiпревосх.; еди́нственный, кто ви́дел его́ tann einasti, sum sá hann; он еди́нственный сын hann er einasti sonur; еди́нственный ребёнок einasta barn [-tn], einabarn [-tn]; еди́нственное сре́дство tann einasta leiðin; с еди́нственной це́лью bara við tí í huga, bara við tí endamáli, bara fyri at...; оди́н еди́нственный ein einasti; я ви́дел его́ (оди́н) еди́нственный раз eg havi sæð hann eina einastu ferð2.(исключительный) einastandandi [-Ꞌsta-]глandi; еди́нственный в своём ро́де a) (уникальный) tann einasti av sínum slag; b) (не имеющих равных) einastandandi, makaleysurсогл, sum ikki hevur sín líka@еди́нственное число́eintal; в да́тельном падеже́ еди́нственного числа́ í hvørjumfalli [-tlɪ] eintal; фо́рма еди́нственного числа́ eintalsformur
еди́нство	n1.(цельность) samanhaldс0о; еди́нство рабо́чего кла́сса samanhaldið hjá [tʃʰ-] arbeiðarastættini2.(сосредточенность в одних рамках) eindж0-ir; еди́нство ме́ста, вре́мени, де́йствияbókm.eindin í stað, tíð og gong;, staðar-, tíðar- og gerðareindлит.3.(неразрывность связи) samsvarс0о; еди́нство фо́рмы и содержа́ния samsvarið millum [-tl-] innihald og form4.(общность) sum er felags; еди́нство взгля́дов felags sjónarmið, samsvar í sjónarmiðum; еди́нство интере́сов felags áhugamál; еди́нство це́ли felags mið
еди́ный	stfеди́н, ~а, ~о, ~ыadj1.(неделимый) ein (с ударением на слово ein); еди́ный мирово́й ры́нокeinheimsmarknaður; еди́ная шко́ла eindarskúli, óbýttur skúli; еди́ный язы́к felags mál; еди́ная систе́ма eitt samanhangandi system [syꞋsteːm]ннк, eitt samnhangandi kerviнп; еди́ная энергети́ческая систе́ма eitt samanbundið orkukerviнп; еди́ный фронт eindarfylking; вы́ступить еди́ным фро́нтом fylkjair(t)seg saman; наро́д и па́ртия еди́ныsovjet.fólkið og flokkurin erueitt, fólkið og flokkurin eru sameind (sovjettiskt slagorð); все еди́ны в том, что нельзя́ молча́ть øll [œtl] eru samd um, at ikki ber til at tiga; øll [œtl] standa saman um, at ikki ber til at tiga; еди́ная во́ля ein felags vilji; Еди́ная Росси́я Sameinda Russland (politiskur flokkur); Социалисти́ческая еди́ная па́ртия Герма́нии, СЕПГ [эс-е-пэ-гэ́]søg.Sosialistiski [soːsjaꞋlɪ-] eindarflokkur Týsklands [-lan̊s], SED [εsː eː Ꞌteː]2.(общий) felagsсоглнескл.; samiнепртк аттр(одинаковый); еди́ная цель felags mál; еди́ный тари́ф sami takstur; еди́ный (проездно́й) биле́т kort (sum er galdandi fyri øll sløg av almеnnum flutningi)3.(один-við neg) ein einastiпревосх.; ни еди́ного о́блака ikki eitt einasta skýggj; ни еди́ного сло́ва ikki eitt einasta orð@всё еди́ноóvkm.sama ger, tað er eitt feittнеформ.;еди́ным ду́хомí ein toyg;все до еди́ногоhvør einasti, allir [atl-] samlir =>госуда́рственный@,мах@,простра́нство@,хлеб@
е́дкий	stfе́док, едка́ogе́дка, е́дко, е́дкиadj1.(разъедающий) etsandiглandi; е́дкая кислота́ etsandi syra [syː-]нн, etsandi sýraнп2.(раздражающий) ramurсогл{a/o}; svíðandiглandi(вызывающий жжение); е́дкий за́пах rámiмгл-i(luktur); е́дкий дым ramur roykur, rámi (roykur);3.fl.(язвительный) forhánisligur [-Ꞌhɔa-]глigur, bítandiглandi, hvassurсогл{a/ø}, speiskurсоглsk, spoyskurсоглsk, spotskur [spɔsk̥-]соглsk; е́дкая иро́ния bítandi ironi [iːɹoꞋniː]; е́дкое замеча́ние ein forhánislig viðmerking; е́дкая усме́шка eitt speiskt [spɔʰkst] grin =>натр
едо́к	Gen, Accедок|а́;plur~и́, ~о́в, ~а́мm1.(лицо) fólkс0о(í kostarhaldi); у него́ в семье́ мно́го едоко́в hann hevur nógvar munnar at metta; на едока́ fyri hvønn, upp á hvønn, upp á hvørt fólkið2.tlm.(лицо,которое ест) átariмгл-ari, áturoppaжгл-aпренебр.; он хоро́ший едо́к hann etur nógv; он плохо́й едо́к hann er eitt nartl, hann etur lítið
едрёна	adj bert stf f:(ну́ его) к едрёне ма́тери {ба́бушке}óv.far at [ɔa] fananum til við honumбран., far hann niður og norður; eg skíti á hannвульг.(плевал я на него); едрёна вошьóv.tað var sum fanin!бран.
едре́не:	(ну его́) к едре́не фе́неóv.far at [ɔa] fananum til við honumбран., far hann niður og norður; eg skíti á hannвульг.(плевал я на него)
ЕДРО	[йэдро́]f indecl stytt. fyriЕди́ная Росси́я (fulla navnВсеросси́йская полити́ческая па́ртия Еди́ная Росси́я)
еду́н	m: еду́н напа́л на него́tlm.,skemt.hann fekk sovorðnan matarlyst, gloprini komu á hannред., hann varð so gorhungraður
её	IGen, Acc síона́IIpron poss переводится разн. конструкциями, в т.ч.hennaraи конструкциями сhjá [tʃʰ-]; О́льга и её муж Olga og maður hennara; маши́на и её владе́лец bilurin og eigarin av honum; страна́ и её жи́тели landið og íbúgvarnir í tí, landið og tess íbúgvarкн.,sí eis.его́2
ёж	Gen, Accеж|а́;plur~и́, ~е́й, ~а́мm1.(Erinaceus europeus) pinnsvínннкс0о, tindasvínнпс0о, igulkøtturлпмсогл-ir{ø/a}2.: морско́й ёж (Echinus) igulkerс0о{+}3.herm.(проволочное заграждение)slag av tanksforðing(við píkatráði o.ø.)@(и) ежу́ поня́тно {(и) ежу́ я́сно}tlm.tað er so eyðsæð, tað er fyri hvønn mann, tað forstendur [-Ꞌstε-]ннкhvørt mansbarn
ежеви́ка	f1.(Rubus fructicosus) bromber [pɹɔm-]с0о{+}(berjarunnur)2.(ягода)eis. kollbromber [pɹɔm-]с0о{+}(ber)тж. собир.
ежеви́чный	adjbromberja- [pɹɔm-]
ежего́дник	márbókж0-ur{ó/ø}, ársritс0о
ежего́дно	advhvørt ár, árliga; um árið
ежего́дный	adjárligurглigur, árs-; árvísur [ɔɹ-]соглред.(случающийся из года в год)
ежедне́вно	advdagliga, hvønn dag
ежедне́вный	adj1.(бывающий каждый день) dagligur, dag-; ежедне́вная газе́та dagblað [takp-], [tεap-]; ежедне́вные посеще́ния dagligar vitjanir2.(повседневный) gerandis-; ежедне́вные забо́ты gerandisbekymringarннк
еже́ктор	mejektor [-Ꞌjε-]м0-torтехн.; jektariмгл-ariмор. (насос)
е́жели	conjtlm., óvkm.síе́сли
ежеме́сячник	mmánaðarblaðс0о{a/ø}{0<>i}; mánaðarritс0о
ежеме́сячно	advmánaðarliga, hvønn mánað
ежеме́сячный	adjmánaðar-; ежеме́сячный отчёт mánaðarfrágreiðing
ежемину́тно	adv1.(непрерывно) áhaldandi, javnt [jam̊t], [jan̊t] og samt2.(каждую минуту) hvørja løtu (в любой момент); hvønn minutt [mɪꞋnʊʰtː]
ежемину́тный	adj1.(непрерывный) áhaldandiглandi, støðugurглugur, alsamurсогл{a/o}; ежемину́тные звонки́ по телефо́ну áhaldandi telefonuppringingar [-Ꞌfoːn-]; ежемину́тная опа́сность støðugur vandi, alsamur vandi2.(происходящий каждую минуту) sum hendir hvønn minutt [mɪꞋnʊʰtː]
еженеде́льник	mvikuritс0о; vikublaðс0о{a/ø}{0<>i}(б.ч. о журналах развлекатеьного характера)
еженеде́льно	advhvørja viku, ... um vikuna
еженеде́льный	adjviku-; sum hendir hvørja viku; еженеде́льный журна́лsíеженеде́льник
ежено́щно	advhvørja nátt
ежено́щный	adjsum hendir hvørja nátt
ежесеку́ндно	adv1.(каждую секунду) hvørt sekund [seꞋkʰʊnt]2.síежемину́тно1
ежесеку́ндный	adj1.(происходящий каждую секунду) sum hendir hvørt sekund [seꞋkʰʊnt]2.ежемину́тный 1
ежесу́точно	advhvørt samdøgur, hvørt døgnннк
ежесу́точный	adjsum hendir hvørt samdøgur, sum hendir hvørt døgnннк
ежеча́сно	adv1.(каждый час) hvønn tíma2.(непрерывно,постоянно) í heilum, alsamt, áhaldandi
ежеча́сный	adj1.(происходящий каждый час) sum hendir hvønn tíma2.(непрерывный, постоянный) áhaldandiглandi, støðugurглugur, alsamurсогл{a/o}
ёжик	m1.dim avёж2.(причёска) plússс0о(hár); стри́чься ёжиком plússaaðisær, blíva plússklipurсогл
ёжиться	ёж|усь, ~ишься, ~атсяipf1.pfпоёжитьсяпоёж|усь, ~ишься, ~атся(от холода) skutraaðisær2.tlm.(стесняться) smæðastir(d), firnastaði; ivastaði, dragaслнó-ó.iá Ꞌ bæði (колебаться)
ежи́ха	fhonpinnsvínннкс0о,hontindasvínнпс0о(síёж)
ежо́вый	adjpinnsvína-ннк, tindasvína-нп, igulkatta-лп@держа́тького-л.в ежо́вых рукави́цахhavaнепрfast tamarhaldá o-m, gevaслнa-ó-io-mstutt boð
езда́	f1.(перемещение) ferðж0-ir(við fari av o-m slag); koyringж0-ar(на машине,велосипеде и др.); ríðingж0-ar(верховая),sí eis.е́хать; бы́страя (верхова́я) езда́ skjót ríðing, skjót (ríðingar)ferð; езда́ на саня́х koyring við sletu; до́лгая езда́ на маши́не утоми́ла её hon varð móð av tí langa biltúrinum; во вре́мя езды́ á leiðini2.: в трёх часа́х езды́ от села́ tríggja tíma ferð frá bygdini, tríggja tíma koyring frá bygdini, tríggja tíma ríðing frá bygdini; от села́ до го́рода 50 мину́т езды́ tað tekur 50 minuttir [-Ꞌnʊ-] at koyra frá bygdini til býin =>верхово́йI I
е́здить	е́зжу, е́зд|ишь, ~ятindef sí eis.е́хатьipf1.(двигаться куда-л.) ferðastaði, faraслнó-ó-a; koyrair(d), siglair(d){+}(судном), ríðaслнei-i-i(верхом)}; е́здить по стране́ ferðast um landið; мно́го е́здить ferðast nógv; е́здить на трамва́е koyra við sporvogni, fara við sporvogni; е́здить в го́сти fara at vitja (fólk); е́здить заInsfara eftir [εʰtː-]Дат; он ча́сто е́здит к ма́тери hann er ofta og vitjar mammu sína2.(уметь пользоваться средством передвижения) (dugair(d){+}at) koyra; е́здить на мотоци́кле duga at koyra (á) motorsúkklu [-Ꞌtʰoː-]; он е́здит на велосипе́де? dugir hann at súkkla?; ты́ е́здишь на маши́не? koyrir tú?; dugir tú at koyra bil?; уме́ние е́здить tað at duga at koyra bil3.tlm.(скользить) glíðaслнei-i-i@е́здить (верхо́м)на ком-л.{на чьей-л.спине́}geraнепрsær dæltvið o-m, benytta [-Ꞌnɪ-]ннкaðisærav o-m
е́здка	plurе́зд|ки, ~ок, ~камffakm.,tlm.túrurмсогл-ar;-,-ir(ið bilur o.a. ger við farmi el. eftir farmi)
ездово́й	Iadjkoyri-, ríði-, dráttar-; ездова́я доро́га koyrivegur; ездова́я ло́шадь ríðingarhestur; ездова́я соба́ка sletuhundurIImherm.herkuskurмсогл-ar
ездо́к	Gen, Accездок|а́;plur~и́, ~о́в, ~амm1.(умеющий ездить) reiðmaðurмнепр(верхом); jockey [tʃɔʰkːi]м0-ar{дат.0}(жокей); súkklariмгл-ari, súkklistur [-Ꞌlɪ-]мсогл-ar(велосепидист); bilførariмгл-ari(шофёр); vognstýrariмгл-ari, kuskurннкмсогл-ar(кучер)2.gml.(всадник) reiðmaðurмнепр@сюда́ я не ездо́кeg komi ikki aftur [aʰtː-] higar, eg seti ikki fótin har oftari
Е́здра	mbíbl.Ezra [εsɹa]м нескл.
Езекии́л	mbíbl.Ezekiel [eꞋseːkiεl]м0{0<>i}
езжа́...	езжа́й, езжа́йтеóvkm.imper avе́хать
е́зженый	[йеж:-]е́зжен, ~а, ~о, ~ыadj tlm1. (о дороге) tilkoyrdurсогл2. (о лошади) vandurсогл, tilriðinсоглосн{ð//d}спец.(um ross)
е́зжу	1. pers pres avе́здить
ей	Dat, Ins síона́
ей-бо́гу	intertað veit Gud [tʰεavaꞋkuːt], [Ꞌtʰεavakuːt]; ей-бо́гу, э́то она́! tað veit Gud, tað er hon!; ей-бо́гу, не зна́ю tað veit Gud, eg ikki veit; ей-бо́гу нет nei, tað veit Gud, tað ikki er
ей-е́й	interóvkm.síей-бо́гу
ей-же-е́й	interóvkm.síей-бо́гу
ЕК	[йе-ка́]f indeclЕвропе́йская коми́ссия; Еврокоми́ссия ES-kommissiónin [-kʰɔmːiʃɔun-]
Екатеринбу́рг	mJekaterinburg [jeːkʰaːtɪriːnꞋpʊɹk]м0{дат.0}(1924-1991Свердло́вск)
Екатеринода́р	msøg.Jekaterinodar [jeːkʰaːtɪriːnoꞋtaːɹ]м0{дат.0},síКраснода́р
Екатериносла́в	msøg.Jekaterinoslav [jeːkʰaːtɪrinoˈslaːv]м0{дат.},síДнепрII
ёкать	ipf(momentёкнутьёкн|ет, ~ут)bert 3. pers brúkturkippastir(t); у меня́ се́рдце ёкнуло hjartað [j-] kiptist upp í hálsin á mær
Екклезиа́ст	mbíbl.«Кни́га Екклезиа́ста или Пропове́дника» Prædikarinмгл-ariопр.
ёкнуть	moment síёкать
е́л…	ел, е́лаo.s.fr. pret avесть I
е́ле	adv1.(чуть,слегка) knappliga (neyvan), nóg illa [ɪtla], ikki meira enn; е́ле слы́шный sum nóg illa hoyrist2.(с трудом) valla [-tla], ikki meira enn; tað var so, at...; við neyð og deyð; næstan ikki; он е́ле говори́т tað er so, at hann fær tosað; он е́ле говори́т по-ру́сски hann dugir næstan ikki at tosa russiskt; е́ле-е́ле við neyð og deyð, við bit og slit, akkurát; я е́ле-е́ле нашёл tað var so, at eg fann; eg mundi ikki funnið; он е́ле победи́л hann vann ein tepran sigur@е́ле живо́й{е́ле-е́ле душа́ в те́ле}meira deyðurглenn livandiглandi
еле́й	m1.kirk.(масло) oljaжгл-a2.fl.(утешение) linniмгл-i, uggiмгл-i
еле́йный	adv1.kirk.(келе́й 1) olju-2.fl.(умильный,слащавый) (smikur)søturсогл, sukursøturсогл; salvilsisfullur [-tl-]энксогл(с пафосом)пренебр.
Еле́на	síСвято́йЕле́ны о́стров
Елео́нская гора́	bíbl.Oljufjallið [-tlɪ]с0о{a/ø}опр.
елеосвяще́ние	n síсобо́рование
ели́ко	advgml.:ели́ко возмо́жноgml.,skemt.eftir [εʰtː-] førimuni; so gott sum til ber
Елисе́йские поля́	1.myt.(в древнегреческой мифологии) Elysion [eꞋlyːsiɔn]с0{дат.0}, Elysium [eꞋlyːsiʊm]с0{дат.0}2.(в Париже) Champs Élysées [ʃaŋ̊seːliꞋseː]с нескл.(í Paris)
ёлка	plur.ёл|ки, ~ок, ~камf1.síель2.(праздничная) nýggjárstræс0о{æ/ø}{0<>i}(новогодняя) (í Russlandi); jólatræс0о{æ/ø}{0<>i}(рождественская); убира́ть {украша́ть} ёлку pynta jólatræ3.(праздник) jólatræс0о{0<>i}(jólatræshald); nýggjársveitsla [-vai̯sla]жгл-a(fyri børnum;í Russlandi)
ёлки-мота́лки	interóvkm.síёлки-па́лки
ёлки-па́лки	interóvkm.á, faninбран.; fanin turki!бран.,fanin brenni!бран.; (bilsni o.a.) tað var sum faninбран.
ело́вый	adjgrann-; ело́вая ши́шка grannkongul; ело́вый лес grannskóg, grannskógurнп; ело́вый стол borð úr grann@голова́ ело́ваяóvkm.títt býtta apparat [-Ꞌraːt]энкпренебр.
ело́зить	ело́жу, ело́з|ишь, ~ятipfóvkm.krúpaслнey-u-o, grulvaaði; vendair(d)og snaraaðisær (вертеться); glíðaслнei-i-i(скользить)
ёлочка	plurёлоч|ки, ~ек, ~камf1.dim avель, ёлка 12.: узо́р ёлочкой {в ёлочку} fjøðurvondж0-ur{o/a/e}, sildabeinsmynstur; вы́шитьчто-л.ёлочкой seymao-tí sildabeinsmynstur3.: поднима́ться ёлочкой (по чему-л.)ganga niðaneftir á skíðum við framendum vendum úteftir
ёлочный	adjjólatræs- (кёлка 2); ёлочная све́чка jólaljós (á jólatræi); ёлочное украше́ние nýggjárstræspynt (í Russlandi); jólatræspynt
ель	f(Picea) grannж0-ir, granntræс0о{æ/ø}{0<>i}eis. koll
е́льник	m1.(лес) grannskógж0-ir, grannskógurнпмсогл-ir;-ar2.(ветки) granngreinж0-ar;-ir, grannkvisturмсогл-ar
ем	1. pers avесть I
Еме́ля	m síмоло́ть@
ёмкий	stfём|ок, ~ка, ~ко, ~ки;comp~чеadjrúmligurглigur
ёмкостный	[-косн-]adjel.kapasitets- [kʰaːpʰaːsiꞋtʰeː-]спец.
ёмкость	f1.(способность вместить в себя) kapаsitetur [kʰaːpʰaːsɪꞋtʰeː-]ннкмсогл-arпроф., спец.; rúmdж0-ir, rúminnihaldс0о(вместимость); ёмкость трю́ма lastakapasitetur [-kʰaːpʰaːsɪ-]; ёмкость ры́нкаbúsk.marknaðarkapasitetur [-kʰaːpʰaːsɪ-]; какова́ ёмкость буты́лки? hvat tekur fløskan?; ме́ры ёмкости rúmmálс0омн2.el.(способность удерживать заряд) kapasitetur [kʰaːpʰaːsɪꞋtʰeː-]мсогл-s,-irспец.3.fakm.(сосуд) beholdari [-Ꞌhɔ-]ннкмгл-ari(для жидкости,газа)
ё-моё	interóv.síёлки-па́лки
ему́	Dat síон, оно́
Енисе́й	mJenisej [jeːnisεi]ж нескл.
ено́т	m1.(Procyon lotor) vaskibjørn [-tn]ннкж0-ir{ø/a}, tváttarbjørn [-tn]ж0-ir{ø/a}зоол.2.(мех) skinn av tváttarbjørn [-tn]лп
енотови́дная соба́ка	f(Nyctereutes procyonoides)djór av ættini Canidae(en.racoon dog; da.mårhund)
ено́товый	adjtváttarbjarnar- [-tn-]лп
-еньк	eftirskoyti1.verður heftur upp í stovnin á navnorðum, lýsingarorðum og hjáorðum til gerð av dim., t.d.па́па-па́пенька, тёплый-тёпленький, сла́бо-сла́бенько2.tlm., barn. verður lagdur aftur at navnhátti av nøkrum sagnorðum til gerð av dim. í tlm., t.d.спать-спа́теньки
епа́рхия	fstiftс0о(в Дании и др.); biskupsdømiсгл-i
епи́скоп	mbiskupurмсогл-ar, bispurмсогл-ar
епи́скопский	adjbiskups-, bispa-
епи́скопство	n1.síепа́рхия2.(сан) biskupsembætiсгл-i, biskupsdømiсгл-i(embæti)
епитимья́	plurепитим|ьи́, ~и́й, ~ья́мf kirk.revsingж0-ar(kirkjulig)
епитрахи́ль	fepitrachelion [-ˈkʰeː-]с0о(í ortodoksum o.ø. kirkjum); stolaжгл-a(;0-ir)(í katólskari og lutherskum kirkjum)
ер	m gamalt navn á bókstavinumъ
ЕР	[йе-э́р]f indeclЕди́ная Росси́я (politiskur flokkur)
ерала́ш	m1.tlm.(беспорядок) hurlivasiмгл-i, rokс0о2.(игра)gamalt kortspæl
Ерева́н	mJerevan [jeːɹɪvan]м0{дат.0}(til 1936Эрива́нь)
ерепе́ниться	ерепе́н|юсь, ~ишься, ~ятсяipf(pfвзъерепе́нитьсявзъерепе́н|юсь, ~ишься, ~ятся)óvkm.vera tvørurсогл, treiskastaði
е́ресь	f1.rel.(в религии) trúvilla [-tla]жгл-aрел., trúarvilla [-tla]жгл-aрел., falstrúgvж0-ir{+}рел.; впасть в е́ресьeis.falla [-tla] frá trúnni2.fl.(отступление от принятых взглядов) frávikс0о(frá viðtiknum sjónarmiðum)3.tlm.(вздор) tvætlс0о, møsnс0о, svassс0о
ерети́к	Gen, Accеретик|а́;plur~и́, ~о́в, ~а́мm1.rel.(в религии) trúvillingur [-tl-]мсогл-arрел. ,trúarvillingur [-tl-]мсогл-arрел. 2.fl.(отступающий от принятых взглядов) frávíkjariмгл-ari, kettari [кʰε-]ннкмгл-ari
ерети́ческий	adj1.rel.(ке́ресь 1) rangtrúgvinсоглоснgvбибл., trúvillu- [-tl-]рел.2.fl.(отступающий от принятых взглядов) frávíkjariмгл-ari, kettariннкмгл-ari
ерети́чка	plurерети́ч|ки, ~ек, ~камf1.rel.(в религии) trúvillingur [-tl-]мсогл-arрел. ,trúarvillingur [-tl-]мсогл-arрел.(konufólk)2.fl.(отступающий от принятых взглядов)o-r, ið víkur frá (frá viðtiknum sjónarmiðum) (konufólk)
ёрзать	ipftlm.sitaслнa-ó-iófriðarliga [-Ꞌfɹiː-]; не ёрзай! sit stillur [-tl-]!
ермо́лка	plurермо́л|ки, ~ок, ~камfkollhúgva [-tl-]жгл-a, kalottur [-Ꞌlɔ-]мсогл-ar(ос. религиозная)
ёрник	m tlm.spottariмгл-ari,o-r, sum ger gjøldur burturúr [-ˈʉuɹ]
ёрничать	ipf tlm. haldaслнe-i-ifyri tað turra spott, havaнепрfyri gjøldur
еро́шить	еро́ш|у, ~ишь, ~атipf(pfвзъеро́шитьвзъеро́ш|у, ~ишь, ~ат)что-л.tlm.frísaaðio-t; reisair(t)fjaðrarnar (о перьях); ývair(d);aðiseg (топорщить)
еро́шиться	ipf tlm.1.еро́ш|ится, ~атся(о волосах и т.п.) vera ývinсоглосн, standaслнó-ó-aí andarisi (hár o.tíl.)2.еро́ш|усь, ~ится, ~атся(горячиться) ývair(d);aðiseg upp, gerast rísinсоглосн, øsair(t)seg upp
ерунда́	f1.(вздор) tvætlс0о, møsnс0о, svassс0о, tvassс0о, vøsс0о, sluturэнкс0осн, vrøvl {vrevl}энкс0о; моло́ть {говори́ть} ерунду́ tvætlaaði, møsnaaði, svassaaði, tvassaaði, vrøvla {vrevla}энкaði2.(пустяк)o-t, sum einki hevur upp á [ʊꞋpʰɔa] seg;o-tsmávegis, bagatell [pakaꞋtʰεlː]ннкж0-ir;o-t, sum lítið er fyri (лёгкое дело);o-t, sum einki er fyri (лёгкое дело); научи́ться пла́вать - су́щая ерунда́ at læra at svimja er púra einki fyri, tað hevur einki upp á [ʊꞋpʰɔa] seg at læra at svimja, tað er eitt spæl at læra at svimja; си́льно поре́зался? - ерунда́! Hevur tú skorið teg illa [ɪtla]? - Tað hevur einki upp á [ʊꞋpʰɔa] seg.
ерунди́ть	ерунд|и́шь, ~я́тipfóvkm.1.(говорить ерунду) tvætlaaði, møsnaaði, svassaaði, tvassaaði, vrøvla {vrevla}энкaði2.(заниматься ерундой) spælair(d)býtt; beraслнa-ó-oseg býtt at (вести себя глупо); не ерунди́! ver (nú) ikki so býttur!
ерундо́вский	1. (вздорный) býtturсогл, tápiligurглigur2.(незначительный) aum einki hevur upp á [ʊˈpʰɔa] seg
ерундо́вый	adj tlm.1. (вздорный) býtturсогл, tápiligurглigur2.(незначительный) aum einki hevur upp á [ʊˈpʰɔa] seg
ёрш1	IGen, Accерш|а́;plur~и́, ~е́й, ~а́мm1.(Acerina cernua)fiskur av áburruættini(en.ruff, da.hork)2.(щётка) lampubustж0-ir, fløskubustж0-ir
ёрш2	IIGenерш|а́;plur~и́, ~е́й, ~а́мmtlm.(смесь пива с водкой) undirvatnsbátur [-van̊s-]мсогл-arшутл., djúpvatnsbоmba [-van̊s-]жгл-aшутл.(blanding av øli og snapsi)
ерши́стый	stfерши́ст, ~а, ~о, ~ыadjóvkm.1.(о волосах) rísinсоглосн, ývinсоглосн, stríðurгл2.(задорный) ringur at hava við at gera, sum ikki flættast við, óflættiligur [-Ꞌfla-]глigur, óflýggjaligur [-Ꞌflʊtʃː-]глigur(ólagaligur), óviðeiriligurглigur
ерши́ться	ерш|у́сь, ~и́шься, ~а́тсяipfóvkm.ývaaði;ir(d)seg upp
ершова́тка	plurершова́т|ки, ~ок, ~камf(Limanda limanda) skrubbaжгл-a, sandsprøka [sans-]жгл-a
еры́	n indecl gamalt navn á bókstavinumы
ерь	m indecl gamalt navn á bókstavinumь
ЕС	[е-э́с]m indeclES [eː εsː]с нескл., EU [eː uː]ннкс нескл. síЕвропе́йскийСою́з
есау́л	msøg.kapteinur [-Ꞌtʰai-]мсогл-ar(í kosakkaherdeild)
е́сли	conj1.condviss {vissi}ннк, umпереводится тж при помощи обратного порядка слов; я приду́, е́сли смогу́ eg komi, vissннкeg kann; е́сли эконо́мить, то де́нег хва́тит vissннкvit spara, so røkka pengarnir; spara vit, so røkka pengarnir; um vit spara, so røkka pengarnir; е́сли ве́рить … skulu vit trúgva…; е́сли я не приду́ в во́семь часо́в, вы меня́ не жди́те vissннкeg ikki eri komin klokkan átta, skulu [skʊlːʊ] tit ikki bíða eftir [εʰtː-] mær; eri eg ikki komin klokkan átta, skulu [skʊlːʊ] tit ikki bíða eftir [εʰtː-] mær; е́сли не хо́чешь, не ходи́ vissннкtú ikki tímir, skalt tú ikki fara; um tú ikki tímir, skalt tú ikki fara; tímir tú ikki, so skalt tú ikki fara; е́сли бы он знал, он не пошёл бы hevði [hεijɪ] hann vitað tað, so var hann ikki farin; vissннкhann hevði [hεijɪ] vitað tað, so var hann ikki farin; е́сли бы не дождь, я пошёл бы гуля́ть vissннкtað ikki fer at regna, so fari eg ein túr; fer tað ikki at regna, so fari eg ein túr; е́сли бы не ты, я пропа́л бы hevði tú ikki verið, so hevði [hεijɪ] verið úti við mær; uttan teg hevði [hεijɪ] verið úti við mær; е́сли бы он мог, то рабо́тал бы hevði [hεijɪ] hann kunnað, so hevði [hεijɪ] hann arbeitt;sí eisбыА2.expat; не удиви́тельно, е́сли все хотя́т… tað er ikki at undrast á, at øll [œtl] vilja...3.concessjálvt [ʃɔl̥t] um; е́сли да́же он дово́лен, он никогда́ не пока́жет э́того sjálvt um hann so er nøgdur, so vísir hann tað ongantíð; е́сли он и был там, я его́ не ви́дел sjálvt um hann var har, so sá eg hann ikki4.contrmeðanили переводится тж при помощи обратного порядка слове́сли на се́вере хо́лодно, то на ю́ге жа́рко er tað kalt norðanfyri, so er tað (harafturímóti [-aʰtː-]) heitt sunnanfyri; meðan tað er kalt norðanfyri, so er tað (harafturímóti [-aʰtː-]) heitt sunnanfyri5.: а {и} е́сли кто винова́т, то э́то он er nakar sekur, so er tað hann; vissннкnakar er sekur, so er tað hann@е́сли бы {б}(лишь бы); (о), е́сли бы она́ была́ здесь! (á,) hevði [hεijɪ] hon bara verið her!; е́сли бы я то́лько знал! bara eg visti tað; hevði [hεijɪ] eg bara vitað tað; е́сли бы он пришёл! hevði [hεijɪ] hann bara komið!; е́сли бы э́то бы́ло пра́вдой hevði [hεijɪ] hetta bara verið sannheitннк; vissннкtað bara hevði [hεijɪ] verið sannheitннк; я пойду́ то́льков слу́чае, е́слион оста́нется eg fari bara, um so er, at hann verður verandi; eg fari bara, vissннкhann verður verandi; в слу́чае, е́сли она́ придёт um so er, at hon kemur; vissннкhon kemur; (а)что,е́слион узна́ет об э́том? hvat nú vissннкhann frættir um hetta?; что, е́сли пойдёт дождь? hvat nú, vissннкtað fer regna?;что, е́сли бывы зашли́ к нему́? hvat nú, vissннкtit stukku innum [inːꞋumː] hjá [tʃʰ-] honum?; что, е́сли бы нам пойти́ в кино́? hvat við at fara í biograf [piːjoꞋkɹaːf]?;е́сли то́лькоvissннкbara;е́сли хоти́теlat okkum siga tað;е́сли бы да кабы́tlm.≈ vissннкomma tín hevði [hεijɪ] hjul [juːl]ннк, var hon ein súkklaпог.,шутл.=>пойти́@,такI,1
ЕСН	[е-эс-э́н]m indeclеди́ный социа́льный нало́г (sí)
ЕСПЧ	[йе-эс-пэ-чэ́]m indeclЕвропе́йский суд по права́м челове́ка Europeiski [œuɹoˈpʰeːɪ-] {Evropeiski [evɹoˈpʰeːɪ-]} Mannarættindadómstólurin
Ессентуки́	Ессентутук|о́в, ~а́мm plurJessentuki [jεsːεntʰuꞋkʰiː]м нескл.
ессентуки́	есстентук|о́в, ~а́мm plur ym. sløg av mineralvatni frá Jessentuki í Norðurkaukasus
есте́ственник	mgml.el.tlm.náttúrufrøðingurмсогл-ar, náttúrugranskariмгл-ari
есте́ственно	Iadvnatúrliga [-Ꞌtʰʏ-]; есте́ственно развива́ться útvikklaннкseg natúrliga; держа́ться есте́ственно vera natúrligur [-Ꞌtʰʏ-]глigurII 1.pred: (соверше́нно) есте́ственно, что… tað er so eyðvitað, at ..., tað er so sjálvsagt [ʃɔl̥s-] at, ...; tað er so vituligt, at ...; sum vera man, so ...2.parentsjálvsagt [ʃɔl̥s-], sjálvandi, sjálvfylgiliga [ʃɔlꞋfɪ-]ннк, sjálvfylgiligt [ʃɔlꞋfɪ-]ннк; vituliga, eyðvitað, sum vera man; он, есте́ственно, согласи́лся hann játtaði sjálvandi
есте́ственность	fnatúrligheit [-Ꞌtʰʏ-]ж0-ir
есте́ственный	stfесте́ствен, ~на, ~но, ~ныadj1.(природный) natúrligur [-Ꞌtʰʏ-]глigur, náttúru-, natúr- [-Ꞌtʰʉuɹ-]; есте́ственная грани́ца natúrligt mark; есте́ственные бога́тства náttúruríkidømiнп, natúrríkidømi2.(изучающий природу) náttúru-, natúr- [-Ꞌtʰʉuɹ-]; есте́ственные нау́ки náttúruvísindiнп, natúrvísindi [-Ꞌtʰʉuɹ-]; есте́ственная исто́рияgml.natúrsøga [-Ꞌtʰʉuɹ-]уст., náttúrusøgaнпуст.3.(нормальный) natúr- [-Ꞌtʰʉuɹ-]; есте́ственная кра́ска natúrlitur [-Ꞌtʰʉuɹ-]; seyðalitur (о шерсти овец); есте́ственная смерть natúrligur [-Ꞌtʰʏ-] deyði4.(натуральный,закономерный) natúrligur [-Ꞌtʰʏ-]глigur, sjálvsagdur [ʃɔl̥s-]согл{a/ø}; соверше́нно есте́ственный púra natúrligur; есте́ственный ход веще́й tann natúrliga gongdin í málunum5.(простой,безыскусный) natúrligur [-Ꞌtʰʏ-]глigur, ótilgjørdurсогл; есте́ственные мане́ры natúrlig medferðж-ir@есте́ственное де́ло {есте́ственным о́бразом {есте́ственная вещь}parentsjálvsagt [ʃɔl̥s-], sjálvandi, sjálvfylgiliga [ʃɔlꞋfɪ-]ннк, sjálvfylgiligt [ʃɔlꞋfɪ-]ннк; vituliga, eyðvitað =>отбо́р,потре́бность@,цветI I
естество́	n1.bókl.(сущность) tað insta; kjarni [-tnɪ]мгл-i(суть)2.gml.(природа) natúr [-Ꞌtʰʉuɹ]ж0-ir, náttúraнпжгл-a
естествове́д	mgml.náttúrufrøðingurмсогл-ar, náttúrugranskariмгл-ari
естествове́дение	nnáttúruvísindiнпсгл-iмн, natúrvísindi [-Ꞌtʰʉuɹ-]сгл-iмн
естествозна́ние	nnáttúruvísindiнпсгл-iмн, natúrvísindi [-Ꞌtʰʉuɹ-]сгл-iмн
естествоиспыта́тель	mnáttúrufrøðingurмсогл-ar, náttúrugranskariмгл-ari
есть1	Iем, ешь, ест; еди́м, еди́те, едя́т;pretел, ~а, ~о, ~и;imper.ешь, е́шьтеipf Acc1.pfсъестьсъем, съешь, съест; съеди́м, съеди́те, съедя́т; pret съел, ~а, ~о, ~и; imper съешь, съе́шьте,sí eis.пое́сть(принимать пищу) etaслнá-ó-eВин; súpaслнey-u-oo-t(ложкой суп,кашу и др.) ; fáaслнe-i-især (кушать,пить;тж как приглашение); есть мно́готжvera matligurглigur; он (о́чень) хо́чет есть {ему́ (о́чень) хо́чется есть) hann er (ógviliga) svangur; хо́чешь есть? ert tú svangur?; vilt tú hava at eta?; есть за четверы́х eta móti fýra;2.кого-л.(жалить, кусать) bítaслнei-i-io-n, stingaслнa-u-uo-n3.pf eis.разъе́стьразъ|е́м, ~е́шь, ~е́ст; ~еди́м, ~еди́те, ~дя́т; pret ~ъе́л, ~а, ~о, ~и; imper ~е́шь, ~е́шьте что-л.(разъедать) tærair(d)o-t4.Acc(причинять боль) svíðaслнei-i-i; дым ел глаза́ roykurin sveið [svεi], [svai] í eygunum; его́ ест тоска́ hann tærist burtur av sorg; э́та мысль постоя́нно е́ла его́ hesin tankin [tʰaɲ̊tʃɪn] gekk á hann5.кого-л.óvkm.(попрекать) brigslaaðio-m o-t, kastaaðio-m o-tfyri; grenjaaði, knarraaðiinn á o-n, júkaá o-n(грызть)@есть свой хлебarbeiðair(d)fyri Ꞌ seg;есть чужо́й хлебlivair(d)(að)av annars náði;да́ром есть хлебa) (быть совершенно бесполезным) onga nyttu vera til; b) (паразитировать) snulta, ikki vinna til lívsins uppihald;естького-л.глаза́миslúkaar(t)o-nvið eygunum;боти́нки есть про́сятskemt.skógvarnir eru fullir [-tl-] í holum;с чем э́то едя́т?skemt.hvør hundan er hetta?;кто не рабо́тает, тот не естum einhvør ikki vil arbeiða, tá eigur hann heldur ikki at fáa at eta
есть2	IIpres síбыть@есть тако́е де́ло!a) (согласен) tað er rætt!; b) (хорошо) fínt!; í lagi! c) (будет сделано) eg skal gera tað!;и естьóvkm.vist; а вот э́то Лена! - Лена и есть Hetta er Lena! - Jú vist er tað Lena;так и есть!soleiðis er tað!; tað passar!;кто {како́й; что} ни на естьhvussu hann so er ella [εtla] ikki; hvat illur [ɪtl-] hann er;са́мый что ни на есть хоро́шийtann allarbesti; tann besti, sum hugsast kann;есть - то есть, да не про ва́шу честьtilt.ikki inn í eygað (spotskt svar til onkran,sum biður um okkurt) =>си́ла@
есть3	IIIinterher!; ja! (svar,tá rópt verður upp)
Есфи́рь	fbíbl.Ester [εstεɹ]ж0-ar
ети́	bert inftabu!síеба́ть1
еть	síети́
е́ться	bert inftabu!síеба́ть1 еба́ться 1
ефре́йтор	m≈ undirkorporalur [-raːl-]мсогл-ar
е́хать	е́д|у, ~ешь, ~утAdef(indef síе́здить,sí eis.пое́хать)í imper verð brúktir formarnirпоезжа́й, поезжа́йтеogóvkm.езжа́й, езжа́йте1.(двигаться куда-л. при помощи средств передвижения) koyrair(d)(на поезде,автомобиле и др.); ríðaслнei-i-i(верхом); siglair(d){+}(на судне); faraслнó-ó-a, ferðastaði; я е́хал вочто-л.eg fór tilo-t(Род с нек. геогр. названиями,иначекн.,уст.); куда́ ты е́дешь? hvar fert tú?; когда́ мы е́хали, шёл дождь meðan vit koyrdu, regnaði tað; е́хать на велосипе́де súkklaaði, koyra á súkklu; е́хать на саня́х koyra við sletu; е́хать на парохо́де fara við skipi, ferðast við skipi; е́хать по́ездом {на по́езде} fara við toki, ferðast við toki; е́хать на самолёте {самолётом} flúgvaслнey-u-o, ferðast við flúgvaraннк, fara við flogfariнп; е́хать на трамва́е на рабо́ту koyra til arbeiðis við sporvogni2.(о транспорте) komaслнo-o-o; koyrair(d)(о поезде,автомобиле и др.); siglair(d){+}(о судне); flúgvaслнey-u-o(о самолёте); по доро́ге е́дет маши́на ein bilur kemur koyrandi eftir [εʰtː-] vegnum [veːn-]Bipf1.(подъезжать) komaслнo-o-o; е́дут! tey koma!; nú koma tey!2.: ша́пка е́дет на́бок húgvan glíður á skák, húgvan fer á skák; но́ги на льду е́дут в сто́руну føturnir glíða á ísinum=>верхо́м 1,не́куда@,ти́ше@
ехи́дна	f1.djór.(Echidna aculeata) meyrutindasvínс0озоол.2.djór.(Pseudechis)slanga av ættini Elapidae(en.black snake; da.sortslange)3.fl. tlm.(о человеке) bakbeist [pakp-]с0о, illmenniсгл-i, vittuggi [vɪtʰʊ-]]сгл-i
ехи́дничать	ipf(pfсъехи́дничать)tlm.vera spottandiглandi, vera óreinurсогл, vera illnatinсоглосн; komaслнo-o-ovið spottandi orðum, komaслнo-o-ovið óreinum orðum, komaслнo-o-ovið illnatnum orðum
ехи́дно	advspotskliga [spɔsk-], spottandi
ехи́дный	stfехи́д|ен, ~на, ~но, ~ныadjspotskur [spɔsk-]соглsk, spottandiглandi
ехи́дство	nspottс0о, óreinheitннкж0-ir
ехи́дствовать	ехи́дству|ю, ~ешь, ~ютipftlm.síехи́дничать
ЕЦБ	[йэ-цэ-бэ́]m indecl síЕвропе́йскийцентра́льный банк
ешь	1.2. pers pres avесть 12.imper avесть 1
ещё	Iadv1.(до сих пор) enn; ещё нет ikki enn; он ещё не верну́лся hann er ikki komin aftur [aʰtː-] enn; ты ещё не уста́ла? tú ert ikki blivin móð enn?; он ещё не говори́т по-ру́сски hann dugir ikki (at tosa) russiskt enn, hann er ikki farin at tosa russiskt enn; всё ещё идёт дождь tað regnar enn, tað regnar við sama lag, tað blívur við at regna2.(вдобавок) meira, afturat [aꞋtʰɹεat]; ещё ча́ю? meira te?; ещё ча́шку ча́я ein kopp av te afturat [aꞋtʰɹεat]; ещё два куска́ хле́ба tveir breyðbitar [pɹεp-] afturat [aꞋtʰɹεat]; чего́ ты ещё хо́чешь? hvat meira vilt tú hava?; что ещё? hvat meira?; привести́ ещё приме́ры seta tvey dømir afturat [aꞋtʰɹεat] fram; 5 челове́к бы́ло уби́то и ещё 11 ра́нено, когда́… fimm fólk doyðu, og harafturat [hεɹatʰɹεat] blivu ellivu [εtl-] særd, tá...; ещё раз eina ferð afturat [aꞋtʰɹεat]3.+compuppaftur [aʰtː-], ennнп, enn ogннк+сравн.; ещё бо́льше uppaftur [aʰtː-] meira; enn og størri, uppaftur [-tː-] størri; она́ ста́ла ещё краси́вее hon er blivin uppaftur [-tː-] penariннк; он не хо́чет, а я ещё ме́ньше hann tímir ikki, og eg tími uppaftur [-tː-] minni4.(не далее как) enn; ikki fyrr enn (только); ещё у́тром я не зна́ла… í morgun visti eg ikki enn... ; ещё то́лько вчера́ enn í gjár, so seint sum í gjár5.(уже;до конца срока) longuчасто не переводится/verður ikki altíð umsett; кни́га вы́йдет ещё в э́том году́ bókin kemur út í ár; я зайду́ к тебе́ ещё сего́дня eg skal koma inn til tín í dag; ещё ребёнком он на́чал занима́ться э́тим longu sum barn [-tn] fór hann í holt við hetta; он уе́хал ещё неде́лю наза́д hann fór (avstað [aꞋstεa]) longu fyri einari viku síðani6.(указывает на наличие возможности) enn; ещё успе́ешь на по́езд tú nært tokið enn, tú lukkast til tokið enn; он нам ещё помо́жет hann skal nokk hjálpa [j-] okkumIIbrúkt sum conces: на э́то я бы ещё мог пойти́ eg hevði [hεijɪ] kunnað gingið við til hetta; э́то ещё не са́мое скве́рное hetta er ikki tað ringasta; э́то ещё ничего́ hetta er ikki tað ringasta, hevði [hεijɪ] hetta verið tað ringastaIIIpart intens: е́сли бы я ещё (хоть) был уве́рен… hevði [hεijɪ] eg so fyrr enn ikki verið sikkurннкupp á tað ...; а ты ещё хоте́л… og tú vildi enntá...; кака́я така́я ещё Ле́на? hvat fyri ein Lena?; по́мнишь Ле́ну, она́ ещё с на́ми в шко́лу ходи́ла? minnist tú Lenu, hon gekk í skúla saman við okkum?; Ты ду́маешь, я не бою́сь? Ещё как бою́сь! heldur tú ikki, eg eri bangin? Um eg eri!; чего́ хны́чешь, а ещё большо́й ма́льчик! hvat gongur tú og sjarrar, ein stórur drongur!IVparent(далее) harumframt, harafturat [hεaɹatʰɹεat]@ещё быa) (конечно, безусловно) sjálvandi, tað vildi eg hildið; мо́жет тако́е быть интере́сным? Ещё бы! kann sovorðið vera serliga spennandi? Um tað er!; ты слу́шал? Ещё бы! lurtaði tú eftir...? Um eg gjørdi!; вы дово́льны? - Ещё бы нам не быть дово́льными! eru tit nøgd? -Skuldu vit ikki verið nøgd!; skuldu vit ikki verið nøgd? Tað skuldi bara manglað [maŋk-]ннк!; b) (было бы не хорошо,если бы…) tað manglaði [maŋk-]ннкbara; ещё бы ты был недово́лен tað manglaðiннкbara, at tú skuldi vera ónøgdur; ещё бы ты жа́ловался tað kundi akkurát [aʰkɹat], [aʰkːʊˈrɔat]passa, at tú skuldi ganga og gremja teg;пока́ ещёenn;всё ещё:он всё ещё не ухо́дит hann verður sitandi; всё ещё идёт дождь tað blívur við at regna;да ещёhartil, harafturat [hεɹatʰɹεat]; он неспосо́бен, да и ещё лени́в hann dugir einki og er harafturat dovin;да ещё как!tað skal valdast!,sí eis.ещёбы а);вот ещё!nei, veitst [vai̯st] tú (nú) hvat!;ещё и ещёaftur [aʰtː-] og aftur [aʰtː-]; meira og meira;а ещё хо́чешьбыть перево́дчиком! og tú vilt vera tolkur! =>хвата́тьII @
ЕЭЗ	[еэ:зэ́]f indeclEBS [eː peː Ꞌεsː]síЕвропе́йскаяЭкономи́ческая Зо́на
ЕЭП	[е-э-пэ́]n indeclЕди́ное экономи́ческое простра́нствоsíпростра́нство@
ЕЭС	[еэ́с]n indeclЕвропе́йское экономи́ческое соо́бщество, ES [eː εsː], Evropeiska búskaparliga samveldið [εvɹoꞋpʰeːɪ-]офиц.
е́ю	Ins avона́bókl.
