e	1(málfr.)sjálvljóðsstavur (nevndur[e:])2(tónl.)tóni og samsvarandi nóti
EBS	(stytting)Evropeisk búskaparlig samgonga
edd	heiti á bókstavinumð
eddukvæði	(bókm.)fornnorrønt kvæði í savninum Eldru Eddu um gudarel.hetjur,Vøluspá og Reginsmál eru eddukvæði;sbr.drottkvæði
edikssýra	(evnafr.)lívrunnin sýra nýtt í ídnaði og til heilivág(teknCH3COOH)
edikur	edikssýra tynt við vatni(nýtt í matgerð),etikur
ediligur	1aðalborin, gøvigur, stórbærur, gævuligur2góður, eiggiligur;hj-liga
edilingur	1(kvæð.)tignarmaður, høvdingi,at ríða edilingdansispæl(Hmb. Savn192)2gott fólk, góðmenni
edilsteinur	gimsteinur
edla	(dj.)slag av lítlum skriðdjóri við longum hala og sum livir á landi, ødla,tær flestu edlurnar eru smá, kvik ránsdjór við longum hala, sum tær brúka til at halda javnvágina við;ferføtlan er ein edla[da.øgle,lat.Sauria]
edrúur	sum ikki kennir til, ódrukkin,(tilt.)edrúur maður skal svara til tað, ið drukkin maður ger
edv	(teld.)stytting fyrielektronisk dátuviðgerð
eðiligur	ediligur
eðilingur	(sj.)edilingur
eðilsteinur	(kvæð.)edilsteinur
eðulingur	(dj.)øðulingur(Sv)
eff	heiti á bókstavinumf;sbr.vaff
effinett	júst, nett, nettupp, nærkvæmsliga,allar bløðkurnar eru so effinett líka vorðnar
eftir	1viðhvnf1(um eftirsitandi, um tað sum liggur eftir (e-n))einkjan eftir Jógvan;hvat havi eg í bøtur tikið eftir sæla faðir mín?;hon sprakk av harmi eftir hann(doyði av sorg);hava e-n eftir seg(eftirkomarar);lata hann fáa alt, við eiga, eftir okkum(arva alt);hann hevði tveir hundar eftir seg(tá ið hann doyði);leggja eftir segel.(stb.)særgloyma at taka við sær;leggja nógv eftir segfáa nógv á skaftið2(um tíð)aftan á,tveir dagar eftir hvítusunnu;eftir jól;eftir brúdleypið;eftir tað;eftir hettaso, síðan, tínæst3(raðfylgi)ár eftir árár um ár;nú kom bátur eftir bát;hann var deknur eftir faðirin(aftan á);fáa e-t í arv eftir faðir sín;dag eftir annan, hann kongin eftir reið4(um uppruna, um høvund e-so.s.fr.)søga eftir Heðin Brú;málningur eftir Bárð Jákupsson5í osb. sumvera væl (illa) eftir seg(væl (illa) fyri);ringur eftir segvið hundasjúku;skjótur eftir segódrúgvur, sum ikki munar leingi;gera eftir segganga aftur, spøkja2viðhvmf1(um rørslu, kenslur o.a.)fylgja eftir e-m;fara eftir e-m;hyggja eftir (e-m);leingjast eftir (e-m);trákkast eftir (e-m);vera eftir e-m(elta, jagstra, forfylgja);snarliga tað eftir honum leið;eftir høvdinumvið høvdinum fyri;eftir nakkanumafturav;eftir liðinivið síðuni fyri;lata (hurðina) aftur eftir sær(í tí at ein er farin um hana)2samsvarandi, sambært,agnið var eftir reiðskapinum;eftir mínum ráðum;tað fór eftir vón;býta eftir húsatali(í mun til)3(um tíð)um, ígjøgnum,eftir einum kvøldimeðan kvøldið líðurel.leið;eftir fýra mánaðum4(saman við hjáorði)aftur eftir:aftur eftir hæli;fram eftir:Ólavur ríður eftir bjørgunum fram;inn eftir;niður eftir;niðan eftir:hann fór niðan eftir vegnum;upp eftir:flugan skreið upp eftir vegginum;út eftir:út eftir gólvinumút um gólviðhj3ein fyri og annar eftir(um fleiri hvønn í hølunum á øðrum);so er hatta ikki eftirso er tað gjørt, liðugt;nú var eftir at ...(enn ógjørt);hvørki fyrr ella eftirongantíð (síðan);dagin eftirnæsta dag;árið eftir;standa eftir á berum(við ongum)4(hj saman við sagnorði)t.d.bera eftir;hava eftir;liggja eftir;liva eftir;sita eftir;vera eftir(sísagnorð);sms. t.d.aftur-,eystan-,eystur-,fram-,har-,heim(an)-,her-,innan-,inn(ar)-,niðan-,niður-,norð(an)-,norður-,oman-,suður-,sunnan-,upp-,uttan-,uttar-,út-,vestan-,vestur-,yvir-
eftiransaður	síansa eftir
eftiransan	tað at ansa eftir, umsjón, eftirlit, tilsjón,kongurin varð settur undir eftiransan í eini av borgum sínum
eftiransin	ansin, varin, (eftir)hyggin, vakin, gáin (um seg),eftiransin má maður vera, tá ið hann gongur í slíkari urð
eftiransing	eftiransan
eftiransingar-	sms. t.d.-maður,-nevnd,-ráð,-stovnur
eftiransni	ansni, varni, varsemi
eftiransur	umsjón, tilsjón, eftirlit, eftiransan
eftiraping	tað at apa segel.sær eftir e-m
eftirá	(flutt m.)doyggja, falla á vali
eftirárin	árin av e-m sum er hent frammanundan,læknin segði, at tað ljóðar sum eftirárin av viðgerðini
eftirbati	(lækn.)batiel.tíð til at koma fyri seg eftir ringa sjúku[da.rekonvalescens]
eftirbátur	1(søg.)stórur skipsbátur havdur aftur úr skipi2(flutt m.)ein ið er aftari, minni menturel.seinni enn aðrir,vit eru eftirbátar í so nógvum
eftirbiti	1leskiligur biti ið goymdur verður til seinast(Sv);(orðt.)átari goymir sær eftirbita2eftirbitarbitar av døgurðanum sum lógu eftir í trognum,vit fingu eftirbitar uppheittar til nátturða3(stb.)ein ið altíð kemur ov seint
eftirburður	tað ið fylgir eftir burði(hjá konu, ær, kúgv o.s.fr.),fitilókur (1), fylgi (3), eftirferð, tað seinna
eftirbøtingur	(lækn.)ein ið er í batning eftir ringa sjúku
eftirdømi	fyrimynd, fyridømi, dømi
eftirdøttur	seinføðingur (2), síðføðingur,tey eiga trý børn, tey fingu ein eftirdøtt nú
eftirepli	epli ið kemur upp av óupptiknum eplum frá árinum fyri, opinepli, vetrarepli, eftirgróður (2), villepl,tað mesta, sum er upprunnið, eru eftirepli
eftirfarandi	álítandi, dyggur, lítargóður,ikkiel.illa er eftirfarandi tí, hann sigur;ikki er eftirfarandi, um sólin skínur á morgni
eftirferð	eftirburður(Ev)
eftirfesti	(málfr.)orðliður settur upp í orð fyri aftan(til at gera annað orð),eftirskoyti,"-ligur" í "stuttligur" er eftirfesti[da.suffiks]
eftirfestur	(málfr.)eftirskoyttur
eftirfylgd	reglufesti, reglubundin hugsan,skipanin hevur brek og trot upp á eftirfylgd[da.konsekvens]
eftirfylgi	eftirfylgja (1),hetta vóru eftirfylgini, ið huldukonan lovaði
eftirfylging	tað at fylgja eftir, stíga í fótaspor e-s,Kristi eftirfylging
eftirfylgja	1avleiðing, úrslit, fylgja 1(1), avstøða[da.konsekvens]2(lækn.)eftirsjúka, eftirrák av sjúku, eftirkembingar
eftirfylgjandi	sum kemur eftir, hesin, næsti,hýsið eftirfylgjandi reglum
eftirgangari	ein ið ikki fylgir við, ein ið er dragnaður afturúr(Ev)
eftirgáað	sígáa eftir
eftirgáan	eygleiðing, viðraking, athygging
eftirgáva	tað at geva eftir, eftirgeving,hon ætlaði sær at havna eftirgávuni og taka sín dóm, sita
eftirgerð	1herming, eftirherming2e-t eftirgjørt, eftirmynd(t.d. av listaverki)3(fólktr.)við gandi at fáa aftur e-t horvið;sbr.gera eftir
eftirgeving	tað at geva eftir
eftirgevingur	(stb.):eftirgevingur á høgætttá ið brim er og landnyrðingur ikki mennir seg móti kvøldi
eftirgivin	sígeva eftir
eftirgjalding	(eyka)gjalding aftaná(t.d. av skattiel.ov lítið goldnari løn)
eftirgjørdur	óektaður, kunsturligur,eftirgjørt skinn[da.imiteret]
eftirgloyma	gomul genta, piparmoyggj
eftirgloymingur	stakkal(adýr), neyðardýr, kroyst
eftirgongusnúður	ov nógvur snúður í spunnumel.tvinnaðum(Ev)
eftirgrein	viðmerking(sum ískoyti aftan á tekst)(JJ Poul N.210)
eftirgróður	1gras sum grør á bønum eftir at sligið er,seta (neyt) á eftirgróður;sbr.hóbeiti2(stb.)eftirepli
eftirhald	1tað at halda løn eftir,eftirhald í løn2treyt, fyrivarni, avmarking, undantak,við tí eftirhaldi, at...
eftirherming	tað at herma eftir (e-m)(Ev)
eftirhildin	síhalda eftir
eftirhyggin	(sj.)(eftir)ansin, varin, gáin, umhyggin
eftirhygging	tað at hyggja eftir (e-m)
eftirhyggingarmaður	(bjarg.,stb.)athyggingarmaður, upsarmaður
eftiri	eftir,hetta sum eftiri er
eftirí	hjí osb. sumtað sangel.dundi eftirí(ljóðaði aftur);einki er eftiríílatið er tømt
eftirkannan	tað at kanna eftir, kanning, rannsókn
eftirkanning	eftirkannan
eftirkembingar	1(lækn.)eftirrák (av sjúku, kenningo.s.fr.), eftirsjúka;sbr.afturkembing2(sj.)brigsl afturumaftur
eftirkomari	1ein sum er ættaður frá e-m, avkomi2eftirmaður(t.d. í starvi)
eftirlagan	tað at laga (e-t) eftir (e-m), tillaging
eftirlagdur	síleggja eftir
eftirlátin	eftirlátligur
eftirlátinskapur	tað at vera eftirlátligur, eftirlæti, eftirlótir
eftirlátligur	góður at fáast við, viðeiriligur, eftirlátin, lagaligur, linur, eirin,maðurin var so eftirlátligur, at konan ráddi øllum
eftirlátur	látur sum ikki vil halda uppat, látur í kíki,læa eftirlátur á seg
eftirleggin	íðin, ágrýtin, hugagóður, fúsur, dúgligur(Ev)
eftirleikur	eftirfylgja, framhald, eftirspæl,rættargangurin var endaður, men har kom ein eftirleikur
eftirleitan	tað at leita eftir e-m, leitan, leiting
eftirleivd	(bíbl.)tað sum eftir er, leivd, avlop, eftirsløð
eftirliður	(málfr.)seinniel.seinasti liður í samansettum orði
eftirlit	umsjón, tilsjón, eftiransan;sms. t.d.banka-,innan-,prís-,skipa-,toll-,trygdar-
eftirlitaður	litaður í liting ið hevur verið nýtt eina ferð(Sv)
eftirliting	eftirlitur 1
eftirlitsmaður	ein sum hevur eftirlit við e-m, umsjónarmaður, tilsjónarmaður
eftirlitur	1liting sum hevur verið nýtt eina ferð2(veikari) litur av liting sum hevur verið nýtt eina ferð(Sv);tað er ikki úr eftirliti (sum tú fært)tað er av besta slag, fyrsta floks
eftirlíka	gera sum sagt verður, gera (e-m) til vildar, geva eftir, slaka, lata sær lynda,hann eftirlíkaði honum;hann læt sær tað eftirlíka(gav seg undir, læt um seg ganga)
eftirlíking	tað at eftirlíka(Ev)
eftirlíkna	líkna skatt aftan á regluliga líkning
eftirlíkning	skattaálíkning eftir regluliga álíkning
eftirljóð	ljóð sum dvølur eftir og hvørvur líðandi
eftirlótir	eftirlæti,tey geva hasum allar eftirlótir(lata tað fáa sín vilja í øllum)
eftirlútur	lútur nýttur aðru ferð
eftirlýsing	tað at lýsa 2(5) eftir e-m horvnum
eftirlæti	tað at lata e-n fáa sín vilja, eftirlótir, eftirlátinskapur,geva e-m eftirlæti
eftirløn	árligel.mánaðarlig veiting frá tí almenna, arbeiðsgevarael.eftirlønargrunni til fólk sum er farið av arbeiðsmarknaðinum(vegna aldur, sjúkuo.s.fr.),pensjón
eftirlønaraldur	aldur tá ið maður verður eftirløntur
eftirlønarfólk	ein ið er farin úr starvi við eftirløn, eftirlønt fólk, pensjonistur, eftirløningur
eftirlønargrunnur	grunnur ið eftirløn verður goldin úr
eftirlønarmaður	eftirløntur maður
eftirlønartrygging	(trygg.)avtala um trygging sum fellur til útgjaldingar við eftirlønaraldurel.deyða
eftirløningur	eftirlønarmaður
eftirløntur	sum fær eftirløn, vorðin eftirlønarmaður
eftirmaður	1ein ið tekur við starvi eftir e-n;sbr.undanmaður2eftirkomari, avkomi
eftirmálsmaður	(søg.)lógsøkjari í drápsmáli
eftirmeta	meta um eftir at e-t er farið fram(t.d. námskeið)
eftirmeting	tað at eftirmeta(t.d. námskeið)
eftirmóður	móður aftan á tungt arbeiði,eg eri so eftirmóð(aftan á próvtøku)
eftirmynd	mynd, avmynd, spegilsmynd,lítið at hesi eftirmynd av altari Harrans
eftirmæli	1umrøða eftir deyðan, minningarorð, gravarlov,hann fekk gott eftirmæli2orð at enda, (lítil) grein aftast (í bók), eftirskrift,móts.formæli
eftirnavn	seinnael.síðsta navn á fólki til eyðkenningar(annaðhvørt ættarnavn, faðirs-el.móðurnavn),børn kunnu nú hava annað eftirnavn enn foreldrini;tey hava Jacobsen til eftirnavn
-eftirni	eftir(sum seinni liður í samansetingum seinast í setningi),í sms. sumheim-
eftirprent	1endurprent2(prentað) endurgáva(t.d. av listaverki)
eftirráð	ráð ið koma aftanáel.ov seint,(tilt.)eftirráðini eru so mongel.ofta góðel.altíð betri
eftirráðin	sum veit betur aftaná, eftirsnarur,hann var ofta eftirráðin(visti betur aftaná, tók ikki ábyrgd meðan á stóð)
eftirrák	eftirkembingar, eftirsjúka,eftirrák av sjúku
eftirrit	avrit, avskrift, endurrit
eftirrættur	matur etin oman á døgurða
eftirseta	tað at sita eftir(í skúla)
eftirseti	ein ið situr eftir(í skúlanum)
eftirsetningur	(málfr.)høvuðssetningur eftir eykasetning
eftirsettur	síseta eftir
eftirseturenta	lívrenta ið eftirsitandi fær
eftirsitandi	(ein) ið livir eftir ein deyðan(t.d. einkja, barn),prestur vitjaði tey eftirsitandi;eftirsitandi einkja
eftirsíðan(i)	síðan(i), seinni, seinnameiri
eftirsíður	(stb.)eftirsíðan(i)
eftirsíggin	neyvur, vandin, pjøkin, sparin, umhyggin, vandaligur
eftirsjón	saknur,tað er eftirsjón í honumel.tí
eftirsjúka	(lækn.)eftirkembingar (1), eftirrák, fylgdarsjúka, afturatkoma, tilslag
eftirskettin	(eftir)ansin, gáin, skettin
eftirskjálvti	(jarðfr.)lítil jarðskjálvti aftan á sjálvan jarðskjálvtan
eftirskoðan	tað at hyggja ígjøgnum aftaná, endurskoðan, grannskoðan
eftirskoyti	(málfr.)eftirfesti
eftirskoyttur	(málfr.)nýttur sum eftirskoyti, eftirfestur,-in er eftirskoytt bundið kenniorð
eftirskrift	eftirmæli (2)
eftirskúli	(skúl.)slag av kostskúla fyri 14-18 ára gamlar næmingar(har ið til ber at taka fráfaringarroynd fólkaskúlans)
eftirsløð	tað sum eftir er, avlop, leivd, eftirleivd, eftirstøða (1)
eftirsnarin	eftirsnarur
eftirsnarur	sum veit betur aftaná(hvussu e-t átti at verið gjørt),eftirráðin;(tilt.)betri er at vera fyrivarin enn eftirsnarur (el.eftirsnarin)
eftirsnúður	snúður ít.d.snøriel.tógvi íkomin við tvinning, tvinningarsnúður,móts.undansnúður
eftirsókn	stremban, strev, stundan, tráan,eftirsókn eftir vindi
eftirspurdur	1sum (stórur) eftirspurningur er eftir, umbiðin2spurdur um loyvi
eftirspurn	eftirspurningur
eftirspurningur	tað at spyrja eftirel.vilja keypa(t.d. vøru o.tíl.)
eftirspæl	eftirleikur
eftirstjóri	1stjóri 1 at halda eftirel.stýra við tá ið e-t verður stjórað2(bjarg.)endi ið menn í neðra (t.d.á báti) hava á bakkabandi;sbr.stjóra,stjóri 1(FA II185)
eftirstøða	1tað sum eftir er, avlop, leivd, eftirleivd, eftirsløð,eftirstøður av eplum2tað sum eftir er av skuld, ógoldin skuld3avleiðing, eftirrák, eftirkembingar (1),tað kemur sovorðin eftirstøða av tí
eftirstøðutorv	torv ið stendur eftir á heiðini(ikki innborið í krógv el. laðað í lut)
eftirtekt	gætur, far, umhugsan, umráð, umráðing,taka til eftirtektarásanna (t.d.eini boð) orðaleystel.uttan viðmerkingar
eftirtíð	1ókomin tíð, framtíð2arbeiða eftirtíðarbeiða út um vanliga arbeiðstíð
eftirtína	klártína
eftirtorv	1vrakað torv tveitt út úr krónni(turkað árið eftir),(stb.)hatta liggur sum eftirtorv um bøin(liggur og sløðistel.rekst)(t.d. um amboð)2torv sum var til avlops(tá ið kráirnar vóru fyltar)
eftirtorva	(einstøk) torva av eftirtorvi
eftirtøka	1vinningur, úrtøka, ágóði, úrslit,tað man so lítið vera í eftirtøku2eftirgerð (1)
eftirútbúgva	veita eftirútbúgving,umskúla og eftirútbúgva arbeiðsfólk;eftirútbúgva segfáa (sær) eftirútbúgving
eftirútbúgving	(skúl.)útbúgving til viðbótar(vanl. fyri fólk í starvi)
eftirútrokning	(búsk.)kostnaðar- og prísútrokning gjørd eftir at vøra er útvegað, gjørdel.seld
eftirvagnur	eftirvognur
eftirvatn	vatn sum vaskað verður aftur umaftur við(eftir at vaskað er við sápulúti)
eftirverandi	sum eftir er, sum vantar í
eftirverkir	1verkir eftir barnsburð2eftirrák
eftirviðgerð	viðgerð aftan á høvuðsviðgerð
eftirvognur	aftari sporvognur
eftirynskjandi	sum ynskjandi er eftir, ynskjandi
eftiryrking	(bókm.)fátækslig herming eftir dygdargóðum skaldskapi
eftiryrkjari	(bókm.)ein ið yrkir eftiryrking[da.epigon]
eftna	(Suð.)aftna,nú eftnar av degi
eg	(í staðin fyri 1. pers. eint)eg og tú;eg veit frá mær sjálvum(av egnum royndum);hon segði tað við meg;húsini hjá mær;kom til mín;(gl.)bíða mín(eftir mær);ert tú komin at vitja mín?
egg1	1hvøss røð á knívi, økso.tíl.,móts.bakki 1(5),líggin er so tjúkkur fyri eggini(hevur einki bit);hann dugir væl at halda góða egg(halda hvast);(flutt m.)út í odd og eggút í æsir, heilt og fult, í øllum lutum, nágreiniliga;lyftið varð hildið út í odd og egg2trom, brún, kantur(á bergi),grasið grør frá egg til dalin innast;hann fór út á egg;sms. t.d.eld-,knívs-,svørðs-
egg2	1eggkykna við føðsluevni (og skali),hønan hevur eggegg er í hønuni;(stb.)fara eftir eggjumfara at ræna;(tilt.)(fullur) sum eggiðdýrandi fullur, ovdrukkin;(tilt.)sum eitt brotið eggógvuliga erkvisinel.smásárur;vit mugu fara við honum sum við einum brotnum eggi(um ein ið tolir lítið av, er tykkin);(tilt.)nú skal antin vera egg ella unginú má verða roynt at fáa eitt úrslit(sama um tað fer at eydnast),nú skal røkka ella støkka2eggformað evni ið ikki leiðir streym(nýtt til ravmagnsleidningar);sms. t.d.antar-,bjarga-,brák-,gásar-,høsnar-,leggingar-,lomvigar-,neyðar-,pín-,ravns-,reiðr-,rúðr-,skarvs-,skell-,skøtu-,tjaldurs-
eggbølla	(stb.)eggbøllur
eggbøllur	(lívfr.)1eggrøtur(Sv)2(hjá eggfugli)smáir eggjareyðar ið verða til egg(hava ikki fingið hvíta og skal uttan á seg enn)
eggfuglur	(fugl.,samt.)fuglur ið verpur, verpingarfuglur,móts.geldfuglur,góður eggfuglur
egggørn	(lívfr.)1rás ímillum eggrøtur og lívmóður2(um fugl, serst. hønu)verpingarleið
egghvassur	knívhvassur
eggja	1brýna, hvessa, hvøtja,eggja knív, líggja2viðhvnfoghvmfelva, birta upp undir, halda (e-m) til, øsa, reita, arga,eggja ein(um) til e-tvið orðum og gerðum fáa e-n til at fremja e-t;ilt er honum at eggja(sannføra, yvirtala, fáa til);honum er ikki at eggjahann er fúsur (til verka);eggja uppundirbirta uppundir;sms. t.d.bran-
eggjabikar	ílat sum egg verður sett á borðið í
eggjabolli	mjølbolli við eggi(í súpan el. bollamjólk)
eggjadagur	dagur tá ið egg verða etin til morgunmatar
-eggjað	síber-
eggjaður	við egg(nýtiligur til eggjarn),jarnið var eggjað(hevði egg)
-eggjaður	síbran-,hvass-,mjúk-,sár-,tví-
eggjagrót	hvast grót;sbr.eggjasteinur
eggjahvítaevni	(lívfr.,evnafr.)lívrunnin evnasambinding av karboni, vetni, súrevni, køvievni og nakað av svávuli(týdningarmikil grundstovnur í øllum livandi verum),protein
eggjahvíti	hvíti í eggi;sbr.eggjareyði
eggjajarn	eggjarn
eggjakalvi	kalvi ið etur egg(sum detta niður úr fuglabjørgum)
eggjakassi	kassi við eggjumel.til egg
eggjakoppur	1tómt eggjaskal(sum etið er úr el. ungi er komin úr),ikki størri enn ein eggjakoppur(um lítlan bát)2(skemt.)lítil leypur
eggjakøka	rættur av rørdum eggjumo.ø.stoktur á pannu
eggjamatur	matur tilgjørdur av eggjum
eggjamál	h3í osb. sumtað var eggjamáltað var við neyð og deyð;eg fekk kotið úr vaðmalinum, men tað var eggjamál;tað var eggjamál, at teir komu fram;teir komu aftur, men tað var í eggjamáli(einki var eftir);har var komið til eggjamáltað var í evstu stund, um reppið (t.d.at vanlukkan hendi)
eggjamettur	eggmettur
eggjamjólk	(mjólk.)mjólk við eggjum rørdum útí
eggjan	tilstudling, ákoyrsla, áeggjan, tileggjan, kveiking
eggjandi1	spennandi, avbjóðandi,hesi eggjandi orðini rinu á honum(gjørdu honum mun)
eggjandi2	hj(sj.)í osb.eggjandi mettureggmettur
eggjaposi	eggposi
eggjaprilla	prilla 1(1)
eggjapulvur	pulvur av turkaðum eggi, turregg
eggjareyði	reyði í eggi;sbr.eggjahvíti
eggjarhakk	(gl.)rørd lundaegg(blandað við mjólk)
eggjari	ein ið eggjar (2)[da.agitator]
eggjarjarn	eggjarn
eggjarmaður	(bjarg.)athyggingarmaður
eggjarn	amboð við egg(t.d. knívur, líggi, øks),hann herðir eitt eggjarn;deigbleytt eggjarn(óhvast)
eggjaroð	(bjarg.)posi av roð til bjargafuglaegg;sbr.prilla 1(1)
eggjarskalvur	skalvur ið hongur út av egg
eggjarskítur	(Leirv.)bátur ið dettur suður um Egg(tí at hann hevur lagt ov lítið upp fyri áðrenn hann legði á fjørðin);(flutt m.)ein sum ikki stendur mát
eggjartrepi	ytsta trom á bergi, eggjartrom,úti á eggjartrepanumytst á eggini;sbr.trepi
eggjartrom	ytsta trom á bergi, eggjartrepi
eggjarær	(stb.)ær ið liggur úti á egg
eggjaskal	skal áel.av eggi
eggjaskeri	amboð at skera harðkókað egg sundur við
eggjasleiv	(bjarg.)langskeft træsleiv at taka egg við(nýggjari snið við lítlum glúpi í staðin fyri sleiv)
eggjast	(um fugl)fáa egg,fuglurin kann hava einar tríggir fýra dagar at eggjast aftur(til hann verpur aftur um hannt.d.hevur verið rændur)
eggjasteinur	hvassur steinur;sbr.eggjagrót
eggjateinur	(kvæð.,kenn.)svørð
eggjatíð	1tíðin tá ið rænt verður, ræning (2),hann fór til Skúvoyar í eggjatíðini2verpingartíð
eggklingra	(støddfr.)afturlatin rás har ið samløgan av frástøðuni hjá hvørjum punkti til tvey føst punkt (brennideplar) er støðug(avlangur rundingur líkur eggi),ellipsa
eggklingrutur	við skapi sum eggklingra, eggrundur, eggvaksin
eggkykna	(lívfr.)kynskykna hjá kvennverum, egg 2
egglega	(plfr.)niðasti uppbólgnaði parturin av sáðgongini har eggið (el.eggini) liggja(ovarium)
eggleysur	(um eggjarn)óhvassur(Ev)
eggloysn	(lívfr.)tað at egg 2 losnar úr egggørn
eggmettur	(stb.)1steinmettur,hann át seg eggmettan2dýrandi fullur, sum eggið
eggposi	1bjølgur undir búkinum á (gomlum) eggfugli,gæsnar drógu eggposan eftir sær2(stb.,skemt.)síður búkur á fólki
eggrassur	(Sa.)(drigin) lundi við eggi
eggrás	kv2/27í osb.vappa sum æða í eggráshava nógv um at vera, tita títt
eggriva	1brestur í stálinum ið gongur inn í eggina,líggin hevur fingið eina eggrivu, so eg vænti, at hann brotnar2riva millum stál og jarn(misløga í sjóðingini, jarnið losnar frá stálinum),øksin hevur eggrivu;eggriva er í grevinum
eggrundur	eggklingrutur
eggrúm	(um hønu)sum er frammi undir verping;sbr.rúmur (2)
eggrøtur	(lívfr.)yrkisgøgn har ið eggkyknur búnast
eggsjúkur	(um fugl, serst. hønu)sum vil verpa,eggsjúk høna;(flutt m.)ganga sum eggsjúk hønavera altráur eftir at gera e-t
eggslitin	(um eggjarn)við slitnari egg(Ev)
eggstrongur	(plfr.)strongur sum eggið (el.eggini) er fest at eggsætinum við
eggsæti	(plfr.)tað stað sum eggið er fest við(Placenta)
eggvaksin	1eggklingrutur, eggrundur2(plfr.)sum er o.u. tvífalt so langt sum breitt(breiðast niðan fyri miðjuna),eggvaksið blað;øvut eggvaksin(blaðið breiðast omanfyri)
eggvákn	eggjarn
eggvølur	(stb.)eggbøllur (2)
egi	1(korn)nál,egið hevur so dimma sirju;tað kemur ikki egi upp av hasum;tað er ikki eitt egi á akrinum2kornvelta, akur,hvussu eru egini?hvussu grør kornið?3(flutt m.)kykt,har var ikki egi inni(eingin);tað var ikki egi at fáa(púra svarta einki)
egilker	(stb.)igulker
egin	1sum viðvíkur e-m sjálvum, sjálvur, persónligur,vera sín egin;seta føtur undir egið borð;standael.sita fyri sítt egið(fyri seg sjálvan)2serstakur, serligur, ávísur, eyðkendur,egin føroysk viðurskifti;kvæðið er so sterkt, so dragandi og egið3serur, løgin, undarligur, margháttligur
egináhugamál	áhugamál (2) eins sjálvs
eginbilur	bilur sum fólk eigur sjálvt
eginfígging	(búsk.)tað at fíggja 1 e-t sjálvur(t.d.keyp, íløgu)
egingirnd	egingóðska, sjálvsøkni
egingjald	tann parturin ið ein sjálvur rindar(t.d.fyri heilivágel.almennar tænastur),nú skulu tey, ið vinna mest, gjalda hægsta egingjaldið, sum er 135 krónur av teimum 175 krónum, sum ein tími kostar at veita
egingóðska	tað at vera góður við seg sjálvan, sjálvgóðska, egingirnd, sjálvsøkni, særlystur
egini	síegi
eginkona	kona, ektakona, eginvív
eginkvota	(sjóm.)kvota ið verður latin eigarael.skipi,fiskimálaráðið er farið í holt við at býta svartkjaftin frá felagskvotu út á eginkvotur;sbr.felagskvota
eginkærleiki	sjálvgóðska
eginleiki	tað ið er eyðkent fyri e-nel.e-t, eginskapur,góður/ringur eginleiki
eginligur	veruligur, rættiligur, sannur;hj-liga
eginlív	(sj.)sjálvlív
eginmerki	eyðkenni, serkenni
eginnýtsla	1tað ið ein sjálvur nýtir, egin nýtsla2(búsk.)tað at taka út vøruel.pening úr fyritøku til egna nýtslu
eginogn	tað ið ein eigur sjálvur, einskild ogn
eginpeningur	peningur eigara í virki, skipio.s.fr.
eginsinnaður	ráðaríkur, stívrendur, stívsinnaður, treiskur, sjálvráðin
eginskapur	eginleiki, eyðkenni
egintelda	(teld.)telda ætlað einum nýtara(í senn)[da.PC]
eginumstøður	viðurskifti hjá einum sjálvum
eginvild	sjálvgóðska, sjálvræði, eginvilji
eginvilji	eginvild
eginvív	(kvæð.)kona, ektakona, eginkona
eglalív	(sj.,stb.)gott og góðsligt fólk
egna	1krøkja agn upp á húk,egna línu;egna avtaka øgn av,eg fari at egna línuna av;egna fyri kalva1egna fyri at fáa kalva2(flutt m.)ætla stórt,egna segegna sær húkarnar(á snøri),egn teg við skund2geva (e-m) eitt sindurt.d.at eta, leska,egna ein3(sj.)ala ein upp á seg við útgjari, lokka, tøla,egna ein
egnari	ein ið egnir línu, egningarmaður
egning	tað at egna (línu)
egningarfløkja	(skemt.)fløkja íkomin av ósketnari egning;sbr.skiparafløkja
egningarmaður	egnari
egningarskúr	skúr at egna í(umborð á skipi el. á landi)
egningarskúrur	egningarskúr
egriða	(stb.)eyrriði
egriði	(stb.)eyrriði
Egyptaland	land í Norðurafrika
egyptari	egyptari
egypti	fólk íel.úr Egyptalandi, egyptari
egyptiskur	íel.úr Egyptalandi
ei1	tvíljóðsstavir (nevndir[ai])
ei2	ikki,hvørki ... eihvørki ... ella;í osb.ei og ikkibæði ja og nei, ivasamt, óvist,hann er ei og ikki ólíkur honumteir sipast;ei var tað síðanisísíðani;sbr.eiggj
eið	eiði
eiðabarur	eiðasørur
eiðadyggur	1eiðasørur2(stb.)sum púra einki veit, púra óvitandi
eiðargerð	(løgfr.)tað at gera eið
eiðasørur	púra sørur, tómur, berur,har var eiðasørt til fisk;hann var ikki eiðasørur til jørð;ikki vera heilt eiðasørurkenna eitt sindur til;tað er so eiðasørt, at ...tað ber ikki á brá, at ...;hon leit ikki aftur um øksl, so eiðasørt(ikki so frægt, als ikki)
eiðfastur	sum ikki vil bróta eið,so eiðfastir vóru vit(høvdu svorið eið um ikki at siga frá)
eiðfesta	(bíbl.)staðfesta við eiði,kongurin eiðfesti honum tað
Eiði	bygd í Eysturoynni,á/av Eiði,til Eiðis
eiði	lækki tvørtur um oyggj(høgt báðumegin við)eið
eiðisbakki	(brattur) bakki 1(1) á eiði
eiðiskyrra	(Fám.)so kyrt at lendandi er á Vágseiði og Hvalbiareiði
eiðismaður	maður áel.av Eiði
eiðsvorin	sum hevur svorið eið(t.d. um trúskap)
eiður	1hátíðarlig váttan, heitstreingi,gera eið (upp á);huldufólk eru til, tað skal eg leggja eiðin á;svørja eið;taka eið av e-m;halda um eið at gera, at...ivast ikki í, at..., vera fullvísur í, at...;leggja ein undir eiðleggja e-m dýrt við(um einki at siga),tað man vera undir eiði, at ...tað man ikki vera hugsingur um, at ...;hoyra hvørki orð ella eið frá e-m(einki);sbr.hilnis-,tólvmanna-,trygdar-2orð(ing) ið sipar til e-t heilagt til at leggja dent á eina útsøgn(oftauppfatað sum óvandamál),gudsdoyð var hansara grovasti eiður;sbr.illbøn
eiga1	(kvæð.)ogn, eigindómur, ognir, ognarlutir
eiga2	1hava í ogn, hava sum eigindóm,tveir brøður áttu alla jørðina;ikki eiga í munnin(einki at eta)2(gl.)hava sum konuel.mann, vera giftur við,(kvæð.)at hava tann, ið onnur ár, tað skal lukkast valla3hava rætt til, lutast, hava afturfyri,fyri prestskjúts í kallinum áttu skjútsmenninir onga løn;søgusmetta varð fyrr argað við válgaranum, hon átti afturfyri4ala av sær, fáa avkom, yngla, gita1(um kvinnu)føða, bera í heim,eiga barn2(um fugl)hava reiður og verpa, reiðrast, byggja,nógvur fuglur eigur har5mega, skula,eiga at gera;tú eigur ikki at gera hatta;(orðt.)ikki eigur at smíða nøgluna fyrr enn bátin6vera mentur, orka, megna,hann rann tað dýrasta, hann átti7í osb.Gud eigi teg, ger tað fyri meg(vælsignaður);hann er ein skilamaður, tað skal hann eiga(tað rós kann hann hava);hann skal eiga tað(hóttandi)hann skal fáa av at vita;ymsir eiga;(orðt.)ymiss er mansins eydna;eiga lívið í e-m;nú eigur tútú ert næsturviðfs/hjeiga av:eiga av særala av sær, føða;eiga áhava til góðar,hann biður um peningin, sum hann eigur á;sbr.áogn;eiga eftir:eiga eftir at ganga(hava eftir);eiga niðurfyrieiga (nógv) til seinni nýtslu, hava at taka til seinni;eiga saman(gl.):eiga orðum samantala saman, skifta orð;eiga við:eiga við e-nhava eitt inni við e-n;eiga sær gott við (e-n)koma ásamt, semjast;sbr.eira;eiga (uppi) í1vera samánari,hann eigur í Hamrahaga;teir áttu uppií2hann eigur einki í tíhann hevur einki við tað at gera(Sv);eiga undir(gl.,spæl)spæla blunda og krógva, spæla undir, spæla fýrabons;eiga út(kortsp.)skula spæla út,hvør eigur út?;eiga sær:tú eigur tær mangar brøðurnar(hevur);eiga sær staðvera, henda, fara fram,hjúnavígsla eigur sær stað í kirkju ella í embætishúsi
eigamál	eiggjamál
eigandi	verdur at eiga
eigarafelag	felag teirra ið eigat.d.hús í grannalag
eigari	ánari, ognari, eigarmaður;sms. t.d.góðs-,parta-
eigarmaður	eigari
eiggiliga	dygt, dyggiliga,hann tapti so eiggiliga
eiggiligur	1vakur (í útsjónd), ásýniligur (1),eiggilig genta2verdur at eiga, virðismikil, dýrabarur, frálíkur, eigiligur
eiggin	verdur at eiga(Sv)
eiggj1	h ób:eitt eiggjeitt sindur, eitt vet;eitt eiggj meiri(Sv)
eiggj2	ja;í osb.eiggj og ikkiímillum beggja, ivasamt(Sv);sbr.ei
eiggjamál	sjáldsemi, hendingur, sjáldsamur lutur, eigamál(Sv)
eigiligur	eiggiligur (2)
eigindómsbygd	bygd við nógvari óðalsjørð, ognarbygd
eigindómsmaður	ognarmaður
eigindómur	óðal, óðalsjørð, ognarjørð;sbr.ogn
eiging	tað at eiga (barn),í osb.komin til eigingar
eik	(plfr.)træ í slektiniQuercus, eikitræ, eikiviður,(orðt.)eingin fer so við eikini, at hon ikki flýtur,sbr.træ
eikikampur	(plfr.)slekt í kvennkampsætt(Gymnocarpium),trífingraður eikikampur(G. dryopteris)
eikikol	eik ið er brend til kol,til at skyggja skeiðir við nýttu tey eikikol og spik
eikikylva	(kvæð.)kylvael.gassi úr eik
eikilund	(í skjaldri)lund við eikitrøum,uppi í eini eikilund
eikilunnur	lunnur av eik
eikimála	mála so at tað líkist eikiviði,eitt eikimálað skáp
eikimáling	tað at eikimála
eikirót	rót á eik
eikiskógur	skógur við eikitrøum
eikitræ	eik, eikiviður
eikiviður	eik, eikitræ
eikja	(søg.)bátur holaður úr viðarbuli
eilívi	(skaldsk.)ævigt lív
eimast	(um eld á eldstaði)gløða, liggja í glóðabaki
eimingur	1(góðn.)(í sornhúsi)eldur, sorneldur2stjørnugrús, eimur (2)(boðar frá illveðri)
eimur	1gløður, eimyrja2(stb.)eimur á luftiniserliga tætt av stjørnum á luftini, stjørnugrús(ofta beint áðrenn hann lækkar)
eimyrja	1(sj.)eimur,hann bað eld og eimyrju aftur í húsið(ynskti at tað skuldi brenna til øsku)2(stb.)(ávísur) atsmakkur,eimyrja gongur at drekkanum(øskusmakkur)
ein	11talið 1, í rómv. tølum I, iel.j,tjúgu og ein;tað var ikki eitt tvey at fáa tað liðugt(ikki løtuverk);tað sat eingin ein (lomvigi)(ikki ein einasti);ikki var seilin ein eftir (av seglinum)(ikki trevilin);(tilt.)fáur kann eitt barn at eigael.eingin dugir eitt at eiga;(tilt.)einel.eitt er næst ongum(sama sum einki);tað er ikki eina ferð, at...(ofta);ikki var eitt, hann hevði Jógvani um at kenna;tað skal vera, sum tú sigur eitt(í løtuni, beinan vegin);einans einbert ein, ikki fleiri enn ein;ein beiggin æt Dánjal(ein av brøðrunum);sum ein maður(samdir);siga (sum) við ein munn(í senn);draga eina línuvera samdir, standa saman;við einari hondvið aðrari hond,hann lyfti henni við einari hond;á einum beini(øðrum beini);sveinur ræður ein fyri ráði(einsamallur)2í osb.alt fyri eittel.alt í einumbeinan vegin, við tað sama, straks;menn eru flestallir á einum í, at...(á einum máli, samdir);í einum og øllumút í odd og egg;út í eitt og altalvegis, á allan hátt;um eina leiðsamstundis, í senn3flt(um par el. samheild)einir sokkar;einir skógvar;einar hosur;eini hjún;eini kort;eini talvfólk;eini hús2l1samur,teir fóru allir ein veg;tað er alt eitt;halda eittvera samdir, hava somu hugsan;í osb.koma til eins um e-tsemjast2einsamallur,(kvæð.)sat í borgum ein;tann einiVárharra, Gud,tað veit eingin uttan tann eini;eingin veit fráel.av einum at siga(sagt tá ið einsamallur maður doyr av vanlukku),tveir einir, tvær einarel.tvey einibert tveir, tværel.tvey3(framman fyri tøl)um leið, okkurt um;einir tjúgu3fn1nakar, onkur, einhvør,nú gongur eitt uttanfyri;eitt tekur í klinkuna;mangur og ein;ein og hvørøll/allar/allir;hvør einhvør einstakur, hvør tann einasti;eitt og annað;í ein eystan(eystureftir);ein dagin;eitt kvøldið;eitt árið;hon fór at læa ein hendan býtta láturin;tað eru einir jassar;tað er eitt tilfar;eitt (er) nútil dømis,mangt er gott á seyði, eitt er nú nakkaspikið2eina;hvsf flt(framman fyrihástnýtt sumhj)av øllum;eina besturav teimum bestu;eina helstfyrst og fremst, serstakliga;hann drakk eina mest(meir enn flestir);hann førdi Royndina eina longst;fílarnir eru eina hentastir at bera stórvið3(verður nýtt at vísa til fólk yvirhøvur)mann,ein hevur ikki orð at siga um hatta4óbd kn:ein maður;ein kona;eitt barn
eina1	einsamallur,eina skal eg í hellið ganga;gekk frá strondum eina;sbr.ein (2)
eina2	1í osb.leggja sær eina viðleggja sær nær, leggja dentel.doyðin á;leggja (e-m) eina viðleggja (e-m) ríkanel.dýran við2(sj.)bert, bara, einans,fái eg eina nomið við kappa hansara, so verði eg frísk;hann bað teir eina hugsa um at bjarga monnunum
einaferð	1einusinni, onkuntíð,einaferð í verðinií gomlum døgum, í fyrndini2umsíðir, at enda, endiliga;sbr.ferð (3)
einahandil	(sj.)handil við einarætti at handla, einihandil
einaharri	einvaldsharri, einræðisharri
einahelst	helst (1), serstakliga,lægri skattur lokkar alt fleiri eldri danir at flyta suðureftir, einahelst til Spania
einalærari	(skúl.)einsamallur lærari í (bygdar)skúla
einans1	einasti, einastur, bert ein,einans handil var í landinum;einans maður fann náði hjá Gudi;hon er einans arvingin;eg eri einans eftir(einsamallur);tey áttu eittans barn
einans2	bert, bara, einast,alt er einans fiskur, ið tú etur;einans rossi dámar best á turrum haga
einari	(støddfr.)eitt av tølunum 1-9, tal eftir tíggjara,vit telja í einarum upp í níggju
einaræði	(stjm.)einræði
einarættur	serrættindi (til e-t)(serst. heimilaður rættur til einsamallur at gera el. selja e-t),einkarættur, einirættur, einrættur
einast1	semjast, koma á samt, vera á e-m máli, vera samráddir,einast um (e-t)
einast2	bara, bert, einans
einasta	bert, bara,konan var horvin, einasta børnini sótu kvirr eftir
einastaðni	onkustaðni, á onkrum stað
einastandandi	serstakliga, hendinga, sera,einastandandi gott sjóskip
einastova	(á sjúkrahúsi)stova til ein sjúkling,hann varð lagdur á einastovu
einastur	sum bert ein er til av,einastur eftir av mongum;tað veit tann einasti(Gud)
einavald	(søg.)stjórnarskipan undir einavaldskongi(stjórnarlag í flestum londum í Evropa frá miðjari 15. øld til nakað inn í 19. øld)
einavaldskongur	kongur ið ræður einsamallur, einvaldur kongur
einaveldi	einavald
einbeintur	við einum beini, einføttur
einbíldutur	(seyðal.)littur um annað eygað;sbr.(tví)bíldutur
einbíltur	einbíldutur
einbílutur	einbíldutur
einborin	1sum eingi systkin hevur, einsamalt barn,Guds einborni sonur2(Suð.)einborið lambeinlembulamb
einburðarlamb	(Suð.)einlembulamb
einburðlamb	(Suð.)einlembulamb
einburður	(Suð.)einlembulamb
einburi	barn føtt einsamalt;sbr.tvíburi,tríburi
einbúgvi	ein sum(serst. av átrúnaðarligum grundum)býr í einsemi burtur frá fólki[da.eremit]
einbýli	bústaður í einingi,móts.margbýli;(orðt.)eingin metir einbýli við tað, tað er vert
einbýlingur	(stb.)einbýli,eingin metir einbýling tað, hann er verdur
einbýlishús	hús til eitt húski
einbýlismaður	ein ið býr einsamallurel.á einum einsligum stað
einbýlisplanta	(plfr.)planta ið ber einkynjaðar blómur av báðum sløgum á sama blómueinstaklingi, sambýlisplanta(monoecus);sbr.tvíbýlisplanta,margbýlisplanta
einbýlisvøkstur	(plfr.)einbýlisplanta
einbýttur	l39í osb.einbýttur hagihagi ið maður eigurel.hevur í hondum einsamallur;í Saksun er einbýttur hagi, men í Tjørnuvík triðingsbýti
eind	1einleiki, heild2serstakur lutur(av størri heild)3stødd í máti, máliel.vekt;sms. t.d.lut-,ríkis-,virðis-
eindarríki	ríki samansett av fleiri pørtum ið mynda eina eind(við ávísum valdsbýti millum partarnar),tað verður staðfest, at Føroyar eru undir donsku grundlógini og eru partar av danska eindarríkinum
eindarskúli	(skúl.)skúlaskipan har sum næmingar fylgjast alla skúlagongdina(fram tilt.d.10. flokk)
eindømi	1(søg.)rættindi til at døma einsamallur,embætismenninir skulu ikki longur hava eindømi her á landi2e-t sum bert kemur eina ferð fyri, einstakt dømi, stakføri
eineggjaður	l6(lívfr.)í osb.eineggjaðir tvíburar(báðir úr sama eggi 2)
eineksingur	k6(plfr.)eineksingarslag av stør við einans ósamansettum aksi á leggjarendanum(monostachyae)
einermdur	við einum armi,bæði haltur og einermdur
einevnisrit	(bókm.)rit um eitt einstakt evni[da.monografi]
einfalda	gera einfaldanel.einfaldari
einfaldan	tað at einfalda
einfaldur	1ikki samansettur, ósamansettur, einkultur,einfaldur hosnatráður2lættur, klárur, eyðskildur3góðvarin, góðtrúgvin, barnsligur;sbr.tvífaldur
einfeldi	1fávitska, fákunna, góðtrúni, góðvarni2tað at vera einfaldur
einfeldni	einfeldi
einfloksskipan	(stjm.)politisk skipan ið bert loyvir einum flokki at virka,móts.fleirflokkaskipan
einføttur	við einum fóti, einbeintur
eingifta	tað at vera giftur við einari konu[da.monogami];sbr.tvígifta
eingil	himmalsk vera, góður andi(vanliga avmyndaður við veingjum),Jesu einglar veri við tykkum;sms. t.d.erki-,høvuðs-,varð-,verndar-,yvir-
eingildur	(evnafr.)sum kann koma í staðin fyriel.ganga í samband við eitt vetnisatom[da.monovalent]
eingilskdansur	pardansur(við tónleiki),móts.føroyskur dansur
eingilskmaður	onglendingur
eingilskur	enskur,eingilskur dansureingilskdansur;(lækn.)eingilsk sjúkableytabeinssótt(rhachitis)
eingin	1ikki nakar,hann hoyrir, at eingin Høgni kemur aftur;eingin einikki ein tann einasti;lítið og einkiat kalla einki;millum nakað og einkiógvuliga lítið;hann var ikki eingin maður(ikki nøkur undirløga (2));eg eri einki(livi ikki væl);einki er ímillum ælini(stutt);slíkt havi eg á ongum sinni sæð áður;taka (e-t) upp úr ongumpenta saman, spinna upp;tað verður av ongumtí verður einki av;eg veit av ongum(veit einki, órar meg ikki);fara fyri einkifara fyri skeytið, fara burturímillum, fara til spillis, forfarast, misfarast,nú mundi tú farið fyri einki(mundi doyð);ganga (sita, standa) fyri einki(einki hava at gera, yrkisleysur, gerðarleysur);fyri einkiókeypis, kostnaðarleyst;vera fyri ongumhava mist mátt og megi, fallin í fátt,hann er ikki fyri ongum(fullbirgur, sum fyrsta dagin, ikki skolaður út av látri);koma burtur í einkiel.koma til einkisvikna, veiklast, fara aftur, versna;til einkistil onga nyttu, til ónýtis, til fánýtis, uttan úrslit, í tóman heim;gera til einkisoyða, týna, oyðileggja, ónýta;gera tað til einkissláa á stert, narra;tað kom til einkis teirra millum;verða við einkieinki fáa;Anna var einki við Guðruna(einki hjartalig, óblíð)2hj:einki(als) ikki, ei;einki er hann býttur;einki sær tað so armóðsligt út
eingingerð	(stb.)ein sum einki tímir at gera, letingi,tú ert ein eingingerð;ganga sum ein eingingerð(fyri einki)
eingir	síong
eingispretta	grashoppa
eingjarbjarnarbroddur	(plfr.)slag av bjarnarbroddi(Tofieldia pussilla)
eingjarblóma	(plfr.)slekt í sóljuætt(Trollius)
eingjarbroyskinsoppur	(plfr.)slag av broyskinsoppi(Russula pascua)
eingjardúnurt	(plfr.)slag av dúnurt, mariustingur, mýriblátt(Epilobium palustre)
eingjarflatbjølgur	(plfr.)slag av flatbjølgi(Lathyrus pratensis)
eingjargarður	bøgarður,hann fer ikki út um eingjargarðin(úr bygdini)
eingjargrevilsoppur	(plfr.)slag av grevilsoppi(Clavulinopsis corniculata)
eingjarhjálmsoppur	(plfr.)slag av hjálmsoppi(Galerina praticola)
eingjarhúsagras	(plfr.)slag av húsagrasi(Poa pratensis)
eingjarkarsi	(plfr.)slag av karsa, vatnlilja(Cardamine pratensis)
eingjarliða	lið í eingjargarði,vit leiddu tey út um eingjarliðað
eingjarmýristrá	(plfr.)slag av mýristrá(Eleocharis palustris)
eingjarrósa	(plfr.)díkimura
eingjarslørhattur	(plfr.)slag av slørhatti(Cortinarius pratensis)
eingjarsyftunsøkugras	(plfr.)slag av syftunsøkugrasi(Alopecurus pratensis)
eingjartimotey	(plfr.)slag av timotey(Phleum pratense)
eingjarvakshattur	(plfr.)slag av vakshatti(Hygrocybe pratensis)
eingla-	sms. t.d.-andlit,-barn,-rødd,-songur
einglabrá	(sj.)vakurt og følið andlit á barni,einglabrá, tað er ikki fyri hann, ið liva skal
einglahár	mjáar álir av glitri(til jólatræspynt)
eingonga	(gl.)tað at ganga einsamallur burtur í hagael.í bjørgini,móts.samgonga,ganga eingongu;Árant varð stevndur fyri eingongu í haganum á náttartíð;ræning gekk mest fyri seg sum seyðastuldur, í eingongu
eingongdur	1sum gongur einsamallur, fyri seg sjálvan,hann kemur eingongdur aftur;hann er eingongdur2ógiftur, stakur
einhandil	einahandil
einhenda	taka, lyfta, kastael.tíl.við aðrari hond(Sv)
einhentur	við einari hond(mist aðra hondina)(Ev)
einhús	1í osb.liggjael.búgva í einhúsivera einsamallur í húsi2hús til eitt húski
einhúskishús	sethús ætlað einum húski,móts.tvíhús
einhvør	onkur
einhvørsvegna	(sj.)onkursvegna
einhyrningur	1(fólktr.)dýr(aloftast líkt hesti)við einum longum snúnum horni í pannuni2veðurlamb við einum horni(mitt í pannuni)3(stb.)slag av fiskisnøri(teinurin øðrumegin loddið)
eini1	(plfr.)baraldur
eini2	(sj.)semja, sátt, samlyndi, góðsemi, samljóð,tað var gott eini teirra millum
einiber	(plfr.)ber 1 av baraldi
einiberlyngur	(plfr.)baraldur
einibertræ	(plfr.)baraldur
einiberviður	(plfr.)viður av eini,tá ið hvalur nærkaðist, telgdu teir av einiberviði og blakaðu út, so skuldi hann rýma
einibúgvi	einbúgvi
einihandil	einahandil
einingis	hjí osb.einingis einsamallurheilt einsamallur, einsamallur áel.í einingi
einingur	k6eí osb.í einingieinsamallur,búgva í einingi;einsamallur áel.í einingiheilt einsamallur, einingis einsamallur
einirættur	einarættur
einisúla	vaðsúla av riknum einitræ,tað var hendingur at finna einisúlu
einitræ	(plfr.)viður av eini
einka-	1við einarætti2onka-
einkabarn	onkabarn
einkadóttir	onkadóttir
einkar-	einka-
einkarblágresi	(plfr.)slag av blágresi(Molinia caerulea)
einkarættindi(r)	serrættindi
einkarættur	einarættur
einkasonur	onkasonur
einkasøla	einsøla
einkavinur	onkavinur
einkenniligur	eyðkendur, serkendur, sermerktur, eyðkenniligur;hj-liga,nøkur fá orð í Seyðabrævinum bera einkenniliga føroyskt merki
einki	h24e:eitt einkilítilsverdur, týdningarleysur persónur, undirløga (2), sjálvvætti,síeingin
einkisleiki	tað at vera einki, tómleiki, fáfongd
einkisligur	vesalur, ússaligur, týdningarleysur,einkisligar spjarrar;einkisligt tos;hj-liga
einkisverdur	sum einki hevur at týða, virðisleysur, ringur, týdningarleysur
einkisvirða	(bíbl.)lítilsvirða, halda lítið um, vanvirða
einkja	kona sum hevur mist mann sín og ikki er gift uppaftur,sita einkja;sbr.ekkja
einkju-	sms. t.d.-drotning,-eftirløn,-peningur,-sonur,-uppihald
einkjumaður	maður sum hevur mist konu sína og er ikki uppafturgiftur
einklæddur	í ongum yvirklæðum,hann gongur einklæddur
einkneptur	(um t.d. jakka)við einum raði av knøppum,móts.tvíkneptur
einkróna	myntur verdur eina krónu;sbr.tvíkróna
einkultur	einfaldur (1), einstakur
einkyknaður	(lívfr.)(um lívveru)sum er einans kykna
einkyknudýr	(lívfr.)einkyknað dýr
einkyknuplanta	(plfr.)einkyknað planta
einkyknuvera	(lívfr.)vera við einari kyknu
einkyndur	einsháttaður, samvorðin[da.homogen]
einkynjaður	(plfr.)(um plantu)sum er annaðhvørt kall-el.kvennblóma(hevur annaðhvørt sáðberar el. sáðgong),móts.tvíkynjaður
einlaðaður	(um grótvegg)laðaður í einari flógv, einfaldur (1),móts.tvílaðaður;sítvílaða,einlaðaður steinveggur
einleiki	tað at vera einans einel.eitt, felagsskapur, samlag,í einleika hins heilaga anda
einleikur	(tónl.)leikur hjá einum fólki á ljóðføri(vanl. við undirspæli)[da.solospil]
einlemba	ær við einum lambi;sbr.tvílemba,trílemba
einlembd	(um ær)við einum lambi,einlembd ær;sbr.tvílembd
einlembulamb	einsamalt lamb, lamb undan einlembu;sbr.tvílembulamb
einligur	(ið býr) einsamallur,einligar mammur(fráskildar, stakar);hj-liga
einlistum	í osb.av einlistumvæl og virðiliga, við nærlagni, sera væl,bøur hansara var veltur av einlistum
einlittur	við einum (og sama) liti, samlittur,einlitt ross
einljóð	(málfr.)eitt (ósamansett) sjálvljóð(monoftong);sbr.tvíljóð
einljóðan	(málfr.)tað at upprunaligt tvíljóð gerst einljóð[da.monoftongering]
einljóðandi	einsljóðandi
einmansavrik	tað ið ein avrikar einsamallur,(ítr.)hóast onkur av málunum vóru vøkur á at líta, so vóru hesi úrslit av einmansavrikum ella einstakari góðari sending heldur enn góðum fótbóltsspæli
einmansføri	einsmansføri
einmanskamar	einsmanskamar
einmansleikur	(ítr.)(t.d. tennis)leikur við einum í hvørjum parti,móts.tvímansleikur
einmansljóð	einsmansljóð
einmastraður	við einari mastur,einmastrað skip
einmál	h3í osb.seta kúnna til einmáls (eis.einsmáls)fara at mjólka kúnni eina ferð um dagin
einmálsligur	(málfr.)á einum máli,einmálslig orðabókeinmálsorðabók
einmálsorðabók	orðabók við leitorðum, frágreiðingum og dømum á sama máli, móðurmálsorðabók
einmánaður	einmáni
einmánasól	mánin í einmána, vársól (2)
einmáni	triði mánaður(í gl. føroyska álmanakkanum)frá 25. mars(mariumessu)til 25. apríl(markusarmessu),ravnur klekir í einmána
einmenniligur	eyðkennandi fyri tann einstaka, einstaklings-, persónligur, einsmansligur[da.individuel]
einmenningsligur	viðv. einmenningsskapi, einstaklings-[da.individualistisk]
einmenningsskapur	hugsanarháttur ið leggur dent á tað einmenningsliga, einsmanslæti[da.individualisme]
einmerktur	(málfr.)við einari merking,orðið er einmerkt
einmæli	tað at vera á einum máliel.samdur(um e-t),avgerðir verða tiknar við einmæli
einmælingur	(málfr.)ein ið ikki dugir onnur mál enn móðurmálið[en.monoglot]
einmælt	á einum máli, sammælt,hetta mál varð einmælt samtykt
einmæltur	l5í osb.vera einmæltir íel.um, at ...vera á einum máli umel.samráddir (um), at ...
einnáttaður	eina nátt gamal,einnáttaður ísur
einnáttarsornur	korn sum liggur eina nátt á sorni
einnevndur	(um navn)sum bert ein eitur, sum er einsamallur um navn sítt,Díðrikur er einnevndur í bygdini
einnevni	(málfr.)tað at hava eitt fornavn (1);sbr.tvínevni
einnýtis-	til at nýta einans ferð;sms. t.d.-blæa,-bók,-fløska,-nál,-spræna,-tilfar
einnælingur	(plfr.)planta við einum gróðrarblað,einnælingarplantubólkur(Monocotyledones)
einoygdur	1við einum eyga, blindur í øðrum eyganum2(flutt m.)eintáttaður, einsháttaður, trongskygdur
einraddaður	(tónl.)(um song)sungin av fleiri samstundis í somu tónahædd,móts.fleirraddaður,einraddaður songur
einráðin	sum vil ráða einsamallur, ráðaríkur
einrúm	1í osb.í einrúmieinsamallur, í einingi, fyri seg sjálvan,hetta mátti hann hugsa um og taka støðu til í einrúmi;tey tala leingi saman í einrúmi(tveyeini, í trúnaði)2einastova
einrúmdur	(plfr.)við einum rúmi,einrúmd egglega
einræði	(stjm.)stjórnarlag við einræðisharra, einaræði
einræðisharri	(stjm.)ríkisstjórnari ið ræður einsamallur[da.diktator]
einræðisligur	sum tekur undir við einræði,einræðisligt stjórnarlag[da.diktatorisk]
einrættur	einarættur
einrøða	(serst. í sjónleiki)leikurel.leikpartur sum ein leikari førir fram(monologos),sbr.tvírøða
eins1	samur, samlíkur,ymist er, um tú og eg síggja við eins eygum at hesum
eins2	á sama hátt, samlíkt, líkasum;livimátin er eins frægari(heldur enn ikki)
eins3	sbí osb.eins ... ogsum, líkasum,hon er svarthærd eins og systirin;eins væl og;vár eins væl og heyst
einsamallur	eina, einsligur, í einingi, fyri seg sjálvan,eg siti einsamallur;(orðt.)árini koma ikki einsamøll(brekini koma við);(orðt.)kráka flýgur best einsamøll(um e-n ið heldur seg fyri seg sjálvan);vit vóru báðir einsamallir á útróðri(tveireinir);hon er einsamalt barn(einborin);hon er eitt einsamalt barn(hevur ongan at spæla við);í osb.ikki vera einsamallur1hava kenning,teir vóru so kváðir, teir mundu ikki vera einsamallir2(um kvinnu)vera við barn, vera tvílívað;hon er ikki einsamøll3duga meira enn at mata seg(Sv)
einsamur	einsligur, einsamallur,bygdin liggur so einsom
einsemd	einsemi
einsemi	tað at vera einsamallur, einsligt lív, einvera
einsetur	h13:sita í einsetri(í einsemi, einsamallur)
einshátta	gera einsháttaðan, javna[da.homogenisere]
einsháttaður	av sama slag (sum e-r/e-t annað), einvorðin, einskendur, fábroyttur,tað snýr seg um at fáa eitt einsháttað kt-umhvørvi, har allir brúkarar arbeiða í eini og somu skipan;umsitingarligu kjarnuøkini á Almannastovuni verða styrkt og málviðgerðin gerst einsháttað
einskaraður	(stb.)í osb. sumtað var tann einskaraði lortur, runao.s.fr.(tann bera og blektaða runa);
einskeftaður	(um vevnað)vovin við einum skafti í klíggjaveviel.tveimum skøftum í vanl. vevi,einskeftað vaðmal;einskeftað vond
einskeftishøvil	høvil við einum skefti
einskendur	av sama slag, einsháttaður, einvorðin, fábroyttur
einskila	fráskila, framúr, einsýna, hendinga,einskila vakur
einskila-	fráskila-
einskilaður	frálíkur, fráskilaður, framúr, óvanligur, serstakur
einskilagóður	fráskila góður, frálíkur, frágerðargóður
einskilamaður	framúrskarandi maður, avreksmaður, valamaður, úrmælingur
einskildur	1egin, einstaklings-, privatur2serstakur,hann hevur skrivað eina grein, ið fæst einskild
einskilja	lata einstaklingiel.einstaklingum rakstur av eini almennari fyritøku(so at leiðslan ikki longur er undir eftirliti frá tí almenna),leiðreglur um at einskilja fyritøkur landsins;landsins ognir vórðu einskildar[da.privatisere]
einskiljing	tað at einskilja,einskiljing av Føroya Banka
einskyns	av onkrum slag, onkur, summur;sbr.alskyns
einskæraður	berur, reinur, skærur,einskærað mjólk(óblandað);einskæraður skittur(berur og blektaður)
einskærur	einskæraður
einsleingin	sum reikar um einsamallur, einsligur, eina
einsleingis	(kvæð.)einsliga, fjarskotin, einsæris, avleiðis,hví eruð tær so einsleingis komin burtur í haga
einsleingismaður	(sj.)maður sum er einsamallur(og ongan annan hevur at senda fyri seg)
einsligur	ið kennir seg einsamallan;hj-liga
einslistum	í osb.av einslistumav einlistum
einsljóð	e-t sum er einsljóðandi, fábroytni[da.monotoni]
einsljóðandi	1(tónl.)fátónandi, fábroyttur, langligur[da.monoton]2við sama orðaljóði,einsljóðandi bræv
einsmansføri	tað ein maður er førur fyri at gera,tað er ikki einsmansføri
einsmansgerð	einsmansføri,tað er ikki einsmansgerð
einsmanskamar	einsmansrúm
einsmansligur	einmenniligur
einsmansljóð	h3í osb.koma upp úr einsmansljóði (við e-m)siga e-t av sær sjálvum, siga e-t sjálvkravdur(og óvæntað)
einsmanslæti	einmenningsskapur
einsmansrúm	(t.d. á gistingarhúsi)rúm til eitt fólk;sbr.tvírúm
einsmansverk	einsmansføri
einsmál	síeinmál
einsnevni	(málfr.)orð við sama framburði(og ofta stavað eins)men við ymiskari merking(homonymum),sagnorðið "at vísa" og navnorðið "ein vísa" eru einsnevni
einsongur	(tónl.)songur sum ein syngur einsamallur(viðel.uttan fylgispæl)
einsporaður	við einum spori,einsporað jarnbreyt
einsstavaður	l6:einsstavað orð;(málfr.)orð við somu stavseting men ymiskari merking(homographe),navnorðið ein "vísa" og sagnorðið at "vísa" eru einsstavað orð
einstaddur	avbyrgdur, (ser)stakur,einstatt fyribrigdi[da.isoleret]
einstaka	einskila, fráskila, serstakliga,einstaka góður;einstaka ringur
einstaklingseyðkenni	tað ið eyðkennir ein einstakan[da.individualitet]
einstaklingsvirki	(búsk.)virki við einum eigara ið eigur allan eginpeningin(eigarin heftir sjálvur við allari ogn síni fyri skuld hjá virkinum)
einstaklingur	persónur, menniskja, fólk, skapningur, vera, staklingur[da.individ]
einstakur	1sum er fyri seg sjálvan, stakur, einsamallur, einastur,einstakar ferðir(nakrar (fáar));einstakir menn(nakrir (fáir), onkrir, summir);í osb.tað man vera einstakt, at ...(eindømi)2frálíkur, framúr, serligur, serstakur,einstakt útsýni
einstavilsisorð	(málfr.)orð við einum stavilsi,"bók" er einstavilsisorð
einstøðingur	1føroyskt skjúrtavaðmal við eins breiðum reyðum og bláum spølum;sbr.hallaspølir2sermerktur maður
einsvegna	onkursvegna, á einhvønn hátt,tú hevur fjálgað (um hana) einsvegna(sum best ber til)
einsýna	frálíka, framúr, einskila, hendinga,einsýna góður;einsýna vakur
einsýnamaður	einskilamaður, fráskilamaður, úrmælingur, hendingur (3),einsýnamaður til bakkagongu
einsýni	tað at vera einoygdur (2), trongskygni, heimføðisskapur
einsýntur	einoygdur, trongskygdur, heimføðisligur,tað er einsýnt at siga
einsýnur	einskilaður, framúrskarandi, tikin úr leikum,hann hevði einsýnar gávur
einsæri	hjí osb.hvør einsæriein og ein, hvør fyri seg;hvørt eittsærihvørt sær
einsæris	(sj.)avleiðis, burturfrá, avsíðis, einsliga, fyri seg sjálvan,hann tók teir einsæris á vegnum;hvør einsærishvør sær;hvørt einsærishvørt sær
einsærur	einstakur,tann einsæri má sjálvur hava skyldina;hvør einsærur
einsøla	(búsk.)tað at ein fyritøka einsumøll hevur sølurættindi
einsølumaður	maður sum hevur einarætt at selja ávísa(r) vøru(r)
eintak	einstøk bók, mynd, blaðo.s.fr.úr heilum upplagiel.einstakur gripur(serst. á savni),trý eintøk av somu bók;blaðið varð givið út í 1000 eintøkum;sbr.tvítak
eintal	1(kvæð.)tað at tala saman tveireinir, samtala í trúnaði,krevja ein fyri seg í eintal2(málfr.)orðformur ið bert sipar til ein(singularis);sbr.fleirtal,tvítal
eintáttaður	1(um tog, band o.tíl.)við einum tátti,greipað varð við eintáttaðum;sbr.tvítáttaður,trítáttaður2einsháttaður, fábroyttur, einskendur, einvorðin,eintáttaður kostur
eintevin	l26:ikki eintevinsum dugir meir enn at mata seg, sum dugir gand, sum kann
eintingum	í osb.av sínum eintingumóbiðin, óboðin, sjálvbiðin, sjálvkravdur, ókravdur, av sjálvsheintingum
eintónaður	fátónandi, fábroyttur, langligur, einsljóðandi (1)[da.monoton]
eintónandi	eintónaður
eintur	nøgdur, foreintur
eintýddur	sum hevur eina merking, sum bert er skiljandi á ein hátt
eintættingur	sjónleikur í einum táttiel.parti
eintølin	eintevin,ikki eintølin
einumegin	øðrumegin,genturnar stóðu einumegin og dreingirnir einumegin;trupulleikar hava stungið seg upp millum djóralæknarnar einumegin og landsdjóralæknan hinumegin
einusinni	eina ferð(ina), onkuntíð(fyrr)
einvaksin	1(um træ)við fáum og smáum greinum,træið er einvaksið2(um eplavøkstur)við einum slokki;rennur bert ein slokkur upp av einum epli, er vøksturin einvaksin
einvaldsharri	(kvæð.)høvdingi sum ræður einsamallurel.sum hevur einavald
einvaldskongur	(kvæð.)einavaldskongur
einvaldur	sum ræður einsamallur,kongur ráddi einvaldur
einvegis	1hjbert annan vegin2lið bert gongur annan vegin,einvegis ferðsla
einveldi	einavald
einvendur	einvegis,einvend ferðsla;einvend hugsan
einvera	tað at vera einsamallur, einsligt lív, einsemi
einvíggi	(kvæð.)bardagi(við vápnum)ímillum tveir, hólmgonga,berjast við ein í einvíggi
einvísur	1treiskur, tvørur, tógvin (3), trongskygdur2sjálvklókur
einvorðin	av sama slag, einsháttaður, fábroyttur, einskendur
einvorðinskapur	tað at vera einvorðin, einvorðni
einvorðni	einvorðinskapur
eir	(sj.,kvæð.)sinnalag, sinni, lyndi, skaplyndi,hann hevur eir úr móður kyni
eira1	(um kopar)fáa eirdømi, gerast eirgingin,nýggir jarnpottar eira
eira2	líva, spara, fara væl við,eira e-m;eira samanhóskael.svarael.hóva saman, sampakka,jarn og mjólk eirir ikki saman;eira við (e-n)halda av, vera góður við, hava yndi til,mær eirir væl við hann;mær hevur altíð eirt illa við hann;eir tærel.stb.teg væl við hannkom væl ásamt við hann;eira særlíva sær;sbr.illeirast
eirdømi	grønt lag ið legst á kopar av sambandi við súrevni(í ráari luft)
eirgingin	eirdur,tornini eru eirgingin
eirgrønur	grønur av eirdømiel.sum eirdømi,eirgrøn klokka
eiri	(um fólk og lutir)yndi, tokki, kærleiki, alskur,hava eiri í e-m;eg hevði einki eiri í honum
eiriliga	varliga, varisliga, hóvliga, spakuliga, eirisliga,gekk so eiriliga uttanum;hann dró eiriliga
eiriligur	góðurel.lættur at vera saman við, vinaligur,hann er so eiriligur;sbr.viðeiriligur
eirin	eftirlátligur, eftirlátin, hóvligur(Sv)
eirindaleysur	miskunnarleysur, náðileysur, harðhjartaður;hj-leyst
eirindaloysi	miskunnarloysi, náðiloysi
eirindi(r)	mýkindi, miskunnsemi, náði,við eirindumvið mýkindum, varliga;tað var ikki við eirindum;teir høvdu eingi eirindi(r) fyri
eiring	eirdømi(t.d. á koparklæddum skipi),banka eiring uttanav
eirisgras	(plfr.)slekt í krossblómuætt, bakkablomstur(Cochlearia);sms.lækna-
eirishvonn	(plfr.)bergeirissýra, bergsýra
eirisliga	eiriliga
eirissýra	(plfr.)slekt í sýruætt, berg(eiris)sýra(Oxyria);sms. t.d.berg-
eisini	somuleiðis, líkaleiðis, við, (har)umframt, eins væl, aftur at tí
eista	(lívfr.)eggskapaður kynskertil (tveir í tali) á mannfólkiel.kalldýri(har ið sáðkyknurnar verða gjørdar),eistasteinur, nossa, steinur (7);sbr.hvítanýra,bøllingur (6)
eistapylsa	eistnapylsa
eistasteinur	(sj.)eista
eistnameltingur	lamb við meltaðum eistum, geldingur, meltingur
eistnapylsa	pylsa úr hvítanýrum latin í indur
eistnaskólpur	skólpur
eistnastrongur	sáðstrongur
eistnasúpan	skólpasúpan
eita	verða kallaður, verða nevndur (atel.á navni), nevnast, heita 3,hann eitur Høgni;hvørgin okkara kundi eitast fullfíggjaður maður;ikki tað, sum eiturikki tað minsta sindur, ikki petti, púrt einki;hann skal eitast at ...sagt verður at ...;tað eitur fyri tað, at ...tað sigst at ...;okkara tíð eitist at vísa stóran framburð;tað eitur einki, sum hon etur(er lítið, ikki nevnandi);tað vildi einki eita, ið seyður fekk skavað(tað var smávegis)
eiti	1navn, heiti (1), nevni,(kvæð.)sig mær, frægur, eiti títt2e-t ið er lítið og einki vert,sita fyri eitt eiti(sum viðfáningur);mans eiti kom aftur í mans stað(ómenni, lítilmenni);eitt eiti av einum skógilítil skógur;(bíbl.)bert eiti er mannahjálp(einkisverd);(bíbl.)heilagskapur teirra var bert eiti og lótir(hykl og ansalæti)3e-t makaleyst (2)el.ómetaligt,tað var ikki eiti, tað hann átti(ikki hissini);ikki eiti á veðurslíkt veður!;tað er ikki eiti á ríkidømi(sagt um stórt ríkidømi);tað var ikki eiti (á)!hygga síggj!(tá ið ein gerst bilsin)4(kvæð.)heiti (4), lyfti,hann streingir tað eiti;hagar streingi eg eiti mítt;sms. t.d.mans-
eitil	1(lívfr.)knykil sum reinsar gróðrarvatnið2knykil í feitum kjøtiel.spiki(í spiki t.d. eftir gomlum svulli);(orðt.)tað er eisini eitil í válgaraeingin er so góður at hann hevur ikki okkurt lýti;(orðt.)eitil er í øllum feitumeingin er lýtaleysur;sms.háls-
eitilkoppur	eiturkoppur
eitlabruni	(lækn.)bruni í eitlum
eitlagreipa	kv1(stb.)ein eitlagreipatvey ódugnavætti
eitlagørn	(sj.)gørn við eitlum
eitlasjúka	(lækn.)sjúka í eitlum (1)
eitlaspik	spik við eitlum (2)(Sv Indb.933)
eitlatroti	(lækn.)trútnaðir eitlar
eitlaválgari	válgari við eitlum (2)
eitlutur	við eitlum (2)(Ev)
eitra	blanda við eitri, geva eitur,eitra e-m matin;áður skutu teir sildreka við ørvum, sum eitraðu blóðið;(flutt m.)spilla,hon vildi eitra sinni hennara;eitrandivið eitri, eitraður, eiturkendur, eitur-,mangar plantur hava eitrandi evni
eitran	tað at eitrael.verða eitraður, eitring;sms. t.d.blóð-,mat-
eitrandi	sum eitrar, eiturkendur;hjógvuliga, avbæra, ómetaliga,eitrandi fínur;eitrandi smáur;eitrandi góður
eitring	(sj.)eitran
eitt	síein
eittans	síeinans
eittari	e-t sum hevur nummar 1t.d.bussur,koma við eittaranum
eitthvat	(sj.)eitthvørt
eitthvørt	okkurt,síeinhvør
eittnú	eitt nú;síein (3)
eittoyra	myntur verdur eitt oyra(avtikið 1973)
eittsæri	síeinsæri
eitttal	talið 1
eitur	drepandiel.skaðiligt evni, gift;sbr.andeitur
eiturbikar	bikar við eitri
eiturbland	eitur latið út í løg, eiturdrykkur, eitur,(kvæð.)leggja mangari kempu fyri eiturbland(geva eitur);hann vildi ikki njóta av ormsins eiturblandi
eiturblásin	(kvæð.)blásin av eitriel.gift
eiturblóð	(kvæð.)eitraðel.eitrandi blóð,ormsins eiturblóð
eiturdrykkur	eitraður drykkur, eiturbland
eiturevnavápn	(herm.)eiturvápn
eiturevni	eitrandi evni, eitur
eiturfínur	(um tógv, tráð o.tíl.)ógvuliga fínur, eitrandi fínur, erfínur,eiturfínt tógv
eiturfon	nótel.net ið eiturkoppur spinnur sær, lokkanet, kongurvág, spinnilvevur, eiturkoppanet, eiturkoppanót, lokkaroykur (2),eiturfon hongur undir bjálkunum
eiturgass	(evnafr.)eitrandi gass(serst. nýtt í hernaði)
eiturherða	spinna ógvuliga smáttel.fínt,eiturhert tógveitrandi fínt tógv, ormatógv
eiturhvassur	bítandi hvassur,hann stardi upp á hana við eiturhvøssum eygum
eiturkaldur	ís(a)kaldur, steinkaldur,eiturkøld luft
eiturkendur	eitraður, eitrandi, eiturkyndur, eiturligur
eiturkoppanet	eiturfon
eiturkoppanót	eiturfon
eiturkoppur	(dj.)lítið áttaføtt kykt(nógvir gera sær nót (eiturfon) at veiða fluguro.tíl.í)(Araneida)
eiturkorn	(kvæð.)korn (lítið vet) av eitri
eiturkuldi	bítandi kuldi,í eiturkulda
eiturkyndur	eiturkendur,eiturkynt hatur
eiturligur	eiturkendur(Ev)
eiturliljuætt	(plfr.)liljuætt
eiturmein	(kvæð.)skaði elvdur av eitri
eiturmorð	morð framt við eitri
eiturnappað	sera vandaliga nappað, dúnnappað,eiturnappað skinnull
eiturormur	(dj.)ormur við eiturtonnum(til at drepa fong við)
eiturpadda	(kvæð.)eitrandi skriðdýr
eitursettur	dekanssettur
eitursmáur	l17:eitursmátteitrandi smátt(Ev)
eitursoppur	(plfr.)eitrandi soppur
eiturtonn	(dj.)tonn ið stendur í sambandi við eiturkertil
eiturtunnur	eitrandi tunnur,eiturtunn bløð
eiturtøka	tað at taka inn eitur
eitururt	urt við eiturevni, eitrandi urt
eiturvákn	sera hvast eggjarn(t.d. knívur, líggi),hatta er tað eiturváknið, ið tú hevur, tað fer sum gjøgnum smør
eiturvápn	(herm.)vápn við eiturevnum
ekjuskip	(skip.)skip sum flytur akfør við farmi[da.ro(ll-on)-ro(ll-off)-skib]
ekkafullur	bangin, ræddur, óttafullur, bangafullur, ekkasamur
ekkaleysur	óttaleysur, óræddur
ekkaloysi	óttaloysi
ekkamikil	ekkafullur, hjartkiptur
ekkamóður	pøstur, tivandi, bráðmóður, deyðmóður
ekkamøddur	(kvæð.)ekkamóður
ekkamøði	tað at vera ekkamóður, stór møði
ekkasamur	trongur (um e-n), ekkafullur
ekki	1(gl.)sorg, harmur, kúrur, sút, tregi (1)2ótti, bangilsi, órógv, stúran, trongd (3),loypa ekka á e-nræða e-n, hvøkkja e-n;eg havi sovorðnan ekka á mær(fjálturskotin, ekkafullur)
ekkja	(gl.)einkja
ekkolodd	tól ið kann máta frástøðuna til ein lutt.d.havbotnin(við at rokna hvussu langa tíð tað tekur hjá signali at náa lutin og at koma aftur aftur)
ekkó	bergmál, afturljóð, dvørgamál
ekkóa	geva afturljóð, ljóða eftir í, svara aftur í, syngja eftir í
ekkólodd	tól at skanta havdýpi við(við ljóðbylgjum)
ekla	vera kargur, natinel.gírigur,hann eklar ikki tað, hann hevurhann sær seg ikki í nevan fyri at geva, hann er gávuríkur;ekla seg inn á (e-n)bjóða av, eggja, øsa upp, fáa illan;sbr.hekla 2
e.Kr.	stytting fyrieftir føðing Krists
ekra	elma;sbr.opinekra
ekrubakki	bakki á ekru
ekrugás	(fugl.)stór grá gás við longum hálsi og nevi(Anser fabalis)
ekrugras	gras í ekru
ekrukúgv	1kúgv á beiti í ekru2letingi(ið etur nógv og er tungur á sær),í osb. sumliggur (og rekst) sum ein ekrukúgvliggur og letast;(um átara)etur sum ein ekrukúgv
ekrulínbendil	(plfr.)slag av línbendli(Spergula arvensis)
ekrulínbinda	(plfr.)slag av línbindu(veksur sum lok í økrum og opinekrum; upphavsplanta at føroyskum rótum)(Brassica campestris)
ekruneyt	h3:sum eitt ekruneytilla gongdur, tungur á sær
eks	heiti á bókstavinumx
eksamia	prógv, próvtøka
eksamur	(tlm.,Suð.)próvtøka
eksem	(lækn.)slag av húðarsjúku
eksibiti	gamalt barnaspæl,spæla eksibiti(Sv Indb.1183)
eksponentur	(støddfr.)tal ið lýsir hvussu ofta annað tal faldast við sær sjálvum,2 í eksponentinum 3 er 8el.2³=8;sbr.veldi (5)
ekspressionisma	listaligt rák ið leggur dent á sálarligar upplivingar(heldur enn at endurgeva tann ytra heimin),ekspressionisman kom fram í Evropa um ár 1900
ekspressionistiskur	viðv. ekspressionismu
ekspressionistur	ein ið er ávirkaður av ekspressionismuni
-ekstur	sísmá-,stór-
ekta	(gl.)gifta seg við (e-m), giftast við (e-m),(kvæð.)ektar tú ikki móður mína, skalt tú lata lív
ektaður	sannur, rættiligur, reinur, veruligur,hin einasti ektaði føroyski skúlin
ektakona	(egin)kona
ektamaður	maður (2)
ekta(r)	í osb.fáa til ekta(r)fáa til konu/mann, giftast við;(kvæð.)kanst tú hana til ekta(r) fáa
ektleiki	tað at vera ektaður, reinleiki, dýrleiki,ektleiki brævanna
ekur	síaka
ekurkúgv	(stb.)ekrukúgv
ekurneyt	(sj.)ekrukúgv
ekvator	(landafr.)miðkringur
el	(ravm.)ravmagn
el-	ravmagns-, rav-
elaklænur	ógvuliga klænur, úrklænur, klæntraligur, pappírsligur, másasligur, visin
elaligur	elalítil
elalítil	ógvuliga lítil, evarska lítil, pinkulítil, ørlítil
elapinkulítil	elalítil
elapinkutur	elalítil
elda1	1hita íel.yvir eldi,gott fiskijarn skuldi kennast á roykinum, tá ið tað varð eldað;elda stáltráð2kynda upp, kyka,elda ovn;elda húskynda upp av og á í húsum sum standa tóm(Sv);eldað rúmrúm ið kynt er í,sbr.óeldaður;elda innundirkyka við e-m sum gevur bráðan hita men brennur skjótt upp(t.d. hølvispónum)3eggja (2), kveikja (2), eldhuga,treytin tykist ikki at hava eldað hansara sinni;hann eldaði menn at fara í víking
elda2	gera (e-n) eldri,slíkt eldir mannin;hann hevur lyndi til at elda seyðin nógv(lata áseyðin gerast gamlan);hann eldi seg út(sleit fullan aldur);eldastverða eldriel.gamal,hvalurin lýsnar, sum hann eldist(við árunum);tað slagið eldist so væl(er birgt á gamalsaldri);hann eldist ikkihann doyði ungur;tað eldist (burtur) av honum(t.d. um sjúku el. óvana)(fer burtur við aldrinum);sbr.aveldast
eldáseting	tað at seta eld á
eldávaring	1ávaring um eldsbruna2tól at boðsenda sløkkiliði við
eldband	(gl.)band við eldkróki at heingja pott í yvir grúgvuni(serligur knútur var á so at tað kundi styttast og leingjast);sbr.eldtræ,skerðingur
eldbirtari	ein ið setur eld á, brennivargur
eldbrík	bríkel.fastur sessur við grúgvuel.fýrstað,hann situr á eldbríkini;sbr.torvkassi
eldbumba	(herm.)bumba við eldfimum evni(t.d. fosfori)
elddovin	(um t.d. torv)sum illa kyknar í,móts.eldfimur
elddópur	1(bíbl.)dópur við eldi(Matt.3,11)2fyrsti (vápna)leikur ein kemur við í,fáa elddópin;(flutt m.)(eld)roynd, byrjan, fyrsta roynd
elddyggur	eldtryggur
eldegg	(á eggjarni)egg eftir fyrstu brýning aftan á herðingina
eldfastur	sum tolir eld, ovndyggur,eldfast leir;eldføst skál
eldfimur	1sum skjótt festir í, sum skjótt tekur eld, eldkvæmur,móts.elddovin2(flutt m.)viðkvæmur, viðbrekin,eldfimt evni
eldfjall	(jarðfr.)gosfjall
eldfrensur	ein sum dámar væl hita, sum krýpur sær fram at eldinum, eldfressur, eldkattur,hann er ein sovorðin eldfrensur, tí brúka tey so nógv kol;teir setast hvør sínumegin komfýrin, tveir gamlir eldfrensar
eldfressur	eldfrensur
eldføri	1amboð at kveikja eld við(fyrr: njóskur, tinna og stál; nú: tól við flótandi gassi),teir hava eldføri hjá sær, sláa eld og tendra ljós2(stb.)svávulpinnar, eldpinnar
eldførisdós	dós við eldførispinnum, eldføriskistil, svávuldós, svávuleskja
eldføriskistil	eldførisdós
eldførisløgur	eldfimur løgur (t.d.bensin) til bennievni í eldførum
eldførispinnur	(lítil) træpinnur við eldfimum evni á øðrum endanum til at kveikja eld við, svávulpinnur, eldpinnur
eldførur	sum kann brenna, brennandi
eldgamal	(sj.)avgamal, elligamal,eldgomul eik
eldgerð	tað at gerael.kveikja eld,tólini, hann hevði nýtt til eldgerð sína, goymdi hann burtur
eldglæma	glæma av eldi
eldgos	(jarðfr.)tað at grótbræðing og ymisk loftsløg(troka seg fram innan úr jørðini og)spríkja upp gjøgnum rivur(sum í erva enda í einum gosopi),eldgos kann mynda gosfjøll
eldgrót	gosgrýti
eldgrúgva	grúgva 1(1), eldstaður
eldgrúvusteinur	(gl.,stb.)grúgvusteinur
eldgrøv	eldslóð,eldgrøvin stóð úr tí;(flutt m.)teir fóru við eldgrøv norðureftir
eldhav	stórur, brimandi eldur
eldhol	(á komfýri)hol niður á eldin,seta út á eldholið
eldhuga	hugtaka, hugfanga, elda 1(3),eldhuga hjørtuni
eldhugaður	við eldhuga, uppgløddur, íðin, ágrýtin,eldhugaður maður
eldhugi	tað at vera eldhugaður, gudmóður, ágrýtni, ídni,hann arbeiddi altíð við eldhuga og gavst ikki, fyrr enn verkið var komið at enda
eldhugur	(sj.)eldhugi
eldhurð	ovara hurð á komfýri;sbr.øskuhurð
eldhús	1(stn.,gl.)húsel.rúm við eldstaði,hennara lív hevði verið millum fjós og eldhúshon hevði ikki verið av bygdiniel.burtur2(ným.,sjóm.)kokkhús
eldi	(stb.,sj.)elli,hann bleiv gamaldur og doyði av eldi
eldibrandur	(gl.)logandi sprek, brandur (1),sum ein eldibrandur(sagt um snarsintan persón)
elding	1tað at elda 1(1)2tað at elda 1(2)3íblástur 1, innblástur 1, andkoma, kveiking
eldiviður	(kvæð.)brenni(viður),eldiviður var illa turr
eldkast	(lækn.)pínufull húðarsjúka við útbroti og bløðrum(herpes zoster),jarðarsipan varð nýtt at lekja eldkast við;sbr.álvareldur
eldkattur	eldfrensur
eldker	(bíbl.)glóðker, eldpanna,eldur brann í eldkeri
eldketta	1ketta sum dámar væl hita2eldfrensur, eldfressur, eldkattur,hatta er tann eldkettan, ið er
eldkjaftur	k6/8í osb.blása eldkjafthava eina gløðandi sneis ímillum tenninar(og blása?)(Sv)
eldkrekkja	(gl.)teyggja 1(1) við fýrstaðin at turka klæði á;sbr.krekkja
eldkrókur	(gl.)(jarn)krókur í eldbandi at heingja pott (1) í(yvir eldstaði);sbr.skerðingur
eldkúla	logandi kúla 1(2),seglini vóru illa brend av eldkúlum;sum ein eldkúlaskjótur, snarur, sum eitt skot;hann var sum ein eldkúla aftur á fótum
eldkvæmur	eldfimur
eldlandsbók	(plfr.)leyvtræ í slektiniNothofagus
eldlandssuðursoppur	(plfr.)slag av suðursoppi(Descolea antarctica)
eldleysur	við ongum eldi,skulu vit gista her, kolsvarta nátt, sjókastaðir og eldleysir?
eldloysi	tað at vera eldleysur,sita í eldloysi
eldmikil	eldhugaður,eldmikil hugur
eldmurtur	(stb.)kombikk (1), beinmurtur
eldneisti	neisti,eldneistar fuku úr gronini
eldoffur	(bíbl.)brennioffur
eldovnur	(bíbl.)ovnur við eldi í, brennandi ovnur, eldsovnur(Matt.13,50)
eldpanna	(bíbl.)eldker, glóðker
eldpinnur	(sj.)svávulpinnur, eldførispinnur, eldføri (2)
eldpokari	(sjóm.)eldskøra, eldrakari,hann stingur eldpokaran inn í gløðurnar
eldraíbúð	íbúð ætlað eldri fólki
eldrakari	eldskøra, eldpokari
eldraki	eldrakari
eldrarøkt	røkt av eldri fólki
eldrasambýli	sambýli ætlað eldri fólki(vanl.minni enn ellisheim)
eldraøki	viðurskifti ið snúgva seg um teir eldru borgararnar í samfelagnum,leggja eldraøkið út til kommunurnar
eldreiða	tilfar at kyka við,ring eldreiða;vanl.flt:ringar eldreiður
eldreiggj	eldreiða,har er vána eldreiggj;har er eldreiggj í Lítlu Dímun
eldrekkja	(stb.)eldkrekkja
eldreyður	reyður sum eldur, glóðreyður,eldreytt hár
eldri	avgamal
eldripari	(herm.)vápn ið goysir úr sær logandi olju
eldroynd	torfør roynd,vera fyri eldroynd;sbr.elddópur
eldsaltur	ógvuliga saltur, ramsaltur, brimsaltur,deiggið er so eldsalt
eldsál	eldhugaður persónur, eldhugamaður,hann er ein eldsál
eldsbruni	tað at e-t brennur(av skaðatilburði el. eldáseting),eldur 1(1)
eldsjógvur	(bíbl.)stórur eldur(Opb.20,10)
eldsjúka	(lækn.)sjúkligur hugur at seta eld á(pyromania)
eldskaði	skaði elvdur av eldsbruna, brunaskaði, brunaeldur(Ev)
eldskáli	(søg.)eldhús, roykstova,Tróndur í Gøtu læt kynda miklar eldar í eldskálanum
eldskírn	elddópur
eldskøra	amboð at skøra í eldinum við, eldrakari, eldpokari
eldslogi	geisandi eldur, logi
eldslóð	gløðandi rípa av eldi(aftan úr e-m ið flytur seg skjótt),eldgrøv;nykbrandar koma við langari eldslóð eftir luftini
eldsløkking	1tað at sløkkja eldsbruna,turkur hóttir eldsløkking(ov lítið vatn at sløkkja skógareld við)2eldsløkkingur
eldsløkkingur	(gl.)sløkturel.útkólnaður eldur, øslakingur,her er eldsløkkingur(øskukaltel.svart);gera eldsløkking:ger nú ikki eldsløkking, tú hin grái drongur(í tátti)
eldsløkkjari	tól at sløkkja eld við
eldsmiður	(stb.)jarnsmiður sum smíðar við eld
eldsovnur	(bíbl.)eldovnur
eldstaður	(í húsum)staður við opnum eldi(til matgerð og hita),árnur, fýrstaður, grúgva 1
eldstál	stál at kveikja eld við
eldstólpi	(bíbl.)høgur eldslogi(2. Mós.13,21)
eldtinna	(jarðfr.)slag av tinnu(áður nýtt at kveikja eld við),grátinna(kalcedon)
eldtolin	(handv.)(um hurð, skilavegg o.a.)sum tolir eld í avmarkaða tíð(og forðar eldi at breiða seg)
eldtryggur	sum ikki brennur, elddyggur;sbr.eldtolin
eldtræ	(gl.)træ sum eldbandel.skerðingur hekk í,ikki bar til at standa á eldtrænum og vaska;sbr.sóttræ (1)
eldtunga	logi líkur tungu,smáir logar komu upp og hvurvu aftur, eldtungur, sum dansaðu leysar í roykstovuni
eldur1	1logi, brenna 1, (elds)bruni, brimi, eldslogi,avbrandaður eldur;bráður eldurstórur eldur;makur eldurlítil eldur;sita við eldin;hava e-t standandi úti á eldinum;taka eldfesta í;tað er. sum tað tekur eld, so blankt(um nýblankað kopar),gera eldkyka;eldur er ítað logar (1)el.brennur 2(1);kóka í eldinkóka yvir;(flutt m.)nú kókar í eldin(um e-n ið sigur ov nógv, leggur óspurdur uppí);(tilt.)lokið er hálvur eldurin(grýta kókar skjótari við loki á);(bíbl.)hin ævigi eldurin(í helviti);tað er við at taka eld(er bjart, skínandi);vera sum ein eldur(snarsintur);tíðindini fóru sum eldur um bygdina(ógvuliga skjótt);hann fór sum eftir eldi(skundisliga);vera í eldi og løgi av e-m(illa staddur);alt var sum í einum eldi(í ruðuleika);eldur er í teirra millum(ósemja);seta eld á (e-t)festa í (e-t);tá var eldur í koluniel.í skálanumel.tá var alt sum í einum elditá var ikki gamansleikur2(gl.)nakrar torvur settar saman(í runding)á heiðini(áðrenn torvið er fullturt),kynda el. seta torv saman í eldar;sms. t.d.álvar-,breyð-,døgurða-,grúgvu-,heljar-,ketils-,lang-,mur-,nátturða-,sorn-,torv-,vágar-
eldur2	vorðin eldri, aldraður, gamal,hon er nógv/einki eld;sbr.aveldur
eldurt	(plfr.)urt at sorta við, sortugras(Geranium sylvaticum);sbr.øt
eldurtarætt	(plfr.)ætt av hulfræingum ið eru tvínælingar(Geraniaceae)
Elduvík	(stn.)bygd í Eysturoynni,í/úr Elduvík,til Elduvíkar
elduvíkingur	fólk íel.úr Elduvík
eldvagnur	1(bíbl.)logandi vagnur(sum Elias profetur fór til himmals í)(2. Kong.2,11)2vagnur sum dregur jarnbreytarvagnar[da.lokomotiv]
eldvandi	vandi fyri eldi, brunavandi
eldvardur	vardur fyri eldi,eldvart rúm
eldvargur	brennivargur
eldvatn	brennivín
eldvápn	skotvápn
eldverk	skreyteldur, fýrverk
elektrikari	(ravm.)yrkislærdur ið arbeiðir við ravmagnsinnleggingo.ø.
elektrisitet	(alisfr.)ravmagn
elektriskur	(ravm.)ravmagnaður, ravmagns-
elektroda	(alisfr.)tráðurel.pláta ið leiðir ravmagnsstreym, ravkleiv, kleiv 1(2)
elektron	(alisfr.)ørlítil bitil løddur við negativum ravmagni
elektronikkur	(alisfr.)vísindi um elektron og virki teirra, ravindi
elektroniskur	(alisfr.)viðv. elektronikki
elfinbein	(tlm.)fílabein
elgja	s10:elgja í segkulka (í seg), kelkja í seg, klesja í seg, sutla,teir elgdu mjólk í seg sum kálvar
elgsdýr	(dj.)elgur
elgur	(dj.)dýr av hjartarætt(Alces alces)
elinnleggjari	(ravm.)ein(oftastelektrikari)ið hevur løggilding til at leggja inn og umvæla ravmagnsútbúnað,løggildur elinnleggjari
elja1	helja
elja2	1(á turrum fiski)tað tunna á ugganum, tunni (2), biti innan á uggabeininum2(stb.)eljubiti3eljubein(Sv);sbr.tunnuggi,uggastykki
eljastríð	(sj.)eljustríð
eljasvøvil	(stb.)hýsusvøvil
eljubein	(á fiski)bein ímillum uggafjøður og uggabein, elja 2(3)(coracoideum)
eljubiti	(á fiski)bitin við uggabeinið, elja 2(2)
eljusjúka	øvundsjúka, svartsjúka, eljustríð (1),illa særdur av eljusjúku
eljusjúkur	øvundsjúkur, svartsjúkur
eljustríð	1øvundsjúka, ástarøvund, svartsjúka, eljusjúka2vanl.ósemja, tvídráttur, klandur,eljustríð var teirra millum
eljustykki	(sj.)uggastykki
ell	heiti á bókstavinuml
ella	1(um val millum tveir el. fleiri møguleikar)heitur ella kaldur;ein ella tveir;hvørki rátt ella soðið;annaðhvørt er tað músin, ið melur, ella er tað tjóvurin, ið stjelur, ella ruggar henda gamla ikki rætt;vegurin er eins góður ella betri;ert tú til dystin fús, ella hvat?2annars,skundið tykkum, ella verða tit ov sein
elli	høgur aldur, aldurdómur, aldur 1(2), elliár, ellidagar, síðsetur,doyggja av elli;merktur av elli;elli tekur at boyggja hannaldur er fallin á hann;(tilt.)ellin kemur ikki einsamøll,sbr.mong eru ellis vomm;líva e-m við ellistytta e-m um lívið, ikki eira e-m ellina(Sv);níva við ellieldast ov tíðliga, ikki elda seg út(Sv)
elliár	elli, ellisár,á elliárum hansara
ellibrek	tað at vera ellibrekaðurel.ellifarin, ellisvamm,hann hevur mong ellibrek
ellibrekaður	viknaður av elli, ellifarin, elliveikur, ellisbrekaður,ein ellibrekað gomul genta
ellidagar	elli,á ellidøgum hansara
ellidøkkur	døkkur av elli,ellidøkk nævur
ellifarin	viknaðurel.veiklaður av elli, elli(s)brekaður,eyguni eru ellifarin
ellifólk	elligamalt fólk, ellimenni, gamalmenni, oldingi
elligamal	avgamal, ergamal, deyðgamal, fyrndargamal, ellikomin
elligráur	gráur av elli
elliheim	(sj.)ellisheim
ellihvítur	hvítur av elli
ellikambur	ellikampur
ellikampur	1húð á handarbaki sum (tá ið klípt verður í hana og togað upp) verður standandi eina løtu eins og ryggur(tí at gyrðið er farið úr henni - merki um elli)rukkur á handarbaki á gomlum fólki2uppstandandi húð á knúgvunum(Sv)
ellikomin	avgamal, elligamal,ellikomin kona
elliljótur	1(um klæði, tógv o.a.)kastaður, litfarin,plaggið var nógv slitið og elliljótt2(um fólk og lutir)ljótur av elli, elligamal, avgamal,hon er so ógvuliga elliljót og bogin;hønurnar eru so elliljótar
ellimenni	gamalmenni, ellifólk, oldingi
ellimerktur	merktur av elli, ellifarin, ellismerktur
ellinti	ellivti
ellipsa	(støddfr.)eggklingra
ellisakfar	gamalt akfar(varðveitt av áhugabólki)
ellisár	elliár,hon livdi til ellisár
ellisbrek	ellibrek
ellisbrekaður	ellibrekaður
ellisdagar	ellidagar
ellisfólk	ellifólk(Sv)
ellisgrógvin	elligamal, fornur,ellisgrógvin hugsanarháttur
ellisheim	(røktar)heim fyri gomul fólk, elliheim
ellisjón	(lækn.,lívfr.)fráskygni ið kemur við árunum(byrjar í 40-50 ára aldri)(presbyopia)
elliskambur	ellikambur
elliskampur	ellikampur
ellislag	(um fólk)slag ið verður gamalt, eldist væl,tað er ellislag
ellismaður	(elli)gamal maður
ellismerki	tekin um elli,rakdropin er ellismerki
ellismerktur	ellimerktur
ellisrenta	(gl.)peningastyrkur veittur gomlum fólki(til fólkaeftirlønin tók við)
ellisrukka	rukka ið ein fær í ellini
ellisvamm	tað at vera elliveikurel.ellibrekaður, ellibrek, aldurdómsbrek,(tilt.)mong eru ellisvomm
elliveikur	viknaður av elli, ellibrekaður
elliviknaður	viknaður av elli, elliveikur
ellivti	raðtal av ellivu, nummar ellivu
ellivu	talið 11, í rómv. tølum XIel.xi,vera sum millum ellivu og sjey(í iva)
ellubiti	1fyrstael.innasta honk 1(3) á noða,byrja noða við ellubita tvørtur um gripin á hondini;(tilt.)tað er sum úr noða aftur í ellubita(frá einum ringum til annað verri)2lítið noða, knurvali (1),hann hevur vundið bygdina upp í ein ellubita(fingið alt upp í eina fløkju)
elma	skorin akur, ekra,bundini liggja á elmuni;seta lamb á elmuna;akurin fall í elmuna(fall niður av vindi)
elri	(plfr.)elrisviður
elrisflushattur	(plfr.)slag av flushatti(Pholiota alnicola)
elrisviður	(plfr.)leyvtræ í slektiniAlnus, elri
elska	1bera ást til, vera góður við, unna, ynna, alska,elska ein(a)2(tlm.)dáma væl,eg elski rullupylsu
elskari	alskari, hjámaður
elskarinna	hjákona, frilla
elskhugi	elskhugur
elskhugur	tað at elska, alskhugur, ást, kærleiki, ástarhugur, elskhugi
elskiligur	(sj.)elskuligur;hj-liga
elskin	(Suð.)alskin,barnið er so elskið
elskuligur	alskiligur, ynniligur, yndisligur, fittur, vakur;hj-liga
elskulingur	ein sum ein er góður við, yndisbarn, alsklingur, onkabarn,elskulingur mín
elskur	(sj.)alskur
elstaráð	(átr.)ráð (2) við hægstu ábyrgd fyri trúarsamfelag
elstur	avgamal
elta1	(sj.)deiggj, kjøtdeiggj, fiskadeiggj, fiskamørur (1)
elta2	1knoða, deiggja (saman),elta tálg21gangael.vera í hølunum á (e-m),elta ein2jagstra, halda eftir, renna eftir, forfylgja,bjørnin elti okkum;(tilt.)eltir sum brugda;(um t.d. seyð)elta niðurtvekkja niður,vit eltu lambið niður(runnu eftir tí til tað legðist fyri);sbr.neyð-
eltibløðra	ein sum altíð eltir 2(2) e-nel.altíð er í hølunum á e-m
eltin	sum hevur lyndi til at elta 2(2) e-nel.vera í hølunum á e-m,eltin hvalur
elting	tað at elta 2(2), jagstran
eltingur	1(sj.)óvandur hundurel.hundahvølpur,Giljabóndin hevði flýtt Jenisi í Laðangarði ein hvølp (elting) at venja til seyðahund fyri hann2ein sum tíðum fríggjar men aldri verður giftur(Sv)
eltiskák	(talv)tað at skáka ferð eftir ferð uttan at fáa sett mát
elubiti	ellubiti
elur	síala
elv	(kvæð.)á 2, elvur,søkki eg meg í elvina niður
elva	1eggja, studla, stuðla, skora á, birta uppundir, mæla til,elva e-m til;elva tveimum samaneggja tveimum at berjast2vera atvoldin í, valda, volda, birta í, íbirta, gera,elva (e-m) nakað;elva sorg, sút, klandur, ófrið, kjak, gleði;(kvæð.)elva gleðiskemta, stuttleika, gleða;elva sár uppskræða sár upp;millum teir túsund vandar, sum stríðið elvir av sær;tað elvir nógv eftir særhevur stórar avleiðingar
elvar-	(kvæð.)álva-
elvi	1styrki, megi, máttur, alv, alvi 1,tað er elvi í honum(Sv)2(alisfr.)rakstrarmáttur, rekmáttur[da.dynamik];sbr.íelvi
elviligur	(alisfr.)máttmikil, magnandi[da.dynamisk]
elving	1tilelving, áminning, áheitan, bøn, (inn)bjóðing,elving til fund2grund, orsøk, atvold, orsaki3loynivitska, íelvi,tokkin er sprottin av bestu og heilnæmastu elvingum í huga teirra
elvur	(kvæð.)á 2, elv,sum elvur í fossinum stríða
EM	(ítr.)stytting fyrikapping um evropameistaraheiti, evropameistarakapping,vinna EM í frælsum ítrótti
emalja	glering
emaljera	glera
emaljumáling	slag av blankari máling
embar	(gl.)1stórt træílat(skorið úr heilum træ),amber2ílat nýtt til mjøl(tá ið malið var á myllu);sbr.embari
embari	(gl.)1lítið træílat(líkt dyllu men eitt sindur breiðari í neðra enn í erva)við høddu hvørjumegin og loki(onkustaðni nýtt sum barkílat og onkustaðni nýtt sum tálgarílat)2ílat havt til náttpott(lægri enn bukka),abbin gjørdi strippur, bukkur og embarar3stórt træílat líkt leypi men størri(kundi taka hálva ella heila tunnu)við holi hvørjumegin til fetilin og borið sum leypur(nýtt til at bera korn og mjøl til og frá myllu);sbr.amber,embar
embæti	starv, arbeiði, kall, ambæti(hjá tí almenna),sita í embæti;fara úr embæti;embætis vegna
embætisbróðir	starvsbróðir, starvsfelagi
embætisfólk	embætismenn,embætisfólkið í Føroyum tosaði danskt
embætisførur	sum er førur fyri at røkja embæti(Ev)
embætisgarður	(søg.)garður (5) sum hoyrdi til eitt embæti
embætishús	sethús hjá embætismanni
embætisjørð	jørð sum hoyrdi til eitt embæti,prestajørðin var embætisjørð
embætisleggald	ein ið fjeppist uppi í embætismonnumel.sum gongur upp í harranasar, fínarimpa
embætisleið	yrkisleið hjá embætismanni
embætisligur	sum er eyðkent fyri embæti, starvsligur, almennur,hann var tigandi og embætisligur
embætislækni	(lækn.)alment settur lækni(ráðgevandi og eftirlitsmyndugleiki hjá tí almenna),landslæknin er hægsti embætislækni í landinum
embætismaður	ein ið situr í (almennum) embæti
embætismannavald	vald ið verður útint av embætismonnum, embætisvald,Fuglakvæðið er yrkt um embætismannavaldið í Føroyum;sbr.skrivstovuveldi
embætisprógv	(fróðsk.)prógv frá lærdum háskúla ið krevst fyri at røkja ávíst starvel.embæti
embætisvald	embætismannavald
embætisverk	landsfyrisiting
emirur	arábiskur høvdingi
emm	heiti á bókstavinumm
emming	(veðurfr.)broyting í veðrinum, veðurskifti(Sv)
enda1	1lúka, slíta, verða liðugur við, fáa enda á,hann endaði talu sína2halda uppat, fáa enda, verða av, falla (niður),nú er kvæðið endað;brævið endaði við vinarkvøðu;tað endaðist við tað, at ...(endaði)
enda2	(um lyfti)halda (2), evna 2,eg skal enda tær eiti mítt
endaboya	(sjóm.)boya á endanum át.d.línu 1(1)el.sildagarni
endabrestur	tað at e-t endar, endi, síðsta tak, lok 1(3),hetta verður endabresturin á óveðrinum;hetta var endabresturin á bátsbandinum;hann var komin í tann aldurin, tá ið gamlir dreingir plaga at gera endabrestin
endadagur	síðsti dagurserst.deyðadagur
endafara	fara gjølla um, kanna út í æsir(Ev)
endafesti	h24(skemt.)í osb.fáa sær endafestisetast, seta seg niður,fáið tykkum endafesti!
endakíkur	(seinni) kíkur á línu,línan var sett, dreggið slept og endakíkurin koyrdur
endaknappur	(plfr.)knappur 1(4) ið sprettur úr leggendanum,móts.síðuknappur
endaknútur	1knútur á enda á bandi2endi, endabrestur,hetta verður endaknúturin á honum(hans deyði)
endakýting	(ítr.)hørð átøk móti endanum(t.d.í kappróðri)
endalangur	endilangur
endaleikur	1(ítr.)endaspæl2(flutt m.)endi, endabrestur
endaleysa	hjí osb.endaleysa langtógvuliga langt;náttin var so endaleysa long
endaleysur	1sum endar brádliga(og óvæntað);hoyterrin var so endaleysur;søgan var so endaleys2sum eingin endi er á, óendaligur, markleysur
endaligur	1sum hevur enda, avmarkaður,heimurin er endaligur2sum geldur til endans,endaligt úrslit, svar3avgjørdur, treytaleysur,sbr.óendaligur
endalína	lína á endanum á (silda)garni
endaljóð	(málfr.)ljóð síðst í orði
endaloysi	tað at vera endaleysur (2), markloysi
endalykt	1endi, niðurløga2deyði, andlát, endastund
endaløn	(búsk.)hægsta løn ið fastløntur fær(móti endanum á starvstíðini)
endamark	(bíbl.)ytsta mark, ytsti endi, útmark,frá endamarki jarðar
endamál	1mál ið ein setur sær fyri at røkka, (enda)mið, mark og mið, markmið, (til)ætlan, stevnumið, hyggja 1(2),endamál boðsins er kærleiki2(sj.,gl.)endans úrslit(av sakarmáli),endamálið var, at prestarnir mistu rættin
endamálsgrein	grein sum lýsir endamálið við lóg, sáttmála, felago.tíl.,í lógini stóð henda endamálsgrein
endamið	endamál, mið 1(2), stevnumið
endanekkur	(stb.)endabrestur,tað verður endanekkurin
endareisa	seta upp eftir enda(Ev)
endarím	(bókm.)rím síðst í ørindisreglu,sbr.stavrím,innrím
endasárur	bekksárur,tá vóru vit bæði sárhentir og endasárir
endaskil	endaligt úrslit,endaskilið er altíð tað sama
endaspurtur	(ítr.)tað at spurta í endanum á kapping
endaspæl	(ítr.)síðsti partur í kapping(til at finna vinnaran millum fremstu liðini),fýra lið eru við í endaspælinum
endasteinur	1steinur á endanum á garðlagiel.tíl.,endasteinarnir á fjørugarðinum síggjast enn2(línu)steinur á línuenda,endasteinur er við borðið(MáR Yrk.35)
endastund	deyði, endalykt, endi, andlát
endastøð	síðsta støð á farleið(t.d. á jarnbreyt)
endaúrslit	endaligt úrslit, endans úrslit
endaveggur	galvur (1), roysnisveggur
endaveitsla	veitsla hildin tá ið e-t er at enda komið(t.d.skúlagongd)
endavenda	venda upp og niður, rannvæla,áin endavendist;hann endavendi øllum í bygdini
endaørindi	síðsta ørindi í kvæðiel.yrking
endi	1evstiel.ytsti partur (av e-m),seta kaggan upp eftir enda;(um bát)spískur til endarnarskarpbygdur;úr enda í enda;fara fyri endanfara norður um oynna(og suður aftur hinumegin);fáa endarnar at røkka samanhava nóg mikið til lívsins uppihald;(flutt m.)fáa um endanfáa tað seinasta við;taka um endankoma til hjálpar;hava buktina og báðar endarnarráða øllum einsamallur;tað gongur av báðum endum(bæði spýr og skræpir);(á hosubandi)gera fyri endangera skúvel.dusk á endan, skúgva 22tog, spotti, stubbi (2),rætt mær endan(landtogið)3hann er á endanum(heldur um endan á línuniel.tognum)4tað at e-t endar, lok 1(3), niðurløga,á enda;atel.í endanum;til endansendiliga (1);gera enda á (e-m)1gera lidnan, enda 1(1)2taka lívið av (e-m), drepa,brennivínið gjørdi enda á honum;komin at enda(liðugur);mánaðin at enda;nú er endi í hendi(lítið eftir);nú sæst fyri endan(skjótt liðugur);vit fingu um endan á góðveðrinum(tað síðsta);góður, ringur, ljótur, bráður endi;endin var, at ...tað endaði við tí, at ...;hetta verður endin á mær(verður mær at bana)(eis. flutt m.),hann var við at ganga til enda, sum hann flenti(um at fara av verðini);(stb.)vera út í endavera uppslitin, orka ikki meir;sms. t.d.akur-,árs-,bak-,bendils-,borð(s)-,bríkar-,brúgvar-,bunkar-,drýl-,fitjingar-,for-,fors-,fram-,garðs-,garnar-,gras-,hamars-,klót(u)-,lands-,lín(u)-,lofts-,lort-,oyggjar-,rangar-,reips-,rót-,skers-,snøris-,sperðils-,spír-,svarð-,svørð-,tog-,torv-,út-,vatns-,veg(ar)-,viljar-
endilangur	eftir allari longdini, barðlangur,hann tveitti seg endilangan á jørðina;hann fór endilangur liggjandi(datt)
endiliga	1atel.í endanum, til endans, umsíðir, loksins2vissuliga, sanniliga, víst3iðel.í hvussu er, í øllum førum,hann er endiliga so stórur sum tú4serliga, serstakliga,veðrið hevur verið gott, endiliga seinast í mánaðinum5beinleiðis,tað illa lagið var ikki endiliga so hart og køvandi, men loyndarfult og eitrandi
ending	(málfr.)stavurel.stavir skoyttir upp í orð í bendingel.avleiðslu,í orðinum "lýsing" er "ing" ending;sbr.avleiðsluending,bendingarending,minkingarending
endleysur	(sj.)endaleysur
endloysi	(sj.)endaloysi,út í endloysið
endurbót	bati, bót, ábót, umbót, umbøting
endurbrot	(løgfr.)endurtikið lógarbrot
endurbúgva	(um óarbeiðsfør)hjálpa inn í vinnulívið aftur við at gera arbeiðsføran í øðrum yrki[da.revalidere]
endurbúgving	tað at endurbúgva
endurbøta	bøta, betra, gera aftur, væla um
endurbøting	umvæling, ábót, ábøting, uppábót
endurdoypa	doypa um aftur
endurdoypari	maður í trúarflokki ið ikki viðurkennir barnadóp[da.anabaptist]
endurdópur	(átr.)tað at endurdoypa
endurferma	ferma um, skipa um, umferma
endurferming	tað at endurferma, umferming
endurfíggja	fíggja 1 av nýggjum
endurføða	(átr.)1(um Gud)vekja til (nýtt) gudrøkið lív, umvenda2(flutt m.)føða av nýggjum, nýggja uppaftur, endurnýggja,alt trúarlívið endurføddist
endurføðing	(átr.)tað at verða endurføddur
endurgáva	endurgeving
endurgera	gera av nýggjum, endurnýggja, endurskapa
endurgerð	1tað at endurgera2beini aftur fyri gjørdan beina,(orðt.)endurgerð og viðurgerð eru longstir vinir(Sv);sbr.viðrgefendr ok endrgefndr erusk lengst vinir(Hávamál41;Maal og minne 1938153)
endurgeva	seta fram aftur í talu, skriftel.mynd (e-t lisið, hoyrtel.sæð), siga upp aftur við egnum orðum, endursiga, mynda,endurgeva eina søgu
endurgeving	tað at endurgeva, endurgáva(t.d.í orðumel.sum mynd)
endurgjald	gjald til at bøta fyri skaðael.miss, skaðabøtur, viðurgjald
endurgjalda	bøta (aftur), gjaldael.rinda aftur, endurrinda, samsýna
endurgreiðsla	endurgjald
endurholding	(átr.)endurføðing til nýtt jarðarlív;sbr.sálarferðing[da.reinkarnation]
endurhugsa	hugsa um aftur, hugsa av nýggjum
endurkasta	kasta aftur(um ljós)
endurkeyp	afturkeyp
endurleiga	leiga út aftur, framleiga
endurljóð	bergmál, afturljóð, dvørgamál
endurljóða	ljóða aftur, bergmála, gella, snjella
endurljóma	endurljóða
endurljómur	endurljóð
endurloysa	(bíbl.)frelsa 2, bjarga 2, fría
endurloysari	(bíbl.)ein ið endurloysir, frelsari, bjargari, loysnari,hin hægsti Gud var endurloysari teirra
endurloysing	(bíbl.)frelsa, bjarging, (endur)loysn
endurloysn	endurloysing
endurmenning	menning av nýggjum, endurnýggjan, endurreisn, endurføðing
endurmeting	nýmeting
endurminning	1tað at minnast (farna tíð), minni, (aftur)minning, lívsminni2endurminningarsjálvsævisøga, lívssøga(ið maður hevur sagt frá ella sjálvur skrivað)
endurmynd	avmynd, eftirmynd,ein droymd endurmynd av henni
endurnýgging	endurnýggjan
endurnýggja	1nýggja upp aftur, endurgera, endurbøta, endurføða (2), uppnýggja,tá verður tó okkara innara menniskja endurnýggjað dag frá degi(2. Kor.4,16)2taka upp aftur, endurtaka, gerael.siga aftur, koma afturum aftur
endurnýggjan	tað at endurnýggja, uppnýggjan
endurnýggjari	ein sum endurnýggjar
endurnýta	nýta gamalt umaftur
endurnýtsla	tað at endurnýta
endurprent	uppafturprentað rit
endurprenta	prenta upp aftur,bókin verður endurprentað
endurprenting	tað at prenta upp aftur, uppafturprent
endurpróvtøka	próvtøka av nýggjum
endurreisa	reisa aftur, byggja upp aftur, endurbyggja, smíðael.gera aftur, endurskipa, endurnýggja (1),endurreisa handil(shús);(flutt m.)endurreisa búskapin
endurreising	tað at endurreisa, endurreisn, afturreising, endurskipan, endurnýggjan
endurreisn	endurreising[da.renæssance]
endurrinda	rinda aftur, gjalda aftur, endurgjalda,endurrinda pening
endurrindan	tað at rinda aftur, afturrindan, afturgjald (2)
endurrit	avrit, avskrift, eftirrit, makaskjal
endurroyting	endurroytingur
endurroytingur	1(á seyði)long hár sum standa eftir tá ið roytt er,(flutt m.)hatta gjørdist endurroytingur(sagt um okkurt ið royndist illa)2seyður ið hevur long hár eftir tá ið hann er royttur,sumt seyðaslag var endurroytingur3(stb.)seyður ið ikki kastar alla ullina4(stb.)seyður ið kastar ullina um veturin5(stb.)e-t ið hevur frísut stubbut hár
endurræningur	k6(sj.,stb.)í osb. sumverða við endurræningin(við sviðusoð)
endursenda	1(útv.,sjv.)senda (sending) um aftur,endursenda morgunlesturin2(postm.)senda um aftur(t.d.e-m ið fluttur er),endursenda bræv
endursending	(útv.,sjv.)tað at senda aftur, umaftursending
endursiga	siga um aftur
endurskapa	skapa av nýggjum, taka upp aftur
endurskin	1ljós ið kastast aftur, afturskin2lutur ið kastar ljós aftur(t.d.á gangandi fólki, akfari),skyggi,nýtið endurskin í myrkri[da.refleks]
endurskinsband	band við endurskini(til at festa umt.d.ermar og brøkur við karðalási)
endurskipa	skipað av nýggjum, nýskipa, endurreisa,felagið varð endurskipað
endurskírn	(sj.)endurdópur
endurskoða	kanna (um) aftur
endurskoðan	tað at endurskoða
endurspegla	spegla aftur
endurspegling	tað at endurspeglast
endurstovna	stovna av nýggjum, endurreisa
endursøgn	(sj.)aftursøgn
endurtaka	taka upp aftur, gerael.siga aftur, endurnýggja (2)
endurtrygging	(trygg.)tað at endurtryggja
endurtryggja	(trygg.)tryggja ein (part av) váða hjá øðrum tryggingarfelag
endurtøka	tað at endurtaka, uppafturtøka
endurtøkutekn	(tónl.)tekn ið vísir endurtøku
endurval	val av nýggjum, umval,taka við endurvali
endurvarp	(útv.,sjv.)tað at endurvarpa (2)
endurvarpa	1endursenda (1)2senda longri fram um endurvarpsstøð
endurvarpsstøð	(útv.,sjv.)støð ið endurvarpar (2)
endurvinna	gera nýtt burtur úr gomlum tilfariel.burturkasti,endurvinna gamalt pappír
endurvinning	tað at endurvinna
enduryrking	(bókm.)tað at enduryrkja, umyrking
enduryrkja	(bókm.)umskrivael.týða skaldaverk listarliga
eni	(stb.)(innibyrgt) illsinni,nú er eni í honum
enn1	(kvæð.)men,enn tað frætti Ragnar kongur
enn2	(eftir miðstig)í mun til, aftur ímóti,hann er størri enn tú;betri er at vera fyrivarin enn eftirsnarur;(tilt.)tigur ikki heldur enn ritan í berginum,sítagna;(tilt.)tað er ikki oftari enn so, Páll fær røtur(um e-n ið fær e-t forkunnugt);hann vildi altíð krøkja sær meira til, enn hann átti;lítið meir enn(nóg) illa;ikki meir ennneyvan, valla;fyrr ennáðrenn, innan
enn3	(stb.)1um, hvørt,eg veit ikki, enn eg fari2hóast,hann fer ikki, enn hann verður biðin fleiri ferðir;um enn
enn4	1enntá, hvaðna, uppaftur,enn betri;tá hataðu teir hann enn meira2framleiðis, framvegis, alsamt (1),enn var stríðið ikki endað;enn verður tikið til;hon svevur enn;enn á døgum;enn sum áður;enn um sinn;ikki enn á sinniikki í bræði3aftur(at),eina ferð enn4(gl.)aftur, uppaftur, av nýggjum
enn5	heiti á bókstavinumn
enni	1fremri partur av høvdi (andliti) oman fyri eyguni, panna 2,strúka e-m um ennið2kantur út úr fjalli,Gulenni, Urðarenni;eitt enni gekk oman gjøgnum torvuna
ennibein	(lívfr.)fremri partur á skalla, brúnabein(os frontale)
ennigulur	l(fugl.)ennigul ontslag av ont(við gulum bletti millum eygnanna)(Anas penelope)
ennihola	(lívfr.)hola í ennibeini, pannuhola(sinus frontalis)
enniholubruni	(lækn.)bruni í enniholum
ennihvítur	(um ross)við hvítum bletti á enninum
enniknæ	(bát.)træ ið bindur saman æsingarnar framman og aftan, ennildiknæ, ennispónsknæ, æsingaknæ
ennildiknæ	(stb.)enniknæ
ennildispónur	(stb.)ennispónur
ennisband	band um ennið(t.d. til prýðis)
ennisbrattur	við brøttum enni
ennisbreiður	við breiðum enni(Ev)
ennisfattur	(kvæð.)við føttum enni
ennisknæ	enniknæ
ennislað	lað (5) borið á enni, ennisprýði[da.diadem]
ennislágur	við lágum enni
ennispónsknæ	(sj.)enniknæ
ennispónur	(bát.)lítið tríhyrnt træ (til prýðis) innantil á stavninum(oman á enniknænum),ennildispónur
enntá1	tó at, hóast, sjálvt um, enntó,hann hevði verið eina tíð í Dali, enntá hann var vaksin upp á Nesi;væl gekst at fáa hann til hús, enntá lærleggurin var brotin
enntá2	1enn, hvaðna, uppaftur,enntá betri2eisini,enntá bygdina tóktist hann at hava gloymt
enntó	(kvæð.)tó at, hóast, enntá 1,enntó hon er ein kvinna
enska	(kvæð.)enskt mál,illa líkar Haraldi kongi, at hann ikki ensku kunni
enskur	íel.úr Onglandi, eingilskur,ensktenskt mál, eingilskt(mál í Onglandi, Norðurameriku og víðari),enskt er heimsmál
enta	(Sa.)ønta,hon entir ikki aftur
entur	síont
epa	(sj.,kvæð.)øpa
epistul	(kirkj.)brot úr ápostulsbrævi(lisið við gudstænastu),epistulin skrivar Pætur ápostul í seinna brævi sínum ...
epl	(Suð.)epli
eplabing	eplakrubba
eplablað	blað á eplaslokki
eplablomstur	blomstur á eplaslokki
eplabløðka	eplaslokkur í næling,eplabløðkurnar komu uppundan;sbr.bløðka 2
eplabøur	bøur til eplaveltingar,betri eplabøur í Víkarbyrgi enn í Sunnbø
epladáli	dáli (2) skorin av epli,stundum lótu tey brent lekjast undir epladálum(RKR Heimaráð97)
epladeild	(Suð.)(smøl) eplavelta
epladøttur	lítil eplasekkur
eplaertur	pinkulítið epli, eplaperla, ertur (3), perla 1(4)
eplaflus	flus (1) av epli
eplaflykra	tunn flís av epli kókað í olju[en.potato chip]
eplaflysari	amboð at flysa epli við
eplafrukt	eplagrøði, eplisfrukt,góð eplafrukt;sbr.frukt (1)
eplagoymsla	goymsla til epli, eplahol, eplabing
eplagrøði	úrtøka av eplum, eplafrukt,eplagrøðin var misjøvn;sbr.grøði
eplahaki	(Sørv.)lítil haki(við ongum grevi og stuttum skafti)at taka upp epli við(serst. í sandi)
eplahol	hol í moldel.sandi at goyma epli í, eplagoymsla, eplarhol
eplahús	1lítið hús av gróti og flag (el.stoypt) til at goyma epli í, eplishús2(stb.)eplakrubba
eplakassi	kassi til at goyma (set)epli í, eplatrog
eplakovi	kovi at goyma epli í;sbr.torvkovi
eplakrubba	avskildrað rúm til at goyma epli í, eplabing
eplakúgv	(skemt.)í osb. sumhon er ein eplakúgv(um konu ið dámar væl epli)
eplakvísl	kvísl at taka upp epli við
eplaleypur	leypur at bera epli í
eplamamma	gamalt rotið setepli(tá ið tikið verður upp um heystið),omma 1(3), mamma (2), eplamomma, mommuepl, móða 2, móðurepli, botnepli, skrukka 1(4)
eplamatur	matur úr eplum
eplamjøl	stívilsi gjørt úr eplum, eplismjøl
eplamold	mold at velta epli í,góð, ring eplamold
eplamomma	(Suð.)eplamamma
eplamorl	morlað kókað epli(mjólk, smør o.a. latið útí)
eplamunni	eyga (5) á epli, munni (3)
eplanál	nál (spíra) á setepli, eplaspíri
eplaneyð	trot á eplum,ofta var eplaneyð, áðrenn upp aftur kundi takast av nýggjum
eplaperla	(stb.)eplaertur, perla 1(4), knas (3)
eplapláss	pláss hóskandi til eplavelting,góð eplapláss eru í Føroyum
eplaposi	posi við eplum, eplasekkur
eplapottur	pottur at kóka epli í
eplareyv	endi á setepli(har sum eyguni ikki eru);sbr.reyv (5)
eplarhol	(stb.)eplahol
eplaryggur	ryggur (5) í eplaveltu
eplasalat	salat av eplum
eplasandur	sandur at velta epli í,sbr.sandepli
eplasekkur	sekkur við eplum, eplaposi
eplasjúka	sjúka í eplum;sbr.eplaspilla,svartaspilla
eplaskal	skal 1 uttan á epli;sbr.eplaflus
eplaskiljing	tað at skilja epli
eplaskrubb	(plfr.)skrubb (3)
eplaslag	slag av eplum
eplaslokkur	slokkur á eplum, eplavísi;sbr.eplastelkur,einvaksin,yvirvøkstur
eplasneis	sneis at taka upp epli við
eplasnórur	snórur við tveimum (alnarlongum) hælum nýttur tá ið epli verða sett niður(so at reglurnar verða beinar)
eplasoð	soð sum epli eru kókað í,eplasoð er gott fyri gikt
eplaspann	spann við eplum
eplaspilla	spilla í eplum;sbr.eplasjúka,svartaspilla
eplaspíri	eplanál
eplastelkur	eplaslokkur(umframt bløðini)
eplastykki	eplavelta
eplasuppa	eplasúpan
eplasúpan	súpan gjørd av eplum, eplasuppa
eplateigur	lítil eplavelta
eplatíð	tíð (á árinum) tá ið epli verða niðursett,í bestu eplatíð
eplatrog	(sj.)eplakassi
eplatunna	tunna við eplum
eplatøð	tøð undir epli
eplavatn	soð sum epli eru kókað í, eplasoð(varð givið barnakonum at drekka fyri verkir)
eplaveður	gott veður at seta niðurel.taka upp epli
eplavelta	velta við eplum, epladeild
eplavelting	tað at velta epli
eplaveltur	(um bø)sum epli hava verið velt í,kornveltur bøur er reingrøsutari enn hin eplavelti
eplavísi	(Suð.)eplaslokkur, vísi 1(1)
eplaær	ær sum er ørg at ganga í eplaveltur
epli	1(plfr.)etandi leggkýli á eplaslokki(undir jørð),jørðepli(Solanum tuberosum)2(kvæð.,bíbl.)súrepli,bóndin fór á skógvin burt epli og aldin at finna;sms. t.d.át-,etingar-,fræ-,gull-,jørð-,mat-,mold-,móður-,sand-,set-,súr-,topp-,vetrar-,villepl
eplibing	(stb.)eplabing
eplisfrukt	(gl.)eplafrukt
eplishús	(gl.)eplahús
eplismjøl	(gl.)eplamjøl
eplisong	velta eftir at eplini eru upptikin;sbr.opinekra
eplutur	(seyðal.)ljósur við smáum dimmum blettum,eplutur seyður;eplut skinn
er	sívera 2
erbylgja	(alisfr.)ravsigulbylgja við bylgjulongd millum 1 og 100 mm[en.microwave]
erbylgjuovnur	mikroovnur
erfínur	ógvuliga fínur, ørfínur,erfínur tráður;erfínt garn(til vevnað),erfín nál
erfornur	(stb.)(um bø)sum hevur ligið óveltur í langa tíð, húðfornur, úrfornur, útfornur,bøurin er slættur og góður, men erfornur
erga	(stb.)ørga
ergamal	(Sa.)ógvuliga gamal, avgamal, elligamal,tað er ergamalt, at ...
erji	(óregl.)->eyrriði
erka-	erki-
erkibiskupur	ovasti biskupur(serst. í katólskum londum)
erkieingil	høvuðseingil, yvireingil
erkistólur	(søg.)embæti hjá erkibiskupi
erkvisin	sum lítið tolir av (pínu), smásárur, eymur (2), viðbrekin, ørkvisin
erkvisni	tað at vera erkvisin, smásæri
erkymla	(stb.)ørkymla
erla	(fugl.)smáfuglur í slektiniMotacilla,erla kongsdóttir(M. alba)
erlamin	(Sa.)ógvuliga lamin, deyðlamin, ørlamin
erligur	ærligur;hj-liga
erljótur	(Sa.)stak ljótur, grimur (í andliti),hann er so erljótur
erma	partur av plaggi sum klæðir armin, ermi,langar, stuttar ermar;sms. t.d.troyggju-
ermagap	op har ið erma verður seymað føst í bulin (4)el.op fyri armi í ermaleysum plaggit.d.vesti, ermahol, ermagat,hevur tú bundið allan bulin í einum og so klipt ermagapið upp?
ermagat	op har ið ermi verður seymað fast í bulinel.op fyri armi í ermaleysum plaggit.d.vesti, ermahol
ermahaldari	gyrðið bandel.tíl.til at forða (ov langari) ermi at glíða niður
ermahol	ermagat
ermaleysur	við ongum ermum,ermaleyst kot
Ermarsund	(stn.)sundið ímillum Onglands og Fraklands
ermastuttur	við stuttum ermum
-ermdur	síein-,lang-
ermi	erma
ermøri	(um seyð, sj. um fólk)ómegd av megurð, úrmøri, ørmøri, óplikt,ermøri er komið í seyðin
ernast	livna upp, hivna upp, pretnast upp, lívgast upp, upplíva, erpnast upp,hon ernaðist upp;nú var hann ernaður
erni	tað at vera errin, errinskapur, stoltleiki, stórlæti, erpni, erpinskapur
-erni	sífógv-
erpa	s30í osb.erpa særgera seg upp, hóreiggja sær, royva sær, bretta sær,erpa sær av e-mbreggja sær av e-m
erpikjaftur	(stb.)reypari, skrøggari,tað var ein erpikjaftur
erpin	sum erpir sær, errin, brettin, brestin, brasin, hástórur, stoltur, nakkhyrntur,erpið sum ein fútakráka
erpinskapur	errinskapur
erpiskítur	(niðr.)ein ið er erpin;sbr.fútakráka
erpisligur	(heldur enn ikki) erpin,erpisligur í atferð;hon var erpislig á málinum;hj-liga
erpnast	s74(stb.)erpnast uppernast
erpni	tað at vera erpin, errinskapur, stoltleiki, stórlæti
err1	heiti á bókstavinumr
err2	(kvæð.)arr 1, ør,eg beri her errið enn
erra	s30:erra uppstimbra, styrkja, kveikja, geva dirvi;erra seg upptaka sær um reiggj, herða seg upp, spenna seg út;erra særerpa sær, gera seg upp, hóreiggja sær, royva sær;erra sær ábreiða seg;errasternast
errin	brettin, erpin, hástórur, stoltur,errin sum lundi;hann var góður við mammu sína og errin av henni
errinskapur	erpni, erpinskapur, stórlæti, dramblæti
errisligur	erpin, errin, hástórur, hugstórur, dramblátur, erpisligur;hj-liga
ersmáur	(stb.)ógvuliga smáur, evarssmáur, ørsmáur
erta	arga,erta samanfáa saman at berjast
ertari	ein ið altíð ertir, mannreitingur, argapisa (1)(Ev)
ertin	ertingarsamur
erting	tað at erta, arging
ertingarsamur	argingarsamur, reitingarsamur, neitutur, ertisamur
ertisamur	ertingarsamur(Ev)
ertnabjølgur	ertnahamur
ertnablóma	(plfr.)blóma av ertnablómuættini
ertnablómuætt	(plfr.)ætt av hulfræingum ið eru tvínælingar(Fabaceae)
ertnabúkur	ertnakíkur(Ev)
ertnahamur	(plfr.)hamurel.skal um ertrar, ertnabjølgur
ertnakíkur	ein ið dámar væl ertur (1), ertnabúkur
ertnastampur	stampur við erturel.ertnasúpan,Esav seldi sín frumburðarrætt fyri ein ertnastamp
ertnasúpan	súpan av kjøti og ertrum
ertur	1fræ í slektiniPisumnýtt til matna2ertnasúpan3pinkulítið epli, gásarepli, eygnasteinur (4);sms.grøn-
erur	(gl.,Sa.)ørur
-erva	síov-
erva1	arva
erva2	í osb. sumí ervaí ovarael.ovasta parti (á e-m), omantil, omanfyri, (ovast) uppi, uppiyvir, ovast(ur);fara niðan í erva;ærin gekk í erva(ovarlaga);fara upp í erva(upp í tróðrið);vaska uppi í erva(tróðrið);úr ervaomanífrá;áirnar skruddu við sær grót oman úr erva(oman úr fjøllunum);tekur stavin niður úr erva(av loftsbitunum);í erva luta(gl.)í kvøld
ervaberg	ovasti partur av fuglabergi
ervabit	bit í erva (hjá seyði);sbr.ervahagi
ervaboð	boð úr erva, fyriskipan(frá einum sum yvir er)
ervabreddi	breddi ovast(á blaðsíðu)
ervað	(skaldsk.)stríð, strev,í ervaði
ervafylgi	seyðafylgi ið gongur á ervabitiel.sum gongur í erva,móts.neðrafylgi
ervahagi	hagi í erva;sbr.undirhagi,yvirhagi
ervakavi	kavi í fjøllunum
ervakrógv	(stb.)torvkrógv ovarlaga í haganum,turrur vindur og sól, gott fyri ervakráir
ervalamb	lamb ið liggur á ervahaga, fjallalamb,móts.bakkalamb
ervaleysur	(sj.)við ongum ervi,pápin fór ervaleysur í grøvina
ervaljós	(í rúmi)ljós íel.úr erva
ervamikil	uppmikil
ervamjørki	mjørki í fjøllunum
ervarók	rók í erva,kavin liggur oman í ervarøkurnar
ervaseyður	seyður sum gongur í erva,móts.neðraseyður
ervasjógvur	sjógvur næst vatnskorpuni
ervaær	ær ið gongur ovarlaga í haganum
ervi	samkoma eftir jarðarferð,drekka ervi
ervingaleysur	(gl.)við ongum ervingum,hon doyði ervingaleys
ervingi	arvingi
ervingur	ervingi,ongan erving eigur hann
ervisrugur	(gl.)rugur til matna í ervi,nú er lítið eftir uttan at mala ervisrugin
ervisseyður	seyður til matna í ervi
ES	stytting fyriEvropasamveldið
ES-grundlóg	grundlóg galdandi fyri øll londini í ES
esil	(dj.)asni, ásin
esilshøvd	(skip.)dupultur stálhólkur ið bindur saman mastur og toppstong(annar hólkurin smoygdur niður á mastrartoppin, toppstongin stungin upp ígjøgnum hin),mastrarhøvd
esja	1(um bleytt skarn)gera 2(1), rotna, orra, rúka illa, deyma, dampa, stinka,køsturin stóð allur og esjaði í summarhitanum;esjandi opnar rennur2dýggja, disja,tað esjar undir fótunum - tað er ein kelda
esjan	1tað at esja (1)2ringur roykur, deymur, rotroykur
eskja	lítil kassiel.ílat við loki(av træ, pappi, blikkio.tíl.),dós, kistil(til at goyma smálutir í);sms. t.d.blikk-,papp-,svávul-
ES-krav	krav sum ES setur(sínum samstarvsfeløgum),fiskavirkir skulu lúka ávís ES-krøv
ES-limaskapur	limaskapur í ES
esmaður	heksmaður(Sv)
esmæli	(óregl.)->eygsmæli
esp	(plfr.)øsp
espingur	(kvæð.)lítil bátur;eis.hespingur
ess1	(kortsp.)kortablað(vanl. við hægsta virði);sms.hjartar-,kleyvar-,rútar-,spaðar-
ess2	heiti á bókstavinums,ikki kenna ess (s) fyri ká (k)ikki duga at lesa
ess3	h(tilt.)í osb.vera í essinumvera væl fyri, væl útborin, væl hýrdur
ES-samstarv	samstarv millum lond ið eru limir í ESel.samstarv sum land uttan fyri ES hevur við landel.lond í ES
esti	estlendingur
estiskur	estlendskur
Estland	land í Evropa
estlendingur	fólk íel.úr Estlandi, esti
estlendskur	íel.úr Estlandi, estiskur
eta	taka føði til sín, fáa sær, munnbera seg,eta døgurða;eta seg mettan;eta hold á seg(fitna);(tilt.)hava etið meir, enn ein hevur spurtel.hoyrt(vita lítið);(tilt.)vilja eta e-n undir eygunivera óður inn á e-n;(tilt.)eta við framtonnunumeta við ongum matarlysti;eta orð síni aftur í segtaka aftur orð síni;hann etur ælingin aftur í seg,síælingur;(tilt.)tað etur ongan mat,símaturviðfs/hjeta av sær1(um seyð)eta ullina av sær2(um neyt)eta seilina tvørturav;eta burtur undan særnýta meir enn ein eigurt.d.av peningi;eta niður í seg(okkurt skaðiligt);eta niðurfyrieta nógv frammanundan(tá ið ein veit at hann ikki fær at eta aftur í bræði),eta seg mettan(til at halda leingi á);sbr.framstoytur;eta uppeta til einki er eftir, súlundaeta seg inn á e-ngera seg inn á e-n, plága, troka seg inn á e-n,hugsanin át seg inn á hann;eta seg inn í e-t(etja, tæra);áin etur seg inn undir bakkanmáar;ikki eta seg undan nagliikki lata tað síðsta ein eigur;sms. t.d.kapp-,ov-,oyð-,stór-
etandi	sum kann etast, munnbærur,tað er (ikki, illa) etandi;hj(áherðandi)etandi fullurel.etandidýrandi fullur, deyðadrukkin;púra etandi einkials einki
etanol	(evnafr.)vanligt alkohol(teknC2H5OH)
etikkur	læra um siðalag,menniskjað skal ikki lata seg taka av fótum av sínum kenslum er í stuttum etikkurin hjá Spinoza
etikur	edikur
-etin	síav-,fugl-,mús-,møl-,ó-,rottu-
eting	tað at eta, át, matarát
etingaramboð	amboð at eta viðt.d.knívur og gaffil, matamboð
etingarepli	epli at eta, átepli,móts.setepli
etingarólag	felagsheiti fyri sálarsjúkur ið hava skaðiliga ávirkan á matarlyst og matvanar(serst.um matstikni og matfýsni);etingarólag sipar til, at antin verður etið lítið og einki, ella verður ovuretið fyri so at spýggja aftaná
etiskur	viðv. etikki, í samsvari við etikkin,etiskir spurningar;á stevnuni verða etiskir spurningar reistir í sambandi við arvagransking, eins og krøv til lóggávu verða tikin upp
etja	(evnafr.)tæra,etjandi evni[da.ætse]
etjing	1tað at etja2mynd gjørd við etjing[da.radering]
etliga	sbr.eydliga
etur1	(evnafr.)loftkvæmur løgur(m.a. nýttur til doyvingar, tekn(C2H5)2O)
etur2	húðsjúka hjá neytiel.rossi(ger at ullin fer av)
etylalkohol	(evnafr.)etanol
Europa	Evropa
europeari	evropeari
europeiskur	evropeiskur
evangelii	(bíbl.)evangelium
evangeliskur	(bíbl.)samsvarandi Jesu læru í teimum fýra evangeliunum
evangelistur	(bíbl.)evangeliumshøvundur,evangelistarnir Matteus, Markus, Lukas og Jóhannes
evangelium	(bíbl.)1fagnaðarboðskapur, gleðiboðskapur, gleðiboð2boðskapur um Guds ríki og Jesus sum frelsara, hin kristni boðskapurin,boða evangeliið3eitt av teimum fýra fyrstu skriftunum í Nýggja testamenti(sum greiðir frá Jesu lívi og gerningum),evangeliið eftir Lukas4brot úr evangelii (3)(lisið við gudstænastu),hetta heilaga evangeliið skrivar Markus evangelistur
evars	hjí osb. sumevars tunnur, smáur(ógvuliga, sera, ovurhonds, avbæra)
evarska	evars,evarska lítil
E-vitamin	(evnafr.)1h3evitamin ið loysist í feitti(serst. í grønum plantum, hveitispírum og mjólk, hevur týdning fyri nøringina)2kv2tablett av E-vitamini (1)
evja1	1vát og bleyt moldo.tíl., runa, móra, marra2botnfallið skarnt.d.í rottanga
evja2	s30í osb.ganga og evjakoma sær upp í, leggja seg út í líkt og ólíkt(Ev);evjast uppverða til evju,tað regnaði alsamt, alt evjaðist upp;evjandi royðableyt og vát royða
evjudíki	evjut díki, runudíki, skarndíki, keksi (3),bøur og hagi vóru svartir sum eitt einasta evjudíki
evjutur	við nógvari evju 1(1), díkjutur, runutur, fenjutur
evla	(stb.)elva,evla ikki til klandur
evli	elvi(Sv)
evna1	1gera, virka, skapa, smíða, mynda,evna til2megna, orka, vera førur fyri,hann evnaði ikki at bjarga sær
evna2	(kvæð.,bíbl.)(um lyfti)halda (2), enda 2,evna heiti;kongurin evndi lyfti sítt
evnabroyting	(lívfr.)evnaskifti
evnaður	1hóskandi, nýtiligur,jørðin var væl evnað til kornvelting2við góðum gávum, gávuríkur (1), vitigur,hon er so væl evnað
evnafrøði	(evnafr.)vísindi um frumevni og sambond teirra, kemi;sbr.alisfrøði;sms.jarð-
evnafrøðiligur	(evnafr.)viðv. evnafrøði, evnisligur (2);hj-liga
evnafrøðingur	(evnafr.)ein ið er lærdur í evnafrøði
evnagóður	1múgvin, múgvandi, fíggjaður, ríkur,móts.evnaleysur2við góðum (andligum) evnum, evnaligur (1), evnaður (2), evnaríkur, gávaður,børnini vóru evnagóð bæði til sál og likam3evnaligur (2)
evnaheimur	tann veruligi heimurin, evnisheimur,liggur ikki sektin á, hvørt evnaheimurin er eitt sindur størri ella eitt sindur minni
evnaleysur	fátækur, armur 2(1), armóðsligur (1),móts.evnagóður (1)(Ev)
evnaligur	1við góðum andligum evnum, gávuríkur,evnaligur unglingi2við góðum (likams)evnum, evnisligur, menniligur,evnaligir menn3úr góðum evni (1), haldgóður, dygdargóður, sterkur (2),evnalig ár;bátarnir vóru úr evnaligum viði
evnalítil	við lítlum evnum (4), orkulítil, veikur, ódugnaligur,evnalítil drongur
evnaloysi	vantandi evni (4), ómagaskapur
evnaríkur	1evnagóður (2), vitigur, gávaður, gávuríkur2evnaligur (3)
evnasamband	(evnafr.)samband millum tveyel.fleiri frumevni
evnaskifti	(lívfr.)evnafrøðiligar tilgongdir ið umbroyta føðina í likaminum, evnabroyting(metabolia)
evnasøla	tað at selja evnavørur
evnaveikur	andliga ófullførur
evnaverkfrøðingur	verkfrøðingur serkønur í evnafrøði
evni	1e-t sum e-t er gjørt av, tilfar, atfeingi,knørrur varð bygdur á Noregslandi, gott var í honum evni2einel.e-t sum (ætlandi) verður til e-t(serst. í sms.)kongsevni, mansevni3tað ið viðgjørtel.umrøtt verður í taluel.skrift, tað ið søga, yrkingo.tíl.er um, innihald,siðsøguligt evni4máttur, førleiki, orka, styrki,evni hevur hann sum bjørn;(tá ið) best um evni(ni) stendurtá ið harðast leikar á, tá ið mest ræður um, tá ið á stendur;tá ið best um evni stóð, slitnaðu teymarnir hjá honum5(evnafr.)frumevniel.evnasamband, tilfar,bakteriutýnandi evni6rúsevni7fltráð, fíggjarorka,hava evni til e-t8(andligar) gávur,hann hevur eingi evni9(stb.)(vánaligur) kyllingur,tað verður at hoyggja upp í evni;sms. t.d.aðal-,arbeiðs-,brenni-,eggjahvíta-,eitur-,fiti-,fóður-,frum-,føði-,føðslu-,grund-,grøði-,hald-,heilsubótar-,høvuðs-,ímyndingar-,javningar-,kálk-,klandurs-,kol-,kongs-,krops-,kvíggj-,køvi-,likams-,lit-,lívs-,lut-,mál(s)-,mans-,nøringar-,rá-,samrøðu-,skaða-,spreingi-,stíl-,stríðs-,súr-,trætu-,turr-,tvátt-,umtals-,val-,vatn-,verk-,yrkis-
evning	1tað at evna 1(1), tilevning (1), tilskapan(Ev)2(skúl.)lærugrein ít.d.tekning, pappírsklippi og leiri, tilevning (2)
evningartími	(skúl.)skúlatími við evning (2) sum lærugrein
evningarvoks	mjúkt voks til at evna myndir og skap burturúr[da.modellervoks]
evnisbroyting	(lívfr.)evnabroyting, evnaskifti
evnisbundin	sum viðvíkur evni (1), evnisligur (1), tilfarsligur,evnisbundin siðmenning, sjónarmið[da.materiel]
evnisdagur	(skúl.)dagur tá ið ávíst evni verður tikið til viðgerðar
evnisfang	evni (1), tilfar, atfeingi,rætturin hevði ikki nóg mikið evnisfang í hondum til at døma hann
evnisfastur	væl gjørdur, væl samansettur,greinirnar vóru evnisfastar
evnisheimur	evnaheimur,tað illa, bæði í evnisheimi og í siðalag
evnisligur	1evnisbundin2evnafrøðiligur3evnaligur (1)(Sv);hj-liga
evnismál	evnisbundið mál 1(7), evnisbundin viðurskifti,eingin framgongd í evnismálum
evnismegn	(alisfr.)evnisnøgd, evnistyngd
evnismentan	evnislig (1) mentan
evnismikil	sum hevur nógv evniel.innihald,evnismikil bók
evnismisnýtari	fólk ið misnýtir rúsevni
evnismongd	(evnafr.,alisfr.)mongd av e-m evni(mátað í mol)[da.stofmængde]
evnismótstøða	(alisfr.)mótstøða í leiðara (3) sum er 1 mm2 í tvørmáti og 1 m langur[da.resistivitet]
evnisnøgd	1(alisfr.)tað sum 1 cm3 av einum evni vigar í g, evnismegn, evnistyngd,vatn hevur evnisnøgdina 1 g/cm3[da.massefylde]2(evnafr.)tal av molum[da.stofmængde]
evnisogn	verðslig ogn
evnissamur	lutligur
evnisskifti	(lívfr.)evnaskifti
evnisskipan	skipan av evni (í bók)
evnisskrá	yvirlit yvir evni(t.d. í bók)
evnisstílur	(skúl.)stílur (2) um ávíst evni við støði í uppgivnum teksti (el.tekstum)
evnistyngd	(alisfr.)evnisnøgd
evnisval	(skúl.)tað at velja evni (3)
evnisvágur	(lækn.)slag av heilivági,eingin evnisvágur rínur á virusi(kemoterapeutikum)
evnisvika	(skúl.)vika tá ið ávíst evni verður tikið til viðgerðar
evnisyvirlit	yvirlit yvir evni(t.d. í bók)
evra1	í osb.í evraí erva 2(Sv)
evra2	(búsk.)felags evropeisk mynteind í Evropasamveldinum(nýtilig sum gjaldoyra frá 2002)
evri	ovari, hægri
Evropa	ein av heimspørtunum
Evropasamveldið	(búsk.)politiskur og búskaparligur felagsskapur millum lond í Evropa, ES
evropeari	fólk íel.úr Evropa
evropeiskur	íel.úr Evropa, evropiskur
evropiskur	evropeiskur
evstaljóð	(alisfr.)ljóð við sera høgari tídd[da.ultralyd]
evstamark	evstael.seinasta freist[en.deadline]
evstur	1ovastur, hægstur2síðstur, seinastur,á evsta degiá dómadegi;áel.í evstutil endans, at enda, endiliga (1);í evstu stund;hjevst1ovast, hægst2síðst, seinast
evurklænur	sera klænur
evurlítil	evars(ka) lítil, elalítil, pinkulítil, ørlítil, evurslítil,eina evurlítla løtu
evurslítil	evurlítil
evursmáur	ersmáur, ørsmáur, evurssmáur
evurspinkulítil	evars(ka) pinkulítil, elalítil
evurssmáur	evursmáur
ey1	tvíljóðsstavir (nevndir[ɛi])
ey2	sbr.hey
eya	sbr.eyeyameg
eydliga	etliga
eydmjúkur	eyðmjúkur
eydmýkja	eyðmýkja
eydmýkt	eyðmýkt
eydna	1tað sum er ætlaðel.ílagað, lagna, forlag 2, skepna (3),ymiss er mansins eydna2góð lagna, lukka (1), hepni, happ (1),hava eydnuna við særvera heppin;sms. t.d.barna-,fiski-,fólka-,lívs-,mat-,mis-,neyta-,ó-,seyða-
eydnast	hepnast, lukkast, bera til, berael.ganga í lag,móts.miseydnast,alt eydnaðist væl fyri henni
eydni	eydna (2)(Sv)
eydnisdagur	eydnudagur
eydnisfullur	eydnusamur,hann var so eydnisfullur
eydnisgóður	eydnugóður, heppin,hann hevði verið við eydnisgóðum skipi
eydnisligur	eydnuligur
eydnismaður	eydnumaður, lukkumaður,eydnismaður, í máltíð kemur
eydnismikil	eydnumikil
eydnuberandi	sum berel.gevur eydnu, happadrúgvur,gott og eydnuberandi nýggjár
eydnuborin	eydnuríkur,sjáldan verður hann eydnuborin, ið sinni hevur av trælli
eydnudagur	dagur tá ið ein hevur eydnuna við sær, eydnusælur dagur, eydnisdagur
eydnudís	guddómlig vera, Gad,men tit, sum ... reiða borð fyri eydnudísini(Jes.65,11)
eydnudrúgvur	eydnuríkur, happadrúgvur
eydnugóður	eydnuríkur
eydnugripur	eydnuberandi gripur, verndargripur, eydnulutur
eydnuhjól	hjól við tølum á ið verður malið til at finna vinnaran í eydnuspæli
eydnuleikur	eydnuspæl,fiskivinnan er eydnuleikur
eydnuleysur	sum ikki hevur eydnuna við sær, ólukkuligur, óskepnuligur, vansælur
eydnuligur	eydnuríkur, eydnisligur
eydnuloysi	tað at vera eydnuleysur
eydnulutur	eydnugripur
eydnumaður	eydnuríkur maður, eydnismaður, lukkumaður,eydnumaður ert tú, væl var týtt, og væl var miðið funnið
eydnumikil	eydnuríkur, eydnismikil, heppin
eydnuríkur	sum hevur eydnuna við sær, eyðin (1), eydnusamur, eydnuborin, lukkuligur
eydnusamur	eydnuríkur
eydnuspæl	spæl har ið tilvildin ræður fyri úrslitinum, lukkuspæl, eydnuleikur, happadráttur
eydnusæla	tað at vera eydnusælur, lukkusæla
eydnusælur	eydnuríkur, lukkusælur
eydnutal	tal ið hildið verður at bera eydnu við sær,7 var eydnutal hennara
eydnuynski	ynski um eydnu (2), lukkuynski, góðynski
eyð	hjí osb.eyð so gottí so gott, fult so gott;eyð veri taðtað er sjálvandi, tað er (so) vitiligt
eyðátin	(um mat)átuligur, matligur (2)(Sv)
eyðbiðin	lættur at biðja
eyðborin	lættur at bera
eyðboygdur	lættur at boyggja
eyðbrotin	lættur at bróta
eyðbýttur	lættur at býta,har var eyðbýtt
eyðfimur	ógvuliga fimur,lættur og eyðfimur
eyðfingin	lættur at fáa,móts.vandfingin,klæði og føði vóru teimum eyðfingnir lutir
eyðfittur	(sj.)sera fittur, dygdargóður,ein ógvuliga eyðfittur bátur
eyðfunnin	1lættur at finna,móts.vandfunnin,miðið er eyðfunnið2eyðskildur,hatta mátti verið eyðfunnið
eyðførur	1(um bát)lættur undir árini, lættur at taka av lunni, kimiligur, vegligur (2),eyðført tíggjumannafar2(um amboð)lættur at handfara, fimsligur (2), smidligur (1), viðførligur,líggin er so eyðførur
eyðgitt	lætt at gita,tað er eyðgitt
eyðgjørdur	lættur at gera, lættgjørdur,tað er eyðgjørt
eyðgongdur	lættur at ganga, lættgongdur (2),har er eyðgongt
eyðgreiddur	lættur at greiða
eyðhoyrdur	lættur at hoyra,tað var eyðhoyrt, at ...
eyðhugsaður	rætt hugsaður(Sv)
eyðin	1sum hevur eydnuna (2) við sær, heppin, eydnuborin,fær maður kalva, verður sagt: tú vart eyðin2(kvæð.)eyðið:verður tær tess eyðiðfellur tað tær í lut, lutast tað tær, er tað tær lagað
eyðkanna	(stb.)velja burtur úr, vera áfallin við,hon eyðkannaði fólk
eyðkendur	lættur at kenna, eyðkenniligur, sermerktur, serkendur,(orðt.)eyðkendur er úlvur í roði(fáur fær fjalt sína sonnu muru)(Sv)
eyðkenna	vera eyðkendur fyri, sermerkja,eyðkenna e-n;dømið er eyðkennandi
eyðkenni	eyðkent merki (6), sermerki, eyðkennisskapur, kenningarmerki (2);sms. t.d.aðal-,einstaklings-,lyndis-,ser-,sjúku-,tjóðar-
eyðkenniligur	eyðkendur;hj-liga
eyðkenningur	bólkurel.slag við ávísum sereyðkennum,sjónleikurin lýsir ymisk føroysk viðurskifti eins og tveir eyðkenningar: politikaran og ídnaðarmannin
eyðkennisbúni	klædnabúni hjá fólki í sama yrki, bólki o.s.fr., serbúni, búni (2)
eyðkennislag	(t.d. í útvarpi)lag(stubbi) ið altíð ljóðar undan tátti av ávísum slag(t.d.undan útvarpstíðindum)
eyðkennisnavn	navnliður(oftast fremst)ið eyðkennirel.lýsir høvuðsnavniðí navninum Nólsoyar-Páll er Nólsoyar eyðkennisnavn;
eyðkennisskapur	eyðkenni
eyðkeyptur	lættur at keypa(Ev)
eyðkvæmi	(lækn.)virussjúka sum týnir órinsverjuna í kroppinum(AIDS)
eyðkvæmislinja	telefonupplýsing um eyðkvæmi
eyðlind	ríkidømiskelda,tær fornu eyðlindir fólksins(t.e. kvæðini og dansurin)
eyðlisin	lættur at lesa, lættlisin,móts.torlisin,eyðlisin bók
eyðlýsa	(sj.)lýsa við serstøkum eyðkennum(t.d. mann ið løgregla lýsir eftir)
eyðlýsing	tað at eyðlýsa[da.signalement]
eyðlýstur	lættur at lýsa 2(6)
eyðmerking	tað at eyðmerkja
eyðmerkja	gera avel.sanna hvør ein er, bera kensl á[da.identificere]
eyðmintur	lættur at minnast
eyðmjúkleiki	(bíbl.)eyðmýkt
eyðmjúkligur	(heldur) eyðmjúkur;hj-liga
eyðmjúkur	sum setur seg sjálvan lágt, lítillátin, lítillát(að)ur, eyðmjúkligur,boygdi eyðmjúkur høvur
eyðmýking	tað at eyðmýkja, mannminkan, illkennan
eyðmýkja	fáa e-n at kenna seg lítlan, gera eyðmjúkan, gera (e-m) mannminkan,eyðmýkja seg (fyri e-m)
eyðmýkt	(bíbl.)tað at vera eyðmjúkur, lítillæti, eyðmjúkleiki,eyðmýkt gongur undan æru
eyðnýttur	eyðtøkur
eyðnæmur	1lættur at læra (uttanat),tað er eyðnæmt2ógvuliga næmur, lærufúsur, flognæmur
eyðræna	ræna til einki er eftir, ama út, mergsúgva, blóðræna (3)
eyðrænari	ein ið eyðrænir, eyðræningi
eyðræning	tað at eyðræna
eyðræningi	eyðrænari
eyðsagdur	lættur at siga
eyðseldur	lættur at selja
eyðsjónligur	bersýndur, eyðsæddur, eygsjónligur, ásýniligur;hj-liga
eyðskildur	lættur at skilja
eyðsvaraður	lættur at svara,hesin spurningur er eyðsvaraður
eyðsveipin	villigur, fúsur 2(1)(Sv)
eyðsýna	(bíbl.)vísa, sýna, opinbera, birta
eyðsýndur	greiður, týðiligur, skilligur,myndirnar vóru eyðsýndar
eyðsýnt	1klárt, týðiligt, skilligt, sjálvsagt, sjónskt, eyðsætt, bersýnt,tað er so eyðsýnt, at ...;hatta er so eyðsýnt(gott at finna)2við góðum sýni, klárt, klárviðrað
eyðsæddur	góður at síggja, bersýndur
eyðsæð	lætt at síggja, týðiligt, skilligt, sjónskt, eyðsýnt, eyðsætt,tað er eyðsæð, at ...
eyðsætt	eyðsæð
eyðsøktur	lættur at vinna á
eyðteknaður	lættur at tekna
eyðtikin	1lættur at taka,kenningarlombini vóru eyðtikin2lættur at velja, eyðvaldur (1),hesin parturin er eyðtikin
eyðtrúgvið	púra satt,tað er eyðtrúgvið(Sv)
eyðturt	(stb.)(um gras)skjótt fyri at torna,hetta er so eyðturt
eyðtýddur	lættur at týða,søgan er eyðtýdd
eyðtøkin	eyðtøkur
eyðtøkur	sum skjótt verður uppi, sum skjótt gongur undan, ódrúgvur, eyðnýttur, eyðtøkin,tað er eyðtøkt
eyður1	ríkidømi, fæ (2), góðs (1), dýrgripur,ei skortar honum eyð
eyður2	oyðin, tómur, (eiða)sørur,tað er eytt(sørt við fiskel.fugl)
eyðvalamaður	(sj.)serstakur valamaður
eyðvaldur	1lættur at velja, eyðtikin (2)2(um kríatúr)spakur, temiligur3fráskila góður, frálíkur
eyðvalur	(stb.)eyðvaldur (2),hønan var so eyðval
eyðvitað	lætt at skilja, eyðsýnt (1), sjálvsagt, vituligt,tað er eyðvitað
eyðvísur	lættur at bera eyga við, púra vísur,hatta liggur so eyðvíst
eyðvolað	(kortsp.)lætt at vola,her er eyðvolað
eyðvunnin	lættgjørdur,tað er eyðvunnið
eyðætlað	lætt at ætla um, eyðgitt,hvør ið hevur fingið mestan vinningin, er eyðætlað
eyeyameg	frálíkt, óført
eyga	1yrkisgagn at síggja við,blá eygu;fríð eygu;hvøss eygu;brostin eygu;millum eygnanna;svart eyga(blóðlopið um eygað av slagel.stoyti);taka rusk úr eyga;fáa tár í eyguni;undir fýra eygum(um samrøðu í trúnaði millum tvey fólk);ikki við turrum eygumvið táravátum eygum;taka til eygunifara at gráta;fáa eygu1vakna2(um kettling)fara at síggja;frá tí at eygað klovnarfrá tí at ein vaknar;eg bant ikki eyguni alla nátt fyri vindi(sovnaði ikki, fekk ikki mók í eyguni);leggja eyguni saman1blunda2(flutt m.)doyggja, andast;vilja eta e-n undir eygunivera óður inn á e-n;sita (standa) undir eyguni í e-m(upp um bæði oyru);vera vinur upp í eyguni (á e-m)látast at vera vinur;ikki fáa inn í (síggjandi) eygað(einki, ikki undir naglin);ikki at blinda eygað við(lítið);ikki so mikið sum tú kundi væta eygað við(lítiðel.einki);fáa inn (upp) í eygaðfáa kenning;tað kennist á eygunumtað kennist úr honum;gott komi í eyga títt(vælsignaður);ólukka í eygaðóreint í hatta;(fólktr.)ill eygueygu við yvirnatúrligum evnum at granda tí tey síggja,hann segðist hava ill eygu;(orðt.)eitt eyga er skjótt at bregðahin einoygdi gerst lættliga blindur, hætt er um eitt eyga;(orðt.)tvey eru eyguni og triði er muðurintríggir eru góðir gripir(Sv);tað koma eygu aftan á okkumkomandi ættarlið fáa at síggja tað vit hava gjørt(segði maður ið vandaði sær væl um);(tilt.)tað skalt tú ikki seta eygað tiltí skalt tú ikki rokna við, tað skalt tú ikki líta á2sjón, skygni,missa eyguni;eyguni eru farin;bera eyga viðraka við, verða varur við;hava eyguni eftir e-mansa eftir e-m;festa eyguni á e-t(hyggja at);sær mítt eyga rætt, kemur hon nú stetlandi niðan eftir túninum;renna (skjóta) eyguniskeita, kveita;draga við eygunumel.draga eygað í pungvera rangoygdur, skeita;renna eyguni víðahyggja víða uttan um seg;renna (skjóta) eyguni eftir e-mvera hvassoygdur;tað gongur mær undir eyguni(argar meg);hava gott eyga til e-nhava yndi til e-n, hava eiri í e-m;hava ringt eyga til e-nikki torga e-n;(orðt.)gløgt er gestsins eygafremmand eygu síggja alt best;(orðt.)mangt er dagsins eygailla loynist tað ið gjørt verður á alljósum degi;(tilt.)ung eygu roynast best;eyguni á baki,síbak 1(5);lygna við eygunum,sílygna 2(3)3(bert í flt)andlit,vaska sær um eyguni;siga e-m undir eygunigeva e-m eina dygga ábreiðslu;siga e-m e-t upp íel.til eyguni(bart út);vera inni í eygunum á e-m(heilt nær, tætt við)4holel.ringur(t.d.á tolli, hvørvisteini, nál, húki, sóknarongli, høvli, øksar-el.hamarshøvdi, kvørnarsteini, malju),roka í eyga,síroka 25(á setepli)kulla har sum nál rennur út6lykkjael.bukt í binding,missa eyga niður;lata eyga (út)avbinda7(bjarg.)bukt á endanum á bjargalínu(sum sigklæði eru bundin í)8lítil torvgrøv, torveyga9lítil pallurel.kulla í fuglabergi har sum fuglur eigur(minni enn spor (4))10miðja í flotkeldu11lítil fiskatorva, loppur, titil,fiskurin gongur í eygum;er eitt eyga av fiski, verður tað broddað upp beinan vegin12lítið mið, plinkur,reyðfiskaeyga13prikkur, depil(t.d. á terningi)14(kortsp.)stig,essið telur ellivu eygu15(í eggi)fyrsta tekin til unga,eggið er (komið) í eyga;(flutt m.,skemt.)tað er komið í eyga (hjá henni)(er júst vorðin við barn);sms. t.d.døglings-,gásar-,glar-,glas-,gull-,hyljar-,keisara-,kettu-,kleps-,kol-,kúgv-,kvørnar-,lomviga(r)-,mjadnar-,nálar-,páva-,rang-,reyðfiska-,reyvarrings-,sand-,sálar-,sigl-,skeit-,sólar-,tálg-,torv-,vatnsopa-,vind-
eygabakki	bakki 1(3) á torveyga
eygabein	eygnabein
eygaboltur	boltur 1 við eyga (4) á
eygagóður	1góður (1), góðlyntur, góðhjartaður2við blíðum eygnabrá, blíðoygdur, dámligur, fittur,hon er so eygagóð
eygamál	1mál 2(1) tikið upp á gjøt(uttan amboð at máta við)2evni (4) til at meta um mál, fráleikao.tíl.við berum eygum(uttan amboð),hava gott eygamál
eygapartur	ovari partur av hálvum seyðarhøvdi, eygnastykki, kinningur (3), kinnur (2),móts.kjálki (4)
eygarogn	eygnarogn
eygatonn	kinntonn í yvirmunni(dens caninus)
eygbera	eygleiða
eygbragð	h5/6í osb.hava ringt eygbragðhava ringa uppsiktel.ringt upplit
eygbrúnur	við brúnum eygum, brúnoygdur, moroygdur
eygfara	hyggja (gjølla) at, líta at, skoða
eygfesta	festa eygu(ni) á, hyggja stívt at,hann eygfesti sannleikan á ein nýggjan hátt uttan at blunka
eygførur	(óregl.)->eyðførur
eyggráur	(seyðal.)gráur um eyguni,eyggrá ær
eyghavin	(stb.)sum gevur øllum væl gætur,eyghavin maður
eygleiða	hyggja at, eygbera, hyggja aftan á (e-m)
eygleiðari	ein ið eygleiðirel.fylgir við, athyggjari,politiskur eygleiðari[da.observatør]
eygleiðing	athygging, eftirgáan, viðraking,eygleiðingar hansara í føroyskum djóraheimi
eyglit	eygnabrá,fast eyglit
eyglitaður	(seyðal.,stb.)eyglittur
eyglittur	(seyðal.)við liti um eyguni(helst svørtum);sms.grá-,mor-
eygljótur	(sj.,stb.)ljótur at síggja til
eyglýsa	lýsa 2(5), kunngera, birta 2(2)
eyglýsing	tað at eyglýsa, lýsing (2), kunngerð (1)
eygmorreyður	(seyðal.)morreyður um eyguni,eygmorreyð ær
eygna	tekkja, hóma,høgt uppi eygndi eg fýra likkur;eygnast;(stb.)(um tvey)hyggja í eyguni hvørt á øðrum
eygnabakki	(sj.,stb.)eygnabarmur
eygnabarmur	hvarmur
eygnabein	(á kalva)beinið ímillum eyguni,eygnabeinið er feitt og bleytt at bíta
eygnablunk	blunk (1) við eygunum, eygnabrá, ørstutt bil,í einum eygnablunki
eygnabotnur	(lívfr.)afturveggur eygans
eygnabragd	1eygnabrá2(lítil) løta, bil 1(1), bragd (4), andatak, eygnablunk
eygnabragð	eygnabragd,um eitt eygnabragð eru teir úr eygsýni
eygnabrá	knapplig rørsla við eygunum, eygnabragd, eygnakast, eygnaskot, eygnablunk
eygnabruni	(lækn.)bruni (5) í eygunum
eygnabrúgv	(á fólki)mjáur hárvøkstur oman fyri eygað
eygnabrún	(gl.)eygnabrúgv
eygnadropar	(lækn.)flótandi heilivágur til at dryppa í eyguni(oculoguttae)
eygnafjarur	við fjarum eygnabrá
eygnagløs	brillur
eygnagras	(plfr.)slekt í órøkjuætt, mykineskarsi, ormagras(Euphrasia),reytt eygnagras(E. atropurpurea),skotskt eygnagras(E. scotica);sms. t.d.fjalla-,fugloyar-,heiða-,lyng-,ostenfelds-
eygnahagur	sum hevur gott skyn á hvussu e-t eigur at verða gjørt,(tilt.)eg eri eygnahagur, tó eg eri ikki handahagureg veit hvussu tað eigur at verða gjørt, men dugi ikki sjálvur at gera tað
eygnahár	hár á hvørmunum, brá 1(1)
eygnahol	(sj.)eygnahola
eygnahola	holan sum eygað situr í(orbita)
eygnahvarmur	hvarmur
eygnahvíti	(lívfr.)tað hvíta í eyganum(sclera)
eygnahædd	hædd áraka eyguni,í eygnahædd
eygnakast	eygnabrá
eygnaknøttur	(lívfr.)sjálvt eygað
eygnakoppur	1eygnahvíti2stór eygu, tað at vera opinoygdur,tú hevur einar øgiligar eygnakoppar3eyguni og økið uttan um tey,tað liggur til slagið at hava stórar eygnakoppar
eygnakrókur	krókurel.horn í eyganum(har ið eygnalokini møtast),innari og ytri eygnakrókur
eygnakúpa	atkúpa
eygnalag	bragd (5), yvirbragd, eygnabrá,treiskið eygnalag
eygnalappi	lappi at vaska særel.e-m um eyguni við, eygnaskeyti
eygnalepi	(stb.)eygnalappi
eygnaleysur	blindur (1),hin eygnaleysi hevði fingið eyguni aftur
eygnalitur	1litur á eygum2litur (at smyrja) um eyguni[da.mascara]
eygnalok	(lívfr.)húðarklaffur ið skýlir eyganum,(tilt.)ikki fáa (inn) undir eygnalokið(ikki inn í eygað, ikki undir naglin, ikki eitt viðursvet);tað er sum eygnalokið(sagt um arbeiði har ið einki sæst aftur)
eygnalækni	(lækn.)serlækni í eygnasjúkum
eygnamið	endamál, mið 1(2), markmið, ætlan (1)
eygnamørur	mørur (1) um eygað(á seyði)
eygnariv	1e-t ið vísir seg at vera nakað í rúgvu men roynist illa,hatta er ikki eygnariv(roynist væl)2e-t ið vekur ans (og sum kanska argar),hetta skal ikki standa til eygnariv(t.d.brennivínsfløska sett til viks tá ið brennivínsmaður kom inn);hetta er ikki eygnariv(sagt um kjøt)(ikki bara at hyggja at men eisini at eta);sbr.argasjón3(sj.)dýrgripur4(ným.)e-t ið fangar eygað(t.d.litføgur sølulýsing)[da.blikfang]
eygnarívandi	spennandi, hugvekjandi,okkurt nýtt og eygnarívandi var hent
eygnarogn	hálvbúgvið rogn(eyguni farin at síggjast),eygarogn
eygnasjúka	(lækn.)1sjúka í eygunum2blindasjúka(hjá seyði)
eygnaskeyti	eygnalappi
eygnaskot	eygnabrá,hon hugdi at henni við ræðuligum eygnaskotum
eygnaskuggi	litur at smyrja á eygnalok
eygnasteinur	1(gl.)eyga, eygnaknøttur2runt (svart) op í lithinnuni á eyganum(ið ljós kemur ígjøgnum),sjónop3(serst. um fólk)ein ið ein er (ógvuliga) góður við, yndisbarn, skattur (4),hon var eygnasteinur hansara;hann er eygnasteinurin í honum(Sv);goyma sum eygnasteinin(sera væl, sum reyðargull)4pinkulítið epli, ertur (3), gásarepli,berir eygnasteinar
eygnastykki	ovari partur av hálvum seyðarhøvdi, eygapartur, kinningur (3), kinnur (2),móts.kjálki (4)
eygnatonn	eygatonn
eygnatænari	ein ið á sleiskan hátt veitir beinar til tess at fremja egin áhugamál, undirbrotligtel.sleiskt fólk, hyklari
eygnatænasta	beini ið eygnatænari veitir
eygnavarmi	(stb.)eygnavarmur,ilt í eygnavarmanum
eygnavarmur	hvarmur
eygnaverkur	eygnasjúka, tað at hava ilt í eygunum,Tróndur hevur so illan eygnaverk
eygnavernd	útgerð til at verja eyguni(móti skaða)
eygnavørr	(stb.)eygnahvarmur,hovin um eygnavarrarnar
eygsjón	kv2eí osb.í eygsjóní ljósmála, sum sæst;úr eygsjónsum ikki sæst (longur), úr eygsýni;missa úr eygsjónmissa burtur;báturin hvarv úr eygsjón(sást ikki longur)
eygsjónligur	eyðsýndur, eyðsjónligur, opinberur, eygsýniligur,munurin er eygsjónligur;hj-liga
eygsmál	h3í osb.tað er ikki eygsmál á (el.í)tað er skjótari enn eygað sær,tað er ikki eygsmál á, so eru skógvarnir slitnir uppum;kópurin melur sær runt so kvikt, at tað er ikki eygsmál á;tað er ikki eygsmál í veðrinum(loypur ætt úr ætt)
eygsmæli	h24(Nóls.)í osb.tað er ikki eygsmæli átað er ikki steðgur áel.ímillum
eygsvartur	(seyðal.)svartur um eyguni
eygsveipin	(óregl.)->eyðsveipin
eygsýni	eygsjón,úr eygsýni
eygsýniligur	eygsjónligur;hj-liga(Ev)
eygsýnur	eyðsýndur, sjálvsagdur, skilligur, týðiligur
eygutur	leyst bundin, gærutur, levsutur, grisin
eygvaldur	(óregl.)->eyðvaldur
eygvermi	(Sa.)hvarmur
eygvermutur	(Sa.,seyðal.)vørmutur
eyk	seinført fólk, drongsl, drumbur (2),hann var eitt eyk
eyka-	sum kemur afturat, umframt, hjá-,sms. t.d.-arbeiði,-ágóði,-álit,-blað,-dystur,-fundur,-gjald,-hjálp,-inntøka,-kostnaður,-loyvi,-lykil,-lækni,-lærari,-løn,-prógv,-rokning,-roynd,-rættur,-skip,-skrá,-starv,-studningur,-tíð,-tími,-umstøður,-útreiðslur,-váði,-veiting
eyka1	vaksa um, nøra, økja (um),(kvæð.)hoyr tú, gorpur litadimmi, eyka tær ongan vanda;eyka umnøra um;eyka (e-t) tilleggja afturat, seta afturat, skoyta uppí;sbr.eykast 1
eyka2	sbr.úteykaður
eyka3	(ið er) umframt,50.000 kr verða eyka at vinna í V4;eg havi tveir menn eyka
eykaaðalfundur	aðalfundur hildin umframt ársaðalfundin
eykaárin	(lækn.)hjáárin
eykabind	bind (bók) sum viðbótel.ískoyti
eykafall	(málfr.)fall annað enn hvørfall, bent fall(casus obliquus)
eykahjól	hjól til at taka, tiltakshjól
eykajáttan	(búsk.)peningur játtaður umframt vanliga játtan,sjúkrahúsverkið hevur fingið eykajáttan, av tí at raksturin gjørdist dýrari enn væntað
eykaleikari	(ítr.)leikari ið er tøkur um øðrum berst frá
eykaligur	møðsamur,sum tað er eykaligt;sbr.eykast 2
eykalutur	lutur í staðin fyri brotnanel.slitnan lut(t.d. í motori),tiltakslutur
eykamaður	1ein ið er tøkur um øðrum berst frá,eykamaður á einum fótbóltsliði2(stjm.)eykavaldur tingmaður, varamaður
eykan	eyki(Ev)
eykanavn	(Suð.)eyknevni
eykapersónur	(bókm.)persónur ið ikki hevur avgerandi leiklut(í sjónleiki, skaldsøguo.tíl.);sbr.høvuðspersónur
eykasetningur	(málfr.)setningur ið ikki kann standa einsamallur men er liður í øðrum setningi,móts.høvuðssetningur;sms. t.d.orsakar-,sagnar-,sambindingar-,tíðar-,treytar-
eykaskattur	(búsk.)skattur at gjalda umframt vanligan skatt
eykast1	økjast, nørast, vaksa, vinda upp á seg,orð ókst av orðitrætan harðnaði í hvørjum
eykast2	síeyka 2
eykatingseta	(stjm.)tingseta eftir tingslit
eykatíð	tíð út um vanliga tíð(helst arbeiðstíð)
eykavaldur	(stjm.)valdur á ting umframt teir umdømisvaldu,umframt fýra umdømisvaldar fekk flokkurin tveir eykavaldar;sbr.umdømisvaldur
eykavinna	vinna 1(1) umframt høvuðsvinnu
eykdovin	ógvuliga dovin, blóðlatur, blóðdovin
eyki	tað at eyka, øking, ískoyti[da.supplement]
eyknevna	geva eyknevni, skíra (2), kalla (4)
eyknevni	niðrandi nevni, eykanavn,eyknevnið Krókurin hevði hann av tí, at hann vildi altíð krøkja sær meira til, enn hann átti
eyks	í osb. sumverael.sita til eyks1ikki hoyra uppí, vera til at taka, vera umframt,teir høvdu eina ár til eyks(eyksár)2(á báti)vera eyksmaður,hann var til eyks
eyksár	(bát.)ár 1 til at taka, ár til eyks, tiltaksár
eyksmaður	maður ið er umframt bátsskipanina
eyksum	umframt,eg havi 5 gyllin eyksum teir, ið N.N. eigur
eykutur	møðsamur, leiðisamur(t.d.um arbeiði)
eymd	armóð (1), neyð (2), vesaldómur
eymingi	(gl.)armingi
eymk	stun(i), stynjan, venan;sbr.ank
eymka	1harma, vera harmur um,eymka seggremja seg (um), harmast (um), lemja seg (um), klukka 3(3), vena seg2eymka segstuna, stynja;sbr.anka
eymkan	1samkensla, várkunn, miskunn, samhugi2tað at eymka seg, venan, gremjan, gremjingar, eymking
eymkiligur	ússaligur, vesalligur, eymur (1);hj-liga;sbr.ankiliga
eymking	eymkan (2)
eymleiki	tað at vera eymur, umsorgan, yndi
eymligur	1sárliga, sáran, grøtiliga, ønskriliga,djórini ýldu so eymliga2blídliga, vinaliga, alskiliga,hann kíndi henni eymliga um ennið
eymur	1ússaligur, vesalligur,eymur er maður, ið agn sparir2sum einki tolir av, erkvisin, smásárur, hveppin, holdsárur3sárur (1), pínumikil4alskin, kærur, elskuligur,(kvæð.)mong er kvinnan eym
eyra	s30(stb.)í osb.har eyrar og seyrar, so tað er illa inniverandi(lekur);sbr.tað lekur í eyri og seyri
eyrbakki	eyrutur (áar)bakki
eyrblandaður	blandaður við eyri,eyrblandað mold
eyrborin	(um veg)sum eyrur er borin á, lagdur við eyri
eyrbotnur	eyrutur botnur (4)
eyrfløta	eyrkend fløta
eyrgrýti	1(jarðfr.)grótslag av samanrunnum eyri og (rundum) smágróti(konglomerat)2(flutt m.)skurvblandingur,bergensbúgvar eru eitt eyrgrýti av tilfari úr øllum heimi
eyrgøta	eyrborin gøta,gongur eftir smølum eyrgøtum út um bygdina
eyrhakkari	hakkari at høgga eyr við, eyrhøggari, eyrpikkari
eyrheyggjur	eyrutur heyggjur
eyrhol	hol sum eyrur verður tikin úr
eyrhøggari	(stb.)eyrhakkari
eyrkendur	sum eyrur er í, eyrutur,gróðrarlendið er so eyrkent
eyrlendi	eyrkent lendi
eyrlind	lind 2(2) av eyri
eyrmikil	við nógvum eyri(Ev)
eyrmold	eyrkend mold
eyroyða	bert eyrut lendi,hagin er grót og eyroyða
eyrpikka	(stb.)eyrhakkari
eyrpikkari	(stb.)eyrhakkari
eyrriða	(fisk.)eyrriði
eyrriðaglúpur	glúpur at fanga eyrriðar við
eyrriðamið	staður har ið eyrriði fæst,besta eyrriðamið við vatnið
eyrriðanet	net á stong at taka eyrriðar við, eyrriðaglúpur,(flutt m.)(tunt) sum eyrriðanet(um voviðel.bundið plagg)eygut, grisið
eyrriðaposi	(stb.)netposi við avlangari gjørð í munnanum at fanga eyrriðar við
eyrriðasild	kombikk (1)(Sv)
eyrriðaskræða	skræða á eyrriða,loppuprikkutur rætt sum eyrriðaskræða(í tátti)
eyrriði	(fisk.)fiskur av laksaætt, eyrriða, anriða, síl(Salmo trutta)
eyrriðunet	eyrriðanet
eyrrok	rok av eyri,eyrrokið stendur frá
eyrrúgva	rúgva av eyri
eyrryggur	ryggur (2) av eyri,hann var farin at høgga ein eyrrygg
eyrsáld	gamalt vánaligt far, rotabukka, lekabukka
eyrskriða	skriða 1(1) av eyri
eyrskruv	eyrut lendi, skruv,tjaldursungin er samlittur við eyrskruvið
eyrsteinur	(jarðfr.)grótslag ið ryður sundur í eyr og ikki klovnar fyri sløgum, kandisgrót
eyrtúvusteinbrot	(plfr.)slag av steinbroti(Saxifraga rosacea)
eyrur	1grovur sandur við smágróti, áarsandur2føst og hørð jørð(ein blandingur av molnaðum gróti, leiri, sandi og mold),(tilt.)tað lekur í eyri og seyri(ógvuliga illa, sum sáldið);sms. t.d.áar-,gos-,jóla-,sjógv-,skrið(u)-
eyrutur	við nógvum eyri í, eyrkendur
eyrvegur	eyrborin vegur
eyrveka	(stb.)eyrvika
eyrvika	1vátligt hagalendi blandað við eyriel.smágróti2vátlend og bleyt leirjørð
eyrvikujørð	bleyt og vát jørð
eyrvikukent	1við eyri í2keksut (1) lendi
eyrvikukynt	eyrvikukent
eyrvøka	eyrvika
eyrvøkujørð	eyrvikujørð(Sv)
eyrvøkut	(stb.)eyrvikukent
eyskar	(bát.)ílat at oysa við, geilarsíl, skopa, skválpa,grindakempa varð áður nýtt til eyskar;sbr.lív-
eysmál	ávís mongd av kjalarvatni(upp í eitt eyskar)komin inn í bát(Ev)
eysrúm	(bát.)rúmið har oyst verður, eystur (2)(ímillum rúmbekk og lærbekk),á seksæringi og tíggjumannafari eru tvey eysrúm, fremra og aftara;sbr.rangarúm,rættaeystur
eysrúmsbekkur	(bát.)næstaftasti bekkur, rúmbekkur
eysrúmstollur	(bát.)tollur við eysrúmsbekk
eystan-	sms. t.d.-alda,-brim,-brot,-lot,-ódn,-stormur,-æl
eystan1	1eysturætt, eystanvindur,eystan er góður hjá okkum;(tilt.)eystan er mannadeyði2í ein eystaní eysturætt, móti eystri
eystan2	1úr eystri, eystaneftir, eystanífrá,hann er eystan (í ættini)(eysturætt, eystanvindur);høgur eystan;lágur eystan;landnyrðingur eystan;landsynningur eystan2eystan fyriel.fyri eystaneystur úr (e-m);eystan fyriel.fyri eystan Fugloynna3eystarumegin, í eystara parti,fyri eystan;londini fyri eystan(í eystara parti av heiminum, eystanfyri)4fseystan fyri,eystan Á
eystanat	eystaneftir,hann legst eystanat
eystanbygd	(Sa.)eysturbygd
eystandráttur	rák eystaneftir(Ev)
eystanduni	(kvæð.)harðveður (við torusláttri?) av eystri,mikil ódn og eystanduni / mínum var faðir at deyða(Hmb. FK I102)
eystaneftir	úr eystri, eystan 2(1), eystanífrá, eystanat,trolararnir sigla heim eystaneftir
eystanfyri	fyri eystan, eystantil,eystanfyri á oynni er Viðvík;frætt er frá trolarunum eystanfyri(í Barentshaviel.við Svalbarð)
eystanífrá	eystaneftir
eystanlond	lond í Eysturevropa
eystanmaður	maður úr eystanbygd í Sandoynni
eystannátt	nátt við eysturætt,ruskut eystannátt
eystanpíningur	eystantømingur,í ringum eystanpíningi støkkur tað ikki av nakrari ær
eystanrótan	rótan av eystri,aftan á eystanrótan av landsynningi løgdust stórar tarabrúgvar upp
eystantil	fyri eystan, í eystan, eystanfyri, eystarumegin,eystantil á oynni
eystantømingur	tráur eystanvindur
eystanveður	eysturætt, eystanvindur
eystanvert	eystanfyri, eystantil,eystanvert viðeitt sindurel.nett eystan fyri,eystanvert við Nakkin er ein drangur, sum eitur Konan
eystanvindur	vindur av eystri, eysturætt
Eystarasalt	(stn.)havið norðan fyri Eysturevropa, Eystursjógvurin
eystari	longri eysturi
eystarlaga	langt eysturi
eystarumegin	á eystursíðuni (á), eystantil, eystanfyri
eystastur	longst eysturi
eystfall	sjóvarfall eystureftir, suðurrák, suðurrek,móts.vestfall,eystfallið ger fjøru;eystfallið var stórt(gjørdi nógv um seg);fallandi eystfall(í linking)
eystfalsbroddur	fullbroddað eystfall,á eystfalsbroddi er háfjøra
eystfalskyrrindi(r)	runnið eystfall, kyrrindi eftir eystfall
eystleiki	eystlig støðael.lega
eystligur	1sum er íel.móti eystri2(um ætt)sum kemur eystaneftir,nú er hann eystligari;hj-liga
eystmaður	(søg.)norðmaður
eystrønur	eysturlendskur,finska fólkið er av eystrønum uppruna
eystur1	1tað at oysa bát, oysing,sita í eystri2eysrúm3soga4kjalarvatn at oysa
eystur2	1ein av teimum fýra høvuðsættunum(har ið sólin (á leið) kemur upp),móts.vestur 2,stormur av eystri(eystaneftir);tað lotar á eystri;hann rekur á eystri(skýdráttur eystaneftir)(Sv);í eystri;dagur roðar í eystri;í eysturí eystan, í eysturætt, eystureftir;úr eystrieystaneftir2tann eystligi parturin av heiminum, eysturheimur,stríðið millum eystur og vestur3(gl.)klokkan seks á morgni,frá eystri til vestursfrá klokkan seks um morgunin til klokkan seks um kvøldið;tað er eystur;hálvga eysturklokkan hálvgum fimm á morgni
eystur3	1í ættina har ið sólin (á leið) rísur, eystan, eystureftir, eysturá,sigla eystur um oynna;Sigmundur fór so eystur til Noregs;vit skulu fylgja tygum eystur;húsini standa eystur og vestur;fara eystur um e-t(yvir á eystursíðuna)2eysturi,eystur í havinum
eysturá	(longri) eystur 3, eystureftir,beinir seg eysturá, meðan tað harðnar(um eystfall)
eysturbygd	bygd eystantil áel.í eini oyggj, eystanbygd
eysturbýur	eystari býarpartur(í Tórshavn)
eystureftir	móti eystri, í ein eystan
eysturfyri	framvið eystureftir(Sv)
eysturgerð	afturundirgerð ið rekur eystur inni við land
eysturgjørdur	farin at reka eystur,sjógvurin var eysturgjørdur
eysturhallur	l12(veðurfr.)eysturhallur landnyrðingurætt millum landnyrðing og landnyrðing eystan;eysturhallur landsynningurætt millum landsynning og landsynning eystan;eysturhallur norðanætt millum norðan og landnyrðing norðan;eysturhallur sunnanætt millum sunnan og landsynning sunnan
eysturheimur	eystari heimspartur, Eysturlond
eysturi	í eystara parti, eystarlaga,har eysturi;har eysturi á oynni
eysturland	1eysturlondlond í eystara parti av heiminum(t.d. í Asia),(bíbl.)vísmenninir úr eysturlondum2Eysturlandeystari partur av landit.d.Íslandi,á Eysturlandinum
eysturlandstúrur	(fiski)túrur á Eysturlandinum(í Íslandi),vanligt var at enda eysturlandstúrin um javndøgurstíð
eysturlega	(um neyt ið liggja úti)fyrsta lega (1)(at jótra),tað kundi henda seg, at kýrnar høvdu ikki reist seg av eysturleguni, tá ið neytakonurnar komu;sbr.landsuðurslega,middagslega,vesturlega
eysturleiki	eystleiki
eysturlendingur	fólk íel.úr Eysturlondum
eysturlendskur	íel.úr Eysturlondum
Eysturlond	Ásia og Egyptaland,vísmenninir úr Eysturlondum
eysturlongd	(landafr.)longd (6) eystan fyri longdarkringin gjøgnum Greenwich, eystlig longd
eysturmark	mark eystureftir
eysturmáli	í osb.koma íel.fáael.hitta eysturmála(um bát)fyllast við sjógv;standa í eysturmálastanda og oysa (bát)
Eysturoy	(stn.)oyggj millum Streymoy og Norðuroyggjar,Eysturoyggin;í/úr Eysturoynni,(inn) í Eysturoynna
eysturoyingur	1fólk íel.úr Eysturoy2(Fám.)fólk íel.úr bygdum eystanfyri í Suðuroynni
eysturríkari	fólk íel.úr Eysturríki
Eysturríki	land í Evropa
eysturríkskur	íel.úr Eysturríki
eystursíða	eystara síða(t.d. á fjalli),seyður, ið hevur gingið á eystursíðu, er hildin at vera kjøtbetri enn annar seyður;hagagott kjøt er altíð á eystursíðu
eystursjógvur	1havel.sjógvur eystan fyri landið, oynnael.tíl.;sbr.vestursjógvur2(stn.)EystursjógvurinEystarasalt
eysturum	yvirum eystarumegin (e-t),fara eysturum
eysturundir	afturum eystureftir(Ev)
Eysturvegur	(kvæð.)londini sunnan og eystan fyri Eystarasalt
eysturætt	vindur av eystri, eystanvindur,gomul eysturætt er sera góð á Norðhavinum
eytt	síeyður
