I	rómv. taltekn fyri 1(II = 2, III = 3, IV = 4, XIII = 13o.s.fr.)
i	(málfr.)sjálvljóðsstavur (nevndur[i:]el.fyrra[i:]),seta prikkin yvir i'iðgera e-t fullkomið
ideal	hugsjón
ideologi	hugmyndafrøði
ið	1sbsum,maðurin, ið átti húsini;tú sært, hvør ið har kemur;hatta er tann maðurin, ið er(eingin hissini maður – eisini nýtt speiliga);skamm fái hatta, ið so ikki gongur;skamm og last í teg, ið ringur ikki eróreinur ert tú!2hj/sb1har sum,annar kosturin var at herja á nær við, ið aðrir skóru torvið;(kvæð.)ið Tíðrikur fyri var(har ið T. var staddur)2tá, tá ið,(kvæð.)árla var um morgunin, ið sól tók fagurt at roða3hvar iðhvar, har sum,hvar ið hann hevði verið?;hvar ið hann ætlaði sær?(hvagar);hvar ið hann kom, var sama skilið(allastaðni)4tá ið[tɔajɪ]tá, hvørja ferð,tá ið tær komu, plagdu tey at taka ímóti5nú iðí somu løtu sum, tá ið,nú ið hann sær hann, minnist hann alt aftur6higar ið(kvæð.)tá ið,higar ið teirra snekkja kendi fagurt land7(kvæð.)hvussu,hygg, ið væl hann bítur(knívurin)8sama, uttan mun til,ið hvat arbeiði menn høvdu uppi á landi, róðu teir altíð út, tá til bar;ið hvør hann er;hvat ið hann (so) ger;hvør ið hann (so) er;lítið nyttar, ið hvat tey fáa;hatta er ikki fossadun, ið hvat hatta er;ið hvussuel.hvussu ið;ið hvussu hannel.hvussu ið hann leitaði, fann hann teir ikki(sama hvussu);ið (í) hvussu ersíhvussu
iðra	angra, harma (gjørda gerð),iðra seg eftir e-mel.e-t;eg iðri meg ikki eftir, at eg gjørdi tað;iðra seg um e-t;alt, ið meg iðrar er, hvussu tey fáa seg til at brúka pengar til sovorðið(harmar, gremur);iðrastiðra seg,iðrast eftir (e-m)
iðran	tað at iðra segel.iðrast, angur,vreiði og iðran bilgdust í honum
iðranarfullur	sum iðrar seg, iðringarsamur angurmerktur, harmur
iðranargrátur	grátur av iðran
iðranargrein	(løgfr.)grein í keypssáttmála ið gevur keypara rætt til at iðra seg um keypið
iðranarleysur	ið iðrar seg ikki,(bíbl.)við iðranarleysa hjarta tínum
iðranarloysi	tað at vera iðranarleysur, angurloysi
iðranartár	tár av iðran
iðrari	ein sum iðrar seg(t.d.um syndir sínar),størstu halgimennini eru iðrarar
iðri	(sj.)iðran,ein bítandi iðri fór gjøgnum merg og bein;alt endaði í iðra og vónloysi
iðring	(sj.)iðran
iðringarsamur	(sj.)iðrandi, iðranarfullur
iðrun	(gl.)iðran
igil	(dj.)1(gl.)liðamaðkur sum áður varð latin súgva blóð úr sjúklingum(Hirudo medicinalis),hann otaði seg upp í hin sum ein igil2igli
iglagras	(plfr.)tjarnaks(planta sum varð hildin at valda iglasótt hjá seyði),vatnskøra
iglahoyggj	(Bø.)(gott) hoyggj sum ber á grátt,iglahoyggj, tað dámdi pápa so væl
iglasjúka	iglasótt
iglasjúkur	(um seyð)við iglasjúku, vatnsjúkur,á vátum haga tekur seyðurin ofta vatn og verður iglasjúkur
iglasólja	(plfr.)slag av sólju(vanlig á vátlendi)(Ranunculus flammula)
iglasótt	sjúka av iglum(hjá neytum og seyði),vatnsjúka, vatnbrek, iglasjúka, livrarvatn(distomatosis)
iglasóttarseyður	vatnseyður
iglavatn	(hjá seyði)livrarvatn,var seyðurin rokaður í iglavatni, so beyð hann ikki bøtur
igli	(dj.)flatmaðkur sum livir sum sníkur í livrini á seyði og neytum, igil (2)(Distomum hepaticum),um iglar eru í livrini á seyði, verður sagt, at hann hevur iglasótt
iglutur	(seyðal.)ljósur við dimmum blettumel.rípum, smádroputur;sbr.ímutur;sms. t.d.grá-,mor-,svart-
igulker	(dj.)(kúput) botndýr við tindum(Echinoidea);sbr.egilker,øðuker
igulkøttur	(dj.)tindasvín(Erinaceus europaeus)
-igur	(eftirfesti),sí t.d.átigur,hegnigur,kunnigur,matigur
ikin	síaka
ikki	(noktandi orð)ei,eg royki ikki;hann vildi ikki siga tað;hann blundaði ikki á náttini;meg ræðist hann ikki;drongurin roytti gentuna, "ikki!" rópti hon(lat vera, gevst)1(at herða á nokting)ikki tori eg;ikki skal tað vera fyri einki, tú gert hetta;ikki mást tú gráta, omman veit vegin;ikki tær arbeiða, ei heldur tær spinna;ikki veit eg, hvussu hetta endar2(í spyrjandi setningum)ikki eiga tygum ein royk at geva mær?munnu tygum eiga...?;ikki hevur tú ein heitan munn at leska hesa gomlu niður á hjartað, lukkan?;tit eiga ikki grind at selja?;bar ikki til at fáa hatta burtur hiðani?3í osb.ei og ikkibæði og,hann er ei og ikki ólíkur honum(sipast honum);skamm fái hatta, ið so ikki gongur og melur(sum hatta gongur og melur);óreint slái, sonur tín, hann nasadjarvur ikki er(sum hann er nasadjarvur);ið kærleikin, hann sterkur ikki er(sum hann er sterkur);so fanglast hann og ikki, at hesa ferðina sleppur hann leysur(fanglast onkursvegna soleiðis, at...);ikki tær at sigatað veitst tú helst;ikki meir ennknapt, neyvan, valla;ikki tíkortini, tó;fyrr enn ikkiið hvussu er;heldur enn ikkiikki sørt
-iksutur	sístór-
il	1tað flata undir fótinum(sum gingið verður á),ilferð,rundur undir ilinilorkutur í gongulagi, argur at detta, rundføttur;hann er drýlur undir ilini(rundur undir ilini, dugir illa at fóta særserst.í brøttum);frá høvur til iljarallur sum hann er2(sj.)sóli, botnur(undir skóm, hosum o.ø. fótbúnaði),ongar iljar vóru undir skónum;hon bant il upp undir ein hosuleist
-il1	(eftirfesti),sí t.d.biðil,dregil,lykil,diskil
-il2	(eftirfesti),sí t.d.heimil,lítil,mikil
ildari	(dj.)ránsdjór skylt mári(Mustela putorius)
ilferð	il (1)(Sv)
-iljaður	síslætt-
iljarbreidd	breidd (sum) á il,smøl rás sum iljarbreidd at ganga upp ígjøgnum
iljarbreiður	sum ein il til breiddar,iljarbreið rás
iljarskógvur	(Suð.)1il,iljarskógvurin var slitin inn at berum kjøti;(skemt.)eg skal vísa Várharra iljarskógvarnar á tær(fella so at føturnir venda upp, venda upp og niður)2ilskógvur,bloyta iljarskógvar
iljaslættur	(lækn.)slættur undir ilini, slættiljaður
illa1	hava at, lasta, siga ringan,tað var eingin, sum illaði hann fyri tað
illa2	1als ikki væl, vánaliga, illani,móts.væl,akta illavera sera ólýðin;e-m dámarel.líkar e-t illa(heldur lítið um);duga illahava lítlan kunnleika;enda illafáa ringan enda;fara illa1fáa ringan enda2(um kvinnu)hitta reis3(um gest)fara og ongan blíðskap hava notið;tú fert so illa, hevur hvørki fingið vátt ella turt;fara illa við,sífara,illa gjørdur(óvandaliga);illa ílatin;illa klæddur(vánaliga);láta illa atfýlast á, vera ónøgdur;síggja illahava ring eygu;sova illahava ringt svøvnlag;tíma illahava lítlan hug;verða illa viðhvøkka við, verða skelkaður, gerast loturel.hámur(av e-m ið kemur óvæntað)2valla, neyvan, nærum ikki,illa arbeiðsførur;teir høvdu illa fingið kastað, fyrr enn teir vóru fastir í fiski(høvdu valla kastað);hann nælir illa upp úr rossaspori(ikki);tað er illa útfaranditað er ikki útfarandi (fyri veður);nóg illaneyvan, valla3(um e-t ið er áhaldandiel.javnan kemur fyri)tað vestasta bergið hevur lopið illa;hundurin bítur illa(er argur at bíta);kettan klórar illa;hann bannar illa(er ringur at banna);drekka illavera fallin til drykk4meint, dyggiliga,illa sjúkur;illa særdur(meint);tað píndi illa(nógv)5(um trongd, tørvo.tíl.)vilja illa sovavera svøvntungur;vilja illa pissa, kukka, spýggja,sívilja6í osb.illa vartreyðugt so;fyrr var illaannars varð ikki væl vorðið;tað var illatað var harmiligt;koma illa av skaftiikki eydnast væl;vera illa eftir seg1ikki vera væl til passar(av náttarvøku o.ø.)2(um e-t ið sýnist drúgvari enn tað roynist)tað er illa eftir seg;tað vildi so illa tiltað var so óheppið;vera illa gitinhava ringt orð á sær;illa staddurí neyð, í trongstøðu, neyðstaddur;illa verði honum fyri!skamm fái hann;illa komin á hold,síhold;vera/koma e-m illa viðel.vera illa viðkoma (e-m) dátt við
illamansamjólk	1illamansblomstur2sevja úr hagasólju
illamansblomstur	(plfr.)hagasólja (1)
illamansbøn	(sj.,stb.)illbøn,mamma hennara fór at lesa illamansbønir út yvir hana
illamansskel	(dj.,stb.)langfiskur
illamansull	(plfr.,stb.)mýrifípa
illamansørindi	h flt24í osb.ganga illamansørindileggja ilt fyri (e-n), bera slatur
illandi	illur andi,óveðursins illandar
illani	(tlm.)illa
illanssettur	settur av hinum verstael.illum anda, dekanssettur
illanstíð	so aldrin, tramanstíð, devulstíð, fananstíð,illanstíð tímdi hann at fara at keypa;illanstíð vera náttargesturin í hesum klandursholinum;illanstíð skal tað verða sagt;illanstíð komi tey aftur!fast takist teimum, tí hava tey gott av;illanstíð batni tærgævi at tú ikki batnaði
illasjúka	(lækn.)virussjúka hjá seyði(serst. lombum)sum sæst sum skurvel.útbrot um munn, nasar o.a.(kann elva til hundaland (2) hjá fólki)(ecthyma contagiosum)
illavorðin	1óskikkiligur, óargaligur, bannsettur,ein illavorðin drongur;tað er illavorðið gjørt(ljótt)2ósømiligur, ónæriligur, ólíkligur,tað var fyri okkum, sum orðið lygn var eitt illavorðið orð;illavorðin skriving3ljótur í munninum, óreinur, óhøviskur,hon var so illavorðin við hann;ikki siga illavorðiðikki bannast(sagt við børn)4(gl.)(um útsjónd)ljótur, misháttur,ringurin skal hvørki vera minni ella illavorðnari5(um luft)hann stendur so illavorðinhóttir við illveðri
illbatan	illbati,hon hevði illbatan av, at tær sóu eitthvørt, tær vildu ikki siga
illbati	illbatan, illpatan, illgruni, grunur, grunsul, varhugi,hava illbata á e-m;eingin hevði illbata til nakað ringt;illbati kom á fólk;eg hevði illbata av títað vardi meg
illbálkaður	(stb.)ófryntligur, tvitin, tvørur,ikki plagar hon at vera illbálkað at tala til
illbestur	(sj.)frægastur(av fleiri vánaligum),tað man vera illbest
illbiðing	(bíbl.)tað at biðja ilt, bann (3), bannføring,tessvegna oyðir illbiðing jørðina
illbikkja	óreint fólk, beist, bikkja (3), skarnsvætti,hatta hevur tú funnið upp á sjálvur, tín illbikkja
illbindindi	(sj.)ótol, ótolni,nú eru illbindindi í Føroyum, tí einki hoyrist frá okkara ríkisdagsmonnum
illbirtari	ein sum setur ilt ímillum fólk, illibirtil, klandursvætti
illbirtil	illbirtari
illbirtin	sum birtir ilt í,full av lygn og sviki, øvundsjúk og illbirtin
illbirtni	tað at vera illbirtin
illbit	1ringur skriði (sum kann fylgja viðt.d.andvekri), illsinnisskriði2eitt ið er bitut í orðum, illorðað fólk, illsinnavætti
illbítast	havast ilskliga orðum saman, tráberast, deilast
illboð	1slatur, sleyg,bera illboð2eitt sum gongur um við sleygi, slatrivætti,hatta er tað illboðið, ið er
illboðandi	sum boðar frá illum, ófrættakendur,hesin dagurin var undarligur og illboðandi;hj:hann lær illboðandi
illbólkaður	illbálkaður,hann kundi, tá ið hann var illbólkaður og snurrutur, gerast ógvorðaður
illbólkutur	illbálkaður
illbragd	ilskubragd, illgerð,mong eru illbrøgdini, hann hevur avrikað
illbregði	(lívfr.)úrskeping, úrkynjan,illbregði er ikki komið í hendan stovnin[da.degeneration]
illbrimil	(stb.,sjónavn)havgás, imbrimil,havgásin varð nevnd illbrimil, - tað skuldi ikki blíva eydnisdagur, tá ið ein segði havgás
illbrotin	(stb.)brotillur,hetta er so illbrotið(torv)
illbruni	(lækn.)(ringur) bruni
illbrýnskaður	illbrýnskutur
illbrýnskast	seta knyklar í brýr, vera grískur á at líta, illfjøskast (2)
illbrýnskutur	illbrýntur, illbrýnskaður, illfrýnutur
illbrýntur	ilskur á at líta, grískur, brúnasíður
illbuksur	vánaligar buksur(at hava uttan á einum betri)
illbøn	1orðing ið inniheldur ynski um ólukkuel.revsing yvir e-n/e-t(siparoftasttil djevulin),vanbøn, vandabøn,lesa illbønir yvir e-n;(tilt.)ein illbøn á nátt er líka so ring sum sjey á degi2tað at biðja ilt yvir e-n,einaferð í fyrndini var illbøn biðin yvir tann, ið vágaði sær at velta hesar teigar;sbr.eiður
illbønastykki	1(á neyti)múli2eitt sum bannar illa,eitt herviligt illbønastykki
illbønavætti	illbønastykki (2), blótvargur
illbønustykki	(stb.)1illbønastykki (1)2(á rossi)yvirvørrin upp um nasagluggarnar
illbønuvætti	(stb.)illbønavætti
illdálkutur	illdulkutur
illdámaður	(um hvítt plagg el. klæði)við ringum dámi, ódámaður, illdusputur, illlittur,dúkarnir eru illdámaðir
illdeyðaseyður	seyður við illadeyða
illdjór	(dj.)skaðadjór, -dýr,rottan er versta illdjórið í Føroyum
illdulkutur	illdæmdur, illlittur, ódámaður, ódæmsligur,hvítar geitir verða so illdulkutar
illduskutur	illlittur, illdulkutur(Sv)
illdusputur	(stb.)ilsligur, ófantaligur, ónossligur,eg føli meg so illdusputa(ikki nóg reina)
illdýr	1illdjór2óargadýr, illvætti
illdæmdur	illa dæmdur, við ringum dæmi, illlittur,illdæmt andlit;tann illdæmda, tjúkka skøddan
illdæmi	ringt dæmi, ódámur,tað er sovorðið illdæmi á tí(t.d. fólki, klæðum)
illeirast	s74/75(stb.)í osb.tað er ikki at illeirast viðtað er ikki at lasta, tað er at gleðast um
illfatan	(stb.)illgruni, illbati
illfjøsin	(sj.)illfjøskutur
illfjøskast	1dálkast(Sv)2gerast illfjøskutur, illbrýnskast(Sv)
illfjøskutur	1ófantaligur, ótrivaligur, fjøsutur,flekkutur og illfjøskutur sá allur bøurin út;hetta at strúgva burturúr var illfjøskut arbeið2illveðursligur, illfýsin, ruskutur,illfjøskut veður
illflenn	óreinur (2)el.háðandi látur, spottlátur,hon lær sítt undarliga illflenn
illflenna	flenna háðandiel.óreint,hann illflenti upp í eyguni á honum
illfokn	(sj.)fokn (1),hava illfokn á e-m
illfokni	(sj.)illfokn,ikki beri eg hvørki hat ella illfokni at Danmark
illfrýntur	ilskur á at líta, illbrýntur, illfrýnutur, illfúsur
illfrýnutur	illfrýntur,illfrýnutir og trølsligir á at líta
illfuglur	(fugl.,sj.)skaðafuglur
illfúsur	1meinskur, óreinur (2), ilskufúsur, illnatin,embætismenninir vóru illfúsir við fólkið2illfýsin, bítskur
illfýsi	meinfýsni, óreinskapur
illfýsin	1illførur, illur, bítskur,hin yngri var tá illfýsin, tí at hin róði ov lítið;at Páll kann hava verið heldur illfýsin við sýslumenninar, er væl ætlandi2illveðursligur, ruskutur,tað var heldur illfýsið í veðrinum3treyður, ófúsur,menninir vóru móðir og tí heldur illfýsnir at fara
illføri	tað at vera illførur, illsinni, grimd,leggja av alla vreiði, illføri og hevndarhuga
illførur	bítskur, illur, illfýsin, illsintur,fólk vóru ofta von við illførar læknar;hann drakk sum eitt beist og var illførur við brennivíni;hesir hundarnir eru illførari enn aðrir
illgerdur	(Suð.)[-jɛrd-]illgjørdur
illgerð	1ring gerð, misgerð, brotsgerð,hatta var ein sonn illgerð2(kvæð.)gandagerð, gandur, galdur (2), illgerning(oftast at óveður verður reist móti monnum á sjónum),illgerð sóu teir norðan koma
illgerðamaður	maður ið ger ilt, óbótamaður, brotsmaður
illgerin	illgjørdur
illgerning	(kvæð.)gandur, gandagerð, illgerð (2)(oftast at reisa illveður móti monnum),(hann) ristir ramar illgerningar, út í havið sendi;hetta vóru illgerningar, ramur gandur(MJ Fiskim.32)
illgerningur	1(kvæð.)illgerning2illgerð
illgign	kv2(Suð.)óndskapur, óreinskapur, illvild,gera e-t í illgign
illgirnd	(stb.)øvund, øvundsjúka
illgita	leggja undir illgruna, illteinkja,illgita e-n fyri e-t
illgitan	illgiting
illgitin	1sum illgitir, illgrunasamur,tann, sum illgitin var, hevði ivaleyst verið undarliga við2(sj.)illa gitin, tiltikin fyri tað ringa,tann illgitna skúlalógin varð síðan avtikin
illgiting	tað at illgita, illgrunasemi,brigsl og illgiting
illgitni	illgitan,tað endar við trúttan og illgitni
illgjørdur	sum ikki vandar sær um(í arbeiði sínum),óvandaligur,hatta er so illgjørt
illgongd	tað at illa gongst,at syrgja um mistøk og menniskjaliga illgongd
illgongdur	1ringur at ganga (um), torgingin, torfarin,gøtan er illgongd;tað er skjótt at berast á, her er so illgongt;har er illgongt, brattlendi og berg2illa gongdur, tungur upp á sporið,hann er so illgongdur, dettur og glíður
illgras	1illgresi,(bíbl.)illgrasið í hveitiakrinum2(stb.)gras sumt.d.sólja er uppi í,sláa illgras inn til neytini
illgráur	við grómutum gráum liti, dimmgráur,skurin er illgráur um hálsin og í neðra;í gjár dundi kavin niður úr tí illgráa loftinum
illgresi	(plfr.)illgras, lok, arvi,bøurin var yvirgrógvin við illgresi
illgresjaður	(um bø)sum sýrulegguro.a.illgresi veksur í,móts.reingresjaður
illgron	eitt sum gongur við gron, skriðuskortur(Sv)
illgrómutur	(Suð.)hálvskitin um andlitið, grímutur,tú hevur ikki vaskað tær í morgun, tú er so illgrómutur
illgruna	hava illgruna til (e-n), illteinkja,hann stardi illgrunandi at henni
illgrunakendur	(heldur) illgrunasamur (1)
illgrunaleysur	ið einki ilt grunar
illgrunasamur	1illtrúgvin, illvarin, illgitin,frá hesum degi var hann illgrunasamur og øvundsjúkur ímóti honum2illgrunaverdur,tað tókti mær illgrunasamt
illgrunasemi	tað at vera illgrunasamur
illgrunaverdur	sum vekur illgruna, illgrunasamur (2),skipið tókti honum illgrunavert
illgrundaður	við ringari muru, grund(ar)ringur
illgruni	illbati, gruni, varhugi, illgrunsil, illtanki,fáa illgruna av e-m;illgruni kom á teir;leggja undir illgrunaillgruna, illteinkja
illgrunsil	illgruni,tá kom illgrunsil á teir
illgrýti	grót ið er til bága,eitt skarð við niðurraplaðum urðum og illgrýti
illhirsin	kaldur og illa til passar, illa hirsin, illa stjølaður,hann kendi seg sjúkan og illhirsnan;síggja illhirsin út
illhirsni	tað at vera illhirsin,eitt illhirsni kom á hann
illhoyggj	vánaligt hoyggj(ið eingin dugur er í),kyknað upp sum loppur úr turrum illhoyggi
illhugaður	sum hevur ilt í huga,myrkrið er fult av illhugaðum blídni
illhugsa	(sj.)illteinkja, illgita,hann illhugsar hana fyri at hava gjørt tað
illhugsin	illgrunasamur
illhvítur	ikki snjóhvítur,býurin við sínum illhvítu húsaveggjum
illhýrdur	illa hýrdur, í ringum lag, sum ein illtorva,hatta situr illhýrt
illibirtil	illbirtil
illideyði	kartis (2), karti, illasjúka(serst. hjá lombum, skáldast um múla og føtur og skruvur koma á)
illimaður	hin versti, hin grábeinti, fjandin, fanin, djevulin, óndimaður
illipartur	(stb.)tann minniel.vánaligari parturin av e-m(t.d. amboði),illipartur á klova er tann styttri parturin
illkalt	ráligt og kalt, rákalt,her er illkalt inni;illkalt var, kavaælingur stóð eftir fjøllunum
illkemban	(stb.)illneitan
illkenna	1deila, ilskast inn á, brigsla, leggja undir,illkenna e-n;hon illkendi seg sjálva fyri alt hetta2misbjóða, vanvirða, háða,eingin happar og illkennir meg;(bíbl.)biðið fyri teimum, sum illkenna og forfylgja tykkum3illkennastdeila, illneitast,teir tóku at illkennast um, at teir máttu bera fuglin til húsa;hann illkendist fyri seg sjálvan;konan illkendist inn á mannin
illkenning	tað at illkenna, vanvirðing, háðan,tá kundi eingin illkenning ganga honum nær longur
illketta	kv1í osb.sum tvær illkettur(um tvey konufólk sum illsemjast og físa hvørt móti øðrum)
illklæði(r)	vánalig klæði(uttan yvir betri);sbr.illbuksur
illkrút	(stb.)illsinnavætti,á, títt illkrút!
illkvendi	(niðr.)illført konufólk, bikkja, skarnskvendi,hetta er títt verk, títt illkvendi !
illkvæmisorð	ókvæmisorð
illkvæmur	1(um sár)sum skjótt tekur ilt fyri seg2(lækn.)illkynjaður(um sjúku)
illkykt	(dj.)lýs, loppuro.tíl.
illkynjaður	1(lækn.)álvarsamur, hættisligur, vandamikil,illkynjaður krabbavøkstur2(um fólk)við ringari muru, óreinur (2)
illkyrra	ókyrra,illkyrra var í sjónum
illlendi	(jarðfr.)oyðilendi berkað og gjøgnumgrivið av regni[en.badland]
illlitaður	illlittur,sjálvt hitt mjúkasta hold er illlitað
illlittur	1grómutur, illdámaður, illlitaður,teir floygdu ungarnir eru meira illlittir;hesi longu illlittu skýggini2(seyðal.)skjómutur, hjómutur, øskulittur
illlýsi	myrkligt lýsi (1), dimmlýsi,illlýsi á luftini;illlýsi undan heglingi ella toruslátti
illmegn	(skaldsk.)illur máttur, óndskapur,um myrkurs púki vil alt illmegn leggja til
illmeinskast	(stb.)meinskast, illkennast,eg illmeinskist ikki inn á tey
illmeintur	sum vil ilt, óreinur (2), illviljaður,eg helt einki illmeint vera í tí;teir eru so illmeintir;illmeint stikl
illmenni	beist, bartrog, búrhundur, bakbeist, óvætti,títt illmenni, slært tú eitt verjuleyst barn!
illminnast	vera illmintur,illminnast sum tarvur
illmintur	ímintur, langrøkin (3), hevnisamur
illmold	(niðr.)vánaslag(av fólki),illmoldin, hon fjalist ikki
illmoldartorva	1torva av vánaligum mógv2(flutt m.)vánaslag av konufólki;sbr.illtorva
illmorreyður	(seyðal.)við óreinum morreyðum liti
illmura	ring mura,ein illmura sprottin av sjúkum huga
illmuraður	(stb.)við ringari muru
illmutla	mutla ilskliga,knosar seg illmutlandi aftur á føtur
illmyrkur	l1:illmyrktmeira enn hálvmyrkt, rættiliga dimt;tað er illmyrkt innast við
illmæli	útspilling, bakbit
illmælismaður	(bíbl.)ein sum talar ilt um onnur, bakbítur
illmælisorð	(bíbl.)bakbit, illmæli,hví fert tú eftir illmælisorðum teirra
illmæltur	1ilskur á málinum, bítskur,hann beit hana av illmæltur2sum tosar illa um onnur,eitt illmælt lygivætti
illnati	1illvild, øvund, klandursemi,illnatið í smábygdum er ofta nógv;av ræðslu og berum illnati2óreint fólk, óargadýr,eitt illnati
illnatin	ilskur, knarrutur, óviðeiriligur,hann er altíð so illnatin
illnáðir	ampi,eg havi ongar illnáðir av tí
illneita1	illkvendi, óhirja, neita(Sv)
illneita2	stinga (5), glósa, agga (1),illneita e-n;tað hevði kanska trongst til, illneitar hon;illneitastdeila, ilskast, neita;hví illneitast vit um leys ross
illneitan	illneitilsi
illneiti	1illneitilsi, illvild, meinfýsni,í hansara lyndi er illneiti og óreinsskapur2(stb.)illstøða, ósemja,teir vóru komnir til illneitis
illneitilsi	tað at illneitast, gremjan, brigsl,og nú var gamli ikki longur við sínum illneitilsi;nú, nú, einki illneitilsi!
illneitin	illneitutur
illneitisliga	illneitut
illneitutur	ilskur, bítskur, bitutur,hann hugdi illneitut aftan á henni
illnit	eitt sum er óviðeiriligt, klandursvætti,illnit hava verið ímillum, ið klandrast hava við bygdarmenn
illnærisbrigsl	grovt og ósømiligt brigsl
illnærisætlan	ósømilig ætlan,tað má vónast, at henda illnærisætlan teirra ikki ber ávøkst
illorðaður	(altíð) við tí illa orðinum, ljótur í munninum,illorðaðar skuldsetingar;tigandi, men illorðaður, tá ið hann talaði
illortur	(sj.)illorðaður
illoygdur	ilskur í eygnabrá, við illum eygum
illpatan	illbati,tað var sum ein illpatan á honum, at okkurt fór at henda
illpati	illbati
illpjøskutur	illfjøskutur (1),har situr eitt gamalt við eldin og er so rísut og illpjøskut
illramur	sum luktar illa, ramur, svørmutur, køvandi,meðan eldurin reyk, var illramt inni;hann hyggur seg um og finnur tað ógvuliga illramt niðriundir
illreyður	við dimmum og grómutum reyðum liti,hesi gulu og illreyðu handilshúsini
illrið	(Suð.)tað at vera illa til passar, illhirsni,tað kom sovorðið illrið á meg
illris	ris í sjónum upp undir harðveður, uppundirris(Sv)
illroyndur	sum roynist illa, svikaligur,lúnut og illroynt er veðrið í apríl
illroyningur	einel.e-t sum roynist illa, svíkur,tann maðurin hevur eingin illroyningur verið;tað verður illroyningur í hoynum í ár;hasin báturin verður illroyningur;tað er ofta illroyningur í tí at bíleggja úr príslista
illrukkutur	trútin, tvitin,við einum illrukkutum skorti
illruskutur	heldur ruskutur, ófantaligur,illruskut veður
illryski	1bartrog, vittuggi,hann var eitt illryski og ein margskálkur2illgjørt fólk, ótrivavætti
illsemja	ósemja, illstøða, klandur,illsemja var hjúnanna millum;hon lá í støðugari illsemju við grannabygdirnar
illsemjast	sita illa um sátt, vera ósamdir,altíð illsamdust teir
illsinnabiti	(fólktr.)nasarót(har ið tey trúðu at illsinnið situr),illsinnisrukka
illsinnabløðra	ein sum er illsintur, illsinnavætti, illsinnapirra
illsinnagleps	gleps í illsinni, viðskurður
illsinnapirra	illsinnabløðra
illsinnaríð	tað at illsinni brádliga kemur í e-n, illsinnishirs,hon er sjúk, hevur fingið eina illsinnaríð
illsinnavætti	illsinnabløðra,lundar eru ringastu illsinnavætti
illsinni	tað at vera illsintur, sinnismunur, vreiði, øði,illsinni fleyg í hannøði kom í hann;illsinnið rann av hennihon sissaðist;kóka av illsinnivera í øðini;í illsinnií øði, í sinnismuni;blása seg upp í illsinni sum tarvurøsa seg upp;bróta illsinnið útloysa av at deila;fullur í illsinni
illsinnisgron	illsinnavætti
illsinnishirs	illsinnaríð
illsinnislúnur	(stb.)ein sum gongur fullur í illsinni,ein sovorðin illsinnislúnur
illsinnisrið	illsinnaríð,orð søgd í einum illsinnisriði
illsinnisríð	(sj.)illsinnaríð
illsinnisrukka	rukkan við nasarótina;sbr.illsinnabiti
illsinnisskriði	skriði sum fylgir illsinnisriðum(prikan niður í hárrøturnar)
illsintur	1sum lættliga verður illur, snarsintur, bráðlyntur2illur, argur, forsyndaður,illsintari og illsintari gjørdust tey inn á hann
illskapur	1tað ið ilt er, óndskapur,eg vóni at tú hevur fyrigivið okkum og gloymt allan illskap;illskapur og harðskapur2tað at vera illur (1), øði, (v)reiði
illskørutur	í ringum skørum, sum gevur ilt av sær, illfrýnutur
illslyðri	vánalig klæði(t.d. hosur og brøkur),far í hasi illslyðrini
illsnakin	illførur, bítskur, hvassorðaður,illsnakin og stækin og ógvisligur í framferð sínari
illstakin	1(um veður)ilsligur, ófantaligur, illfjøskutur,tað er so illstakið veður í dag2sum er illur í sær, bítskur, kvettin, illsnakin,hatta er so illstakið
illstøða	ósemja, illsemja, stríð, tvídráttur, klandur, træta, ódagar, deila,ofta stóð illstøða av slíkum;illstøða kom í millum hann og føroyingar
illsvartur	(seyðal.)dimmgráligur,tá ærin var lamb var hon svørt, men hon er lýsnað við aldurin, so nú er hon illsvørt
illsvermutur	(stb.)illa til passar, illhirsin,tú er so illsvermutur í høvdinum, tá ið tú hevur krím
illsvørmutur	illramur,her er so illsvørmut inni
illsvøvntur	við ringum svøvnlag
illsýnt	sum sæst illa aðrastaðni frá, ósýnt,har er so illsýnt, har er gott at krógva seg
illtanki	illgruni
illteinkja	hava illgruna til, illhugsa, illgita,fólk illtonkti hann fyri at hava dripið hana
illtet	(gl.,stb.)ein sum altíð er misnøgdur og í ringum lag, ríggjuskøltur, knarr, grenj,hatta er eitt illtet
illtolin	(stb.)ótolin
illtonktur	sum hugsar ilt um onnur, illtrúgvin, illgrunasamur (1),hon var ikki illtonkt í sínum eydnudøgum
illtorva	hálvrá torva(liggur longst á),(flutt m.)hatta situr sum ein illtorva (við eldin)(illhýrd og knarrar øðrum til ampa);sbr.illmoldartorva (2)
illtrivin	(sj.,stb.)ófantaligur, ónossligur
illtrívast	mistrívast, vantrívast
illtrúgv	mistrúgv, illtrúni
illtrúgvin	mistrúgvin, illgrunasamur
illtrúni	illgruni, illtrúgv
illtungur	ið kennist tyngri enn er, óhøgliga tungur, dragsutur,illtung er fuglabyrðin;illtungt er at bera saltposa á bakinum langan veg;illtungt var at knosa seg fram eftir hesi bleytu mómýrini
illturt	toluliga turt, mestsum íslitið,tað hevur regnað illa, men nú er illturt;tað var illturt av luft
illtýggi	ótýggi, týggidýr
illunnilsi	tað at unnast illa,tað kemur eitt sovorðið illunnilsi á hann, ein sovorðin trongd
illur	1óður, vreiður,óndur (2),vera illur við e-n;vera illur inn á e-n;vera illur um e-t;fúkandi (rúkandi, kókandi) illurí øðini;illur tarvur(óður);ilt fleyg í hann(gjørdist brádliga óður);ilt kemur í e-n(ilskast);ilt er í e-m(óður);fáa ilt í e-n;loypa ilt í e-nfáa øði í e-n;tá var ilt í nøsini á øllumtá spann øði í øll;hava ilt inni við e-nbera agg til e-n;vera illur í sær(harðligur í orð og tal, í ringum lag, bítskur);av illumí øði, í álvara(ikki í spølni),dreingirnir bardust av illum;í illumí illsinni,onkur drongur rýmdi heim í illum2ringur, óndur, vándur,siga ein illan fyri e-t(lasta e-n);vera við tí illa orðinum(við tí ringa orðinum);gera ilt verrigera meira skaða enn gagn;hvør ill krákan er, so er hon hjá okkum alt árið;so langt sum eitt ilt ár(sera drúgt);gera e-t av illari ætlan;hann hevur eitt ilt hjarta(er eitt ringt fólk);í illum líkiófantaligur, illa gjørdur,fekst hann at lata nakað úr hondum, var tað altíð í illum líki;kom hann, var tað í illum líki(bara til at gera ónáðir);tað var strevið arbeiði at skera akur og ilt fyri ryggin;illur andi,síandi (5);ill eyguónd eygu;illi maður,síillimaður;ill tungaspírstunga;illar tungurbakbit;ikki má ilt orð sigast innan fyri fjósdyr;eingin veit, nær tann illa stundin er(óhappaløtan);(tilt.)ill ráð fáa bráðan enda;(tilt.)ilt er skap at eggja,sískap;(kvæð.)ilt er til forlag at kvíða,síforlag 2;(kvæð.)elvist her illur vandi(stórur vandi);(kvæð.)ilt hevur tú verkið vunnið(ónda gerð);bera iltbanna;bera e-m ilttosa illa um e-n;berael.seta ilt fyri e-nbaktala e-n;gera iltgera herverk;seta ilt ímillumíbirta illstøðu;teir vita ikki, hvat ilt kann njótast av tí(gera sær ikki grein fyri fylgjunum av e-m);slíta iltvera fyri vanlagnu;við hvørt spyrst ilt burtur úr slíkum(ólukka);grunael.óra iltvarnast at e-t er áfatt;lova ilthótta;hava ilt við segfáa mótstøðu, vera fyri ágangi;ilt liggur á tísama ger, tað hevur ongan týdning;av tveimum illum(tveimum ringum kostum);við illumvið hørðum;av illumfyrr enn ikki,av illum mátti tú farið hagar kortini;í illumí armóð,doyggja burtur í illum;tað er illum líkt(sær ikki væl út, einki gott at vænta);enn er ilt ókomiðenn er tað versta eftir;(tilt.)tann, ið ilt hugsar, ilt ger;(tilt.)hann, ið ilt gitir, hann ilt ger;(orðt.)ilt nýtstel.vinst av illumtað kemur aftur um brekku at gera ilt;(orðt.)ofta nýtst ilt av bræði,síbræði;(um sjúku)loypa ilt áelva til lívsýki,men etið nú ikki so nógv, at tað loypir ilt á tykkum3torførur, ringur,nú var ilt við at gera(ringt við at gera);har var ilt at koma at(illgongt);ilt var at síggja at seyma;tað er ilt at skilja;hava ilt við e-tikki vera væl førur fyri e-m,hann hevði ilt við at ganga;hann gjørdi ilt í sjógvin(øtlaði);(orðt.)gamal(ur) ravnur er illur at narra;(orðt.)ilt er svart skinn hvítt at tvá4ússaligur, neyðarsligur, jánkasligur,ein illan hundraðkrónuseðil læt hann;tvey lógu í einum illum av einari song(í eini vánaligari song);trý ill tandur(neyðardýr);(kortsp.)fimm ill(um ringt meld í sjavsi)5(um klæði)gomul, slitin, illa farin, neyðarslig,einar illar hosur;í illum spjørrumí kloddum6(um tík og kettu)ganga á illumvilja makast;sms. t.d.av-,brot-
illvari	illgruni,hava illvara um e-t
illvarin	illgrunasamur
illvarningur	illgruni, varhugi,hava illvarning av e-m
illvánir	ringar vánir, vánalig líkindi
illveður	1ringt veður, vánaveður,hann gjørdi illveður av útsynningi;er illveður í, skal verða gott veður sunnudag2(kortsp.)(í stýrivolti)spæla illveðurspæla hart og royna vol, spæla ódn
illveðursdagur	dagur við illveðri
illveðursdámur	dámur av illveðri, illlýsi
illveðursfiskur	nógvur fiskur fingin á einum stampi(og eingin á hinari línuni),hetta eru illveðursfiskar(fyri illveðri)
illveðursfrøi	(stb.)frøi ið kann koma á fólk upp undir illveður
illveðursfuglur	fuglur sum boðar frá illveðri, óveðursfuglur(t.d. kvørkviski og óðinshanar tá ið tey eru at síggja millum húsa)
illveðurshol	(niðr.)bygd har ið ofta er illveður
illveðursketta	(stb.)ketta sum spælir upp undir illveður
illveðurskráka	óveðurskráka (2),tú ert ein verri illveðurskráka
illveðurskvøld	kvøld við illveðri
illveðursligur	óveðurskendur, ilsligur, ófýsin,heystið var illveðursligt
illveðursmerki	merki ið boðar frá illveðri,sbr.veðurmerki;(flutt m.)best sum var, var illveðursmerki á lofti, og brátt stóð alt í einum roki
illveðursnátt	nátt við illveðri, óveðursnátt,tað var ein røtt illveðursnátt
illveðursskýggj	óveðursskýggj,hann hevði hópað illveðursskýggj upp á luftina
illveðurssós	(sjóm.,skemt.)tjúkk sós
illveðurssummar	summar við illveðri, vánaligt summar,árið eftir var eitt illveðurssummar
illveðursætt	ætt 2(2) ið ofta hevur illveður við sær
illverk	illgerð,(bíbl.)hvør tykkara vendir við frá illverkum sínum
illvild	agg, illvilji, óvilji, fokn,hann hevði illvild til hansara
illvildarmaður	ein sum vil e-m ilt, fíggindi, øvundarmaður
illviljaður	sum hevur illviljael.illvild til e-n, fíggindaligur,ein illviljaður maðurillviljamaður
illviljamaður	illvildarmaður,hann varð av illviljamonnum klagaður fyri yvirvaldinum
illviljandi	illviljaður
illvilji	1illvild,hava illvilja á e-m;bera illvilja til e-n;ein knappligur illvilji kom á hann móti konuni2(stb.)illgruni, varhugi,hava illviljan til, at okkurt fer at henda
illvirki	illverk
illvirkin	illgjørdur, óvandaligur,hann er so illvirkin
illvirkni	tað at vera illvirkin
illvitin	(stb.)illvíkin, firtin,hon er tvør og illvitin
illvíggin	ilskur, illførur, bitutur, firtin
illvíggjutur	1illvíggin2(um veður)ilsligur, ótýdligur,illvíggjut veður
illvíkin	illvíggin
illvorðin	(sj.)illavorðin (5),illvorðið skýggj
illvætti	óargadýr, skarnsvætti, bartrog
illvøkstur	(lækn.)illkynjaður vøksturel.knykil, svullur
ilnar	í osb.koma til ilnar við e-ngerast ósamdur við e-n;teir komu til ilnar (um e-t)(vórðu ósamdir);tað kom til ilnar teirra millum(til ósemju)
ilnaris	(sj.)í osb.koma til ilnariskoma til ilnar
ilnast	ilskast, verða ónøgdur(við e-t),ilnast inn á e-n;ilnast um e-t
-ilsi	(eftirfesti),sí t.d.bang-,dán-,fang-,hamp-,játt-,líkn-,nøtr-,op-,rimp-,rok-,royk-,sip-,skep-,sor-,stív-,svím-,víð-,vælsign-,ør-
ilska1	1vreiði, øði, illsinni,ilskan breyt í honumhann var í øðini;ilskan tustist upp í hannøði kom í hann;hann goymir ikki ilskuna leingi(blíðkast skjótt aftur);(kvæð.)bæði av ilsku og reiðiel.bræði2óndskapur, illskapur,(kvæð.)til ilsku fúsaltíð fúsur at gera ilt3illstøða,ilska var millum bæði húsini41óreinska úr bræddum málmi,teir koyrdu málmin úr einum eldi í annan, til teir fingu skilt ilskuna frá2hálvbrunnið smiðjukol sum loypur saman, skella 25pína, sjúka, brek,hon var nærum at spreingjast av ilsku;tað man eingin ilska vera, ið tær brekar;ilska kom í sáriðtað tók ilt fyri seg;hann hevði eina so undarliga ilsku í búkinum;hevði onkur sligið meg, ilskuna hevði eg kent6(um veður)illveður, rupul, drabb,ilska í sjónum;sjóvarilska;sms. t.d.búk-,gos-,hjarta-,lenda-,maga-,sjóvar-,spýggju-
ilska2	øsa, reita, arga,ilska e-n upp;ilskastgerast óður, øsast, ilnast,teir standa og ilska um standin og stýrið;hann ilskaðist um lagnuna
ilskin	ilskur,við ilsknum eygum
ilskliga	ilsliga,gakk ikki her og órógva meg, segði hann ilskliga
ilskligur	ilsligur (1)
ilskna	sbr.ilnar
ilskógvur	hørð deyð húð undir ilini, iljarskógvur (2)
ilskubragd	1illgerð, misgerð, brotsgerð,hann flýddi haðani fyri manndráp og onnur ilskubrøgd2bragd (5) sum sýnir øði,einki ilskubragd sást á honum
ilskubøkil	(bíbl.)bøkil av ilsku (4),silvur títt er vorðið at ilskubøklum, vín títt tynt við vatni
ilskuferil	feril av pínu,fer aldri hesin ilskuferilin burt
ilskufúsur	illfúsur,hann stóð ilskufúsur og hóttaði framman fyri skiparanum
ilskugrand	(kvæð.)skaði, mein, løstur,hon tók frá honum møði alt og so hans ilskugrand;hann kveikir ilskugrand
ilskur	1illur, illfúsur, ilskin,ilskur á málinum;ilskur skuldi hann vera, tá ið hann frætti tað2meinskur, óreinur (2),hann var ilskur við smámenn
ilskuráð	svikaráð, ráðagerð,leggja ilskuráð móti e-m;hjarta, ið umhugsar ilskuráð
ilskusnúgvin	(kvæð.)ilskufúsur,(skaldsk.)Sátan ilskusnúgvin til ferðar er nú búgvin
ilsliga	ilskliga, bítskliga,hann hugdi ilsliga at henni;hundarnir goyðu hart og ilsliga
ilsligur	1heldur ilskur, ilskligur, bítskur, bitutur2illfýsin (2), ruskutur,ónossligt og ilsligt veður;ilsligur vindur;eitt ilsligt kvøld;ilslig skýggj3illa ílatin, ófantaligur,hatta gongur so ilsligt4óhugnaligur, óunniligur,tað var so ilsligt at koma inn;hj-liga
ilsmansboð	(sj.)illmæli, ósannindi
ilsvíggin	illvíggin
ilsvíggjutur	illvíggjutur
ilsvíkin	illvíkin
ilt1	(evnafr.)súrevni
ilt2	síillur
ilt3	sárt, skaðiligt, meint,fáa ilt1fáa pínu2(um barnakonur)fáa verkir;hon hevur fingið ilt við barni;hava ilt fyri tonnum(um pinkubørn);ilt loypur á einein fær lívsýkiel.leyst lív;tað tekur ilt fyri seg(fer at svølla);hava ilt fyri hjartanumvilja spýggja, vamlast;í osb.hava ilt av e-mhava ampa av e-m
imbrimil	(fugl.)havgás,tá ið teir hoyrdu havgás um morgnarnar á veg til útróðrar, plagdu teir at siga: "Tað verður gott veður, imbrimilin letur í morgun"(góðveðursmerki)
imperialisma	tað at havael.fáa politiskt, hernaðarligtel.búskaparligt vald á økjum uttanlands(serst.nýtt um hjálandaveldini í seinnu helvt av 19. øld),tann italska imperialisman hevði fingið fótafesti í italska Eritrea í Afrika
imperialistiskur	sum fremur imperialismu, ið kemur til sjóndar sum imperialisma,tey kapitalistisku og imperialistisku hjálandaveldini liggja í deyðskrampa
imperialistur	ein ið tekur undir viðel.fremur imperialismu
impressionisma	listaligt rák ið kom fram uml. 1870 innan myndlist, bókmentir og tónleik(har ið listafólkini royna at endurgeva sansaávirkan)
impressionistiskur	viðv. impressionismu,impressionistiskir málningar
impressionistur	ein ið er ávirkaður av impressionismuni
-in1	sbr.hin
-in2	(eftirfesti),sí t.d.fáin,ilskin,minnin
-inda	-inna
indari	fólk íel.úr India, indverji, indiamaður
-indi	(eftirfesti),sí t.d.eirindi,herðindi,kyrrindi,ørindi
India	land í Eysturasia
Indiahav	(stn.)eitt av heimshøvunum(millum Afrika og Avstralia)
indianari	frumbúgvi í Amerika, indiáni
indiáni	frumbúgvi í Amerika, reyðmaður
indigo	serstakur dimmbláur litur
indiskur	íel.úr India
indoevropeiskur	(málfr.)ið hoyrir til ta málætt ið flestu mál í Evropa og Vesturasia eru sprottin úr,indoevropeiskt(til indoevropeisk mál hoyra t.d. germonsk, slávisk og rómonsk mál umframt nógv mál í India)
indrasótt	sjúka í innvølunum á seyði(Sv Indb.736;Landt362)
indur	1lítil kúput hít seymað úr (seyða)vomb til at kóka blóðmør í(stundum lokað við blóðmørspinni),hon letur blóð upp í indrini2blóðmørsindur, pylsuindur3(kvæð.)innvølur (í fólki),risin treiv í hansara kvið, so indrini hingu út;sms. t.d.blóðmørs-,langa-,pylsu-,vambar-
indursárur	við bróstsviða(fyri flagbróstinum)
indursjúka	(stb.)magasjúka(hjá fólki)
indursjúkur	(serliga um seyð)sum hevur indursjúku, indursárur
indverji	indari
indverskur	indiskur
inflatión	(búsk.)tað at lønir og prísir hækka við teirri avleiðing at peningsvirðið minkar
influensa	(lækn.)virussjúka sum smittar illa(oftast við nógvum fepri og beinverki),beinkrím
-ing	(eftirfesti),sí t.d.manning,æsing
-ingi	(eftirfesti),sí t.d.armingi,letingi
ingifer	turkað rót av ingiferplantuni(brúkt til kryddarí)(Zingiber officinale)
-ingur	(eftirfesti),sí t.d.árnfirðingur,blendingur
inkalilja	(plfr.)planta í slektiniAlstroemeria
inn	1(um húsel.rúm),út og inn;mala út og inn;fara inn(í hús);(stb.)fara innfara úr Havn inn á Skálafjørðin;seta e-t inn(t.d. í hús, kjallara, í hjall o.s.fr.)2(saman við sagnorði)t.d.bera inn;binda inn;fara inn;flyta inn;ganga inn;leggja inn;rópa inn;seta inn;taka inn;giftast inn(sísagnorð)3(saman við fs);inn at:inn at landiundir land;inn av:inn av haviuttan av havi;inn á:inn á fjørðin;bera inn á borðiðborðreiða;inn á gólvið;sígólv;inn fyri:koma inn fyri gáttina(innum);inn gjøgnum:inn gjøgnum fjørðinmóti fjarðarbotninum;inn í:inn í bygdina;inn í dalinfram í dalin;inn í bátin(umborð);inn í náttinaút á náttina;børnini spældu inn í myrkrið;inn um:inn um hurðina;inn um nesið;inn um oynna;inn undir:inn undir landat landi;keypa inn undir seg(niðurfyri);inn úr:inn úr havinumuttan av havi;kalt gul stendur inn úr havinum;inn yvir:hann fleyg inn yvir Havnina
-inna	(eftirfesti),sí t.d.gud-,lærar-
inna	1gera, fremja, greiða úr hondum,(kvæð.)mangt kann hon at inna;(bíbl.)Harrin rættvísi innir;hann inti stórt lívsverk;(skaldsk.)her er einki roysnisverk at inna2siga, føra fram,(kvæð.)tungan mælir at inna;inna umnevna, minna á(Sv)3(teld.)gera tað sum liggur í forriti[en.execute];sms.full-,út-
innan1	1við rørslu úteftir, frá innari stað, innanífrá, innaneftir, út,innan av landiút á sjógvin;hann er komin innan av Skálafirði(t.d.til Havnar);innan úr húsinum;innan úr sundinum(út)2á innaru síðu, innarumegin, innvortis, inni,móts.uttan,innan og uttan:fiskahjallarnir kundu vera fullir bæði innan og uttan;innan í jørðini(inni);nógv gekk innan í honum,síganga;innan fyriel.fyri innanlongri inni enn (e-t annað),trolararnir trola innan fyri mark;innan um:turka innan um ílatiðturka ílatið innan;innan undir klæðunumnæst kroppinumfs3innan fyri, fyri innan,innan galvs og gáttainnanhýsis;innan garðainnangarðs;innan veggjainnanhýsis;(kvæð.)innan hallarinni í høllini;(stn.)Innan Glyvur;Innan Barm;Innan Garð;Innan Svað4(um tíð)áðrenn liðin er, fyri,innan tríggjar mánaðir
innan2	1áðrenn,innan dagur at kvøldi kemur2(stb.)ið,skamm fái hetta, innan tungt ikki er;í hann, innan býttur ikki er;smátt í ta huldukonu, innan skjótt ikki gekk3(stb.)um 2(2),eg spurdi hana, innan hon væntaði hann at koma
innanat	(stb.,sj.)innaní,summi lósu nøkur vers innanat, og so høvdu vit ein sálm uttanat
innanbarms	í barmi, í hjartanum (5),ein lítil fløvi, ið ferðast hevur, innanbarms brýtur sær fram
innanbeina	innanvert á beinunum,seymur á buksunum innanbeina
innanbergs	(bjarg.)í berginum (sjálvum),móts.uttanbergs,ganga innanbergs(eftir rókum í berginum);søkja fugl innanbergs(í berginum sjálvum)
innanbíggjar	í bygdel.býi, innan fyri bygdar-el.býarmark
innanbjálka	innan fyri uttasta bita í roykstovu,móts.uttanbjálka,friður uttanbjálka, men ófriður innanbjálka(FFÆ11)
innanborða	umborð (á báti), innanborðs,kapprógva innanborðakapprógva borð við borð;sbr.keikja 2
innanborðs	innanborða,kapprógva innanborðs
innanborðskappróður	kappróður innanborðs,innanborðskappróður, hann var skaðiligur
innanbógva	innan á bógvunum,nú eigur alt at vera liðugt at tumma uttan bringan og tað, vit rópa innanbógva(RJ Býta seyð51)
innanbrek	brek innvortis,lekja húðarsjúku og innanbrek;hann hevur einki innanbrek, hann er sum fjallið
innanbrósts	í barmi, innanbarms,bráður logi leikaði innanbrósts hjá teimum
innanbygdar	í bygdini,felagsskapurin innanbygdar losnaði
innanbygdarmaður	maður ið býr í bygdini, bygdarmaður,tú ert innanbygdarmaður, eg bjóði tær bara inn higar
innandals	(stn.)inni í dalinum
innanding	tað at anda inn
innandura	inni, innanveggja, innanbjálka,móts.uttandura
innaneftir	úr staðel.bygd longri inni(t.d.úr Sundalagnumel.av Skálafirði),hon var innaneftir og var beint komin við mjólkarbátinum til Havnar;alt ferðafólk, sum kom innaneftir og skuldi á Fútaklett
innaneftirlit	innanhýsis góðskueftirlit á virkjumt.d.flakavirkjum
innaneggja	á upsini(millum egg og berg),seyðurin gekk innaneggja;ikki fara ov langt oman innaneggja
innanfelags	í felagnum, millum felagslimir,áskoðanirnar innanfelags vóru misjavnar;nógv klandur voldi uppskotið innanfelags
innanfjarðaður	l6í osb.innanfjarðaður kobbisteinkobbi;sbr.uttanfjarðaður
innanfloks	(stjm.)í flokkinum, innan flokkin
innanfóta(r)	innanvert á fótinum,(tilt.)tann sum traðkar tuflurnar ella skógvarnar meiri innanfóta(r), traðkar eydnuna til sín
innanfrá	innanífrá
innanfyri	innan fyri e-t, fyri innan, innarumegin,fiska innanfyri(innan fyri fiskimarkið);skotskur trolari fekk stóra bót fyri at fiska innanfyri;teir tóku hann innanfyri(mann ið fleygaði ólógliga í bjørgunum);hava lítið innanfyrihava lítið til vit;hann hevur ikki nógv innanfyri;hon hevur ikki heilt einki innanfyri;hava nógv innanfyrivera drukkin
innangarða	l óbí osb. sum(bún.)tá ið innangarða ertá ið alt útiarbeiði á heysti er liðugt;tá ið innangarða var, varð hugsað um at fara í rokkin;tá ið innangarða var, fór bygdarfólkið, helst tey ungu, at læna dansistovu
innangarðs	innan fyri (bø)garðarnar, í bønum,móts.uttangarðs,hann eigur eina hálvmørk innangarðs;tað bítur innangarðs hjá honum(Sv)1hann er múgvandi maður2hann er fullur í lúsum
innangarðsjørð	jørð innangarðs, bøur
innangarðsmørk	mørk í jørð innangarðs
innangleði	still gleði,hetta jólaaftanskvøldið var ein friður og innangleði yvir henni
innanhaga	(um seyð)í sínum hagaparti,fylgið fór til stroks, men til fjalltíð um heystið var tað aftur innanhaga
innanhalla(r)	(kvæð.)inni í høllini,bardust báðir innanhalla(r);er hon nøkur innanhalla(r), tín stár hugur á?
innanhanda(r)	innanvert á hondiniel.arminum,oman fyri albogaliðin innanhanda(r)
innanhjólaður	sum hjólað er innan úr, innskaraður,ein innanhjólaður planki
innanhokin	fáorðaður, fálátaður, innisælur, hvørvin,hann er so innanhokin;eitt myrkt og innanhokið menniskja
innanholaður	innfallin, slunkin, soltin, rak,hann var bleikur og innanholaður í andliti;kúgvin er innanholað
innanhuga	í huganum,tað, ið gevur bókini spenning, eru hendingar innanhuga hjá gentunum
innanhúsa	(stb.)innanhýsis
innanhýsis	inni, innanveggja, sínámillum(í húsum, feløgum, stovnum o.s.fr.),móts.uttanhýsis,smáligt er innanhýsis(lítið at eta);friður og óttaloysi skuldu nú vera innanhýsisóbl:innanhýsis próvtøkapróvtøka við próvdómara frá útbúgvingarstaðnum
innanhýsisarbeiði	arbeiði sum gjørt verður við hús, inniarbeiði
innanhýsisfólk	húsfólk, fólk í sama húsi
innanhýsisklandur	klandur millum húsfólk
innanhýsislív	heimalív, húslag
innanhýsismynd	myndel.málningur av e-m inni í húsi[da.interiør]
innaní	hjí osb.lesa innanílesa í bóko.tíl.,sbr.uttanat
innanífrá	innan úr (e-m), innaneftir,móts.uttanífrá,tá ið hann nærkaðist húsinum, hoyrdist gleimur og dun innanífrá;hurðin var stongd innanífrá
innanjarðar	inni í jørðini,fjøllini eru skotin upp av teim sterku kreftum, ið leika innanjarðar
innankátur	kátur á stillføran og fjálgan hátt,hann var eitt sindur innankátur av lyndi;eyguni livdu í teimum vakin og innankát
innanklædna	1undir klæðunum,regnið rennur niður innanklædna;skaðin var innanklædna(á kroppinum sum klæðini hylja)2viðv. undirklæðum,har man ikki vera so mætt innanklædna(í vánaligum (og skitnum) undirklæðum);sbr.uttanklædna
innanklæða	innanklædna,innanklæða og uttanklæða;rein og heil innanklæða;eru tær ikki líka fríðar innanklæða sum hesar silkiklæddu
innankníggja	innan á knøunum,ilskan situr innankníggja
innanknænna	(stb.)innan á knøunum (el.knænum), innankníggja
innankomin	komin innanífrá,innankomin sjúka
innankuldi	innvortis kuldi, innkuldi
innanlands	í landinum, innanlendis,móts.uttanlands,flogferðir innanlands
innanlandsstríð	stríð (1) millum landsmenn, borgarakríggj
innanlandstíðindi(r)	tíðindi úr landinum, heimatíðindi
innanleggjar	innan á legginum
innanlendis	innanlands,marknaðurin innanlendis
innanlív	sálarlív
innanlæra	innanlærs,hann gevur honum eitt dúgligt klíp innanlæra
innanlærs	innan á lærinum,hann klípti hann innanlærs
innanmaður	maður sum býr innari(í oyggj, við fjørð el. sund),innanmenn komu út á Toftir
innanmynd	innanhýsismynd
innannøra	(lívfr.)hava (framhildið) kynbland millum skyldar einstaklingar
innannøring	(lívfr.)(framhildið) kynbland millum skyldar einstaklingar[en.inbreed]
innanopin	opin innan,teir stóru innanopnu leggirnir
innanorka	orka sum býr innan í e-m,innanorkan í atomunum
innanoyggja	1í Føroyum, innanlands,tíðindi innanoyggja2millum oyggjarnar, innan fyri landoddarnar,lágur landnyrðingur og útsynningur vóru góðar útiróðrarættir innanoyggja
innanoyrna	fyri oyrunum, í huganum,ein hoyrdi ljóðið innanoyrna langt aftaná, at hann hevði talað
innanríkis	í ríkinum(t.d. danska kongsríkinum),innanlands,móts.uttanríkis
innanríkismál	(stjm.)innlendsk mál 1(7) í einum ríki,Fólkaflokkurin harmast, at ein danskur politikari leggur seg út í ísraelsk innanríkismál
innanríkismálaráð	(stjm.)stjórnardeild ið hevur innanríkismál um hendur
innanríkisráðharri	(stjm.)ráðharri ið situr fyri innanríkismálum
innansjón	tað ið ein sær fyri sær í huganum,sær sum í innansjón seg sjálvan gamlan mann
innanskalla	í høvdinum, í huganum,tað man vera eitt ræðuligt órudd innanskalla í hesum góða manni
innanskins	undir skinninumel.skræðuni, innan,tú fórt beinanvegin at hugsa um, hvussu vorðin hesin stórharrin var innanskins
innanskipan	innbúgv,innanskipanin í kirkjuni
innansóknar	í sóknini
innanstýri	innanhýsis stýri, heimastýri,veitingarnar frá ríkinum til Føroya innanstýri
innansyndis	inni á sundumel.fjørðum, innanoyggja,áður var klappus ikki so sjaldsamur í Føroyum, hvørki uttansyndis ella innansyndis
innansyndismaður	innansyndismennmenn ið ikki búgva á brimplássi
innantanna	ljódliga, fyri seg sjálvan, spakuliga(so at onnur ikki hoyra),mutla innantanna;banna innantanna;teir løgdu seg niður og hildu bøn innantanna;hann var í øðini innantanna
innantannalestur	tað at lesa innantanna
innantil	innanfyri, innanvert,vera innantil undirvera á floti innan fyri rákið
innantings	inni á (løg)tingi,fútin spurdi, um nakar innantings ella millum almenningin hevði nakað kærumál at flyta fram
innantómleiki	tað at vera innantómur (2)
innantómur	1tómur innan, innanopin,innantóm tonn;í einum innantómum træ2sum hevur lítið upp á seg, virðisleysur, innihaldsleysur, óektaður,innantómt tos3fávitskutur, býttligur
innantramaður	ikki heilt fullur, ikki javntramaður,ílátið er innantramað(upp til eitt sindur niðan fyri tromina);leypurin er innantramaður
innantrongd	(lækn.,sálfr.)sálarlig trongd, tregi (1)
innantrongur	trongur innan,hann hevur avdúkað tann innantronga køst, sum floksleiðslan er vorðin
innanundir	undir (uttaru) klæðunum,hava eina troyggju innanundir
innanúr	hj:taka innanúrtaka innvølirnar úr,hann var sum ein innanúrtikin skarvur
innanveggja	inni (í húsi), innanhýsis,sita tryggur innanveggja;berligt innanveggja(smátt við mat)
innanveggjaður	sum eigur inni,vera væl innanveggjaður við e-mvera væl áborin við e-t
innanveggur	veggur inni í húsi(innsíða á útveggi),fram við hesum naknu, kálkaðu innanveggjunum
innanvert	innanfyri, innarumegin,í líðini innanvert á oynni;innanvert við (e-t)tætt innan fyri
innanvødda	(lækn.)inn í vøddar,tilbúningur at geva innanvødda
innanæðra	(lækn.)inn í æðr(ar),sprænt inn innanæðra
innanættar	í ættini 1(1)
innanættargifting	samangifta
innar	(inni í húsum)inn, longri inn, úr einum ytri rúmi í eitt innari,móts.uttar,fara innarfara úr køkiel.roykstovu inn í stovuna;fara innar í kór;innar í stovuna;innar eftir gólvinum
innareftir	inneftir(í húsi),øll venda øvugt: eyguni uttareftir og afturpartin innareftir
innari	1l miðstið er longri inni,(stn.)Innari Barmur;í Innara Dali2hj miðstlongri inni,innari í stovuni;mær er annað innarieg havi annað at hugsa um(serst.e-t ringt)
innarlaga	rættiliga langt inni
innarliga	inniliga,biðja innarliga
innarumegin	á innaru síðu, innan (2)
innast	longst inni, inni ígjøgnum,móts.uttast,innast á botni
innastur	sum er longst inni
innat	inn ímóti landiel.lendingini,báturin kemur innat
innav	inn av streyminum,tað eydnaðist teimum at fáa skipið innav, áðrenn útstoyturin kom;vit fóru innav at vita um vit fingu nakrar brondingar fyri rák
inná	1[ɪˈnɔa]longri inn (frá tromel.kanti),hann førkaði seg inná aftur;(í bergi)hann kom inná aftur(av eggini)2[ɪˈnɔa](inn) ímóti(t.d. landi, skipssíðu o.s.fr.),vindurin lá inná;tað var alda inná og rull í sjónum3[ˈɪn:ɔa]inneftir,stíga innávera innføttur
innbakaður	(sbr. postei)
innballaður	vavdur inn (ít.d.pappír, klæði), innpakkaður
innballing	innpakking
innberadagur	dagur tá ið tað viðrar at bera hoyggj inn,í morgin verður innberadagur
innbering	tað at bera hoyggj inn, hoybering
innbilningur	tað at billa sær e-t inn, ímyndan, gykl, heilaspuni
innbilskur	sum heldur nógv um seg standa, erpin, ansaligur
innbinding	1tað at binda bók inn2bind (3)3tað at binda inn á bás(t.d. neyt um heystið)
innbindingartíð	tíðin um heystið tá ið neytini verða bundin inn á bás,fjósið verður liðugt til innbindingartíð
innbjóðari	ein sum býður (inn)(t.d. til fundar),innbjóðingarmaður,teir stóðu sum innbjóðarar til fundin
innbjóðing	tað at bjóða inn,hon sendi teimum innbjóðing at koma á fundin
innbjóðingarmaður	innbjóðari
innblástrarháttur	(lækn.)háttur at geva andahjálp við at blása í munn og nasar
innblástur1	íblástur 1
innblástur2	íblástur 2
innboð	(kvæð.)innbjóðing (at gista),annað ert tú Grímur verð enn innboð av mær tiggja
innborin	innføddur
innbrendur	sum er brendur inn í e-t,árarnar høvdu innbrent navn
innbrot	tað at bróta inn(serst. til at stjala),búrbrot,eitt brotsmannalið hevði framt innbrot
innbrotsmaður	ein sum brýtur inn(til at stjala),innbrotstjóvur, búrtjóvur
innbrotstjóvur	ein ið brýtur inn til at stjala
innbundin	(um bók)í stívari permu
innbúgv	lutir til nýtslu inni í húsit.d.stólar, borð, seingir o.a., húsbúnaður, húsgøgn
innbúningur	innbúgv í heild[da.inventar]
innbygdarfólk	fólk í bygdini,móts.avbygdarfólk
innbýur	miðbýur,kvirran seig niður yvir innbýin
inndjúpur	(stb.)atdjúpur,har er so inndjúpt, at slupp kann leggja at
inndottin	dottin innel.niður (t.d.í hús),takið á gróthúsinum var inndottið
inndrag	(Suð.)fløðandi sjógvur, inndráttur, innfylling, innsúgur,móts.útdrag,við hvørt kemur inndragið eins og ein long skúmut tunga niðan eftir sandinum
inndráttur	inndrag
inndyr	(sj.)dyr úr forstovu inn í køkel.roykstovu,hann hongdi koluna beint fyri inndyrnar;sbr.innhurð
inneftir	1á leið inn, longri inn,móts.úteftir2inná (3),hann gekk inneftir við fótunum
innfallin	innanholaður, rak,kjálkarnir vóru innfalnir
innfararloyvi	loyvi til at fara inn í land, innferðarloyvi
innfaringartíð	tíð at fara inn, húsatíð,tá ið innfaringartíðin kom, góvust børnini við spælinum
innferð	ferð aftur at landi av útróðri,innferðin gjørdist vandasigling av ringasta slag
innferðarloyvi	innfararloyvi
innfesti	(málfr.)orðliður settur inn í orðstovn(at gera annað orð),innskoyti[da.infiks]
innfit	innara fitja á gásarfóti,móts.útfit
innfjørður	(sj.)lítil fjørður inn av størri firði,innfirðirnir hava verið lokaðir av gleri(um útl. viðurskifti)
innflutningsgjald	(búsk.)gjald á (vøru)innflutningi úr útlondum
innflutningsloyvi	loyvi til at flyta inn vørur úr útlondum
innflutningsmaður	ein sum flytur vørur inn úr útlondum, innflytari
innflutningstollur	(búsk.)tollur á innfluttum vørum
innflutningur	tað at flyta inn vøru úr útlondum, innflutt vøra,móts.útflutningur[da.import]
innflytari	ein ið flytur inn (t.d.vøru), innflutningsmaður
innflýggjan	tað at flýggja (2) inn
innflættaður	sum er flættaður inn í
innfylling	1(stb.)inndrag2fylling av grótio.ø.tilfari(t.d. undir gólvi),í innfyllingini undir tigulgólvinum hava vit funnið mynt frá 1667
innfyri	1innum,bróta innfyri(t.d. horn á bókarblaði)2(ítr.)sparka innfyri(frá síðuni og inn móti málinum)
innføddur	føddur í landinumel.á staðnum, innlendskur, innborin
innføðingur	innføddur maður(serst. av frumfólki í fjarskotnum landi)
innførsla	innflutningur
innføttur	sum gongur við fótunum inneftir, sum stígur inná,hann var hjólbeintur, innføttur og slútakslaður
innganga	viðganga, játta (2), íganga,hon inngekk tað, at hon hevði sagt tað;hetta varð bóndin at innganga
inngangsbøn	(kirkj.)bøn sum deknur lesur á kórsgáttini tá ið gudstænasta byrjar
inngangsorð	orð til inngangs
inngangur	1inngongd,loysa sær inngangkeypa atgongumerki2byrjan, formáli (2)
inngátt	gátt í inndurum
inngáva	(lækn.)tað ið verður inngivið av heilivági í einum[da.dosis]
inngifta	tað at fólk verða inngift
inngiftur	sígifta 3
inngirdur	sígirða inn
inngirðing	girðing (1)
inngjald	upphædd ið inngoldin verður
inngjalding	tað at gjalda inn
inngongd	1inngangur (1), dyr2(sj.)inngangur (2), formáli
inngongubøn	(kirkj.,sj.)inngangsbøn
inngonguseðil	(sj.)atgongumerki
inngrógvin	rótgrógvin, rótfestur,sjósálmarnir vóru so fast inngrónir í teirra kristinlív
innheintan	innheinting
innheintari	ein ið krevur inn pening[da.inkassator]
innheinting	tað at heinta inn pening, innkrevjing
innheysting	tað at heysta inn, heysting,øll innheysting gekk lagaliga
innheystingartíð	(bíbl.)tíðin tá ið innheystað verður,frá hesum degi skal sáðtíð og innheystingartíð ikki gretta
innhjólaður	bugaður inneftir, innskaraður[en.concave]
innhjóling	bugur inní
innholaður	innanholaður,hon gjørdist innholað í kjálkunum
innhongdur	(stb.)við fløtum afturparti,mamman var eitt sindur saðilbogin, men dóttirin var meira innhongd
innhugsan	hugleiðing,hann lá á sínum knøum í bøn og innhugsan[da.meditation]
innhugsin	inntonktur, hugsanarsamur,innhugsnir og orðfáir;bóndin fer tigandi og innhugsin frá aftur borðinum
innhurð	hurð fyri inndurum
innhús	(bíbl.)halgasta rúmið innast í templinum,innhús, tað er hitt alrahalgasta
inni1	1innandura, undir taki,her inni;har inni;sita inni;leggjast inniikki fara út;liggja inni1liggja við hús2(um skip)liggja í havn;vera inni1vera við hús2(um seyð)vera í rætt3(kortsp.)hava útspælda litin, kunna svara lit4(kortsp.)eiga fyrst út(til næsta stikk);liggja inni á øðrumvera øðrum til byrði;eiga (e-t) innieigat.d.mat við hús;seta e-n innisteingja e-n inni;goyma, binda, havael.bera inni við seghalda fyri seg sjálvan;bera seg inniskíta seg inni;(kvæð.)drepa e-n innidrepa e-n í húsi hansara;skíta seg inni(tá ið torv verður borið burtur)bera burtur so at ein verður innibyrgdur;(orðt.)tann, ið úti er stongdur, er inni gloymdurskjótt er at gloyma tann ið ikki er hjástaddur2(um tíð)komin, upprunnin,nú er kvøldið inni;ein onnur tíð var inni3(saman við fs)inni á:inni á gøtuni;inni á sandinum;inni í:inni í landinum;inni í húsinum;inni í dalinum;inni undir:inni undir berginum;inni við:inni við landnær við land
inni2	móður, tregi, harmur, saknur,(kvæð.)mælir av tungum inna;tað var av tungum inna, at hann beyð skipi og sjógvi farvæl
innialin	heimføddur,hann var eitt sindur spiltur ella innialin
inniarbeiði	arbeiði sum verður gjørt inni,móts.útiarbeiði,mamman hevði alt inniarbeiði at gera
inniá	inni undir landi, innan fyri streymin;sbr.inná
innibátur	(stb.)bátur sum stendur í neysti
innibleikur	bleikur av innisetu
inniblíður	sum tekur væl ímóti gestum ið koma at vitja, heimablíður,móts.burturblíður
innibyrgdur	1byrgdur inni, innistongdur,bygdin liggur innibyrgd millum fjøll;innibyrgdur vindurfretstingir2innanhokin, fálátaður,hann var stoltur og innibyrgdur í sær sjálvum;fámæltur og innibyrgdur3(sj.)(um hús í gerð)innilokaður,nú var innibyrgt
innibyrging	tað at vera innibyrgdur,í hesari innibyrgingini livdi fólkið
innidagur	dagur tá ið ikki er verandiel.arbeiðandi úti fyri veður,innidagar arbeiða maður og kona ull
innideyður	deyður einsamallur inni hjá sær sjálvum,tá ið fólk kom, hann lá innideyður
innidýr	(smá)dýr sum havt er inni(til fragdar)
innifóður	fóður til kríatúr ið verða fødd inni
innifólk	fólk ið starvast inni(t.d. skrivstovufólk)
innifrakki	yvirplagg til at vera í inni,hann var í innituflum og sínum gamla gula innifrakka[da.slåbrok]
innifrensur	(stb.)ein sum altíð situr inni(serst. um børn),inniløgufressur, innikroyst
inniføddur	lh tát18síføða inni,inniføddur seyður
inniføðing	tað at føða (1) inni
inniføðingarlamb	lamb sum verður føtt inni
innigerdur	(stb.)inngirdur,ein góð innigerd trøð at brúka
innigirdur	(stb.)inngirdur;sígirða inni
innigjørdur	(stb.)innigirdur,fløtturin var innigjørdur við garði
innigoymdur	sum er goymdur inni, innibyrgdur,hon læt sítt innigoymda illsinni sleppa at renna
innigoymsla	tað at goyma inni,leggja epli í innigoymslu
innihald	tað sum er í e-m, evni, tilfar, íhav,innihaldið í fløskuni;innihaldið í blaðnum
innihalda	hava í sær, íhava, innihava, rúma,henda bók inniheldur søguligar yrkingar
innihaldsleysur	við lítlum og ongum innihaldi, innantómur
innihaldsligur	viðv. innihaldi
innihaldsloysi	lítið og einki innihald
innihaldsmikil	við nógvum innihaldi, evnismikil
innihaldsyvirlit	evnisyvirlit(í bók)
innihava	(sj.)innihalda,alt fóður innihevur nakað av vatni
innihavandi	l ób/lh nútí osb.ikki innihavandiið hevst ikki inni
innihiti	hiti inni, stovuhiti,betur hevði hóvað at sitið í innihita enn farið á Suðurlandið
innihokin	(stb.)innanhokin,spell, at hann gjørdist so innihokin
inniholvdur	síholva inni
innihoyggj	hoyggj goymt í hoyggjhúsi;sbr.útihoyggj
innihugni	hugni heima við hús,innihugnin fór við mammuni
inniítrótt	(ítr.)inniítróttur
inniítróttur	(ítr.)ítróttur íðkaður innandura, inniítrótt,móts.útiítróttur
innikavaður	innibyrgdur av kava, inniskelvtur, undirkavaður,tey fingu ikki úthurðina upp - tey vóru innikavað;hálvthundrað ær stóðu innikavaðar
inniklæði(r)	klæði til at vera í inni,hann dagaði fyri vindeyganum í inniklæðum
innikroyst	eitt sum altíð situr inni, krill, innifrensur
innikroystur	innibyrgdur,innikroyst tarmalop
innikuldi	húsakuldi,innikuldi er nógv tann ringasti kuldin
innilagstur	síleggja
innilamb	(stb.)heimalamb, básalamb
innileiki	tað at vera inniligur
inniligur	hjartaligur, kenslunomin,hann bað langar og inniligar bønir;hj-liga
innilivandi	inniverandi,tað er ikki innilivandi fyri royki
innilív	tað javnan at liggja inni,tað stilla innilív;bleik av innilívi
innilokaður	(um bygning í gerð)taktur og við ísettum vindeygum og hurðum,húsini eru innilokað
innilokin	innilokaður
inniluft	luft inni(í húsum)
innilæsing	tað at læsa inniel.verða innilæstur
innilæstur	læstur inni, innistongdur, innibyrgdur,aðrar bygdir eru eisini skjótt innilæstar
inniløga	tað at liggja inni(Sv)
inniløgufressur	(Suð.)ein sum altíð liggur inni;sbr.innifrensur
inniløgugøltur	inniløgufressur(Sv)
innimaður	ein sum altíð situr inni
inning	tað at inna
inniogn	(búsk.)peningur ið ein eigur inni í peningastovni, innistøða (3)
inniróður	(ítr.)tað at "rógva" við rógvimaskinu,kapping í inniróðri
inniseta	tað at sita inni,hon var ikki so heilsugóð longur, tað mundi vera av hesi longu innisetu
innisetstur	ið er setstur inni,síseta (3)
innisettur	(Suð.)eftirsettur(í skúla)
inniseyður	seyður sum er føddur inni,í kjallaranum er hoykrubba til inniseyð
inniskav	húspjak
inniskelvtur	innikavaður, undirkavaður,út at skumpa kava, fyri at tey skuldu ikki verða inniskelvt;seyðurin er inniskelvtur
inniskítur	(gl.,stb.)maður sum troystaði sær ikki ella tímdi ikki at fara út at loysa sær buksurnar
inniskógvur	skógvur til at vera í inni,í inniskóm
inniskvøttur	(sj.)(tá ið torv verður borið burtur)ein ið skítur seg inni(t.e. ber burtur soleiðis at hann verður innibyrgdur),ansa eftir, at tú ikki verður inniskvøttur
innispunnin	1(orðt.)út kemur innispunnið lín (el.tógv),sílín2(stb.)snældan er innispunnin(fløkt tí at garnarendin (2) kemur út)
innispæl	spæl sum verður spælt inni,móts.útispæl,innispøl vóru t.d. kyssa durakelling ella reisa seg úr konusessi
innistarv	inniarbeiði
innisteinging	tað at verða innistongdur, innibyrging
innistongdur	sísteingja inni
innistroymdur	innibyrgdur av hørðum streymi,fátt man vera so dapurt og ringt fyri hýrin sum at sita innistroymdur í einum helli á miðjum Norðhavinum(Jól uttanl. 194324)
innistøða	1(um kríatúr)tað at standa inni2(stb.)hoylomb, innistøðulomb og veðrar føddir inni3(búsk.)inniogn í peningastovni,innistøða á bók
innistøðulamb	(bún.)lamb føtt inni um veturin, hoygjólingur,móts.fjallalamb
innistøðuseyður	(bún.)seyður sum havdur verður inni um veturin
innisælin	(gl.)innisælur
innisælur	sum ikki leggur í at vera millum fólk
innitokin	1fálátaður, hvørvin,hon, sum fyrr var so kát og gekk undan í spæli, er nú innitokin og still2innisælur,tey eru innitokin og vilja ongastaðni fara
innitufla	tufla til at vera í inni, inniskógvur,í innituflum
inniturking	tað at turka inni(serliga fisk),móts.útiturking,sólturking
innitøkur	(stb.)sum er nógv inni, innisælur
inniveður	so vánaligt veður at einki gerst úti
inniveðursdagur	innidagur
inniverandi	lh nútí osb. sumher verður inniverandiher verður hugnaligt at vera inni;her er ikki inniverandiher er ikki til at vera inni(t.d. fyri gangiel.kulda),húsakuldin var so ringur, at illa var inniverandi;ruddið, so her verður inniverandi
inniverk	inniarbeiði
innivist	tilhald, gisting,geva e-m innivist
inniær	(stb.)heimaær
inní	inn í e-t
innkaldur	við innkulda
innkast	(ítr.)tað at kasta bólt inn aftur á leikvøll(tá ið hann er farin út um síðulinjuna)
innkeypari	(búsk.)fólk ið stendur fyri keypi av vøruo.tíl.til fyritøku
innklombraður	í klombrum
innklæði(r)	klæði til at hava innan undir øðrum klæðum,móts.yvirklæði(r),skinnstúkan varð brúkt uttan yvir innklæðini
innknappur	(teld.)(á knappaborði)knappur 1(3) gevur atgongd at tekstluti[en.enter key]
innkoma	tað at koma inn(t.d. í stovu, land),koma
innkomandi	lh nútí osb.har er innkomandihar er nossligt og hugnaligt at koma inn;har var ikki innkomandi(ikki til at koma inn),har er ikki innkomandi fyri óruddi
innkoyring	1tað at koyra inn(t.d. á lokaðan veg),eingin innkoyring2lið inn at húsum(sum koyrandi er um)
innkrevjari	innheintari
innkrevjing	tað at krevja (skuld) inn, innheinting
innkrympaður	skropnaður,búkurin á rossinum var hvørki stórur ella innkrympaður
innkuldi	innvortis kuldi(t.d.av at drekka kalt),innankuldi, skjálvti,ansið nú eftir at tit ikki fáa innkulda og leggjast;hann fekk ikki innkulda av tí kaffinum!
innlagdur	síleggja inn
innlán	(búsk.)innsettur peningur(ít.d.banka)
innlánsbók	(búsk.)bankabók
innlánsrenta	(búsk.)renta av innsettum peningi,móts.útlánsrenta,peningastovnarnir hækkaðu innlánsrentuna
innlegg	1innlegging (1),tað nýggja innleggið er í gildi sum bøurin til støddar2leistur lagdur innan í skógv, ílegg (2)3(ítr.)tað at leggja bóltin inn fyri málið,hann fekk eitt innlegg úr høgru síðu
innlegging	1tað at leggja jørð inn, innlegg (1),fyrsta innlegging til uppdyrkingar var um 18452tað at leggja ravmagn o.a. inn í hús3tað at leggja fólk inn á sjúkrahús
innleggjari	ein ið leggur inn ravmagn í hús
innleiðsla	tað at kunna um e-t frá byrjan(introductio)
innleiðsluskeið	byrjanarskeið
innlendingur	ein sum býr í landinum,móts.útlendingur,tey gera seg inn á bæði útlendingar og innlendingar
innlendis	í landinum, innanlands,norska mentanarstríðið innlendis um landsmál og ríkismál
innlendismál	(stjm.)mál 1(7) sum viðvíkja innlendskum viðurskiftum(løgmálum, kommunumálum, samferðslumálum, náttúrumálumo.s.fr.)
innlendismálaráð	(stjm.)stjórnardeild ið hevur innlendismál um hendur
innlendskur	sum er í landinum, heimligur,móts.útlendskur,landið eigur at styðja innlendska framleiðslu;innlendsk fiskiskip
innlendur	eyðkendur fyri ávíst land,innlend sjúka[da.endemisk]
innlima	lima inn
innliman	tað at innlima
innlit	1(gjøllig) vitan fingin við skjóta skoðan, innsýni,sakarmálið gevur eitt týðiligt innlit í fólkalívið;lóg um alment innlitlóg sum loyvir borgarum innlit í skjøl hjá almennum myndugleikum(og sum hava týdning í avgerðum tiknum í ávísum máli)2(sj.)eftirlit,løgtingið skuldi hava innlit við handlinum
innljóð	(málfr.)ljóð inni í orði;sbr.framljóð,útljóð
innlummi	lummi 1 fyri innan á plaggi
innløga	1tað sum legst til bygdel.hús avt.d.fiski, fugli, grindo.tíl.,fuglaveiða var kanska størsta innløga í bygdini;fliða varð løgd í bátin, so skuldi góð innløga verða;ein berligur vetur: ongar innløgur2inntøka,innløgur felagsins
innløguár	ár 2 við (góðari) veiðuel.inntøku,heimildir siga frá góðum innløguárum
innløgubygd	bygd ið liggur væl fyri til innløgu (1)
innløgumaður	maður ið er dúgligur at leggja til húsiðel.fáa innløgu,so mikil innløgumaður eri eg, at eg haldi pottin;innløgumaður var hann vánaligur, so ofta var svangligt
innløgumatur	matur av innløgu (1)(fuglur, fiskur, grindo.tíl.)
innløgupláss	pláss ið liggur væl fyri til innløgu (1),her er innløgupláss í Dølum, tú heldur pottin meðan tit eru her
innløgutíð	tíð tá ið nógv legst til(húsel.samfelag),seinasti heimsbardagi var ein innløgutíð fyri Føroyar
innmelding	tað at melda seg inn(t.d. í felag)
innmið	mið (rættiliga) nær landi,móts.havmið,teir settust á einum av teimum uttastu innmiðunum
innmorena	(jarðfr.)morena innan í ísi
innmyntur	við innsoknum munni((eins og) hjá tannleysum fólki)
innoygdur	við eygum sum liggja innarlaga
innoyra	(lívfr.)tað innasta í oyra 2(1);sbr.miðoyra,útoyra
innpakking	1tað at pakka inn2tað ið e-t er innpakkað í
innpakkingarpappír	pappír til at pakka inn í
innrakstur	tað at reka inn(t.d. seyð í rættel.grind inn á hvalvág),tá ið gongan nærkast rættini, rópa summir seg upp á innrakstur, og so kemur gongan í rætt;grind í innrakstri
innrammaður	í rammu,innrammað mynd
innrák	streymur sum rekur inn móti landi, innrek,móts.útrák,hann roknaði við, at lágættin vigaði upp ímóti innrákinum
innrás	1(herm.)álop (1), herseting,herurin gjørdi innrás tíðliga um morgunin;sovjettiska innrásin í Afganistan í 19792tað at nógv fólk koma inn í hús, bygd, lando.s.fr.samstundis,ein innrás av ferðafólki;hetta var byrjanin til eina sanna innrás av gøtufólki í Skúvoy
innreið	tað at ríða inn(t.d. í bý),Kristjan kongur helt innreið í Suðurjútland tann 10. juli 1920
innrek	(stb.)innrák
innreyður	(alisfr.)(um ljós)við longri bylgjulongd enn sjónligt ljós[da.infrarød];sbr.útbláur
innrið	(hjá seyði og neytum)skræpa, skitja, samanrenning (2),veðrarnir fingu ymisk strik, meðan teir stóðu inni, t.d. innrið
innringur	innrætt
innrím	(bókm.)rím inni í ørindisreglu
innrúm	(lívfr.)niðara rúm í hjarta,móts.upprúm,vinstra innrúm og høgra innrúm
innrætt	(gl.,stb.)rúmið inni í rætt, innringur(Sv Indb.828)
innrætta	1(húsasm.)smíða hús innan, skildrael.skila av,hann innrættaði húsini sjálvur2skipa seg, seta upp innbúgvo.a.inni
innrætting	(húsasm.)tað at innrætta, timburarbeiði sum er eftir tá ið hús eru innilokað
innsavnan	innsavning
innsavning	tað at savna inn, innsavnan
innsendari	ein ið sendir inn(t.d. grein í blað)
innsending	tað at senda inn
innseta	1(bíbl.)seta í gildi, stovna,Jesus innsetur dópin;hin heilaga kvøldmáltíðin verður innsett2seta í embæti,presturin varð innsettur í embætið í fjør
innsetari	ein sum setur pening inn t.d. í banka
innseting	1tað at seta pening innt.d.í banka,rentan verður roknað frá fyrsta bankadegi aftan á innsetingina2(tøkni)íseting, innlegging3tað at seta í embæti
innsig	árin uttaneftir,lítið og einki innsig kom uttanífrá
innsigla	seta innsigli á, lakka 1(2),brævið var innsiglað við embætislakki
innsigli	bú-el.navnamerki merkt í lakkel.vaks(settt.d.undir skjøl og brøv til staðfestingar)[lat.sigillum]
innsigling1	1tað at sigla inn (í havn)2havnarmunni
innsigling2	tað at innsigla
innsiglingarviti	viti til at sigla inn í havn eftir
innsiglisringur	(bíbl.)ringur at innsigla við
innsíða	innara síða,móts.útsíða,har koyggjurnar ikki vóru, var innsíðan oftast grótveggur
innsíggin	við djúpum skilningi,eyðmjúkur og innsíggin stendur hann við skrivikolinum í hondini
innsjóða	tætta við kóking,innsoðin mjólk[da.kondensere]
innsjógvur	útróðrarleið nær landi,innsjógvin eystan fyri Risan og Kellingina kallaðu teir Hvalvíkshavið
innskaraður	við bugi inní, innhjólaður
innskeytað	(um ár)við skeytunum ov uttarlaga(so at árin er ov long innan fyri stokkin)
innskipaður	1(um farm)komin umborð,tá ið allur seyðurin er innskipaður, skal fjallskipanin koma í bátin2(málfr.)(um eykasetning)sum stendur sum liður í øðrum setningi
innskipan	tað at skipa inn, ferming 1
innskorin	(um oyggj)við nógvum víkum, vágum og fjørðum, víkutur,eystanfyri er oyggin nógv innskorin
innskot	1streymur inn ímóti landi, innrák,damla so heim eftir innskotum í nátt;koma vit undir innskotini, verður ferðin ikki týdlig2(jarðfr.)grót sum skotið er inn ímillum eldri jarðløg,óreglulig innskot eru skotin inn í takið á kolalindini[da.intrusiv]3bráðkomið hugskot (1),tá fær hann eitt innskot;sum eftir einum innskoti fór hann til hennara4peningaupphædd sum sett verður í pengastovn,tølini vísa vøksturin í innskotum sparikassans hesi árini
innskotsfuglur	flytifuglur sum kemur og fer næstan dagstevnt;sbr.veðurfuglur
innskotshorn	(alisfr.)horn (14) millum ljósgeisla niður á speglandi flata og (hugsaða) loddrætta striku[da.indfaldsvinkel]
innskotsknappur	(teld.)(á knappaborði)knappur 1(3) nýttur til at seta tekst inn í annan[en.insert key]
innskotspeningur	(búsk.)peningur ið ein hevur sett í fyritøkuo.tíl.,partapeningur,av samlaða innskotspeninginum teknar landsstýrið 20 %
innskotsryggur	(jarðfr.)ryggur av innskotnum gróti
innskotssteyri	(alisfr.)(hugsað) strika vinkulrætt inn á speglandi flata;sbr.útskotssteyri
innskoyti	(málfr.)innfesti
innskrift	tað sum er høgtel.rist er inn í e-t(t.d. minnisvarða, grip e.a.)
innskriva	(postm.)senda við serligari ábyrgd(t.d. virðispost),innskrivað brævábyrgdarbræv
innskriving	tað at skriva inn
innsløddur	l/lh tát18(plfr.)innslødd plantaplanta borin inn við fólki, djórumel.á annan hátt, innsløðingur
innsløðingur	(plfr.)innslødd planta
innsmogin	sum hevur smogið sær inn,eitt innsmogið danskt orð;sísmúgva
innsneiddur	við sneiðing inní,í frakka, sum var dúgliga innsneiddur omanfyri mjadnar
innsokkin	ið liggur djúpt, innholaður,eyguni í honum vóru innsokkin;kinnarnar vóru innsoknar
innsproyting	innspræning
innspræning	(lækn.)1tað at spræna inn2tað ið sprænt verðurel.er innsprænt, innsproyting
innstikaður	sístika inn
innstoytur	hart innrák, nekkur (í streymaskifti),innstoytur verður tað harða innrákið kallað, tá ið tað kemur tvørt á ein tanga: innstoyturin á Koltursnakk
innstøða	1skipan (5) av kríatúrum(serst. neytum)ið fylgir kongsjørð frá festara til festara og leiga skal latast fyri,innstøðan í Dímun var 36 neyt2innistøða (3)3(gl.)innara skinn í skølingi
innstøðuneyt	neyt sum hoyra upp í innstøðuna
innstøðuseyður	seyður sum hoyrir upp í innstøðuna
innstøkk	bráðkomið hugskot, innskot (3),í seinastu løtu fekk hann tað innstøkkið, at tey áttu at bjóða henni við
innsúgur	1súgur inn móti landi, inndrag,móts.útsúgur,báturin kom inn um steinin við einum innsúgi2(flutt m.)innrás (av fólki at vitja),har var sovorðin innsúgur
innsýni	innlit,hesin tilburður gav eitt klárt innsýni í tað almenna
innsøgn	innmelding,móts.úrsøgn,innsøgn í felag
inntak	1árin á sansar og hug, hugnám[en.impression]2(teld.)dátur sum verða innlagdar í teldu, ílag[en.input]
inntikin	sítaka inn
inntil	(um tíð)til, hagar til,(kvæð.)inntil at hennara stundum leið
inntonktur	innhugsin,ein álvarsamur, eitt sindur inntonktur og stillur drongur
inntriv	1uppílegging, ítak, tiltak,her krevst eitt búskaparligt inntriv2tað at fara harðliga til verka(uttan neyðug fyrilit fyri avleiðingunum),tað ber ikki til við støði í hesi vitan at siga nakað um, hvat hetta inntrivið fer at merkja fyri føroyska náttúru sum heild
inntøka	peningavinningur, innløga (2),krígstíðin bar við sær stórar inntøkur fyri landið;fastar inntøkur
inntøkuár	ár 2 sum inntøka er forvunnin í
inntøkufíggjaður	(búsk.)inntøkufíggjað virksemitað at ein almennur stovnur ger arbeiði fyri onnur fyri gjald(og nýtir peningin til egið virksemi),skúlin rekur skeiðvirksemi sum inntøkufíggjað virksemi
inntøkuføra	bóka sum inntøku í roknskapi
inntøkujavna	javnael.stillat.d.almannaveitingar eftir inntøkuni hjá tí einstaka,neyðugt er at inntøkujavna fólkapensiónina hjá teimum, sum hava góða inntøku frammanundan
inntøkujavning	(búsk.)samhaldsføst skipan har iðt.d.ein kommuna ið hevur hægri inntøkugrundarlag rindar pening til aðra(r) kommunu(r) við lægri inntøkugrundarlagi
inntøkukelda	e-t ið ein fær stórt peningaligt gagn av,tann stóra inntøkukeldan hjá býnum hevur verið ein skipasmiðja
inntøkulóg	(løgfr.)lóg ið heimilar inntøkur hins almenna(t.d.skattel.toll)
inntøkusíða	(búsk.)stað har ið inntøkur eru bókførdar í roknskapi
inntøkuskattur	(búsk.)skattur roknaður av inntøku
inntøkutrygd	(sjóm.)minstaløn,tað er heilt burturvið, at inntøkutrygd hjá útróðrarmonnum skal skerjast fyri at fíggja ein skattalætta til fiskimenn
innum	inn,móts.útum,nú mugu tit gera á tykkum, áðrenn tit fara innum(inn um eggina);fáa fótin innumsleppa framat
innundir	(um rørslu)undir(har ið opið er),har er opið innundir;har var so ótespiligt, at fólk leitaði innundir í bilarnar
innvaldur	valdur innt.d.á ting
innvavdur	1innballaður, sveipaður2fløktur upp í,bestu menn í herinum eru innvavdir í Dreyfus-málið;sívevja
innveggur	innari veggur(t.d.á æðr)
innviðarband	(bát.)band (3);í osb. sumhonum trýtur innviðarbondel.nú fattast innviðarbondnú er hann gorhungraður;hann hevur góð innviðarbond(tolir allan mat)
innviður	1(bát.,skip.)viður inni í farit.d.bond, knø, bekkir o.s.fr.,móts.borðviður2(húsasm.)(stór)viður í húsi,eg fari at klúgva mær eitt mastrartræ, eg eigi, at hava til innvið í hoyggjhúsinum(stólpar o.tíl.);tað er so nógvur innviður í kirkjuni á Kirkju
innvik	1bugur inn ít.d.veggel.garð,innvikið í kórinum, har ið altarið nú stendur;við fýrstaðin var eitt innvik;í einum innviki í garðinum settust vit at hvíla2vík, viki (1), kós 1(2),eitt lítið innvik var niðanfyri, har høvdu teir svomið
innviki	innvik (2),báturin lá við ein innvika í tí norðara landinum
innvoli	(stb.)innvølur
innvortis	innan, inni í(kroppinum),móts.útvortis
innvølur	(lívfr.)lívgøgn í bróst- og búkrúmi(hjarta, livur, nýru, garnar o.s.fr.),innvølurin í jóturdýrum er øðrvísi enn á øllum øðrum dýrum í tí, at tey hava fýra magar;(flutt m.)hann spýði innvølirnar úr sær(spýði illa)
insekt	(dj.)skordýr
instaleringur	(bát.,stb.)føroyskur bátur við fast ísettum motori, maskinbátur
instur	innastur,av insta hjarta(av øllum hjarta)
insulin	(lívfr.,lækn.)evni sum gerst í brisinum og virkar á sukurevnaskiftið í kroppinum(heilivágur fyri sukursjúku)
interessantur	(tlm.)áhugaverdur
internet	(teld.)alnet
inuittur	ein ið hoyrir til fólkaslag sum býr í norðurpólsøkjunum í Grønlandi, Norðurkanada, Alaska og í Landnyrðingssibiria
IRA	stytting fyriIrish Republican Army(katólsk írsk mótstøðurørsla ið krevur Norðurírland sameint við lýðveldið Írland)
irskran	tað at irskrast, nøtran,ein kendi hetta við loyniligari irskran aftur frá sær sjálvum
irskrast	ønskrast, ørskrast, nøtra,irskrast við;tað er so hugstoytt, at tú irskrast við
isa	(sjóm.)geva (seg) út, togna,grasendar isa so væl, so rykkið verður ikki so hart í skipið, tá ið á stendur
isi	róliga, seinliga,aðrir komu til, komu so isi raggandi allastaðnis frá at neystinum
isiani	(gl.)isi
islam	(átr.)trúgv á Allah, muslimsk trúgv
islamisma	(stjm.)politisk hugsjón grundað á islam(t.e. á ta hugsan at lóggáva, rættarverk og stjórnarskipan eiga at laga seg eftir islamskum forskriftum (sharia))
islamistur	(átr.,stjm.)ein ið tekur undir við islamismu
islamskur	(átr.)viðv. islam,islamsk mentan;sbr.muslimskur
-isma	(eftirfesti í heitum á rørslum og stevnum serst. í heimspeki, samfelags- og mentamálum),sí t.d.kommunisma,sosialisma
isolatorur	(ravm.)evni ið ikki leiðir streym
Italia	land í Evropa
italienari	fólk íel.úr Italia, italieni
italieni	italienari
italskur	íel.úr Italia;italsktitalskt mál
itið	síeita
itu	síeita
iv	(stb.)ivi,tað var um eitt iv, um teir ikki skuldu gjalda tað eisini
ivaføri	støða tá ið ivi ræður,í ivaføri
ivakendur	ivandi, ivaskygdur,henda yrkingin ber til sjóndar tað ivakenda í lyndi hans
ivalag	ivandi atburður, støðuloysi
ivaleysa	nóg, ríkiliga, ríviliga,hatta er ivaleysa stórt
ivaleyst	helst, óivað, uttan iva, vist 3,hon hevur ivaleyst einki hoyrt;nú var hann ivaleyst deyður
ivaleysur	1ikki í iva, sannførdur, vissur,teir vóru ivaleysir í, at báturin var burturgingin;vita seg ivaleysan2ríkiligur, ríviligur, nóg mikil,ivaleyst var tilætlað;hon hevði ivaleyst til kúnnanóg nógv hoyggj;teir vóru ivaleysirhøvdu ivaleysa nógv
ivalíkindi(r)	ivingarlíkindi(r)
ivaloysi	tað at vera ivaleysur (1), sannføring
ivamaður	ivandi maður
ivamál	ógreitt mál, ivaspurningur, gáta, vandamál,í ivamálum skal avgerðin koma ákærda til góðar
ivamikil	ivingarsamur, ivandi, tortrúgvin,sorinskrivarin, hin altíð ivamikli og tvøri
ivan	(sj.)ivi,hann var ikki í ivan um tað
ivasamur	1sum ivi er um, óvissur,ivasamt, um tað fór at makta nakað2sum ivast, ivingarsamur
ivasemi	ivi
ivasjúka	sjúklig ivasemi
ivaskygdur	ivandi, ivingarsamur, ivakendur,skaplyndi hans er ivaskygt[da.skeptisk]
ivaskygni	tað at vera ivaskygdur,eitt vist ivaskygni móti pápa hennara andaði gjøgnum grein hansara
ivaspurningur	ivamál
ivast	vera í iva, himprast, fimlast,ivast íel.ivast umvera í iva um;eg ivist ikki í tíeg eri sannførdur um tað;tað er einki at ivast íel.at ivast um;tað er einki at ivast ítað er vist;hon ivaðist í at venda aftur(hugsaði um);ivandiið ivast, ivasamur
ivatyngdur	fullur av iva, stórliga ivandi,hitt ivatyngda stórskaldið
ivaveður	(gott) veður sum óvist er um hvørt tað heldur sær,ein dagin í ivaveðri fóru bátarnir á flot;í vørðsluni stóðu bátarnir, tá ið ivaveður var
ivaær	ær sum ivi er um hvørt hon kann liva (ein vetur afturat ella ikki)
ivi	tað at ivast, ivasemi, iving, óvissa,vera í iva um e-tel.í e-m;vera um ein ivaivast;tað er um ivan(ivasamt);tað ríður um ivan(er ivasamt);tað er eingin ivi um taðtað er ivaleyst;tað var ivi komin á hanahon var farin at ivast;tað er ivi um taðtað er óvist
iving	ivi,ikki var iving um;tað stendur um ivingina, antin tað fer at vera kríggj ella ikki
ivingarlíkindi(r)	ivasom líkindi
ivingarmikil	ivingarsamur
ivingarsamur	ivandi, ivasamur
ivingarveður	ivaveður
ivingarverdur	ivingarsamur
ivingur	ivi,tað er eingin ivingur í;tað er í ivingi, um hann sjálvur visti, hvat hann segði;tað er um ivingin(ivasamt)
ivri	(óregl.)->yvri
ivrigur	íðin, ágrýtin, hugagóður
ivur	ivi,tað er eingin ivur um tað;vera um ivinel.um ein ivvera í iva, ivast;onkur er upp á iv(óvist um hann kemur við)
