J	stytting fyrijoule
j	(málfr.)hjáljóðsstavur (nevndur[jɔd:])
ja1	mðlv(til at geva samtykki),móts.nei 1,kemur tú? ja, eg komi;ja mennvissuliga, sanniliga
ja2	játtan,ein fekk krakk, annar fekk ja
jabb	tað at jabba, meyl, júk, sjagg, munnsjabb,hetta er sama jabbið aftur
jabba	taka upp í saman, meyla, júka, sjabba (2), sjagga, jagga,jabba um e-t;jabba og sjabba um tað sama
jabban	jabb,undirvísingin verður ein jabban upp í saman
jabróðir	ein sum játtar eftir øllum ið annar sigur, ósjálvstøðugt fólk,hann er eingin jabróðir
jada	játa
jaðar	jaðari;(stn.)á Jaðri[jagrɪ]
jaðari	1kantur, rond, trom, útryðja2(stb.)kvarði á streymi;sms. t.d.skóg(ar)-,streym-,út-,veg-
jaðarkliptur	(bíbl.)snøgt kliptur(um alt høvdið)
jaðrakona	(fugl.)jarðarkona
jaður	1(tunt) lag(1),grasið verður rist og fergt væl, jaður fyri jaður2(stb.)rað,rókin var so smøl, at tað var pláss til bara eitt jaður av fugli
jaga	1(sj.)veiða(dýr)2jagstra, elta, forfylgja
jagaraflogfar	(herm.)stríðsflogfar, jagari (2)
jagari	1veiðimaður2(herm.)stríðsflogfar
jagarsveinur	(kvæð.)jagari, veiðimaður
jagg	1tað at eitt sindur óslættel.tvassut er í sjónum, fløktur sjógvur, drabb, kjøkr,tað er sovorðið jagg í sjónum;ógvellan fór ríðandi á jagginum suður undan íðuni2tað at illneitast el. geva ilt av sær í heilum um e-t, jabb, kjøkr, meyl,nú fekst tú løn fyri jagg títt3eitt sum altíð jaggar (2),eitt jagg(Sv);sms.land-
jagga	1tað at jagg er í sjónum,tað jaggar inni við (land)2illneitast el. geva ilt av sær í heilum, meyla, kjøkra, júka,jagga á e-n
jaggutur	1(um sjógv)drabbutur, kjøkrutur2illneitutur, meylutur
jagl	1tað at jagla2knarr (3)(Sv)
jagla	tyggja e-t hart el. seigt, mýla,hann jaglaði ein seigan kjøtbita
jagldýr	(dj.)djóraslag við smávaksnum tonnum(t.d. beltisdýr, letidýr, meyruslúkur)(Edentata)
jagstra	jaga (2), elta, forfylgja,heykarnir jagstraðu mýsnar
jagstran	tað at jagstra;sms. t.d.manna-
jagstur	(sj.)jagstran,hann var fremstur í hesum jagstrinum eftir rossunum
jagt1	veiða, veiðiferð
jagt2	(bát.)lossingarbátur
jagta	1veiða 2(1), jaga (1)2(Suð.)(um brundseyð)hava hug at makast, ræla;veðurlombini mugu takast inn, áðrenn tey fara at jagta
jaguarur	(dj.)ránsdjór av kattarslag(Panthera onca)
jakkaklæddur	í jakka el. klædningi,jakkaklæddir krambasveinar
jakkaklædningur	klædningur (1)
jakkakot	(niðr.,skemt.)(vánaligur) jakki
jakkalummi	lummi 1 á jakka
jakkaskorin	(gl.)skorin sum jakki, sum hevur jakkasnið,jakkaskorið kot
jakkatræ	akslatræ
jakkavel	vel (4) á jakka
jakki	klædnaplagg styttri enn frakki uttan á skjúrtu, blusu el. tíl.,tvíkneptur jakki;sms. t.d.vind-
jaksil	jakslur;sbr.jaksul
jaksla	tyggja við jakslunum, gnaga, jagla,jaksla e-t til
jakslan	tað at jaksla, jagl
jaksli	(stb.)jakslur
jakslur	(lívfr.)tonn aftarlaga í munninum(fløt við knútum omaná)
jaksul	jakslur;sbr.jaksil
jakt	jagt
jakta	jagta
jaligur	játtandi, jasøgin, jasagdur, positivur,móts.neiligur,neisagdur
jall	(kvæð.)jallur
jalladømi	(søg.)jalldømi
jalldømi	(søg.)landspartur sum jallur ræður yvir, jallríki
jallríki	(søg.)jalldømi,Orknoyggjar og Suðuroyggjar gjørdust sjálvstøðug jallríki
jallur	1(søg.)høvdingi í tign næstur kongi,Hákun jallur2enskur aðalsmaður(earl)3miðbeinið í neyta-el.seyðakleyv(nýtt í kongaspæli);síkongur,purka4(talv.,stb.)biskupur
jalov	játtan, játtilsi, jalyfti,hann vildi fáa jalov upp á jørðina;tað var leingi, áðrenn okur fingu jalov frá landsstýrinum(um alistøð)
jalsdóttir	dóttir jals
jalssonur	sonur jals
jalyfti	(sj.)jalov,hann fekk jalyfti, at hann kundi koma við
jammur	tað at jamra seg, gremjan, venan, eymk,jammur kom á hana;tað var eitt jammurs lag(ein syndarligur standur)
jamra	s30í osb.jamra seggremja seg, vena seg
janga	s30:janga á (e-n)deila javnt og samt(Sv)
jangl	(Suð.)møsn, tvætl, svass,lít heldur á mátt tín og megin og ikki sovorðið gamalt jangl
jangla	(Suð.)jagla
jann	(kortsp.)tað at fáa so fá eygu at tapið verður tvífalt(í sjavsi el. grevjassi),vera jann(ikki jannfríur);(flutt m.)tað var kalda jann(eiðasørt við fisk)
jannfríur	(kortsp.)(um tapara í sjavsiel.grevjassi)sum ikki verður jann(soleiðis at vinnarin einans fær hálvt stigatal fyri tað spælið)
januar	fyrsti mánaður í árinum, januarmánaður
januarmánaður	januar
Janus	síHanus
jaorð	játtan(til biðil),hann fekk jaorð gentunnar
Japan	land í Eysturasia
japanari	fólk íel.úr Japan, japani
japani	japanari
japanskur	íel.úr Japan,japansktjapanskt mál
japansmaður	japani
japsa	sigael.taka upp í saman, jabba,japsa upp í samantaka uppaftur og uppaftur;dugir tú ikki hatta, tú hevur sitið og japsað tað ígjøgnum allan dag
jarða	(um lík)leggja í grøv, grava (4), gravseta, gravleggja,(bíbl.)lat tey deyðu jarða síni deyðu
jarðalisfrøði	vísindi um alisfrøðilig viðurskifti í jarðarknøttinum(geophysica)
jarðalisfrøðingur	ein ið er lærdur í jarðalisfrøði
jarðan	gravlegging, gravseting, jarðarferð,eftir deyða og jarðan hans
jarðar	síjørð
jarðarásur	ímyndaður ásur 2(5) sum jørðin melur um,jarðarásurin stendur á halli
jarðarbotnur	tað ovasta leysa lagið á jørðini sum planturøtur vinna ígjøgnum og finna føðslu í(fyri ein part úr lívrunnum tilfari)jørðildi, (jarðar)grund, vørild, mold, gróðrarbotnur;(flutt m.)har var jarðarbotnur fyri rørsluni(gróðrarvánir)
jarðarbók	(søg.)skrá um kongsjørð(1584 -)
jarðarbrúk	landbúnaður
jarðarbræv	(løgfr.)bræv sum váttar ognarrætt til jørð, ognarbræv, skeyti
jarðarbundin	jarðbundin
jarðarbygd	bygd við nógvari jarðarogn,tað var ein innløgubygd og ein jarðarbygd
jarðarbýti	(sj.)1útskifting (2)2óðalsbýti
jarðareigari	ein ið eigur jørð, ognarmaður
jarðareldur	eldur niðri í jørðel.í eldgosi,(skaldsk.)í fornum jarðareldi hert(um landið);millum jøkul og jarðareld
jarðarferð	tað at jarða (e-n), gravarferð
jarðarfiti	(jarðfr.)slag av bleytum leirgrýti ið kann súgva fiti í seg(nýtt til tøvingar)[en.montmorillonite]
jarðarfólk	fólk sum eigur jørð
jarðarfundur	fornlutur funnin í jørð
jarðargóðs	jarðarogn
jarðargrund	jørð, jørðildi, jarðbotnur
jarðarhiti	(jarðfr.)hiti í jørðini
jarðarhús	hús sum eigur jørð, ognarhús,hon var úr einum jarðarhúsi
jarðarhvalur	(søg.)1grindapartur sum lutaðist teimum ið jørðina áttu har sum grindin doyði(avtikin í 1937)2partur í riknum stórhvali sum lutaðist jørðini;sbr.landpartur
jarðarkápa	(jarðfr.)kápa (8)
jarðarkjarni	(jarðfr.)tað innasta í jørðini, kjarni (4)
jarðarkjøt	(stb.)kjøt av seyði á uttanbíggjarjørð,jarðarkjøt kom ballað inn í skinn
jarðarklandur	klandur um jørð
jarðarklóta	jarðarknøttur
jarðarklæði(r)	(stb.)líkverja, líkklæði(FFÆ326)
jarðarknøttur	jørðin, jarðarklóta, knøttur (5)
jarðarkoma	(átr.)tað at koma til jarðar,jarðarkoma Jesusar
jarðarkona	(fugl.)lítil fuglur av sjógvhøsnaætt(Rallus aqvaticus),beinini sum á jarðarkonu(long og kløn)
jarðarkonuleggir	kløn bein, staraleggir,hatta eru rættir jarðarkonuleggir
jarðarkringla	jørðin, jarðarknøttur,hann læt menniskjuni breiðast út um alla jarðarkringluna
jarðarkringur	jarðarkringla,(bíbl.)um allan jarðarkringin
jarðarleiga	leiga 1(3) fyri kongsjørð, kongsleiga
jarðarleysur	sum onga jørð eigur, ognarleysur,jarðarleysir menn
jarðarligur	jarðligur
jarðarlív	lívið á jørð, mannalívið, foldarlív
jarðarlóg	(løgfr.)lóg um jørð (5)
jarðarlóggáva	lóggáva um jørð (5)
jarðarlundi	(Myk.)lundi latin í landpart
jarðarmaður	maður sum eigur jørð, ognarmaður, bóndi,teir vóru góðir jarðarmenn
jarðarmeting	(bún.)virðismeting av jørð[da.taksation]
jarðarmiðbogi	(sj.)miðkringur
jarðarmóðir	ljósmóðir, nærkona
jarðarmóðurleypur	leypur ið jarðarmóðir hevði á ferðum sínum(lokaleypur til støddar sum hálvfjórðingsleypur)
jarðarmunni	(Suð.)ben(har ið grivið er inn í halla),koyggjuveggurin gekk líka móti jarðarmunnanum;teir gróvu inn í jarðarmunnan, og so ruddi alt niður yvir teir
jarðarmunur	hæddarmunur á lendi
jarðarnavn	navn á jørðel.jarðarteigi
jarðarnøt	(plfr.)slekt í skjólurtarætt(Conopodium),stór jarðarnøt(C. majus)
jarðarogn	1tað at eiga jørð2ogn (2)
jarðarognari	(sj.)jarðareigari, ognari
jarðarpartur	(sj.)landpartur
jarðarpetti	lítið jarðarstykki, jarðarsnøkil
jarðarráð	ráð ið situr fyri almennari jørð, búnaðarráð,Føroya jarðarráð
jarðarrás	(stjfr.)ringrásin hjá jørðini um sólina,jarðarrásin um sólina
jarðarríki	jørðin, verøldin, heimurin,móts.himnaríki,veit tað eingin á jarðarríki
jarðarrøkt	(bún.)tað at røkja jørðina
jarðarserkur	(gl.)serkur sum kona varð jarðað í(MSH Gl. g.89)
jarðarsipa	(plfr.)jarðarsipan
jarðarsipan	(plfr.)slag av skón ið veksur í bø(Peltigera canina),jarðarsipan fyri rivju og eldkast(heimaráð)
jarðarskattur	(búsk.)skattur rindaður av jørð eftir markatali
jarðarskeki	(stb.)jarðarsnøkil,tey høvdu einans jarðarskeka eftir
jarðarskifti	(bún.)óðalsbýti
jarðarskjálvti	(sj.)jarðskjálvti
jarðarskorpa	(jarðfr.)ytsta lag á jørðini (1)(5-70 km tjúkt)
jarðarsnøkil	snøkil (2) av jørð, kloddi (5)
jarðarsokkar	gravarsokkar
jarðarstova	(í ævintýri)stovael.skýli undir jørð,hann gróv teimum eina jarðarstovu í einum heyggi(FFÆ418)
jarðarstykki	stykki av jørð, teigur, jarðarpetti
jarðarsøga	(jarðfr.)jarðfrøðiliga søgan hjá jørðini,jarðarsøgan er býtt sundur í øldir(JR Øldir12)
jarðartala	(stb.)jarðtala
jarðarteigur	jarðarstykki,hann átti ongan jarðarteigin(var ognarleysur);har var neyvan jarðarteigur í húsinum;eg var so góður við hvønn jarðarteig
jarðartrá	longsil eftir deyðanum,nakra jarðartrá havi eg ikki kent á mær enn
jarðartunga	(plfr.)slag av soppi(Geoglossum)
jarðarvatn	vatn sum setur úr jørðini
jarðaryvirflati	yvirflatin á jørðini
jarðákast	tað at kasta jørð á lík
jarðbelti	(heldur mjátt) øki um tvøran jarðarknøttin,vársins unga ljós, sum verður føtt uppi yvir jarðbeltunum fyri norðan[da.zone]
jarðber	(plfr.)1planta í slektiniFragaria2átulig saftmikil reyð frukt á hesi plantu;sms.urtagarðs-
jarðbik	(jarðfr.)tjúkk bikkend evja ið verður til úr lívrunnum tilfari djúpt niðri í jørðini, asfalt
jarðbika	asfalta
jarðblettur	brúnur blettur á holdinum á gomlum fólki
jarðbotnur	(sj.)jarðarbotnur
jarðbók	(sj.)jarðarbók
jarðbót	(bún.)royndir at bøta um jørð (3),kálk til jarðbótar
jarðbundin	1verðsligur av lyndi, jarðgrógvin, moldbundin2(ravm.)við jarðsambandi
jarðdýpd	(Suð.)dýpi á mold(Sv)
jarðeldur	jarðareldur
jarðevnafrøði	(jarðfr.)vísindagrein sum kannar evnini í jørðini, samanseting teirra og ringrás í náttúruni(mineralogia)
jarðfall	tað at falla til jarðar, syfta niður,geva e-m jarðfall(fella);fáa jarðfalldetta
jarðfastur	fastur í jørð,jarðfastur steinur;jarðfast grót;jarðfast fornminni
jarðfeingi	tilfeingi ið kann vinnast úr jørðini,viðurskifti viðvíkjandi gagnnýtslu og varðveitslu av landsins jarðfeingi
jarðfesta	1festa í jørð, rótfesta,fáa e-t at jarðfesta seg;hann jarðfesti líggjan(í tátti)(rendi líggjan undir tjógvið)2kasta jørð á,jarðfesta lík
jarðfiti	(jarðfr.)jarðarfiti
jarðflati	yvirflatin á jørðini
jarðfrost	rím, rímfrost, turrafrost,hógvurin var mest allur avhómaður av jarðfrosti
jarðfrøði	vísindagrein um jarðarskorpuna, steinsløg í henni og upphav hennara(geologia)
jarðfrøðiligur	viðv. jarðfrøði
jarðfrøðingur	ein ið er lærdur í jarðfrøði
jarðfunnin	(um fornlut)funnin í jørð,jarðfunnið fæ
jarðgass	(jarðfr.)gass úr jørðini[da.naturgas]
jarðgimbri	jarðgimbur
jarðgimbur	kv17í osb. sumikki jarðgimbur;hann eigur ikki jarðgimbur(ongan seyð);har verður ikki jarðgimbur eftir(ikki ein kleyv eftirt.d.av ringari røkt)
jarðgrógvin	1grógvin fastur í jørð, jarðfastur,nú liggur steinurin jarðgrógvin2(um fólk)niðurtjúkkur3(flutt m.)jarðbundin, moldbundin,hetta er eitt jarðgrógvið fólk;(skaldsk.)jarðgrógvið matmaðka tos
jarðgrøni	(jarðfr.)grønjørð
jarðhella	føst hella,eitt sindur av vølli omaná, og so jarðhella niðriundir;jarðhellur stinga uppúr(valla undan)
jarðhús	(søg.)rúm undir jørð
jarðir	síjørð
jarðiskur	jarðligur, verðsligur, jarðbundin
jarðkaðal	(ravm.)kaðal grivin í jørð
jarðkava	(um kava)rúka (fram eftir jørðini),tað jarðkavar
jarðkavaguv	(sj.)jarðrok, jarðkavi (1)
jarðkavi	1jarðrok(Sv)2upphald (1) á fjøllum(Sv)3(stb.)kavi sum liggur leingi og harðnar
jarðklettur	1jarðfastur klettur2stórur klettur, bergklettur,teir høvdu jarðklettar til grundarsteinar
jarðknøttur	(sj.)jarðarknøttur,títlingskongur er minsti fuglur á norðara helmingi av jarðknøttinum
jarðlag	(jarðfr.)lag í jørðini, flógv (3), lind 2(3)
jarðlagdur	(plfr.)(um legg)ið liggur fram eftir jørð og festir ikki røtur
jarðleggja	1fella til jarðar, sláa niður, jarðsláa,hann jarðlegði mannin2drepa;síhjartleggja
jarðleggur	(plfr.)partur av plantu sum er undir jørð,jarðleggur veksur ymist vatnrætt ella upp og niður;sbr.loftleggur
jarðleysur	sum onga jørð eigur, ognarleysur, jarðarleysur
jarðligur	sum hoyrir jørðini (4) til, jarðiskur, verðsligur,jarðligar lógir, sum yvirvaldið verndar
jarðmeting	tað at meta jørð, meting av jarðarognum(til at álíkna skatt eftir)[da.taksation]
jarðnøt	(plfr.)slag av suðurlendskari nøt(Arachis hypogaea)
jarðolja	(óreinsað) olja upp úr jørð
jarðormur	(stb.)maður ið er grammur eftir jørð, moldgýðingur
jarðrok	(turrur) kavi sum fýkur undan vindiel.rýkur fram eftir jørðini, guvurok, jarðkavi,tað var ikki avfall, men nógv jarðrok;dúnlætt jarðrok myldi út av skalvinum
jarðroykur	guva upp úr mold, av vegum o.tíl.(upp undir kulda);sbr.velturok
jarðrøring	(jarðfr.)rørslurel.smáskjálvtar í jørðini
jarðsamband	1(ravm.)samband hjá ravmagnsleiðing við jørð2(flutt m.)tað at duga á at skyna veruleikanum og ikki sveima í leysum lofti,hava jarðsamband
jarðsangari	(stb.)ein ið syngur fyri líki
jarðskjálvtafrøði	(jarðfr.)vísindi um jarðskjálvta(seismologia)
jarðskjálvti	(jarðfr.)brádligar ristingar í jarðarskorpuni(elvdar av jarðrøringum),landskjálvti
jarðskot	(um klæði)tað at vera jarðskotin
jarðskotin	(um klæði)við dimmum modnablettum
jarðsláa	jarðleggja, sláa niður,eg skuldi so jarðsligið teg
jarðslættur	l23:leggja jarðslættanleggja niður, fella(í bardaga)
jarðspell	tað at jørðel.gróðrarlendi spillist(av náttúru- el. mannaávum),tað er nógv jarðspell, tá ið teir byggja burtur frá býlingum(um kaninir),tað er jarðspell av grevstri teirra
jarðsteinur	steinur sum vallar undan svørði(tó ikki meir enn at líggi fer yvir);sbr.jarðklettur
jarðsøguligur	viðv. jarðarsøgu,í fornum jarðsøguligum øldum
jarðtala	líktala
jarðtunga	(plfr.)slekt av soppi (2)(Geoglossum);sms. t.d.norður-
jarðvargur	(bíbl.)skaðakykt av grashoppuslag
jarðvarp	(gl.)tað at fellael.jarðleggja e-n
jarðyrkismaður	búnaðarmaður, bóndi
jarkafinna	kv1(stb.)í osb. sumikki øðrvísi enn ein jarkafinnalítil, lágur á vøkstri;eg skal rógva ímóti tær og øllum tínum jarkafinnum(dreingjunum ið vóru smávaksnir)
jarki	1uttari jaðariel.kantur á fóti,eg noyddist at ganga á jarkanum(sárføttur)2(stb.)innari kantur á fóti framman fyri svangan3(stb.)uttari kantur á hond
jarm	1(um seyð)tað at jarma2(flutt m.)gremjan, klaga, jamran
jarma	1(um seyð)lata hoyra í sær, geva ljóð frá sær,(skaldsk.)hoyrið jarma lambið káta;vargur jarmar ikki, klývur ikki í tvey;jarma seg saman1(um ær og lamb)finna saman aftur við at jarma hvørt eftir øðrum2(flutt m.)(um drong og gentu)fáa samband hvørt við annað,nú hava tey jarmað seg saman3(um sundurskild hjún)finna saman aftur2gremja seg, klaga, jamra,jarma yvir ungdómin
jarman	tað at jarma, jarm
jarmari	(fugl.,stb.)havskrápur
jarming	jarman, jarm
jarn	1(evnafr.)metal vunnið úr jarnmálmi(frumevni, teknFe, t.e.ferrum)2kleppurel.annað at høggael.krøkja við,hava jarn í bátinum3húkur, ongul,eg kom aftur við berum jarni(avegndur);fiskur á hvørjum jarni4fjøtur, leinkjur,hann var dømdur at arbeiða í jarni á Bremerholm5arbeiðssamt og ágrýtið fólk, arbeiðsgrev,hon var eitt jarn(eingin bloyta);hann var eitt jarn til ágrýtni;arbeiðsjarn6í osb.(tilt.)salta jarnganga fyri einki, letast;hava jarnið á (e-m)áminna, hava at, harta,eg havi altíð jarnið á teimum, siga tey slíkt;seta jarnið á1strúka (2)2siga (e-m) hvussu eigur at vera, harta (e-n),seta jarnið á ein;(kortsp.,stb.)nú hevur jarnið svikið megel.nú er jarnið gingið frá mæreg fái ikki góð kort longur7(sum seinni liður í sms.)amboðel.búnýti úr jarni,góðaráðjarn;bráarjarn;høggujarn;saksingarjarn;strúkijarn;vaflujarn;sms. t.d.egg-,gerðis-,hóv-,hyppi(ngar)-,hæl-,klepp(u)-,korka-,krúlli-,lív-,morð-,plóg-,pressi-,raki-,rukku-,sinar-,stangar-,tak-,veðra-,øl-
jarnband	1fjøtur av jarni,í tí sterka jarnbandi2band (4) av jarni
jarnbera	strúka við strúkijarni(Sv)
jarnbetong	betong styrkt við jarni í stoypingini
jarnbinda	1(í stoyping)binda jarn saman til at styrkja betong við2(í lendi)binda jarn fyri til at darva omanskrið,hann jarnbant benið omanfyri3(húsasm.)festa við jarnbindi,har kirkjan var jarnbundin, helt
jarnbindari	(í stoyping),maður sum fæst við at binda jarn
jarnbindi	(húsasm.)jarn úr syllel.hornastólpa niður í grundel.stein,jarnbindi var á húsinum
jarnboltur	boltur 1 av jarni
jarnbreyt	breyt av skinnarum 1(2) til tok og onnur jarnbreytarfør at koyra eftir
jarnbreytarfar	far sum koyrir eftir jarnbreyt, tok
jarnbreytarferja	(skip.)ferja ið flytur jarnbreytarfør
jarnbreytargarður	jarnbreytarstøð, tokstøð
jarnbreytarstøð	farstøð fyri tok(har tey steðga og ferðafólk og farmur verða avgreidd),tokstøð
jarnbreytartok	tok
jarnbreytarvognur	farma-el.ferðafólkavognur í (jarnbreytar)toki, tokvognur
jarnbrot	jarnstongt.d.til at loysa grót við, jarnstykki,hann bendir við jarnbroti og slær við mokara;(flutt m.)brúka (e-t) sum jarnbrotbrúka (e-t) sum amboð til at fáa e-t framtel.at náa einum máli,vit kunnu siga, at vit brúka WTO-avtaluna sum jarnbrot í stríðnum fyri eini betri handilsavtalu við ES;sbr.træbrot
jarnbrúdleyp	70 ára brúdleypsdagur
jarnburður	(søg.)tað at bera gløðandi jarn til at sanna sakloysi,mál kundu verða skotin til jarnburð
jarngjørð	gjørð (1) av jarni
jarnharður	harður sum jarn,hjarta hansara knýttist í ein jarnharðan knút
jarnhavin	sum jarn er í, jarnkendur,jarnhavið vatn
jarnhespa	hespa úr jarni,barðholini vóru styrkt við jarnhespum
jarnheysur	(viðurnevni)maður sum gongur hattleysur í øllum veðri,Óli jarnheysur
jarnhælur	1hælur (3) við jarni undir,(flutt m.)landið kom undir útlendskan jarnhæl(kúgað, trælkað)2hælur (6) av jarni,hann setti ein jarnhæl niður í eggina og lesti seg niður
jarnídnaður	skipað framleiðsla úr jarni
jarnkaldur	kaldur sum jarn, ísakaldur
jarnkendur	sum jarn er íel.ber dám av jarni, jarnhavin,jarnkent vatn
jarnketa	keta av jarni
jarnkongur	kongur 2(1) av jarni
jarnkós	kós (3) av jarni
jarnkuldi	kuldi í jarni,ketilin er einki ornaður enn, tað er bara jarnkuldin farin úr honum
jarnkúgv	(sjóm.)(á skipi)tól at gera mjólk við(mjólkarpulvur og vatn samanblandað)
jarnlagdur	við jarni undir, styrktur við jarni,jarnlagdir hælir
jarnleistur	(hjá skósmiði)trígreint jarnamboð til at skósa á(t.d.negla sólar uppundir)
jarnmálmur	málmur sum jarn verður vunnið úr
jarnnagli	nagli av jarni
jarnnám	nám har jarn verður vunnið úr jørðini
jarnnokki	(kvæð.)skipel.bátur av jarni
jarnpetti	petti av jarni
jarnpík	stavspík av jarni,fjallstavur við sterkari jarnpík
jarnpíkur	jarnpík
jarnpláta	pláta av jarni
jarnsag	sag til at saga jarno.tíl.við
jarnseymur	seymur (2) av jarni
jarnskip	(skip.)skip av jarni,sbr.træskip
jarnsmiðja	smiðja
jarnsmiður	smiður sum smíðar jarn, smiðjumaður
jarnsmíð	tað at smíða jarn
jarnspong	spong (4) av jarni,jarnspong til at styrkja stevni á báti
jarnstiði	stiði, amboltur, steðji
jarnstokkur	bindingarstokkur av jarni,jarnstokkar vóru vanligir fyri umleið 50 árum síðani
jarnstong	stong úr jarni, jarnbrot,(kvæð.)risin reiggjar jarnstongini
jarnstykki	(stb.)jarnbrot
jarnsørur	sum einki jarn er í
jarntak	tak úr (rukku)jarni, jarntekja
jarnteinur	jarnrim,jarnteinar vóru fyri vindeyganum
jarntekja	jarntak
jarntjald	1(í leikhúsi)eldtrygt tjald av jarni millum pall og sal2(søg.)mark millum Eystur- og Vesturevropa (1948-92)
jarntráður	1tráður úr jarni2stokkatráður
jarntunna	tunna av jarni
jarnvegur	(sj.)jarnbreyt
jarnverk	rimaverk úr jarni fram við trappum, pøllumel.svølum,kringlað jarnverk vóru framvið
jarnvirki	verksmiðja ið virkar jarn
jarnvøra	vøra úr jarni[da.isenkram]
jarnøld	(fornfr.)forsøguligt tíðarskeið eftir bronsuøld tá ið farið varð at vinna jarn úr jarnmálmi til vápn, amboð o.a.(í Norðurlondum o.u. 500 f.Kr. til o.u. 1050 e.Kr.)
jarpur	(ljóst) brúnur á hárliti;sms.dimm-,myrka-
jartekin	1(átr.)tekin sum prógvar e-t, sannprógv2undur, kraftagerð,jartekin Jesusar3fyriboðan(um e-t guddómligt)
jarvur	(dj.)ránsdjór av márætt(heldur til í fjøllum í Norðurnoregi og Svøríki)(Gulo gulo)
jasa	(sj.)siga ja, játta, loyva,hatta jasar til alt;hatta skuldi ikki verið jasað til
jasagdur	jasøgin, jaligur
jaspis	(jarðfr.)óskyggið steinslag(reytt, brúnt el. grønt á liti)
jassastikk	(kortsp.)stikk tikið við jassinum
jassi	(kortsp.,Suð.)jassur,eg havi jassan
jassur	1(um drong)stavnur, knevil, kúllur, skálkur2(kortsp.)drongurin í trumfi(í grevjassi)
jasøgin	jaligur, játtandi, positivur
jatnir	síjøtun
jauari	(skemt.)íslendingur,jauararnir vóru illa sperdir, tá ið landið fór á húsagang
javna	1slætta, gera javnan,hann stóð og javnaði grøvina niður2býta javnt,epli, petrolium o.a. javnaðu teir millum skipini3spjaða seg javnt(um rakstur t.d.),tá ið vit reka, mugu vit javna okkum sundur4lekja, fáa í rættlag, laga,tíðin javnar alt;tað man javna seg;hann javnaði seg eftir hvøkkin(kom fyri seg)5sætta, semja,onkur illstøða var, men tað er javnað aftur6gera eins, gera lík,javna saman bygdamálini7stilla[da.regulere]8(ítr.)fáa tað at standa á jøvnum,teir javnaðu til 2-2 í seinna hálvleiki9smakka sær á dagin eftir(fyri hundasjúku),um morgunin fekk hann sær ein lítlan at javna við10lata javning út í, gera út á(súpan o.a.)11bera saman (við),javna hann við eitt skógartrøll
javnaðarfelag	felag javnaðarmanna
javnaðarflokkur	(stjm.)flokkur sum virkar fyri javnaði(í samfelagnum, ofta nýtt um arbeiðaraflokkar í øðrum londum),Javnaðarflokkurinføroyskur flokkur(stovnaður 1928)
javnaðarmaður	(stjm.)limur í javnaðarflokkiel.ein ið velur javnaðarflokk
javnaðarmerki	(støddfr.)merki um at tvey tøl eru javnstór (=), javnatekn
javnaðarstjórn	(stjm.)ríkisstjórn við javnaðarflokki(í meiriluta)
javnaður	1tað at javnt er býtt(í samfelagnum),javni (2), rættvísi, javnrættindi2(støddfr.)tað at tvey tøl eru javnstór
javnaglíma	sbr.javnglíma
javnaldra	ein sum er javngomul (við e-n),tær møta eini javnaldru
javnaldraður	sum er á sama aldri, javngamal(við e-n),teir eru javnaldraðir
javnaldri	ein sum er javngamal(við e-n),javnaldur
javnaldur	1javnaldri2(skemt.)javnaldurinkynslimurin(á mannfólki)
javnan	1ofta, tíðum, støðugt, vanliga,hvalir síggjast javnan um okkara leiðir;tey høvdu javnan 10 tunnur av korni um árið2javnt, regluliga,hann reyt tungan og javnan
javnari	munnur av brennivíni(fyri hundasjúku),fáa sær ein javnara
javnatekn	(støddfr.)tekn ið vísir at tøl, mongdirel.tíl.eru javnstór, teknið =, javnaðarmerki
javnaætt	(plfr.)ætt av leggstreingjagróplantum(Lycopodiaceae)
javnbakaður	javnt bakaður,penar og javnbakaðar vaflur
javnbeintur	(støddfr.)(um tríkant)við tveimum javnlongum síðum
javnbjóða	s39/30í osb. sumjavnbjóða seg viðjavnmeta seg við, standa seg ímóti, kunna kappast við;ein skúli, sum kann javnbjóða seg við útlendskar skúlar
javnbjóðis	1við sama rætti, á jøvnum føti,nú standa hesi bæði mál javnbjóðis í Finnlandi;javnbjóðis við e-n;kvæðini vóru fólksins andligu ognir javnbjóðis við danskar kempuvísur2fsá jøvnum føti við, ájavnt við,javnbjóðis e-m;fáir kundu verða mettir javnbjóðis honum
javnbrattur	javnt brattur,har er so javnbratt at ganga
javnbreidd	kv2:í javnbreidd við e-njavnbjóðis e-m;ganga fram í javnbreidd við frændur okkara
javnbreiður	eins breiður allan vegin,ein javnbreiður malarbrúgv lá inn við barminum
javnbrótari	(ítr.)eyka sett 2(2) at avgera dyst sum stendur á jøvnum,eftir støðuna 2 - 2 var síðsta sett ein sera spennandi javnbrótari, og hann endaði 15 - 13 til SÍ, og sostatt endaði dysturin 3 - 2 til SÍ
javnbýti	javnt býti
javnbýttur	javnt býttur(ímillum fleiri),nøvnini sýnast so javnbýtt um landið
javndimmur	javnt dimmur,ungfuglurin er javndimmur omaná
javndjúpur	(allur) javnt djúpur,Eystarasalt er javndjúpt allastaðni;tungt er at ganga í javndjúpum kava
javndøgur	tíðin tá ið sólin er beint yvir jarðarmiðboga og nátt og dagur eru javnlong um alla jørðina(ein av døgunum 19.- 21. mars á vári og 21.- 24. sept. á heysti);sbr.heystjavndøgur,várjavndøgur
javndøgursstormur	stormur um javndøgurstíð
javneksingur	k6(plfr.)javneksingarslag av stør við fleiri enn einum eins aksi á hvørjum leggjarenda(homostachyae)
javnfall	(stb.)tað at tveir ið berjast detta báðir í senn, hvørgin kemur undir
javnfirringur	(støddfr.)ikki rætthyrntur ferhyrningur við javnfjarum síðum[da.parallelogram]
javnfjarur	1eins fjarur,báðir eru javnfjarir frá sannleikanum2(umt.d.linjur)sum allastaðni eru eins langt hvør frá aðrari,linjurnar eru javnfjarar[da.parallel]
javnflokkur	(skúl.)ein av tveimumel.fleiri skúlaflokkum í sama árgangi[da.parallelklasse]
javnflyta	(støddfr.)flyta allar lutir í punktmongd líka langt og sama veg[da.parallelforskyde]
javnflyting	(støddfr.)tað at javnflyta
javnføra	laga eftir ávísum reglum og tørvi[da.regulere]
javngamal	á sama aldri, javnaldraður,vit vóru javngomul;hann er javngamal við meg
javngildi	sama gildi, javnvirði,hann fekk javngildi fyri jørðina
javngildur	við sama gildiel.virði, javnlíkur[da.ækvivalent]
javnglíma	tað at tað stendur á jøvnum(í bardaga),teir stóðu í javnglímu;sbr.javnaglíma
javngóður	1eins góður, líka góður,fuglakjøt er javngott við grindatvøst;hann heldur seg hava javngóðan rætt til teirra og hann;at fara burtur úr landinum at sanka sær kunnleika, hann átti at kunna fáa javngóðan her;(kvæð.)tær javngott vív at fá2javnt góður, javnurel.einvorðin til góðsku,allur matur er javngóður hjá honum, sum matarlyst hevur;dugnaskapurin til at fáa nógva og javngóða mjólk alt árið trýtur hjá teim flestu;neyvan hevur javnbetri manning farið út úr nøkrum havnarlagi í Føroyum;javnbesti sessur norður í Bergi
javngráur	javnt gráur,teir gomlu nebbafiskarnir verða javngráir um allan kroppin
javnheitur	javnt heitur
javnhvítur	javnt hvítur
javnhyrntur	(støddfr.)við javnstórum hornum (14)
javnhøgur	1javnt høgur,fjøllini eru javnhøg úr Nesi í Nakk2eins høgur, líka høgur,urðin lá næstan javnhøg við stakkin
javni	1líki, javnlíki, javningi,fáur var hans javni í skili;(kvæð.)hann tykist vera tín javni;(kvæð.)eg eri ein góðs mans javni2javnaður, javnrættindi,tá fer at vera javni tykkara millum3(búsk.)javnvág(t.d. í roknskapi);sbr.handilsjavni4(plfr.)hagaurtir(nýttar til at gula við)(Lycopodium, Huperzia, Diphasiastrum);sms. t.d.hosta-,litingar-,lyng-,mis-,mosa-,ó-
javning	í osb. sumbinda til javningar(tá ið ov lítið tógv er til at binda pløgg ið hoyra saman tvey og tvey),binda tvey pløgg javnlangt við tónum ið til er og gera liðugt við øðrum tógvi
javningi	líki 1, javnlíki, líkamaður,(kvæð.)hvar vitið tær mín javninga
javningur	1javningi2(í matgerð)mjøl rørt upp í vatn til at lata út í sós, súpano.tíl.(so at røtt tjúkt fæst);sbr.gera útá
javnlangur	eins langur, líka langur,tá ið vundið varð saman trítráðað, var tað óeydna, um træðrirnir vóru javnlangir;javnlangur ogeins langur og
javnleikur	(ítr.)tað at tað stendur á jøvnum (í dystiel.kapping), óavgjørdur leikur
javnliga	1javnt,hann bað teir stjala javnliga frá øllum2líðandi,sandbotnurin hellir javnliga3javnan, tíðum, ofta,seyðurin gekk heim, um hann ikki javnliga varð rikin burtur;hann vitjaði javnliga higar
javnligur	heldur javnur,javnligt var av fugli;tú tókst nakrar javnligar vørrir, semingsróður, útfrá
javnlíka	(kvæð.)á sama hátt, eins
javnlíki	javningi,(kvæð.)hvar vitið tær mín javnlíka
javnlíkt	(kvæð.)javnlíka
javnlíkur	heilt líkur,javnlíkur e-m;skipanin var ikki javnlík teirri donsku;eg meti meg ikki javnlíkan hesum báðum miklu rithøvundunum
javnlyndur	javnt sintur, sinniligur, róligur
javnløn	sama løn til menn og kvinnur fyri sama arbeiði
javnmeta	meta eins, seta javnt (við),hennara vakurleiki kundi ikki javnmetast við nakað;hesar hendingar kunnu ikki javnmetast;tað er gamalt sagt, at Kúlan í Elduvík og Kletturin á Rimlinum í Húsavík skulu vera javnmett til brim
javnmikil	eins mikil,einum fámentum fólki tørvast helst javnmikið og einum fjølmentum
javnnógvur	1javnt nógvur,so javnnógv gras hevði hann ikki sætt á bønum áður2eins nógvur,tað kom javnnógv burtur úr hesari nevnd sum burtur úr øðrum nevndum
javnringur	javnt ringur,eg havi ikki vitað so javnringt veður
javnríkur	eins ríkur
javnræði	(kvæð.)hóskandi gifta,hvar vitið tær nú javnræði mítt?
javnrættindi(r)	tað at hava jøvn rættindi (við onnur),kvinnur kravdu javnrættindi(r) við menn
javnrættur	javnrættindi
javnrøddur	(um bát)beinrøddur(Sv)
javnseta	seta javntel.javnsíðis við, javnmeta,hann javnsetur støðu sína við okkara;javnsettur við (e-n)í somu støðu sum, á sama stigi sum
javnsinni	tað at vera javnsintur, javnlyndi
javnsintur	1javnlyndur, róligur, sinniligur,hon er so mild og javnsint2samsintur,tað var so lætt at mala (á kvørn), tá ið tað vóru tvær javnsintar (ið mólu)
javnsíðaður	(støddfr.)(um tríhyrning)við øllum síðum javnlongum
javnsíðis	lið um lið, borð um borð,javnsíðis fóru bátarnir norðureftir;tekstirnir eru prentaðir javnsíðis í bókini
javnskapaður	einvorðin
javnskavaður	fullur upp at trominiel.kantinum, javntramaður, javnstrokin,200 pund vigaði málið(av hvalatvøsti),tá ið tað var javnskavað,dekkið var javnskavað av toski;hvørt gil lá javnskavað í kavarokinum
javnskipa	stilla, javna[da.regulere]
javnskipaður	(málfr.)(um setning)sum er skipaður javnt við annan
javnskipan	(málfr.)tað at setningar eru javnskipaðir(parataxis)
javnslættur	javnt slættur,aftan á skalvin lá alt javnslætt oman á kirkjugarðin
javnsmáur	javnt smáur, smáur yvirhøvur,javnsmáur fiskur;sbr.smáfallandi
javnsnøggur	javnt snøggur,ongantíð hevur bøurin verið javnsnøggur(so lítið gras á yvirhøvur)
javnstaddur	í javnstøðu
javnstórur	1javnt stórur,javnstórur fiskur2eins stórur, líka stórur,javnstórur og;javnstórur við (e-n)eins stórur og, líka stórur sum
javnstreymur	(ravm.)einstevndur ravmagnsstreymur,móts.vendistreymur
javnstrokin	javnskavaður,fannakavi var lagstur, og alt var javnstrokið;hættisligt er at halda á skarafonnina, ið liggur javnstrokin oman á Garðarnar
javnstøða	1tað at standa javnbjóðis øðrum, javnrættur,stríðið fyri javnstøðu millum kvinnur og menn2javnvág,hann fekk hetta alt í javnstøðu innan í sær
javnstøðulóg	(løgfr.)lóg um javnstøðu millum mannfólk og konufólk
javnstøðunevnd	nevnd ið sær til at javnstøða er kynjanna millum
javnsvara	(sj.)samsvara við,kjøtprísurin her javnsvarar kjøtprísi í útlondum
javnsýna	samsýna, endurgjalda,eg kendi meg noyddan at javnsýna honum fyri beinan
javnsýning	samsýning, endurgjald
javnt	síjavnur
javntjúkkur	javnt tjúkkur,javntjúkkur lá kavin um alt landið
javntramaður	fullur upp at tromini, javnskavaður, javnstrokin,kjallarin var javntramaður av mold;javntramaður leypur(við ongum roka)
javntungur	l1:javntungur við (e-n)eins tungur og, líka tungur sum
javntøkur	sum samsvarar heilt við e-t annað, er eins, allíkur, einsháttaður,hesar báðar merkingarnar eru javntøkar;(støddfr.)javntøkir formar[da.kongruent]
javnur	1samsvarandi, fult líkur, eins høgur, stórur, sterkuro.s.fr.,teir eru javnir;hann var ikki javnur við hann;tú skalt taka javnan lut við okkum;á jøvnum føtivið somu treytum2slættur, beinur,javnur kantur3í osb.standa á jøvnumvera óavgjørdur(um tveirel.fleiri partar ið eru javnt sterkir),stendur á jøvnum eftir vanliga leiktíð, verður umdystur;stendur á jøvnum, er atkvøða formansins avgerandi4einsháttaður,hitin er toluliga javnur har um vegir5støðugur, áhaldin,skuldi nakað koma á skaftið, mátti tú vera javnur á tí(liggja á takinum, dríva á)6toluligur, hálvvánaligur, ússaligur, sum ikki hevur tað betri enn gott,tað var ikki meir enn javnt hjá mær7vanligur, algongdur,tað javna er, at so verður gjørt8javnt[jamt]hj1støðugt, áhaldandi2javnt og samtí heilum, støðugt3ofta, tíðum, sum heild,hendan leiðin var tann, sum javnast var farin4teir verða ikki raktir javnt við aðrar(á sama hátt, í sama mun)5tað gekk javnt átað var føst regla;tað gekk javnt á, hvør ið fyrri átti at taka6líðandi,liturin kámast javnt burtur;sms. t.d.ájavnt,mis-,ó-,stev-
javnvaksin	1javnt vaksin, beinur,hesin tongulin var klænur, liðiligur, javnvaksin2líka stórur, javnstórur,á jóansøku er lambið javnvaksið við ærina
javnvág	1(alisfr.)tað at tveir lutir viga tað sama, javni, javnvøga,tá ið pílurin varð gjørdur, funnu teir javnvágina á honum við at viga hann á knívseggini2(búsk.)partur av ársroknskapi hjá fyritøku har ið ogn og skuld verða uppgjørd, javni (3), munur (5)
javnviðrað	við sama veðri(í longri tíð),samviðrað,eg havi ikki verið so javnviðrað á havinum
javnviga	1viga beintel.javnt, vera í javnvág (1)2(búsk.)vera í javnvág (2),fíggjarlógin javnvigar við 1 milliard krónum3(spæl)danda, ríða grimilsi
javnvigan	javnvág
javnvirði	tað at vera javnur í virði (við), javngildi
javnvæl	líka væl, eins væl,tað er ikki javnvæl umtókt av øllum
javnvøga	javnvág, javnvigan
jáa	(kvæð.)játta,tí vil eg nú blíðum soni mína dóttur jáa
Jákup	sern:klænbeinti Jákupgjóstur, Ívar (beinleysi)
jákupsdagur	25. juli
jákupsskel	(dj.)slag av skeldýri(upp til 9 cm long við uml. 20 rípum uttan á skelini)(Pecten opercularis);sbr.rípuskel,saguskel,smørskel
jákupsstigi	k1e(stjfr.)JákupsstigiSkákstjørnur(nar), Skákið(í stjørnumyndini Orion)
jánka	1hálvavegna lovael.játta, svara jánkasliga,jánka um2lorka niður (úr hondunum), missa,jánka niður úr hondunum
jánkaligur	gjánkaligur;hj-liga
jánkasligur	1ivingarsamur, ivandi, óvissur2seinførur, dovisligur, lorkutur;hj-liga;sbr.gjánkasligur
játa	hart grønligt steinslag(nýtt til prýðislutir),jada
játta	1siga ja, samtykkja, sanna, staðfesta, lova,hann játtaði tí;"So er," játta teir eftir;játtandi myndugleikar(ið játta pening)2ganga við, viðganga, viðurkenna,játta syndir sínar;játta trúgv;játta seg sekan
játtan	1tað at játta, játting, játtilsi, lyfti2(búsk.)veiting, peningajáttan(t.d. á fíggjarlóg);sms. t.d.fyri-,lívs-,trúar-
játtanarlóg	(búsk.)lóg ið ásetur treytir og mannagongdir fyri játtanum(úr landskassanum),ongar útreiðslur eiga at verða goldnar, uttan at heimild er fyri teimum í teirri fíggjarlóg ella aðrari játtanarlóg, ið er í gildi, tá ið ávíst verður
játtilsi	játtan
játting	játtan
je1	mðlv(stytting fyri Jesus),á, harra je;tað veit je[tɛavaˈje:]
je2	(Suð.)ja,je, beiggin;je?er tað satt? meinar tú tað?(av gleði)
jeg	(Suð.)eg
jekari	(søg.)1soldátur í skansaliðinum í Havn(til 1865)2løgreglumaður, politistur í løgregluliðinum eftir 1865;sms.yvir-
jemmil	(Sa.)munnur, gákur, kjaftur,hon dugdi at brúka jemmilin;jemmilin á hasum
jeppur	sterkt bygdur bilur við drivi á øllum hjólum[en.jeep]
jesa	rópa upp á Jesus, barma seg,okkurt konufólk trívur í at jesa;hann jesaði við
jesan	tað at jesa,har var róp og gníst, jesan og bønan
jesuitti	(átr.)munkur í jesuittaregluni ið varð stovnað 1534
jesuittur	(átr.)munkur ið hoyrir til munkaregluna sum Ignatius Loyola stovnaði í 1534;
Jesus	navn Krists,Jesus veri við tær(heilsan til e-n ið fer avstað);báðir biðja teir Jesus vera við sær(fara niður í línu);Jesu navn, hvat skuldi hann gera?;Jesus komi til mín!
jesuspápablomstur	(plfr.,barn.)undirløgugras
jesuspápadýr	(dj.,barn.)lítið reytt kykt á fjørugróti, kongalús, rupa, urðaroksi(Acarus litoralis)
jesuspápalamb	(dj.,barn.)jesuspápaseyður
jesuspápaleika	(barn.)máni, fullmáni
jesuspápaseyður	(dj.,barn.)jesuspápadýr, kongalús
Jesuspápi	Jesus
jettflogfar	flogfar drivið við trýstluft
jiddiskur	l24:jiddiskttýskt mál hjá gýðingum (uppr. í Eysturevropa)(blandað við hebraiskt og pólskt)
jobstol	framúr gott tol,har skal jobstol til
jod	1(evnafr.)fast evni døkt á liti(frumevni, teknIel.J)2evni nýtt til at reinsa sár við,tað vanliga jodið er jod sum er loyst upp í spritti
jodd	heiti á bókstavinumj
jodla	(tónl.)syngja við ongum orðum ymist við høgum og lágum tóna
joga	1(heimsp.,átr.)indisk heimspekiel.átrúnaður ið nýtir likamligar venjingar og andliga hugsavning(til átrúnaðarligt innlit og frelsu)2(ítr.)slag av fimleiki ið hevur til endamáls at linka spenningar í kroppinum(ávirkað av indiskari heimspeki og umfatarm.a.venjingar í andadrátti og djúphugsan)
jogga	(ítr.)smárennael.ganga skjótt(fyri at røra seg),tritla (2)
jogurt	(mjólk.)mjólkarúrdráttur súrgaður við ávísum bakteriugróðri
jokari	(kortsp.)serstakt eykakort(vanl. við mynd av fívli)ið kann verða nýtt sum hægsta kort í summum kortspølum
jolla	lítil bátur, skipsbátur,(spæl)loysa jollunaloysa fimlu
jomfrú	1moyggj,jomfrúnna tók hann í sín favn2(stb.)anari3(skip.)rundur áflatur trækubbi við trimum holum(til at festa vantini í)
jomfrúband	moydómur(hymen),um moynnar jomfrúband tú slítur
jomfrúgrein	(stb.)rygglundin í turrum fiski
jomfrúhummari	(dj.)klænvaksið liðadýraslag í sjónum, hummari (2)(Nephrops norvegicus)
jomfrúkinn	(kvæð.)moyggjarkinn,so er at líta á jomfrúkinn, sum droyrin drýpur á snjó
jomfrúmerki	h25(stjfr.)JomfrúmerkiðMoyggin
jomfrústykki	(á kalva)sporlið og sterturin
jompa	(um gongulag)hirsa upp og niðurel.gera nógv um seg í gongd(tó lítið líður eftir),hoppa,ganga og jompa
jon	(alisfr.)atomel.mýl við ravmagnsløðing
jona	(alisfr.)klúgva í jon
joning	(alisfr.)tað at jona
Jorsalaborg	(gl.,stn.)Jorsalir
Jorsalir	(gl.)Jerúsalem
joule	(alisfr.)mátingareind fyri orku, jul(teknJ, 1 J = 0,239 kaloria)
jóansøka	124. juni(katólskur halgidagur til minnis um føðing Jóhannesar doypara),gamla jóansøka13 dagar seinni enn jóansøka nú er2stevna hildin í Suðuroy ymiskt í Vági og á Tvøroyri um 24. juni
jóansøkuaftan	dagurin fyri jóansøku
jóansøkudøgg	døgg um jóansøku,tann, sum hevði skrubb, skuldi tváa sær í jóansøkudøgg
jóansøkugras	(plfr.)jóansøkugøtubrá
jóansøkugøtubrá	(plfr.)slag av gøtubrá(láglendisurt nýtt til at lita grønt við),langskøra, jóansøkugras(Plantago lanceolata)
jóansøkuhald	tað at halda jóansøku
jóansøkunátt	náttin fyri jóansøkudag,gomlu jóansøkunátt varð dansað um Varmakeldu, lekidómur var í henni kl. 12;gomlu jóansøkunátt komu kóparnir upp at dansa
jóansøkutoka	toka um jóansøkutíð,teir plagdu at tosa um jóansøkutokuna, tá ið teir komu aftur frá skipi og fóru at skjóta fugl
jóansøkuveður	gott veður, dýrdarveður,nú er jóansøkuveður
jói	(fugl.)kjógvaslag(eitt sindur størri enn vanl. kjógvi)(Stercorarius pomarinus),(kvæð.)tá kom jói fríði fuglur
jól	(átr.)1kirkjuhátíð 24.-26. desember(fram á fjórðu øld og enn í Russlandi t.d. 6. jan., sbr. gomlu jól)til minnis um føðing Krists;gomlu jól(eftir gamla álmanakkanum)6. jan.;gleðilig jól;á jólumum jólini;fyri jólundan jólum;millum jólanna1frá jóladegi til tjúgunda dag jóla(13. jan.)2frá jóladegi til trettanda(6. jan.);(kvæð.)drekka jólhalda jól;halda jólhava hátíðarhald um jólini;bera jólini á baki(num)fara avstað uttan at hava fingið vátt ella turt har ið ein hevur vitjað um jólahalguna;bera jólini útbera jólini á baki;hann hevur jól og góðar dagarhava tað gott, liva eitt harramanslív;ganga sum á jólumganga væl, sum eftir ánni;telja jólinikvøða ávísar vísur í dansi á føstulávint(t.d. "Mær gav sankta Mortan tjúgunda kvøld jóla ...")2(í heidnari tíð)offurveitsla á miðjum vetri, sólstøðuhøgtíð(helst hildin seinni enn kristin jól nú)
jólaaftan	dagurin og kvøldið fyri jóladag
jólaaftansdagur	dagurin jólaaftan
jólaaftansdøgurði	døgurði jólaaftan,her er jólaaftansdøgurði útbloyttur fiskur og garnatálg
jólaandvekur	(stb.)andvekur á børnum upp undir jól, jólaríggjur
jólablað	jólahefti
jólaboð	1jólaboðskapurin2(stb.,flutt m.)góð tíðindi
jólaboðskapur	boðskapurin um føðing Krists, jólaevangeliið
jólabolli	slag av (søtum) bolla ið etin verður um jóltíðir
jólaborð	jólaborðhald,fólk fara til jólaborð saman við vinum og arbeiðsfeløgum
jólaborðhald	borðhald í sambandi við jólini(vanl. fyri jól),skrivstovan hevði jólaborðhald fyri øllum starvsfólkinum
jólabók	bókel.rit givið út til jóla
jólabrenni	brenni til jóla,tollaksmessudagur hevur altíð verið nýttur til at fáa jólabrenni at húsum(torv)
jólabrennivín	brennivín til jóla, jóladrekka, jólaløgur
jólabygd	(gl.)bygd har sum dansað varð annað jólakvøld;sbr.nýggjársbygd,trettandabygd,kyndilsmessubygd
jóladagur	1fyrsti dagur í jólahalguni, 25. desember,annar jóladagur26. desember2dagur yvirhøvur í jólahalguni,teir høvdu verið á flotið fjórða jóladag;(flutt m.)hava jóladagarhava góðar dagar
jóladansur	(føroyskur) dansur annað jólakvøld
jóladámur	dámur (2) eyðkendur fyri jólini,tað var rættur jóladámur(jólaligt)
jóladrekka	drekkaløgur til jóla
jólaevangelium	frásøgn Bíbliunnar um føðing Krists, jólaboðskapurin
jólaeyrur	(stb.)eyrur stroyddur á tún upp undir jól
jólaferðing	tað at ferðast um jólini
jólafiskur	(ræstur) fiskur havdur til døgurða jólaaftan(saman við sperðli)
jólafriður	(hátíðarligur) friður vegna jólahalguna,jólafriður byrjaði tríggjar dagar fyri jól, tá kundi ikki stevnast
jólafrí	jólafrítíð
jólafríggjari	k1í osb.tað er ikki altíð, at jólafríggjari verður páskafríggjari;jólafríggjari verður páskaskýggjaritað er ikki altíð at fríggjarafólk halda longur saman enn frá jólum til páska
jólafrítíð	frítíð (frá skúlagongdel.arbeiði) um jólini
jólaføsta	tær seinastu fýra vikurnar fyri jól(byrjar fjórða sunnudag fyri jóladag),advent, lítlaføsta,teimum gomlu dámdi ikki, at dansað varð í jólaføstuni
jólagáva	gáva givin á jólum(vanl. jólaaftan)
jólagestur	gestur ið vitjar um jólini
jólagleði	gleði av jólunum
jólaglíma	(kvæð.)glíma á jólum,halda jólaglímur
jólagóðgæti	jólagóði
jólagóði	jólamatur, jólagóðgæti
jólagreytur	(rís)greytur sopin á jólum
jólagriður	(kvæð.)griður vegna jólini, jólafriður,eggjar mann í Botnar norður, gevur ei jólagrið
jólagrind	grind sum doyr um jóltíðir(tiltikin feit);sbr.kongagrind
jólahald	tað at halda jól
jólahalga	jólahátíð, jólahøgtíð
jólahandil	1jólasøla (1),jólahandilin gekk væl í ár2handil (1) ið vinnur heitið sum vakrast pyntaði handil til jóla,Siri var ársins jólahandil 20113handil (1) ið selur jólaprýði,har er ein jólahandil við alskynt jólaprýði
jólahátíð	jól
jólahefti	hefti við jólasøgum, lítil jólabók, jólablað
jólaheilsa(n)	heilsan send til jóla
jólahosa	hosa ið børn hongdu á songarstokkin og sum tey funnu góðgæti og smágávur í jólamorgun,eru tit ikki hampilig, fáa tit einki í jólahosuna
jólahýrur	góður hýrur á fólki um jólini,Mikkjal legði skjótt fyri við einum nýggjum kvæði, og jólahýrur kom tá aftur á fólk
jólahøgtíð	jólahátíð
jólakaka	jólakøka
jólakalendari	kalendari við 24 lúkum at lata upp frá 1. desember til jóla
jólakassi	(søg.)brennivínskassi til jóla
jólaklokka	1kirkjuklokka ið ringir til gudstænastu á jólum2lítil klokka til prýðis át.d.jólatræ
jólaklæddur	í jólaklæðum
jólaklæði(r)	nýggj klæði til jóla,nýggj jólaklæði(r) var vanligt at fáa sær
jólaknetti(r)	knetti høvd til jólamat,vit hava fingið okkum til jólaknetti(r);tygum mugu vera ein av teimum, sum hava fingið krava sín av kjøti, tá tygum ikki kenna jólaknetti(r)
jólakort	(myndprýtt) postkort til jólaheilsan
jólakrubba	myndil av fjósinum í Betlehem(við barninum í krubbuni o.s.fr.)
jólakúgv	kúgv sum kálvar um jóltíðir
jólakvøld	kvøld jóladag
jólakøka	formakøka við rosinum
jólalag	1jólahýrur2jóladámur3(tónl.)lag á t.d. jólasálmiel.jólasongi
jólalamb	(gl.)1gimburlamb tikið til jólamat2lamb sum arbeiðsfólk fekk upp í lønina um heystiðel.seinni,húskallar áttu jólalamb
jólalesnaður	lesnaður til jólini
jólalestur	lestur (2) lisin við húsel.í kirkju um jólini
jólaligur	1eyðkendur fyri jólini, við jóladámi,nú var tað eitt sindur jólaligt úti;hitt rætta jólaliga sinnið2(skemt.)farin (so smátt) at kenna til fyri jól,ert tú longu jólaligur?
jólaljós	(lítið) kertiljós tendrað til hugna á jólum,tey plagdu at tendra jólaljós og seta tey í vindeyguni
jólaløgur	(stb.)jóladrekka,fáa sær jólaløgin
jólamaður	1góðvættur søgd bera børnum gávur á jólum, jólavættur2fólk ílatið sum jólamaður (1)3(stb.)maður ið gongur við kenning um jóltíðir,sást tú nógvar jólamenn í gjárkvøldið?
jólamatur	(góður) matur etin á jólum
jólamánaður	desembermánaður,komið var út í jólamánaðin
jólamerki	(postm.)merki at seta á postsendingar um jóltíðir(til frama fyri góð endamál)
jólamorgun	morgunin jóladag
jólanátt	náttin fyri jóladag,(tilt.)sum lundi á jólanáttsjáldsamur, óvanligur;sbr.trøllbarn (1)
jólanissa	jólavættur
jólapakki	(post)pakki við sending til jóla
jólapottur	(gl.)pottur av brennivíni sum hvør húskallur fekk til jóla(AW Tjóðm.54)
jólaprýði	e-t at prýðael.pynta við til jóla
jólapynt	jólaprýði
jólaravi	(gl.,stb.)ravi (1) etin á jólum, jólstykki
jólaríggjur	(stb.)knarran og ófriður á børnum framman undan jólum, jólaandvekur,barnið hevur jólaríggjur;sbr.ríggja 1(2)
jólarósa	(plfr.)garðsblóma í slektiniHelleborus(blomstrar jan.-febr.)
jólasálmur	sálmur at syngja á jólum
jólaseyður	seyður tikin til jóla,taka jólaseyð;skinn av jólaseyði máttu tey ikki rota, tí so kom húsið fyri miseydnu;teir eru á fjalli í jólaseyði
jólaskeki	(stb.)jólaskekil (1),fáa jólaskeka
jólaskekil	1fleingja (sum barn fær) á jólum(stór skomm),tú fært jólaskekil2barn flongt á jólum,tú verður jólaskekil
jólaskip	(gl.)skip ið kom við vøru og ferðafólki til jóla
jólasnøkil	(stb.)jólaskekil (2)
jólasongur	songur at syngja á jólum
jólasól	mánaður(í gl. føroyska álmanakkanum)frá um 20. des. til gomlu trettandu,jólasólin tendrast 4 dagar fyri jól;nú verði eg feigur, eg sá jólasólina tómhentur;onkur verður fongurin, ikki var eg tómhentur, eg sá jólasólina
jólasperðil	1sperðil úr feitiseyði at eta aftur við fiski jólaaftan2fløkt snælda (3)
jólasták	jólastákan
jólastákan	stákan undan jólum
jólastás	stás til jóla
jólastingur	(um seyming)langir og ótættir stingir(í skundi),hatta eru jólastingir
jólastjørna	1bjørt stjørna ið birtist fyri føðing Krists2silvurlitt stjørna ovast á jólatræ3(plfr.)útl. inniplanta við reyðum bløðum í erva(Euphorbia pulcherrima)(nýtt til prýðis um jóltíðir)
jólastrika	(stb.,skemt.)press í nýpressaðum buksum,hava jólastrikur
jólasummar	summarsligt veður um jóltíðir,teir gomlu søgdu, at jólasummar gjørdi páskavetur
jólasunnudagur	sunnudagur millum jóla og nýggjárs
jólasøla	1vørusøla tann seinasta mánaðin undan jólum, jólahandil (1),jólasølan hevur stóran týdning fyri bókahandlarnar2søla av handgjørdum lutum til frama fyri áhugafelag(vanl.í desembermánaði),tann árliga jólasølan hjá Føroya Heimavirkisfelag verður 10. desember
jólatíð	(kvæð.)jóltíð,tað var um eina jólatíð
jólatorv	(gl.)torv at brenna um jólini,henda ferðin eftir jólatorvi gekk Óla ongantíð úr minni
jólatræ	1nálatræ(vanl. grann)pyntað við ljósum og øðrum at hava til prýðis á jólum2jólaveitsla,jólatræ fyri børn(um)
jólatrøll	arbeiði sum ikki fæst liðugt fyri jól(t.d. e-t bundið),tað arbeiðið, sum lá í hálvum gekki, varð upphongt í roykstovuni, tí tað var jólatrøll;verri skomm var ikki til enn at fáa jólatrøll;sbr.nýggjárstrøll,tjúgundatrøll,trettandatrøll
jólatvongur	k34(skemt.)jólatveingirstrá sum standa eftir tá ið illa er sligið,í støðum stóðu jólatveingir einsligir eftir
jólaveitsla	veitsla hildin um jólini
jólaverður	(gl.)verður etin á jólum,har suðuri fingu húskallarnir fastan jólaverð, sum var limur úr gamalseyðakrovi
jólavika	vikan sum jólini eru í
jólavist	vitjan um jólini(Sv)
jólavísa	(gl.)jólasongur
jólavættur	jólamaður (1)
jólaær	1ær tikin til matna um jólini2ær sum húskallur fekk upp í lønina (um heystið),av seyði fingu húskallarnir í klipping eina góða ær, ið kallaðist jólaær
jólaøl	1h3eserst. gott maltøl bryggjað til jóla2kv2fløska við jólaøli (1),tvær jólaøl
jólhestur	(gl.)maður ílatin rossahúð við høvuðleðrinum(til skemtanart.d.í dansi á jólum),(tilt.)rennael.leypa sum ein jólhestur(hart og ódliga);leika í sum ein jólhestur;nú fer hon um sum ein jólhestur(um konu ið hevði verið lamin)
jólhøna	(gl.)fólk ípjøssað so at tað skuldi líkjast hønu(til skemtanar á jólum)(Varð. 4180)
-jóli	síhvann-
jólstykki	jólaravi
jóltíð	tíðin um jólini,um jóltíðel.jóltíðir
jólur	(plfr.)blómuleggur(serst. á hvonn);sms.ata-,hvann-,sløkju-
jómsvíkingaæl	(stb.)ógvuliga grovt æl,ja, tað var grovt, men einki jómsvíkingaæl korti
jómsvíkingur	(søg.)ein í tí danska víkingaliði ið helt til í Jómsborg í Vendlandi í 10. og 11. øld
jónhav	háhválv
jóra	(stb.)njóra,jóra upp í saman
jótra	1(um jóturdýr)tyggja føði aðru ferð(sum tey í fyrsta umfari svølgja ótugda og goyma í vomb og keppi og síðani klíggja upp aftur)2taka upp í saman, meyka, møsna,standa og jótra upp í saman
jótur	1(djfr.)1tað at jótra, evnini at jótra,kúgvin misti jótrið2tað sum verður jótrað(gras, hoyggj)3(á seyði og neyti)húð undir gómanum,serst.smáir leparel.tindar innan í kjálkunum,hann ið vildi fáa gott mál, skuldi eta jótrið av seyðarhøvdi;sbr.syngja 121eg havi fingið jótur av tí(keðu)2tað at jótra upp í saman, jabb
jóturdýr	(dj.)dýr sum jótrar
jugoslavari	jugoslavi
jugoslavi	fólk íel.úr Jugoslavia, jugoslavari
Jugoslavia	land í Evropa
jugoslaviskur	íel.úr Jugoslavia
jul	(alisfr.)joule
juli	7. mánaður í árinum, julimánaður
julianskur	sbr.gregorianskur
julimánaður	juli
jungmaður	(sjóm.)ungmaður (2)
juni	6. mánaður í árinum, junimánaður
junimánaður	juni
junkarajørð	(søg.)jørð sum aðalsmenn áttu í Føroyum(LZ Før.282)
junkari	(kvæð.)ungur aðalsmaður
junkarskapur	k12e:dríva junkaraskap1ganga fyri einki, letast2gl. spæl(Sv)
Jupiter	(stjfr.)størsta gongustjørna í sólkervinum
jú	1mðlvjáttandi svar(serliga upp á noktandi spurning),ætlar tú ikki at sleppa tær avstað nú? jú2mðlv:á jú, betri enn someiri enn so;jú men, ert tú ein knassi(sanniliga)3hj:nú eru buksurnar vorðnar jú so pertnar(í so)4hjvíst, sanniliga,hann var jú illur5hj:jú fleiri hundar, jú tynri soðiðtess ..., tess ...
júgrað	l kv6:kúgvin er væl júgrað(hevur stórt júgur)
júgrafetil	1fetil at binda júgrið upp við(tá ið kúgv hevur kálvað)2(slang)brósthaldari
júgralag	(stb.)(á gimburlambi)vølur har sum júgrið fer at koma,teir handlaðu, har sum júgralagið er
júgrast	(um kvidna kúgvel.ær)trútna um júgrið, kultrast,kúgvinel.ærin (er farin at) júgrast
júgur	(dj.)húðposi uttan um mjólkarkertlarel.stálma á súgdýri, kusa 1(1)
júgurbruni	(dj.)bruni í júgri
júgursíður	1við síðum júgri,júgursíð kúgv2sum gongur hokin í knæsbótunum og seinliga(Sv)
júgursmyrsl	smyrsl til neytajúgur
júgurverkur	verkur (2) á júgri
júgv	jú,ámmin og júgv eftirgævi at so verður(Sv)
júk	tað at taka upp í saman, jabb, jagg, meyl,mangt var júk, sum tey gomlu søgdu frá
júka	siga upp í saman, jabba, jagga, meyla, møsna,júka á e-n;sita og júka
júkan	tað at júka, júk
júkungar	(søg.)nivlungar
júkutur	argur at júka, meykutur, meylutur,hon tosaði við hann sum við eitt júkut barn
júli	(gl.)juli
júliskur	l24:hin júliska tíðarrokningin(julianska)
júni	(gl.)juni
júsa	á ja, á jú, jú menn,hann fekk ikki høvi at siga annað enn nei og ja og júsa
júsá	júsa
júst	nettupp, akkurát, beint,tað er júst tað, sum er hent
jústa	(ítr.,skemt.)(um málmann)sláa bóltin burtur frá málinum við nevunumel.hondunum
jútalygn	kolsvørt lygn
júti	fólk íel.Jútlandi
Jútland	(stn.)landspartur í Danmørk[da.Jylland]
jútskur	íel.úr Jútlandi,(kvæð.)jútskan hatt á høvdi bar;(kvæð.)tað jútska riddaramál
jødadómur	(átr.)jødiskur átrúnaður (og mentan), gýðingadómur
jødahatur	tað at hata jødar, gýðingahatur
jødakaka	slag av rundari smákøku við sukri og kaneli á
jødi	1ættarfólk av tí semittiska fólkinum sum fyrr í tíðini búði í Palestina(búgva nú lutvíst í Ísrael og lutvíst í øðrum londum)2fólk við jødiskum átrúnaði;eis.gýðingur
jødiskur	viðv. jødum, gýðinga-
jøkil	1ruskel.gras sum liggur leyst á kava og har sum kavi hevur ligið2gras sum er fryst og brotnar av vindinum og fýkur saman í giljum o.a.3avgnagaður hagi,hatta liggur á jøklinum og gnagar(um seyð),(flutt m.)verða hildin á jøklifáa lítið at eta4harður, turrur og soltin mógvur, jøklatorv5gamal, skorpnaður tari sum fýkur tá ið vindur er,kýsar og hár, grátur og tár, skrambla um skálan sum jøkil um vár
jøkilgras	jøkil (1)
jøkilshagi	jøklaður hagi
jøkla	gaddael.gnaga av,kúgvin hevur jøklað stykkið upp;stórdýr jøklaðu hagan
jøklalendi	jøklað lendi
jøklatorv	jøkil (4)
jøkslum	síjakslur
jøkul	(jarðfr.)vítt øki við tjúkkum ísiel.harðfrystum kava(hvørvur ikki um summarið);sms. t.d.skrið-
jøkulá	(jarðfr.)á sum rennur undan jøkli
jøkulborin	(jarðfr.)sum jøkul hevur borið við sær,jøkulborin legugrýti
jørð	1jørðintriðja gongustjørnan frá sólini í okkara sólkervi, jarðarknøtturin,jørðin gongur um sólina2jarðaryvirflati, jarðarskorpa,niðri við jørðina;(um klæði)røkka niður á jørðina;bera við jørðnerta við jørðina;sláa e-n til jarðarsláa e-n niður31jørðildi, jarðarbotnur, mold,góð jørð;seta hakan í jørðina;(kvæð.)lunnar brustu og jørðin skalv2í osb.fryst er jørð fyri vesalasvínumeinki ber til hjá tí lata;blíður sum jørðinfyrikomandi, lagaligur, findarblíður;hann er sum jørðin(tigandi sum grøvin);skommin fór at leggja hana í jørðina(í moldina, í grøvina);kasta jørð ájarðfesta4jarðarríki, verøld, verð,á Guds grønu jørð;í himni og á jørð;mangur dagur á jørð, síðan eg havi sætt teg;nøra upp á jørðinafáa fleiri børn51jarðarogn,sita fyri jørðhava jørð (hjá øðrum) í hondum;har varð nógv jørð í húsinum(nógv ogn);í Føroyum eru 2400 merkur í jørð;jørðina setti hann burtur fyri byrsuna(veðsetti jørðina)2jarðarstykki, teigur,hvørt (jarðar)stykki hevði sítt navn, t.d. Garðajørð, Staðajørð6(ravm.)jarðsamband (1),binda í jørð;sms. t.d.arva-,býtis-,dyrki-,festi-,gras-,kongs-,land-,mó-,oyði-,óðals-,sand-,uttanbíggjar-,ættar-
jørðepli	(sj.)epli
jørðildi	1mold og annað tilfar sum er oman á fastari hellu, jarðarbotnur, vørild (2), (jarðar)grund, lendi, gróðrarbotnur,javna jørðildið;jørðildið er óslætt2(flutt m.)støði, umstøður, grundarlag (2),yrkingin er sprottin úr heimligum jørðildi
jørp	síjarpur
jøtun	risi,(stn.)Jatnagarðar
jøvn	síjavnur
