o1	(málfr.)sjálvljóðsstavur (nevndur[o:])
o2	áh
o.a.	stytting fyriog annað, og aðrir, og aðrar
o.a.m.	stytting fyriog annað mangtel.meira
obeliskur	høg fýrhyrnt steinsúla við pýramidulíkum toppi, minnissúla
oberstur	(herm.)høgur heryvirmaður
oblat	(kirkj.)altarbreyð
odda	peiggja, medda(við knívi ímóti e-m),odda knível.við knívi;sit ikki og odda ímóti beiggja tínum
oddabiti	biti aftur fyri at læna knív at skera kjøt við
oddablað	(bókb.)blað fremst í bók(áfast við blaðið límað innan um permuna),lívdarblað[da.forsatsblad, smudsblad]
oddabrak	(ítr.,slang)spennandi dystur millum tvey (jøvn) oddalið
oddadystur	(ítr.)dystur millum oddalið
oddafiskur	1fremsti hvalur í grind 1(1)2fremsti fiskur í torvu 2(1),tá ið sildin er á gongd, síggjast oddafiskarnir leypa leysir úr sjónum3(flutt m.)ein ið stendur á odda fyri e-m, oddamaður, undangongumaður
oddafólk	fólk ið stendur á odda (fyri e-m)
oddafundur	(stjm.)(millumtjóða) fundur á hægsta stigi, toppfundur
oddagás	(fugl.)gás ið flýgur á odda fyri flokkinum(skiftast um at flúgva á odda)
oddagrein	(í blaði)grein(á føstum plássi)við áskoðan blaðsins á ávíst mál, leiðari (2)
oddaleysur	(um knív)við ongum oddi
oddalið	(ítr.)fremsta lið (fremstu lið) í kapping,oddaliðini í bestu deildini hittast sunnudagin
oddamaður	1ein ið stendur fyri e-m, formaður, undangongumaður,tey ungu fylktust um oddamann felagsins2(í seyðarakstri)maður ið er á oddanum (1)(vanl. tveir)
oddasessur	(ítr.)tað at vera á fyrsta plássi í kapping,vinna sær oddasessin
oddaseyður	fremsti seyður í fylgi,tungt var at ganga í kavanum, so oddaseyðurin lækkaði seg og hinar eisini
oddaskapur	leiðsla (1), fyristøða
oddastarv	starv millum teirra hægstuel.fremstu(í samfelagiel.fyritøku)
oddastríð	(ítr.)kapping um at vinna fyrsta plássið í deildini,Kyndil dragnaði í oddastríðnum eftir ósigur móti grannunum úr Neistanum
oddbogastílur	(byggil.)byggingarstílur við oddbogum, gotiskur stílur
oddbogi	(byggil.)gotiskur bogi, spískbogi(ovast í gluggum og durum);sbr.rundbogi
oddi	1fremsti partur í seyðagonguel.grind,móts.hali 1(8),ein bátur róði fram innan fyri grindina fyri at boyggja oddan av henni út fyri tangan;vera á oddanumganga fremstur í seyðarakstri;(um seyð)taka odda í seg(nakrir undan og hinir aftaná);(flutt m.)standa á oddastandael.stíla fyri e-m;tey múgvandi og ráðandi á odda, vesalavættini á halanum;liggja á oddavera fremstur(t.d. í kapping)2landoddi;sms. t.d.háls-,land-,sand-,tanga-
oddklingrutur	l5(plfr.)oddklingrut blaðblað við bløðku ið er tvær ferðir longri enn breið, breiðast á miðjuni og mjækkast javnt móti báðum endum ið eru spískir
oddklombur	spískt klombur (4)<>,í oddklombrum;sbr.bugklombur,hornklombur,klovaklombur
oddmjáur	(plfr.)við mjáum oddi,frukthylkið er oddmjátt
oddpíkskur	(Suð.)spískur (sum nálaroddur)
oddspískur	(plfr.)spískur sum oddur,oddspísk bløð
oddur1	broddur (1), spíssur, tað fremstael.ytsta á e-m,(kvæð.)oddar bóru saman(t.e.svørðsoddar);oddurin á lítlafingri(fremsti liður);út í odd og eggút í æsir, heilt og fult;(Sa.)vera oddur eldriikki lata seg lumpa, duga at vara seg fyri svikum;draga saman oddar(um skýggj úr mótsettum ættum)reka hvørt móti øðrum;(kvæð.)royna odd við (e-n)berjast við, fara í bardaga við;sms. t.d.háls-,kjalarborðs-,klandurs-,knívs-,nálar-,nevs-,snið-,spjóts-,svørðs-,sýlar-,tungu-,ørvar-
oddur2	reiðskapur til sílaveiðu(framspísk fjøl við dorg drigin fram við landi)[no.oter]
oddviti	ein ið stendur á odda (fyri e-m), oddamaður,oddviti í tjóðskapar- og frælsisstríði føroyinga
offiserur	(herm.)yvirmaður, heryvirmaður
offur	1gáva ið latin verður gudiel.guddómi, offurgáva,bera Gudi offur2(kirkj.)peningur borin fram og latin í smb. við t.d. brúðarvígslu og barnadóp;sms. t.d.brenni-,drykkju-,fagnaðar-,lov-,mann-,royk-,skuld-,skurð-,slátur-,synda-
offurbolli	(kvæð.)bolli 1(1) til blóð av offurdjóri
offurdjór	djór ið ofrað verður
offurdýr	offurdjór
offureldur	eldur til brennioffur
offurfólk	fólk í brúðarskara,offurfólkini skipa seg í pør;sbr.brúðfólk
offurfúsur	fúsur at bera offur, hjálpsamur
offurgangur	(kirkj.)tað at fara fram í kór at lata offur(í brúdleypi)
offurgáva	offur (1)
offurgerð	tað at ofra (1), ofring (1), blót
offurheyggjur	(bíbl.)heyggjur har ið ofrað varð,eg rívi niður offurheyggjar tykkara
offurknívur	(bíbl.)knívur at drepa offurdjór við,sjálvur tók hann eldin og offurknívin
offurlamb	lamb at ofrael.ið er ofrað
offurpar	(í brúdleypi)tvey ið fylgjast í brúðargongu,einaferð ið offurgangur var í einum brúdleypi, vórðu offurpørini parað saman
offurpengar	(kirkj.)pengar latnir sum offur (2)
offursfólk	offurfólk
offurveitsla	(søg.)blótveitsla
offurvilji	vilji at ofra seg (fyri onnur)
o.fl.	stytting fyriog fleiri
ofra	1bera fram offur (1), blóta (1),ofra til skurðgudar2bera fram offur (2)(t.d. presti, dekni og klokkara)3siga frá sær e-t(til frama fyri e-t annað),bæði rík og fátæk hava víst vilja til at ofra bæði tíð og pening;ofra seg fyri e-t4(talv)lata fólk fyri betri støðu5(skemt.)spýggja(t.d. av sjóverki)
ofring	1offurgerð2(kirkj.)tað at ofra (2),meðan ofringin var fyri(við brúðarvígslu)
ofsin	opsin
ofta	við (heldur) stuttum millumbilum, í heilum, tíðum, mangan, javnan,ofta og tíðum;ofta og stund;tað er ikki oftari enn so(ikki hvønn dag);fyri tað oftasta(oftast, vanliga)
oftani	ofta
oftum	(gl.)ofta,oftum lýtst happ av hundi;(kvæð.)tað er enn, sum oftum er
og	1(bindur saman tvey orð, tveir setningsliðirel.setningar),himmal og jørð;svartur og hvítur;aftur og fram;av og á;ungur og óstiltur;væl og virðiliga;stórur og sterkur;kom og hjálp mær;ein fór, og annar kom;fyri berg og bláar skorar;virtur og so vín;fagran og so fríðan;so við og við;hvussu víkur og vendir;tað stendur upp og niður;við bit og slit;líkjast í brún og brá;leka í eyri og seyri;halda e-n fyri háð og spott;hava jól og góðar dagar;mítt og títt er óbýtt;sorg og sút;líkt og ólíkt2(í herðingarlættari støðu til at sýna hendingagongd),sit og tig;hann sat og roykti;gev uppat og royk;kom og dansa3(vanligt millum tveir teir síðstu liðirnar í upprokning),tær fýra høvuðsættirnar eru norður, suður, eystur og vestur;børn, ung og gomul4(partur av samsettari sambinding),bæði og;hon er bæði stór og sterk;eins og;henda myndin er eins vøkur og hin5(skaldsk.,bíbl.)(fremst í setningi uttan samband við tað sum frammanfyri stendur),og Jesus kom fram at teimum og nam við teir og segði;og hann beyð mannamúgvuni at seta seg niður á jørðina6eins og, sum,listansur føroyinga er hin sami og hjá øðrum tjóðum;hon líkist ikki støðin nú og hon var7(stb.)(saman við fyrra lýsingarhátti),nú kemur hann og stunandi niðan gjøgnum trappuna;nú kemur hann og støplandi;eg og spelandi inn
ogn	1tað at eiga (e-t), tað ið ein eigur, eigindómur,føst ogn;ogn og skuld;fáa e-t til ognar;mín dýrasta ogn;føra til ognargóðskriva;tað er ikki hvørs mans ogn;tað er ogn í tí(vert at eiga, virðismikið);tykja(st) ogn í e-mhalda vera vert at eiga,móður tykir ogn í unga sínum2(serst. um)óðal, óðalsjørð, ognarjørð,ognin skuldi eisini hava sín part av neytunum;hvør systirin setti seg á sína ogn3ognir(búsk.)ogn (1) av ymsum slag (t.d. peningur, útbúnaður, áogno.tíl.) við búskaparligum virði(t.d. í roknskapi);sms. t.d.almanna-,á-,fast-,felags-,fólka-,jarðar-,lands-,sam-,ser-,sjálvs-
ogna	luta, veita, geva,ogna særel.ognast (e-t)fáael.vinna sær, fáa til ognar,summum ognaðist eitt lamb(lutaðist);ogna e-m e-t(víga, kanna 3(2)),bókin er ognað honum
ognan	tað at ognast (e-t)
ognarbóndi	(sj.)óðalsbóndi, ognarmaður,hann er handilsmaður og ognarbóndi
ognarbræv	(løgfr.)skjal ið váttar fastogn, skeyti 2
ognarbygd	bygd har (næstan) øll jørðin er óðalsjørð,móts.kongsbygd
ognarbøur	bøur ið er ogn (2),toftin liggur í ognarbønum
ognarfornavn	(málfr.)fornavn (2) fyri tann ið eigur (e-t)(pronomen possessivum),mín, tín og sín eru ognarfornøvn
ognarfólk	(bíbl.)serliga útvald tjóð,teg hevur Harrin kosið sær sum ognarfólk fram um allar aðrar tjóðir á fold
ognargenta	genta ið situr við ogn,trúlovaður við einari ognargentu
ognarhagi	hagi ið hoyrir til ognarjørð
ognarhús	hús ið eigur jørð,størsta ognarhúsið í bygdini
ognari	1ein ið eigur (e-t), ánari, eigari,hann var ognari til tríggjar merkur í óðalsjørð2áognari,móts.skuldari
ognaríbúð	íbúð sum búfólkið sjálvt eigur;sbr.leiguíbúð
ognarjørð	óðalsjørð,móts.kongs(jørð)
ognarland	(bíbl.)serliga útvalt land,í ognarlandi tykkara
ognarleysur	ið einki eigur, blóðfátækur
ognarloysi	tað at vera ognarleysur
ognarloysingur	ein ið er ognarleysur, fæloysingur,summir ognarloysingar gjørdust niðursetumenn hjá óðalsmonnum
ognarlutur	lutur ið ein eigur, ogn (1),hann kom heim at fáa skil á ognarlutum sínum
ognarmaður	maður ið eigur jørð, óðalsmaður,óðalsjørðin er so smábýtt, at ognarmenn liva ikki av henni
ognarmark	kenningarmark, kenningarmerki(á høgra oyra);sbr.hagamark 2
ognarmørk	mørk 1(3) í ognarjørð,í Vágshaga er ein ognarmørk
ognarrættur	1rættur at eiga2(løgfr.)løgfestur rættur til ogn
ognarseyður	seyður hjá ognarbónda,móts.kongsseyður
ognarsíða	(búsk.)stað har ið ogn verður bókað í roknskapi,móts.skuldasíða
ognarskattur	skattur av fastogn
ognarsteyp	(ítr.)steyp 1(2) ið vinnari vinnur til ognar,móts.ferðasteyp
ognartaka	flytael.taka (sjálvboðiðel.tvingað) ogn til tað almenna fyri samsýning,ognartaka jørð til vegagerð
ognarteigur	teigur av ognarjørð,her er bara kongs og ikki ein ognarteigur
ognartræ	(stb.)bóndatræ
ognartøka	tað at ognartaka[da.ekspropriation]
ognaruppgerð	uppgerð ið sýnir ogn og skuld hjá skattgjaldara(at lata líkningarmyndugleika),ognaruppgerð skal latast inn saman við sjálvuppgávu
ognarviður	(stb.)viður av ognartræ, bóndaviður
ognarviðurskifti	tað ið viðvíkur ognarrættio.tíl.,ógreið ognarviðurskifti
ognskriva	(búsk.)skriva sum ognarael.bóka til ognar, góðskriva
ohm	(ravm.)máteind fyri ravmagnsmótstøðu(eftir týska alisfrøðinginum G.S. Ohm 1787-1854)
ok	1tvørtræ sum akteymar á dráttardýrum eru festir í2tvørtræ at leggja um herðarnar(at bera t.d. vatn við)3(flutt m.)tung byrði, kúgan;sms. t.d.træla-
oka	ota(Sv)
okara	(Sa.,Skú.)okkara
okari	(sj.,stb.)oki
oki	(húsasm.)træ neglt tvørtur um fjalir(til at halda teimum saman, t.d. á hurð),klampi, tvørtræ,hillarnar liggja niður á okarnar;oki er undir endunum á skríninum, so at botnurin skal ikki standa á gólvinum
okkara1	sívit 2
okkara2	1(viðv. tí ið hoyrir 1. pers. flt til)okkara hús;óvanligur gestur um okkara leiðir;málið er lívæðrin í okkara fólki;kvæðaskaldskapur okkara2(viðv. skyldskapi)foreldur okkara;børn okkara;døtur okkara3(í atfinningarsamari tiltalu)okkara býttlingar!4(í staðin fyri navnorð)eg fari niðan til okkara;sbr.vár 3
okkum	sívit 2
okkur	(jarðfr.)samnevni (1) fyri ávísar blandingar av jarðmálmi við gulum, brúnumel.reyðum liti í(nýtt t.d. í máling)
okkurgulur	gulur sum okkur, brúngulur, illgulur
okkurlittur	okkurgulur,við okkurlittum framfaksi
okkurt	síonkur
okkut	síonkur
okn	(fugl.)1svanur(Cygnus cygnus),hin fannhvíta oknin2(kvæð.)slag av fugli(óvist hvør),eg sá fljúgva oknir sjey, rann teim blóð at veingi
oknagras	(plfr.)slekt í oknagrasætt(Isoetes),mjúkt oknagras(I. echinospora);sms.vatna-
oknagrasætt	(plfr.)ætt av leggstreingjagróplantum(Isoetaceae)
okra1	taka ov høga rentuel.ov høgt gjald, selja alt ov dýrt
okra2	(Suð.)okkara
okrari	ein ið okrar, okurkallur
oksa	rósa av øvund, halda at e-t er størri og betri hjá øðrum(Sv)
oksabásur	básur til oksa
oksaeyga	(plfr.)slektir í kurvablómuætt(lík baldursbrá)(Chrysanthemum, Leucanthemum),gult oksaeyga(C. segetum),hvítt oksaeyga(L. vulgare)
oksafall	h10eí osb.geva e-m oksafallsyfta e-n niður
oksafarmur	bátsfarmur av oksum,teir róðu altíð av makt við oksafarmi
oksafjórðingur	fjórðingur (1) av oksa,kokkurin hevði ein oksafjórðing við sær
oksafrælsi	frælsi (2) undir ein oksa,Høvdin skuldi vera tólv oksafrælsi
oksahald	tað at haldael.hava oksar
oksakálvur	tarvkálvur(Sv)
oksakjøt	kjøt av oksa
oksakroppur	(kvæð.)kroppur av oksa,oksakroppin át hann upp
oksaleggur	(kvæð.)leggur av oksa,Kolbein tók upp oksalegg
oksalær	(kvæð.)tjógv av oksa,tey bóru honum fram oksalær
oksasíða	(kvæð.)síða (2) av oksa,hon legði fram eina oksasíðu
oksasteik	steik av oksakjøti,hava oksasteik til døgurða
oksatjógv	tjógv av oksa
oksavetringur	veturgamal oksi
oksi	1tarvur geldur ungur2(gl.)tarvur,(kvæð.)oksan ein og geitir fimm;(spæl)átta beinel.føtur á oksa(spæl við bandi um og millum fingrarnar);sbr.krákufótur;sms. t.d.hólm-,urðar-
oktan	(evnafr.)slag av kolvetni í bensini
oktober	10. mánaður í árinum, oktobermánaður
oktobermánaður	oktober
oktobur	oktober
okum	(Sa.,Suð.)okkum
okur1	tað at okra 1, órímiliga dýr søla,bót fyri okur
okur2	(Suð.)vit
okurkallur	okrari
okurprísur	órímiliga høgur prísur, ovurprísur,teir krevja ein okurprís fyri kistuna
okurrenta	órímiliga høg renta, ovurrenta
okursprísur	(ov) høgur prísur(goldin fyri e-t),atgongumerki verða seld fyri okursprís
OL	(ítr.)stytting fyriolympiuleikir
oldabbi	(stb.)oldurabbi
oldingi	gamalmenni, ellimenni
oldomma	(stb.)olduromma
oldurabbi	abbi abbael.ommu
olduromma	omma ommuel.abba
olivinolja	olja vunnin úr fruktum av oljutrænum
olja1	1flótandi fitievni vunnið úr oljuberjum, ymsum øðrum ávøkstum, urtum og dýrum,steikja í olju;seinasta oljan(fyri deyða)(sakramenti í katólsku kirkjuni),fáa seinastu oljuna2flótandi brennievni av plantu- og dýraleivdum(vunnið djúpt úr jørðini),bora eftir olju;(flutt m.)oysa olju á báliðel.eldingera ilt verri, gera meira skaða enn gagn;sms. t.d.brenni-,jarð-,lín-,rá-,stein-
olja2	1smyrja við olju,(flutt m.,stb.)fara oljandi(serst. um skip og bátar)(stimandi)2(stb.)í osb.olja niðursláa, fella,hann oljaði grasið niður
oljuber	(plfr.)ber 1 av oljutræ[da.oliven]
oljubilur	tangabilur til oljuflutnings
oljublað	blað av oljutræ,dúgvan hevði oljublað í nevinum
oljublettur	blettur av olju(t.d.á sjónum)
oljuboring	tað at bora eftir olju
oljubrendur	(sjóm.)(um skip og bátar)í uppisetri við olju,vit mugu aftur at landi, annars verða vit oljubrendir
oljubrøkur	(sj.)oljubuksur
oljubuksur	(sjóm.)vatntættar buksur(úr olju-el.plastbornum dúkiel.klæði)
oljudansur	vatntætt sítt yvirklæði hjá sjómonnum(heilt frammantil),dansur 2
oljudálkaður	dálkaður av olju, ið olja er komin at, oljutur,oljudálkaður fuglur
oljudálking	dálking av olju(t.d.í náttúruni)
oljudunkur	dunkur til olju
oljufarmur	skipsfarmur av olju
oljufelag	felag ið vinnur útel.selur olju 1(2)
oljufella	(jarðfr.)poknutar fláir har ið olja setur útí og savnast
oljuframleiðsla	tað at framleiða olju
oljufyrisiting	almenn fyrisiting fyri virksemi í sambandi við oljuídnað,Oljufyrisiting Føroya
oljufýr	oljufýring
oljufýrdur	oljukyndur,oljufýrdur ketil
oljufýring	ovnur ið kynt verður í við brenniolju(til miðstøðarhita),oljufýr(ur), oljukynding,ein stór broyting var, at trolararnir skiftu frá at vera kolfýrdir til oljufýring
oljufýrur	oljufýring
oljugjald	avgjald á olju(til tað almenna),tann størsti parturin av inntøkunum stavar frá serliga oljugjaldinum og innflutningsgjaldinum á blýfríum bensini
oljuglas	glas við olju og veiki, anari,oljuglasið brann sum yvir einum sjúklingi
oljugoymsla	goymsla til olju 1(2),har standa nú saltbing og stórar oljugoymslur
oljuhavn	havn har ið olja verður tikin í land, reinsað og avskipað
oljuhosa	(gl.)hosa úr toyi smurd við fernisi(at hon skuldi vera tøtt at nýta á sjónum),teir høvdu oljuhosur innan undir skølingunum
oljuhúsi	(tøkni)ílatel.húsi við smyrjiolju í(á motori)
oljuídnaður	ídnaður ið arbeiðir við at finna, vinna út og framleiða olju, oljuvinna
oljukanna	kanna 1(1) til (smyrji)olju
oljukelda	staður har olja vellir uppel.verður pumpað úr jørðini
oljukendur	sum hevur olju í sær, oljutur
oljuklæddur	í oljuklæðum,skiparin var oljuklæddur
oljuklæði(r)	vatntøtt yvirklæði(ið serst. sjómenn nýta),síðani vóru tað oljuklæðini: troyggja, brøkur og útsynningur;oljuklæði(r) av plasti
oljukynding	oljufýring
oljukyndur	kyndur við oljuel.oljukynding
oljukøka	tunn køka gjørd úr tí sum eftir er tá ið olja er vunnin úr berjum, urtumo.tíl.(serst. nýtt sum fóður til kríatúr)
oljulampa	(gl.)lampa ið brennir olju,elsta náttljós man hava verið oljulampan ella kolan
oljuleiðing	rør(skipan) til at flyta oljuel.gass langan veg
oljuleiting	leiting eftir olju
oljuleki	tað at olja lekur út
oljulitur	litur blandaður við línoljuel.fernisi(nýttur í málningalist);sbr.vatnlitur
oljulomvigi	oljudálkaður lomvigi;sbr.lýsilomvigi
oljulygna	lygna 1(1) av olju (á sjónum), oljublettur
oljumáling	máling blandað við línoljuel.fernisi
oljumálningur	málningur málaður við oljulitum
oljuneyð	oljutrot
oljuovnur	ovnur ið brennir olju
oljupálmi	(plfr.)pálmi ið pálmaolja verður vunnin úr(Elaeis guineensis)
oljureinsiverk	verk ið reinsar jarðolju
oljusteinur	steinur at brýna afturumaftur við(til at fáa eggina mjúka)
oljustivli	1(gl.)roðhosa smurd við fernisi og olju(at hava innan undir skølingum),vit nýttu ikki stivlar sum nú á døgum, men oljustivlar og skølingar2vatntættur stivli úr oljubornum lørifti;sbr.hanaskógvur
oljusvinta	svinta úr oljubornum evni
oljutangi	tangi 2 til olju
oljutrot	tað at trot er á olju
oljutroyggja	vatntøtt troyggja úr olju-el.plastbornum evni,hann hevði smoygt sær úr oljutroyggjuni, áðrenn farið var at rógva
oljutrýst	trýst sum ávís oljunøgd fremur í rørskipan
oljutræ	(bíbl.,plfr.)slag av træ í ættiniOleaceae;vanl.træ ið ber fruktir sum ymisk oljusløg verða vunnin úr(Olea europaea)
oljutunna	1tunna við olju2(rúmmál)158,76 l av reinsaðari olju(nýtt í oljuídnaði)
oljutur	oljudálkaður
oljuvánir	vánirel.møguleikar at finna olju
oljuviður	(bíbl.)oljutræ
oljuvinna	tað at vinna olju úr jørðini, oljuídnaður
oljuævintýr	oljuvinna við stórum búskaparligum avleiðingum(ið at kalla virka óveruligar),tá oljuævintýrið einaferð er liðugt(tá ið oljan er uppi)
olmussa	1gáva til neyðstaddan, fátækrahjálp,fáa (e-t) í olmussu;biddarar biðja ferðamannin um eina olmussu;(í vanda staddur)lova burtur (í) olmussulova e-m(t.d. fátækum, kirkjuo.tíl.)gávuel.góðgerð fyri at sleppa úr vanda2hjolmussuneyðar, neyðars,tær olmussu konur
olmussubeist	(sj.)olmussudýr
olmussudrongur	1neyðarsligur og fátækur drongur, olmussudýr2(spæl)skíra olmussudrong,sbr.munkaprestur
olmussudýr	1armingi, fátækadýr, neyðardýr, stakkal2olmussudýrið(blíðm.)(at sýna várkunnel.harm)søti mín, lukka(n),far aftur og legg teg, olmussudýrið;hann man eingi sunnudagsklæði eiga, olmussudýrið(stakkalin)
olmussugenta	neyðarslig og fátæk genta, olmussudýr,tá ið faðirin doyði, varð hann kongur og olmussugentan drotning
olmussuheiðar	torvheiðar latnar ognarloysingum
olmussukirkja	(søg.)kirkja sum lovað varð burtur í olmussu til,gamla kirkja í Vági var okkara einasta olmussukirkja
olmussulamb	lamb lovað burtur í olmussu
olmussuligur	1ússaligurel.neyðarsligur til útsjóndar, illa dæmdur2ið vekur várkunn
olmussumaður	neyðarsligur maður, olmussudýr (1), vesalavætti
olympiskur	1(gudal.)viðv. grikska fjallinum Olympos,teir olympisku gudarnirgriksku gudarnir(ið búðu á Olympos)2viðv. olympiuleikum,olympisku leikirnir
olympiuleikir	1millumtjóða ítróttastevna hildin fjórða hvørt ár ymsastaðni í heiminum2(søg.)ítróttastevna í forna Grikkalandi ið allir frælsir grikkar høvdu atgongd at(hildin fjórða hvørt ár frá 776 f. Kr. til 394 e. Kr.)
oman	1úr erva og niður, niðureftir, omaneftir(ofta um hallandi, lækkandi rørslu),móts.niðan,farael.ganga oman(niður);detta omanfara fyri bakka,sídetta oman;kastael.stoyta omanbeina fyri við at koyra út av har ið bratt er(t.d.hundar, kettlingar);kasta sær omanbeina fyri sær við at leypa útav;oman og niðan1hornrætt á halla(í ávísa ætt),húsini standa oman og niðan2omaneftir og niðaneftir,nú fóru neytini at ganga oman og niðan(niðan í hagan á morgni og oman aftur til hús á kvøldi)3allastaðni, allar staðir,sólin skínurel.sær bæði oman og niðan(av tí fagrasta)2(saman við fs)oman at:oman at húsum;oman at flóðarmálanum;tvey fremmand komu gangandi oman at bøgarðinum;oman av:oman av landi(burtur),hvørt ár fara fleiri og fleiri ungdómar oman av landi til skips;taka móðu oman av potti(burtur av);oman á1niður á,oman á bakkan2upp áel.yvir,rómi legst oman á mjólk3(um mat)eftir høvuðsmáltíð, sum afturíkast,oman á døgurða fingu teir kaffi;oman fyriel.fyri omanlongri uppi(enn e-t annað),oman fyri húsini,móts.niðan fyri;flogfør surraðu oman fyri teir(uppi yvir teimum);raskur oman fyri hálsvølin,síhálsvølur,hevur aldri verið til uttan oman fyri hálsvølin(ongantíð verið annað enn tóm orð);oman í:oman í brýrniður at eygnabrúm;oman ígjøgnum:teir gingu oman ígjøgnum hagan;oman til:oman til strandar;oman úr:koma oman úr fjalli;oman við:oman við ánniniður og fram við ánni;oman við Strondfsviðhvnf3niður eftir, oman eftir,sum eitt fok oman brekkunaniður brekkuna, undan brekkuni;hann rann oman trappurnar(niður ígjøgnum)4hægri enn (e-t annað), oman fyri, fyri oman,svimur sum oftast við høvur sínum oman vatnið;førur oman belti;oman Hoydalar;oman Viðarlund5vera oman stokk(uppi, vakin),er hann so frægur, at hann er oman stokk?(sí eis.omanat,omanav,omanáo.s.fr.)
omanat	oman á lendingina,hann fór omanat móti manninum
omanav	(burtur) av, úrel.frá yvirflata,taka omanavtaka róma av mjólk;grava omanav;har brotnaði alt bæði omanav og niðanav(av skipi í ódnarveðri)
omanavtikin	ið rómi er tikin omanav,omanavtikin mjólk(skúmað)
omaná	1oman á e-m,liggja omaná(t.d.í bardaga)2á lívi, livandi,tað skal ikki henda so leingi hann er omaná3í osb. sumetael.hava e-t omaná(dessert eftir høvuðsmáltíð, afturíkast)
omanávatn	vatn savnað oman á jørðini,móts.grundvatn,ofta er lítið salt í omanávatninum
omanbergs	hj(bjarg.)í osb. sumfarael.síga omanbergs(úr erva niður í bergið);teir tóku omanbergs(frá eggini);ólukksáligt brimsummar, sluppu ikki undir landið, fóru omanbergs at fleyga,móts.niðanbergs
omanbergsfuglur	(serst. um lomviga)fuglur ið av vindi slær upp um eggina og dettur niður í hagan(og ikki sleppur á flog aftur),omanbergsfuglurin er vanliga ikki fyrr enn um summarið
omanbering	(um torv)tað at bera torv av heiðini oman til hús,omanberingin fall í bestu summarmánaðum
omandeks	uppi á dekki,aftur at tí skaða, vit fingu omandeks, kom eisini hol á skipið
omandottin	1fallin(í brattlendi)2í osb.hann var omandottin eitt dansikvøld(komin fyri barn við eini gentu);sbr.detta oman
omandøttur	tað at e-t dettur oman, fall,av omandøttri og ringari hagreiðing var seyðatalið minkað
omaneftir	(um veg)(úr erva og) oman, niður, niðureftir
omaneggja	hj(bjarg.)í osb.ræna omaneggjaræna við at síga av eggini
omanfleyg	1(á báti)tað at fleyga fugl ið flýgur niður úr bergi(serst.lomviga),taka (í) omanfleyg;nógvir dugdu væl at taka omanfleyg2(flutt m.,sjóm.,speis.)taka omanfleyglifra fyri yvirmonnum;sbr.gera hvítt
omanfleyggj	omanfleyg
omanfrá	1[-'f-]longri niðri, longri oman(enn e-t annað),húsini stóðu nakað omanfrá(niðanfyri);hann gekk nakað omanfrá2úr erva, omanífrá,(bíbl.)tit eru niðanfrá, eg eri omanfrá, tit eru av hesum heimi, eg eri ikki av hesum heimi
omanfyri	1í erva, omaná, uppiáel.-yvir,høg fjøll omanfyri og smalt sund niðanfyri2longri uppi, hægri, ovari3(um seyðaskinn)spretta omanfyri[-ˈf-]skera upp aftanífrá og frameftir undir búkinum(tá ið tummað er);síspretta (2)14(Mikld.)fara omanfyri[-ˈf-]fara á flot;sbr.niðrifyri
omangongd	staður har gingið verðurel.gongt er oman, niðurgongd,tað er klettur norðanvert við omangongdina
omanhallur	ið hellir omaneftir
omanífrá	úr erva
omankast	leyst grót ið dettur niður úr bergiel.fjalli,akvegurin liggur illa fyri omankasti;hann fór av omankasti(ein steinur datt á hann)
omankavað	l hí osb.nú er nógv omankavaðkavin kemur langt oman;tað er ikki omankavað enn, so seyðurin gongur høgt
omankavi	(sj.,stb.)kavi ið kemur av luftini, kavaavfall,móts.jarðrok
omankoyring	vegur ið koyrandi er oman eftir,tá ið vit komu til omankoyringina, brotnaði bremsan
omanleið	leið ið hildin verður oman, ferð omaneftir(t.d. úr fjøllum),mestan møttu tit kendum fólki, sum var á omanleið?
omanljós	ljós íel.úr erva, ervaljós,í omanljósi
omanlop	1tað at grót, moldo.a.loypur (úr fjalliel.líð), skriða 1(1), skriðulop, grótlop,menn vóru bangnir fyri omanlopi2tað ið omanlopið er(t.d. eyrur, moldo.tíl.);sbr.berglop;omanlopið liggur framman fyri munnan enn;(flutt m.)síggja út sum eitt omanlopvera grimur á at líta, lúnast, gronast;sbr.skriðuskortur
omanlopin	lopinel.ruddur oman, niðurdottin,hitt omanlopna grótið er hvasskent;torvan er nú omanlopin
omannevndur	nevndur omanfyriel.frammanundan,omannevnda uppskot varð sett í gildi
omanrakstur	tað at reka seyð oman úr haga, seyðarakstur (í rætt) oman úr haga;sbr.bakkarakstur
omanrák	suðurrákel.vestfall í Nólsoyarfirði
omanreiðing	tað at reiða 3serst.torv oman av heiðini,síðan varð farið at leita eftir rossum til omanreiðingina
omanrent	(um stað í t.d. bakka, hamriel.bjørgum)ið seyður lættliga kemst oman í men illael.als ikki upp úr,teir mega vita, hvar ið tað er omanrent, og hvar ið tað er niðanrent hjá seyði;sbr.niðanrent
omanristing	(um gerð og úrslit)tað at rista oman,hann ristir oman, til tað kemur saman við fyrru omanristingina framman fyri bringuna
omanrok	nógv kavaavfall í stormi,var ættin ímóti, hevði eg ikki funnið, tí so nógv var jarðrokið og omanrokið
omanrudd	omanruddur eyrur, gróto.tíl., skriða 1(2),víkingagravirnar eru grivnar niður í mølheyggjar, sum liggja fleiri hundrað metrar undir omanruddi
omanskalvur	skalvur sum hongur í egg í erva(losnar og loypur)
omanskrið	omanlop (1), skriða 1(1), skriðulop, grótlop,eg minnist fleiri ferðir til omanskrið av bæði kava og gróti
omansleipin	1(um lendi)hálur og bratturel.hallur(og geingi tí er ringt),tú skalt ikki fara har, tí tað plássið er so omansleipið;har er hált og omansleipið og tí ringt at draga nót;(flutt m.)tú sært mær heldur omansleipin út(ringur eftir teg, hundasjúkur)2hallur, skráur,set teg ikki í handa stólin, tí hann er so omansleipin(ringur at sita í)
omansnákutur	við slættkembdum hári, snákutur(um høvdið),tú ert so omansnákutur í morgun
omansneyt	(Gj.)omantúnsneyt
omantil	í ovara parti, í erva,móts.niðantil,opið omantil á tunnuni
omanturt	við skáael.ælasliti,tað var jarðrok, men omanturt;tað er omanturt(regnar ikki)
omantúnsneyt	(Gj.)neyt ið verða rikin niðan eftir, omansneyt
omanum	1niður og tvørturum,ein ójavni, har vatnið skolar moldklumpar omanum2tvørturum í erva,flábygdur bátur, ið liggur so nógv út omanum
omanundir	niðureftir og innundir
omanvatn	(stb.)regn
omanvegur	vegur oman, omanleið,á omanvegnum
omanvert	hjí osb.omanvert við (e-t)eitt sindur oman fyri (e-t)
omanvæta	omanávatn,omanvætan og væta í undirgrundini er til miklan bága
omma1	1móðir at faðirel.móður, faðirmóðirel.móðurmóðir2gomul kona,ein gomul omma3(stb.)eplamamma;sms. t.d.gaml-,lang-,oldur-
omma2	(Nóls.,skemt.)brúdleypsdrekka,einar átta dagar framman undan brúdleypinum varð farið til Havnar eftir ommu;sbr.amma
ommba	(barn.)ommubeiggi
ommubarn	barn ið ein er omma at;sbr.abbabarn
ommubeiggi	bróðir ommu
ommudidd	(barn.)ommudidda
ommudidda	(barn.)ommusystir
ommudóttir	genta ið ein er omma at,hon er ommudóttir hennara
ommuligur	gamalsligur(t.d. um konufólkaklæði),alt er nýmótans, sjálvt hitt ommuligasta
ommupikk	h9e:ommupikkiðbindingarmynstur(HMD Bindm.39)
ommusonur	drongur ið ein er omma at,ommusonur mín
ommusystir	systir ommu
ommutur	ommuligur,ein ommutur kjóli
ompil	(fugl.)ungi hjá súlu til hann hevur kastað dúnið,ompil eitur ungin til út í august-september mánað, tá verður hann nevndur grásúla;sbr.grásúla
ond	1andi (1),dragael.missa ondina;vera tungur fyri ondinihava ilt við at anda;skifta ondinael.ondinianda inn,hann hevði so sterkt bróst, at hann kundi kvøða báði niðurlag og ørindi uttan at skifta ondina;ondin blakast í honumhann liggur í andaleypi;við ongari ond1uttan at fáa andað, tivandi,hon stóð rættiliga við ongari ond, sum hon hevði runnið;hann helt av húsinum við ongari ond(í stórum skundi)2í skellilátri,tey sótu við ongari ond yvir brævinum2andi (6),stórur í ondinihástórur, stoltur3fleyr (1), kyling (1), ættargul(við hitael.kulda),kyld,ondin er køld;tað er kalt í ondini;hann stóð á landnyrðingi við eini frískari ond4(stb.)blástur 1(2),døglingur hevur høga ond5(sjónavn)hvalur6(flutt m.)vera sum ein ondvera upp í loft, vera eldhugaður,hann var sum ein ond beinanvegin;sms. t.d.arbeiðs-
ong	(kvæð.,skaldsk.,stn.)graslendi(til slótturel.beiti),vøllur,gras av eingjum;eg smáttu veit á grønu ong;(kvæð.)hann leiðir sín hest í ong;(stn.)Oyrareingir;sms. t.d.eplis-,káls-
ongan	síeingin
ongantíð	á ongum sinni, aldri,ongantíð beturhevði tað verið so væl, gævi satt;ongantíð nakrantíðaldri yvirhøvur,hatta tólið hevur ongantíð verið gott nakrantíð
ongastaðna	(Suð.)ongastaðni
ongastaðni	á ongum stað, ongar staðir
ongila	(sj.)ongilia
ongilia	fremsta stykkið niðantil á kalva
ongiliubein	uggabein á kalva(clavicula)
ongiliugeisli	fremsti ryggjargeisli á kalva(Sv)
ongilja	ongilia
ongiljubein	ongiliubein
ongiljubeita	beita 1(2) skorin av ongiliu
ongiljugeisli	ongiliugeisli
ongilsbeita	(stb.)ongiljubeita
ongin	eingin
onglalag	(gl.)1amboð til at rætta uppaftur bognaðan húkel.ongul2amboð til at smíða húkar við,húkurin varð tikin úr eldinum og stungin í onglalag og bukaður;sbr.naglalag,tindalag
Ongland	land sunnast í Bretlandi
onglendingur	fólk íel.úr Onglandi
ongspretta	(dj.)grashoppa,ongsprettur eta tíðum alla grøðina av
ongul	krókur(oftast úr jarni og við agnhaldi)á snøriel.línu við agni á at fiska við, húkur,ongul í reyvið einki hevur fiskað, krøktur;ikki loysa ongulineinki veiða(av fiski);sms. t.d.fót-,kalva-,kenningar-,kúlu-,murt-,seiða-,sóknar-,stór-
ongulfastur	(um fisk)fastur á ongliel.húki,bregður væl við, so hann ongulfastur er
ongulfesta	rykkja í snørið(at fiskurin skal festast á húkinum),bregða við, festa á ongul
ongulsál	(stb.)stunga (1)
onk	(stb.)eymk,vit hoyrdu onkini frá honum
onka	(stb.)eymka,onka seg
onka-	ið ein hevur serligan tokka til, yndis-
onkabarn	barn ið er serliga kært og elskað, einkabarn, yndisbarn, eygnasteinur (3),hann var onkabarnið umborð;(flutt m.)bókmentafelagið var í mong ár onkabarn hansara
onkabróðir	(kvæð.)kærur og elskaður bróðir
onkadóttir	1dóttir ið er e-m serliga kær og góð, einkadóttir,(kvæð.)kongurin læt eina gullbreyt gera til onkadóttur sína2(sj.)einasta dóttir,onkadóttir hansara lá fyri deyðanum
onkar-	onka-
onkasonur	1sonur ið er e-m serliga kærur og góður, einkasonur,(bíbl.)tú sýtti mær ikki onkason tín;onkasonur Guðs2(sj.)einasti sonur
onkavinur	serliga góður vinur, einkavinur, trúnaðarvinur
onkrantíð	(sj.)onkuntíð,onkrantíð tegi tú
onkrastaðni	(stb.)onkustaðni
onkun	(gl.)síonkur
onkuntíð	1eina ferð (í fortíðel.framtíð),onkuntíð var eg fitt á fótum(fyrr);var tað sum onkuntíð, hevði hetta ikki pøst meg(sum fyrr)2bara hendingaferð, sera sjáldan, av og á, stundum, við hvørt,tað var ikki meira enn onkuntíð, at ...
onkunvegin	(sj.)onkursvegna
onkur1	k(gl.)í osb. sume-m tykir onk í e-m(synd)
onkur2	einel.eitt ið ikki er nærri tilskilað, eittel.annað (ávíst) men tilvildarliga valt, einhvør, nakar,onkun daginein av fyrstu døgunum;onkun dag uppímillumein dag (av og á);onkra frægari gentu mátti hann funnið;onkur annar;væl er hon ikki so andlitsfríð sum onkur onnur;okkurt var at geraeitthvørt mátti gerast;okkurt sigur tú;okkurt sovorðið;okkurt um(stytto.u.)um leið;(kvæð.)Haraldur liggur í síni song onkun morgun snimma(einhvønn)
onkursvegna	á onkunel.onkran hátt, á ein hátt, einhvørsvegna,tað man fara at laga seg onkursvegna
onkustaðna	(stb.)onkustaðni
onkustaðni	á onkrum stað, einastaðni,onkustaðni stendur skrivað
onnur	síannar
ont	(fugl.)antarfuglur, villdunna;sbr.dunna;sms. t.d.brim-,kol-,krik(k)-,snældu-,spegils-,spón-,stikk-,stokk-,sutl-,súg-,tann-,teym-,topp-,trøll-
op	tað ið opið er, hol (1), gat 1(1), munni (1),einastaðni var op á inn í landið;sms. t.d.blað-,sjón-
opa1	(sj.)op, hol (1),bandið, sum eg skuldi gloppa opurnar í luftbjølginum við, slitnaði;bert úti í fjarðarmunnanum er ein opa
opa2	1gera opið e-t ið tipt er, opna 32(í fletting)gera op á kroppin, kryvja,henda kundi, at menn fingu upp í glasið, tá ið opað varð og fitin komin til sjóndar3lata upp, opna,opa øðurnar
opalur	(jarðfr.)prýðissteinur(úr vatnríkari kisilsýru)
-opari	sípípu-
opera	1(tónl.)slag av dramatiskum sangleiki har ið leiklutirnir verða sungnir(meðan spælt verður undir)2hús har ið opera (1) verður framførd,operan í Wien
opilsi	op,øll opilsi í plantunum fyllast við luft
opin	1ikki afturlatinel.lokaður, ikki stongdur, ólæstur,opið stóð út í tún(víðopið);setael.blaka opið eftir særikki lata hurðina aftur eftir sær;dyrnar standa opnar1á víðan vegg2ólæstar,opin innantómur innan, innanopin;nøtin er opin innan:opin ferðaseðil(ikki dagfestur);hava opið høvdminnast væl til, vera skilagóður;(málfr.)opin ljóð;opið sjálvljóð(gjørt við stórum munnopi),opið bræv(kunngjørt alment);(úti) á opnum haviá víðum havi;í osb. sumhar er opið innundir(t.d. klett, áarbakkao.tíl.);í osb. sumsigla opnan fjørðinsigla eftir firði til munni sæst fyri havi2óvardur, verjuleysur, berur (1),liggja opin(á bakinum);opið beinbrot(beinstubbi fer út ígjøgnum húðina)3ið ikki dugir at tiga um e-tel.krógva e-t, opinskáraður, søgutur, søgvísur4ið mjólkar (eitt sindur),kúgvin er opin(er ikki slept);einans kúgv er opin;eingin kona er opin(mylkin);sms. t.d.aftur-,hálv-,innan-,víð-
opinbera	geva til sjóndar, lata koma í ljós, kunngera, lýsa 2(5), boða (2), sýna, avdúka,hann opinberaði dýrd sína;Harrin opinberaði seg fyri Ábrahami
opinbering	1tað at opinberael.verða opinberaður2e-t ið verður opinberað3(átr.)sjónel.fyriboðan ið ein menniskja fær umel.frá hægri veruel.Guði,fáa eina opinbering frá Guði;Jóhannesar opinbering
opinberingarbók	(átr.)bók ið sigur frá evstu tíðum og heimsins undirgangi,(í bundnum formi serst. um)Jóhannesar opinbering,í brøvunum og í opinberingarbókini(apokalypsis)
opinberligur	opinberur, almennur, týðiligur, skilligur,kenslan av einsemi og fremmandaleika er heilt opinberlig;opinberligur sannleiki;hj-liga,gera e-n opinberliga til skammar;atfinningarnar komu fram opinberliga
opinberur	eyðsýndur, eyðsæddur, bersýndur, greiður, opinberligur,danska stjórnin stóð í opinberari mótstøðu við tjóðskaparrørsluna í Føroyum;betri er opinber atfinning enn kærleiki, sum heldur seg fjaldan
opinekra	1(burturløgd) velta ið ikki er aftursvarðað(hevur áður borið epli, røturel.korn),liggja í opinekru(tá ið ikki varð sett niður í aftur um várið),fyrst er tað velta, so opinekra og síðan nýlendi2velta ið velt er í nógv ár, moldvelta,seta niður í opinekru
opinekruarvi	(plfr.)slag av arva 1(Stellaria media)
opinepli	(stb.)eftirepli
opinleiki	tað at vera opin (3) og óhulin,størri opinleiki[russ.glasnost]
opinlyndi	opið lyndi, opinleiki,yrki teirra - runnið av opinlyndi og víðfevnandi hugsjónum
opinlýst	frítt, ótarnað, opið, ódult,Jesus kundi ikki longur koma opinlýst inn í nakra bygd
opinlýsur	opin, óduldur, opinberur
opinoygdur	við stórum og opnum eygum, við útrendum eygum
opinreyv	opnareyv
opinskára	avdúka, boða frá, siga frá, leka (3), smetta,teir fáa einki burtur úr tí uttan at opinskára seg sum falsarar;lærarin var ikki tann maður, at hann opinskáraði nakað;tað verður skjótt opinskárað, at vit eru her
opinskáraður	1ið sigur e-t bart út, ið sigur sum er, bersøgin, ærligur,tað var honum so líkt at vera opinskáraður við slíkum, ið skuldi verið væl umhugsað og varisliga sagt;hon hevði altíð verið opinskárað og aldri dult nakað fyri honum2ið illa dugir at tiga(um e-t loyniligt),opin (3)
opinskáraføri	tað at vera opinskáraður, bersøgni,í opinskáraførifyri almennings eygum, alment;eg tordi ikki at drekka í opinskáraføri;koma í opinskáraføri(um innibyrgdar kenslur)koma fram, koma til sjóndar, opinberast
opisligur	opin, tómur, innanopin, innantómur,altíð so mikið opisligt millum rimarnar í neystinum;har var ógvuliga opisligt innan;tað ljóðaði opisligt at ganga eftir brúnni
opium	(lækn.)rúsevni vunnið úr dreymsólju(nýtt til at doyva pínu)
opna1	(dj.)vaksin kvennkópur, úldrynja;sbr.brimil
opna2	1tvær síður ið síggjast samtíðis í opnari bókel.opnum blað,úr hvørjari opnu vellir kærleikin til ættina2innsíðanel.tað opna á krovi,opnan á krovinum skuldi altíð venda frá fólki(sum komu inn í hjallin)
opna3	lata upp, gera opnan, opa,hann fekk næstan ikki í lag at opna brøvini;opnastlata seg upp, gerast opin,best at koma sær tætt at landi, áðrenn bygdin opnast;himmalin opnaðist fyri honum
opnahjallur	hjallur við laðaðum skjøldrum og taki men opin á síðunum, stabbahjallur við ongum rimum(serst. at heingja fisk í),gjóstur sum í einum opnahjalli;(tilt.)hanga sum kráka í opnahjalli(um onkun ið krøkist, klintrast og lesir seg);(tilt.)sum fressur í opnahjalligrammur (eftir e-m);sum ein opnahjallur(um e-n ið ikki dugir at tiga við e-m)
opnakeil	eitt sum ikki kann tiga við loyndarmálio.tíl., eitt sum einki legst undir
opnareyv	1ein ið setur opið eftir sær2opnakeil
opnari	1amboð at lata e-t upp við(t.d. fløsku, dóso.tíl.)2(gl.)borur(Sv);sms. t.d.dósa-,fløsku-
opnatroyggja	troyggja opin fyri framman,eg fari at binda eina opnatroyggju
opning	tað at opna(Sv)
opningur	(lækn.)1tað at fáa av sær, tað at hjálpa sær sjálvum,rugmjøl ymisliga tilgjørt varð fyrr nýtt, tá ið illa gekst at fáa opning2tað ið ein fær av sær, skarn, (manna)trekkur,harðurel.linur opningur;hava harðan opning
opra	s30(stb.)í osb.opra undanhopa undan
opsin	óhyggin og opinskáraður, forsin og bersøgin,hann var altíð opsin
opsni	tað at vera opsin, opinskáraføri,flestøll læðu eitt sindur at forvitni hansara og opsni
optikari	ein ið er útbúgvin at evna til og selja brillur og atkúpur
optiskur	(alisfr.)viðv. ljósiel.sjón,til lívsins uppihald slípaði hann optisk gløs, og tað eru nakrar av hesum linsum, sum eru vorðnar mín ogn
orangutang	(dj.)stór mannapa(við longum ørmum og síðari reyðbrúnari ull)(Pongo pygmaeus)
ordan	(tlm.)í osb. sumgera í ordangera í stand, hampa, umvæla;vera í ordanvera í lagi
ordans	(tlm.)rættur, rættiligur, óførur (4),hatta er ein ordans gloypubiti
ordans-	(tlm.)dugna-, megnar-,ein ordanskona/ordansmaður
ordiligur	rættur, rættiligur, veruligur,hann sær, at tað er ikki ordiligt fólk;ein ordiligur lubbi;ver ordiligur!(skikkiligur, hampiligur (1));hj-liga
ordri	1boð, orðsending,geva ordrargeva boð (um e-t)2bílegging, umbiðing
orð	1(málfr.)minsta merkingarberandi eind ið kann standa einsamøll sum útsøgn (1)2tað ið sagt verður,(bíbl.)í fyrstuni var orðið;fariseararnir gingu saman í ráð, hvussu teir skuldu fáa sett Jesus fastan í orðum;vita orð fyriduga at orða,teir høvdu á sær hesa undrandi kenslu, sum teir ikki vistu orð fyri;ikki leita eftir orðunumtala raðið og beinrakið;hann átti eingi orð fyri gleði síni;taka orð úr munninum á e-msiga júst tað, ein annar ætlar at siga;vera við tí góðael.ringa orðinumsíggja tað góðael.ringa íel.við e-m, rósael.lasta,hann er altíð við tí góða orðinum;tað var ikki orð á, sum hann varð róstur(tað sigst ikki frá, ikki eiti á);í orð og tal kundi hon mangan vera ov greflig;orð ókst av orði,síeykast 1;gloym ikki títtel.tíni orð!(sigur ein høviskliga við annan, tá hann vil skjóta e-t inn í tosið, sum honum kemur í huga í løtuni);øvut orð;taka orðið av;havael.taka seg aftur í orðinirætta tað ið er sagt skeivt;(tilt.)eitt var orðið, annað høggið(stutt millum tað ið sagt og gjørt verður);skaðin var størri á orði enn á borði(í orðum enn í royndum);(orðt.)mangur er á orði, ið ikki er á borðimong eru samd men svíkja tá ið fremjast skal í verki;(orðt.)tað er ikki hvørt orð, tú skalt svara til, og ikki hvørt gildi, tú skalt fara til,sbr.snildi3tað at tala, framsøgn,orðum kønur;ikki fáa orðið uppel.frameinki fáa sagt;taka til orða(nna)(fara at) tala,(kvæð.)keisarin tekur til orða svá4tað at tala saman, tað at koma á tal við, samrøða,skifta orð (við e-n um e-t);eiga orð saman;hava orðum saman1tala saman2keglast, deilast,koma til orða við e-n(á tal við e-n);vera til orðahittast;fáa orð á (e-n)fáa (e-n) í tal;bera orð á (e-n)tala áel.til (e-n);teir komu til orða inni í kolinum(at deilast);bera orð av dreingi/gentuvera settur í samband við drong/gentu,Dávur hevði ikki borið orð av gentu síðan;tey bæði høvdu borið orð av hvørjum øðrum nøkur kvøld;bóru tvey orð av hvørjum øðrum, so var altíð nógv at siga um tey5tað at umtala, umrøða,hava á orði1umtala2rósa e-m, (lov)prísa e-m,(orðt.)fátt er betri enn á orði havtsjáldan er nakað betri enn tað er sagt at vera;hava (e-t) við orði(umtala, nevna),eg havi ofta havt tað við orði, hvussu góður fiskurin er;øll hava teir við orðitala (rósandi) um teir;hava á orði við e-n (um e-t)tala við e-n (um e-t), hava (e-t) á munni við e-n, umrøða e-t (við e-n);hava orðið umnevna,har veksur hin reyði tarin, tygum høvdu orðið um6tað ið frættistel.hoyrist, leysatíðindi,komael.førast út í orð;loypa út í orð;hesari ferð hansara gekk mikið orð av;orð gekk av, so gott prógv hon hevði fingið;orð hevur gingið um kærleikan teirra millum;uttan orð og/ella boðuttan ávaring, beinan vegin,hann gjørdi tað uttan orð og boð;hoyra hvørki orð ella eiðals einki frætta (frá e-m);áðrenn nakar visti orðið av tí(nakað um tað yvirhøvur)7ámæli (2), ummæli (4),hava gott/ringt orð á sær;orð gongur avtað sigst;hann ber orð fyri at vera sterkur(verður sagdur at vera sterkur);bera e-m gott orð(alt gott);koma (e-m) í ringt orð;slíkt er óhóskandi, óverdugt fyri fólk, ið vil hava orð fyri at vera mentað fólk;sýslumaðurin hevði einki orð á sær(var illa umtóktur);leggja góð orð fyri e-n;mátti hava vissu fyri, at maðurin var, so sum orðið gekk av honum(sum hann segðist vera)8orð(a)tak,eitt gamalt orð9lyfti, tilsøgn, heiti (4),halda orð;bróta sítt orð;geva (e-m) orð og eiti fyri, at...;fútin vildi ikki bróta orð og eiti sítt10tað at leggja afturatel.skoyta uppí, tað at taka e-t uppaftur,taka í aftur orðið;"ein kann ikki bara arbeiða", tók Gunnar í aftur orðið;eg taki nú aftur í orðið;hann tók so aftur í orðið11tað at leggja uppímillum(í samrøðuel.orðaskifti),hava orð uppií;onkur kona hevði eitt orð uppií;eg skoytti ikki um at geva orð til(svara)12(átr.)orðiðGuds orð, gleðiboðskapurin, skriftin, Bíblian13(fólktr.)hava orðið á e-mrósa so at ilt verður úr,hav ikki orðið á honum(t.d. at siga um ein sjúkan at hann er í betring);teir hildu orðið á honum(høvdu);lat meg ikki hava orðið á (tí, tæro.s.fr.)lat meg siga tað meðan væl er vorðið, Gud lati meg góðan tíð tala;sbr.spírstunga 1;hann hevði hetta brýnið á orði, hvussu gott tað var - og tað brotnaði;hon hevði eina hvassa tungu og nógv av tí, hon spáddi og hevði orðið á, skuldi ganga út;sms. t.d.arv-,boð-,festar-,for-,frøði-,ganda-,háðar-,heit-,hjá-,lygnar-,lýsingar-,minningar-,óvanda-,rím-,sagn-,skrift-,spei-,tal-,trúar-,tøku-,vinar-,yrkis-
orða	nevna, bera upp á mál, bera fram (í orðum), seta saman (í orðum),orða e-t við e-n;orða burturfáa (e-t) at hvørva;tað gekk so væl - nú orðaði tú tað burtur!;orða ein burturhava orðið á e-m(so at hann doyr),hann orðaði seyðin burtur(hevði orðið á honum);orða fisk avhava orðið á fiski(so at hann fer av),nú orðaði tú hann av;orða ímótimælael.muta ímóti;orðastkomael.førast út í orð;sms. t.d.um-
orðabanki	(teld.)teldutøkt orðasavn
orðabending	(málfr.)tað at benda (3) orð, bending (2)
orðabók	bók við orðatilfari í ávísum máli í stavraðaðari uppseting og við skilmarkingum á samael.øðrum máli(vanl. við upplýsingum um framburð, bending, nýtslu, orðasøguo.tíl.),føroysk-donsk orðabók
orðabókar-	sms. t.d.-forrit,-gerð,-handrit,-ritstjóri
orðabókargrein	(í orðabók)leitorð viðt.d.skilmarking, samheitum, dømum og ymsum málsligum upplýsingum
orðabrask	stórlátin og reypandi orð, gabb (1)
orðadráttur	orðgonga, kjak, kegl (1), træta,verael.liggja í orðadrátti við e-ndeilastel.keglast við e-n
-orðaður	sí t.d.blíð-,fagur-,fals-,fá-,góð-,harð-,hittin-,hvass-,ill-,ljót-,mjúk-,ógv-,stór-,stutt-,søt-,títt-
orðafall	orðalag, málbrúk,eg havi sjáldan hoyrt so vakurt orðafall
orðafar	málbrúk, málbering, orðalag,hann er altíð so bøllutur í orðafari
orðafáur	1ið sigur lítið, fáligur (1), fáorðaður, fámæltur, orðalítil,hví mundu tey vera so orðafá og innisæl2ið nýtirel.hevur fá orð,málið er orðafátt
orðafelli	1(orða)tiltak, máliska,føroysk orðafelli og orðtøk2málbrúk, málnýtsla, orðafar,av teimum gomlu lærdi eg gott føroyskt orðafelli
orðaflokkur	(málfr.)hvør av teimum flokkum sum orðatilfarið í málinum verður býtt í eftir merking, formi og støðu í setningi(t.d. navnorð, lýsingarorð, talorð)(pars orationis)
orðafloymur	floymur av orðum, orðaflóð,eg var eitt sindur illa við av hesum orðafloymi
orðaflóð	orðafloymur
orðafrágreiðing	orðalýsing
orðagangur	orðabrask, deilan, møsn, tvass,láturligur orðagangur hoyrdist úr krambúðini
orðageip	geip við orðum, gabb, skrøgg, møsn
orðagerð	(málfr.)tað at gera nýggj orð(t.d. við avleiðsluel.samanseting),orðasmíð,orðagerð á heimligari grund
orðagjálv	geip, reyp, skrøgg
orðakappi	(bíbl.)ein ið stendur í orðastríði,hvar er orðakappi í hesum heimi?
orðakringur	orðkringur
orðalag	tann háttur orð eru lagað og skipað í setning, máti at orða e-t, málbrúk, orðafall, orðing,hann kundi stundum tykjast bonskur í orðalag;tað er eitt (ræðuligt) orðalag, hann hevur(ljótur í orðum);tað fyndiga, máttmikla orðalagið;greitt, beinrakið og mergjað var orðalag teirra;gott og greiniligt orðalag;hava gottel.ringt orðalag til e-nhava e-t gottel.ringt at bera e-mel.siga um e-n;hann hava tey einki orðalag til(rósa honum ikki)
orðalagsheild	(málfr.)heild av orðum samansett eftir reglunum í orðalagslæruni[da.syntagme]
orðalagslæra	(málfr.)grein í málfrøði um setningsgerð og samband millum setningar, læra við reglum um (málsliga rætta) samanseting av orðum í setningar, setningafrøði(syntaxis)
orðaleikur	1tað at nýta einsljóðandi orðel.fleirtýddar máliskur til at fáa fram t.d. e-t láturvert, leikur við orðum2tómorð, tungusnild, røðusnild,alt hetta við talum, skrúðgongum og strætan um geilarnar var tað bera ról og orðaleikur;alt endaði í berum orðaleiki
orðaleyst	uttan mótmæliel.ábreiðslu, uttan at muta ímóti,gert tú hatta, verður tað ikki orðaleyst(so verður tú deildur fyri tað);tað skal ikki vera orðaleyst;tað gjørdi hann orðaleyst(uttan at muta ímóti);einhvør hevur gjørt hesa góðgerð orðaleyst(tigandi, stillisliga, uttan hóvasták)
orðalisti	stavraðaður listi við orðum, orðaskrá
orðalítil	orðafáur, fáorðaður, fámæltur,álvarsom og orðalítil;hon var orðalítil og læt aldri nakað leka út, sum hon visti;hesi fólkini vóru so orðalítil(søgdu ikki nógv)
orðaljóð	orðing, orðalag,brævið varð lisið upp í fullum orðaljóði
orðalýsing	lýsing av orði, orðafrágreiðing, skilmarking
orðalæra	(málfr.)læra um orð(t.d. innihald, nýtslu, bendingo.s.fr.)
orðamikil	stórorðaður, gabbutur, reypsamur,tú plagar ikki at vera so orðamikil
orðamunur	munur í orðing, frábrigdi (1), avbrigdi,orðamunur úr øðrum handriti stendur við hvørt undir tekstinum
orðanøgd	nøgd av orðum, orðafloymur,orðanøgdin var ógvulig, men skilið var lítið
orðarað	(málfr.)raðfylgi av orðumel.liðum í setningi, rað av orðum,setningur við beinum orðarað;øvut orðarað(t.d. tá ið sagnorð kemur undan navnorði)
orðaraðið	orðarætt, raðið,frásøgan er prentað at kalla orðaraðið;ikki er orðaraðið avskrivað
orðareiggj	(gl.)orðadráttur, deiling 1,teir áttu eina harða orðareiggj saman
orðaríkur	ið nýtirel.kennir nøgd av (sjáldsomum) orðum,hann var tiltikin fyri at vera orðaríkur;ikki bert orðaríkur, men dáðríkur eisini
orðarætt	beint sum sagtel.skrivað er, orðaraðið,endurgeva orðarætt;fleiri brot eru tikin at kalla orðarætt
orðarættur	sagdurel.skrivaður orð fyri orð(í beinari endurgávu),orðrættur,orðarøtt frágreiðing;hjorðarætt,barnið segði søguna orðarætt, sum tað hevði hoyrt hana
orðasamband	samband av orðum, orð ið standa saman(oftast fastel.hevdbundið),fast orðasamband;í vissum orðasambondum
orðasavn	(stórt) skipað savn av orðum(t.d. á seðlum, í telduo.s.fr.)
orðaskifti	tað at skifta orð (um e-t), orðadráttur, kjak, umrøða,teir høvdu sitið í orðaskifti um okkurt mál;orðaskifti um fíggjarlóg
orðaskiljing	(sj.)orðalýsing
orðaskolan	skról, goff, skvaldur
orðaskrá	stavraðað skrá við orðum, orðalisti, orðasavn
orðaskvaldur	skról, goff, møsn, roks, orðagjálv
orðasmiður	ein ið ger (nýggj) orð,kringur orðasmiður
orðasmíð	(málfr.)tað at smíða (nýggj) orð, orðagerð(t.d. úr samansetingarliðum, stovni (5), forfesti, eftirfestio.s.fr.)
orðastríð	stríð í orðum, orðadráttur, orðgonga, kegl, træta,tey vóru ógvuliga ofta í hvøssum orðastríð;hann var fúsur til orðastríð
orðatak	orðtak
orðatilfar	1nøgd av orðum í einum máli, málføriel.sermáli, orðfeingi2nøgd av orðum ið ein nýtirel.kennir,virkið og óvirkið orðatilfar
orðatiltak	tiltak (5), máliska (1)
orðatrot	tað at trótael.vanta orð,hann er ikki í orðatroti
orðaval	tey orð ein velur sær at nýta, val av orðum,hann er óstortsligur í orðavali(í orðum)
orðavargur	ein ið er stórorðaður, skræðugákur, gabbari, reypari, skrólari,hann var ein sovorðin orðavargur, hann tók so ógvusliga til orðanna;hann hevur ikki verið tiltikin fyri at vera nakar orðavargur
orðavas	orðaskvaldur
orðavavstur	vavstur av orðum, ógreið og høpisleys tala, orðaskvaldur
orðbera	siga frá (í orðum), orða,orðbera segmálbera seg, orðføra seg;tað er torført at orðbera seg á rættan hátt
orðblindi	tað at vera orðblindur
orðblindingur	ein ið er orðblindur
orðblindur	ið vantar evni at lesa og skriva rætt;sbr.talblindur
orðbragd	orðalag, orðafar,longu í 15. øld síggjast donsk orðbrøgd at vera komin inn í norskt og føroyskt skriftmál
orðbrosin	(gl.)munnkátur, ógvorðaður
orðbýta	(málfr.)býta orð sundur millum reglur
orðbýting	(málfr.)tað at býta orð sundur millum reglur
orðfáur	fáorðaður, fámæltur, orðalítil, orðafáur (1),stillførur og orðfáur maður;við hesi orðfáu lýsing er nógv sagt
orðfeingi	(málfr.)orðatilfar
orðfella	(um málburð)fáa at sita, siga, orða,hann tosar reint suðuroyarmál og dugir væl at orðfella tað;kvæðið er ikki so væl orðfelt(fylgir ikki so væl lagnum)
orðfelli	orðafelli
orðfelling	tað at orðfella (seg)(í kvøðing)
orðfesta	staðfesta í orðum, skriftfesta, kunngera
orðfimi	tað at vera orðfimur,hon segði frá tí við einføldum orðfimi
orðfimur	fimur í orðum, ið dugir væl at taka til orðanna, orðkringur, lagorðaður, munnfimur
orðfittur	orðfimur, munnfittur,vera orðfittursiga e-t beinrakið
orðformur	(málfr.)orð í serstøkum (bendingar)formi, orðsnið
orðfúsur	ið dámar (ov) væl at tala, íðin at siga e-t,tú ert so orðfúsur;hann angraði, at hann hevði verið so orðfúsur og høgt so niður á hana
orðføra	s1:orðføra segorðbera seg, málbera seg,hann dugir væl at orðføra seg
orðføring	orðalag, málburður
orðførur	munnkátur, mælskur, ógvorðaður, prátríkur, prátutur, orðbrosin,hann kundi vera í so orðførur(taka ov rívan til, gera ov nógv av)
orðgonga	orðadráttur, kjak
orðgýtast	brúka seg, skræða seg, mýkja geilatíkina,hann er so raskur at orðgýtast
orðhagur	1orðkringur, lagorðaður,(kvæð.)Tormaður er so orðhagur, hann yrkir ráina saman2(sj.)orðhavin
orðhaldin	ið heldur orð, álítandi, trúgvur,orðhaldin maður
orðhavin	ið talar við ongum fyriliti, gáloysin í orð og tal, munnlættur,hann var so spotskur og orðhavin
orðhildin	orðhaldin
orðing	1tað at orða, háttur at orða, orðalag2tað ið er orðað
orðkringur	orðfimur, lagorðaður, orðhagur, orðførur,orðkringur maður
orðkvettin	kvettin, kvettorðaður, bitutur,hann er so orðkvettin
orðkýtast	(Sa.)munnkýtast, deilast, keglast
orðkýtingur	(Sa.)munnkýtingur
orðleiða	1(bíbl.)bera fram, siga, mæla,orðleiða tað, ið fjalt hevur verið frá upphavi2(sj.)skendska, deila 2,at kunna standa so og orðleiða fólk;hon var illa orðleidd
orðleikur	orðaleikur (2),uppreisturin var vunnin við einum orðleiki
orðleypa	s53í osb.orðleypa segovtalael.ovsiga seg(siga e-t ið ikki átti at verið sagt),at eg skuldi orðleypa meg so;hon hevði altíð verið so orðleypandi(fitt í munninum)
orðleysur	uttan orð, ósagdur,ekki og iðran herja orðleys á hann;hjorðleystuttan at mæla orð,orðleyst tilbað eg tey
orðliður	(málfr.)liður í (samansettum) orði
orðloypin	orðhavin,hann var altíð nakað orðloypin
orðloysi	tað ikki at halda orðel.lyfti
orðloysingur	ein ið ikki heldur orðel.lyfti
orðlutur	(málfr.)partur av orði(kann bæði vera orð og avleiðsluending),í orðinum dagstovnur hava vit orðlutirnar dag+stovn
orðmikil	orðamikil
orðmynd	(málfr.)snið sum skrivað orð hevur(viðvíkjandi útsjónd, tali og raðfylgju á bókstøvunum),tað ræður um hjá børnum at læra seg orðmyndirnar
orðna	1fáa skil á, skipa, greiða,hetta er skjótt at orðna2geva øðrum boð(um at gera e-t),ráða (6),hon orðnar altíð(er so ráðarík)
orðníðingur	(mikil) orðloysingur
orðrómur	(bíbl.)orð (7), ámæli (2)
orðrót	(málfr.)rót (7) í orði
orðrættur	orðarættur;hjorðrætt,eg segði orðrætt frá tí(orðaraðið)
orðsending	boð (1), áheitan,nógv fólk kom til býin eftir orðsending frá Ólavi kongi
orðskiftast	skifta orð, kjakast, umrøða,teir stóðu og orðskiftust um viðurskiftini
orðskvaldur	orðaskvaldur
orðsnið	snið á orði, orðformur
orðsnildi	tað at duga hendinga væl at málbera seg, tungusnild,hennara ýlandi orðsnildi sló fólk sum við øks í høvdið
orðsnúgvin	snúgvin í orðum, orðkringur
orðsstaður	k14í osb.taka e-t í orðsstaðtaka e-t uppaftur, líta á e-t,tað er ikki takandi í orðsstað, tað hann sigur
orðstovnur	stovnur (5) í orði
orðstýrari	fundarstjóri
orðtak	1setningur(ofta í lagføstum sniði og t.d. við stavrími)ið endurgevur lívsroyndir, lýsir siðaregluro.tíl., orðatak, munnmæli,sum orðtakið sigur: "eingin veit á morgni at siga, hvar hann á kvøldi gistir";"tungur er tigandi róður" er annað orðtak2í osb.taka e-t í orðtaktaka e-t uppaftur, spjaðael.bera tíðindi,eg taki tað ikki í orðtak
orðtaka	(málfr.)velja og skriva orð úr teksti(at seta í orðasavnel.orðabók),orðtaka bók
orðtakast	skeldast, deilast
orðtal	hí osb.taka í orðtaltaka upp aftur, smetta,tak tað ikki í orðtal
orðtøka	(málfr.)tað at orðtaka
orgallur	skálkur, illmenni, bakbeist(Sv)
organ	(kvæð.)urga
organspípa	(kvæð.)urgupípa,har vóru trodnar organspípur
orgul	urga
orka1	1máttur, styrki, megi, kraft,leggja alla sína orku íel.á e-t(gera sítt ítasta);(kvæð.)hvørgin gat á orku spart2(alisfr.)máttur til vinnu,orkan í mati;vatnorka(t.d. til ravmagn)(energeia);sms. t.d.arbeiðs-,atom-,innan-,keyp-,kjarn-,røringar-,vatn-
orka2	vera menturel.førur fyri, megna, kunna, fáa,hann orkar ikki at eta upp;hann orkar ikki at tiga við tí longur;ikki orka meiravera mettur;hann róði alt tað, hann orkaði(var mentur);ikki orka1ikki megna(t.d. at ganga),hann orkaði ikki á støðna2ikki torgael.tola (e-t),eg orki ikki at síggja teg;ikki orka fyri e-mikki tolael.torga e-nel.e-t
orkestur	(tónl.)bólkur av tónleikarum ið spæla saman, tónleikabólkur,hornorkestur;symfoniorkestur
Orknoyggjar	oyggjaland millum Skotlands og Hetlands
orknoyingur	fólk íel.úr Orknoyggjum
orknoyskur	íel.úr Orknoyggjum
orkufrekur	ið krevurel.nýtir nógva orku,orkufrek framleiðsla
orkugerð	(alisfr.)tað at orka verður loystel.umgjørd
orkugevi	e-t ið gevur orku
orkugonga	(stb.)gonga (1) ið krevur nógva orku, hørð gonga;í osb. sumgangael.fara orkugongu(við miklan skund);brátt fór maður av húsi orkugongu á fjøllini at veita teim neyðstøddu dugnað
orkukelda	tað ið nýtt verður til at útvinna orku,olja og vindmegi sum orkukeldur
orkukreppa	kreppa av tí at trot er á orku
orkulind	lind 3 ið gevur orku, orkukelda, máttarlind
orkulítil	máttlítil, veikur, ússaligur, kraftaleysur (1), lítið til manna,konan føldi seg sjúka og orkulítla
orkuloysing	(alisfr.)tað at orka verður loyst, orkugerð
orkumál	(stjm.)málel.viðurskifti viðv. orku,landsstýrismaður í orkumálum
orkumálaráð	(stjm.)stjórnardeild ið hevur orkumál um hendur
orkumálaráðharri	(stjm.)ráðharri ið situr fyri orkumálum
orkumikil	sterkur, kraftamikil
orkunýtsla	(alisfr.)tað at nýta orku 1(2)
orkuráð	ráð (2) ið sær um orkumál
orkuríkur	1við nógvari orku, orkumikil2ágrýtin, virkisfúsur, raskur, framtøkur
orkusparandi	ið minkar um orkunýtslu(ít.d.ravmagni, upphiting og framleiðslu)
orkuspell	oyðsl við orku, spell av orku,tað hevur óivað elvt nógv orkuspell
orkustøð	støð 1(2) ið veitir orku, máttarstøð
orkutøkni	(alisfr.)tøkni viðv. orku
orkutørvur	tørvur á orku(t.d. olju, streymio.tíl.)
orkuverk	verk ið veitir orku, orkustøð
orlogsskip	(gl.,skip.)herskip
orlov	1heimfararloyvi, lov 1, frælsi,(kvæð.)orlov biðjum vær2farloyvi, fríloyvi(t.d. frá skúla, arbeiðio.tíl.)
ormaár	ár 2(1) við nógvum grasormi,kemur várskerpingur, er ormaár væntandi;árið fyri ormaárið
ormabit	(bíbl.)bit 1(1) av ormi,skaði av ormabiti
ormabotnur	(stb.)állabotnur
ormaeitur	eitur av ormum,ræðuligt ormaeitur
ormagarn	fínt spunnið garn,fínt sum ormagarneitrandi fínt spunnið
ormagras	(plfr.)eygnagras
ormalamb	lamb við bendilormi
ormasekkur	k31(sj.)í osb.tín ormasekkurtítt vittuggi(við barn ið t.d. ikki vil hava tað sum tí verður boðið)
ormasjúka	1(stb.)sjúka hjá seyðihelstskánormur2(lækn.)sjúkaserst.hjá børnum(elvd av ormi (5))
ormasjúkur	ringur av ormi,seyður var ofta ormasjúkur í oynni;barnið var illa plágað av ormi
ormatógv	eitrandi fínt tógv, ormagarn
ormaungi	(bíbl.)ungi hjá ormi,tykkara ormaungar, hvussu kunna tit tala tað, ið gott er, tá ið tit sjálvir eru óndir?
ormaveður	maðkaveður
ormetin	maðketin, maðkaboraður
ormstunguætt	(plfr.)ætt av leggstreingjagróplantum(Ophioglossaceae)
ormur	(dj.)1langt dýr av skriðdjóraætt, slanga 1(1)(Serpentes)2maðkur3ormvera hjá ávísum skordýrum4(fólktr.,kvæð.)dreki (1),Ormurin langi;sbr.lindormur,frænarormur5(lækn.)sníkur í innvølumserst.hjá børnum(Enterobius vermicularis),barnið hevur orm;sms. t.d.barna-,bendil-,búk-,døkk-,eitur-,høgg-,kopar-,korn-,liða-,silki-,skán-,tind-,vit-
ormvera	(dj.)skordýr á ungum menningarstigi,ormveran skiftir ham
orna	1vermast, hitna,tá ið ornað var inni, var liðið út um miðja nátt;(kvæð.)orna tók hans blóð;(flutt m.)nú var tað rættiliga farið at orna teirra millum(renna saman)2gerast illa við, verða illa heitin,orna um skallan;orna av skomm;eg bæði ornaði og rodnaði;hann ornaði við
orr	stinkandi evja
orra	(um evjuo.tíl.)gera 2(1), esja, rotna,flotkøstar og blárennur, sum standa og orra;(flutt m.)standa og orrastanda fyri einki, vera fyri
orragoggur	1(stb.)veðragjólingur2(flutt m.,niðr.)ein ið er argur at vinna neisur, skálkur,hatta er tann orragoggurin, ið er
orri	(fugl.)útl. fuglur skyldur rýpu(Tetrao tetrix)
orrusta	stríð, bardagi, træta, klandur, illstøða,vekja orrustuyppa klandur
orsak	(gl.,tlm.)orsøk
orsaka	1gera, elva, volda, birta í, vera atvold í (e-m),orsakað av e-mav tí at2fyrigeva, avsaka, umbera,orsaka e-ntaka útyvir við e-m;orsaka segbiðja um umbering
orsakan	(sj.)tað at orsaka (2), umbering, fyrigeving
orsakareykasetningur	(málfr.)sambindingareykasetningur ið lýsir orsøk til tað ið sagt er í yvirsetningi(t.d. við sambindingarorðunum "(av) tí at"),hann fær ikki komið, tí at hann er burturstaddur
orsaki	orsøk,hava orsaka at gremja seg
orsøk	gerð, støðao.tíl.ið veldur e-t annaðt.d.aðra hending, gerð, støðuo.tíl., grund (8), atvold,orsøkin til ólukkuna var ov nógv ferð;hon hevði góða orsøk at vera fegin;orsøk og virknaður;sms. t.d.aðal-,høvuðs-
ortur1	síyrkja
ortur2	borin upp á mál, orðaður,vera vælel.illa ortur1nýta vøkurel.ljót orð2tosa vælel.illa (um fólk), tosa við sómael.niðrandi (um fólk);vera undarliga orturnýta undarlig orðel.orðafelli;sms. t.d.ill-
orv	skaft á líggja;sms. t.d.líggja-,stutt-
os	sívær
osa	1rúka illa, hjara (1), deyma, slíma (1),lampanel.ljósið osar(slímar)2guva,ketilin stóð og osaði og var kókaður næstan tómur;potturin stendur og osar
osara	(gl.,stb.)okkara,sívær
o.s.fr.	stytting fyriog so framvegis
osi	dampur 1(2), guva, hjari, hjararoykur(serst. við steiking),slím(serst. frá lampuel.ljósi),osin rann niður eftir bróstinum;turka osan av rútunum
oskabásur	oskbásur,kúgvin stendur á oskabási
oskabjørn	(dj.)krabbadýr ið livir sum sníkur á fiski, grunnlús(Aegidae)
oskadralvi	ketilostur(Sv)
oskamjólk	(mjólk.)fyrsta málið undan kúgv eftir at hon hevur kálvað, rámjólk
oskasmør	smør av oskamjólk, rásmør,oskasmør varð hildið vera dygdarbetri enn annað heimasmør
oskbásur	k11í osb. sumkúgvin stendur á oskbásikúgvin er nýkálvað og mjólkar enn oskamjólk(t.e. átta dagar eftir kálving),taka kúgv á oskbásimjólka kúgv fyrstu tíðina eftir at hon hevur kálvað
oskramjólk	(stb.)oskamjólk
osonlag	(alisfr.,evnafr.)jaður av osoni í lofthavinum(verjir fyri útbláum geislum frá sólini)
oss	os, osum;sívær
ostabotnur	havbotnur við osti (2)
ostafarg	ostaformur, ostkista
ostaformur	træformur(lítil ferhyrntur kassi)til ostagerð, ostafarg, ostkista,ostaformur er útskorin bæði á lokinum og í botninum
ostagerð	tað at gera ost
ostahøvil	ostskeri
ostakoppur	(stb.)ostafarg
ostalak	tunt klæði at leggja innan um ostafarg
ostamjólk	(mjólk.)mjólk til ostagerð
ostaskerari	ostskeri
ostaskorpa	skorpa áel.av osti
ostatíggjund	(søg.)tíggjund av osti,smør- og ostatíggjundin vóru lagdar saman
ostbásur	(óregl.)->oskbásur
ostevni	(um mjólk)eggjahvítaevni ið stadnar tá ið mjólk verður loypt[en.casein]
ostflís	flís av osti
osthøvil	ostahøvil
ostkista	(gl.)ostaformur
ostra	(dj.)útl. skeldýr av lindýraætt(onnur skelin kúput, hin rættiliga fløt)(Ostrea)
ostruskel	skel av ostru
ostskeri	amboð at skera ost við, ostaskerari, ostahøvil
ostur	1føðievni úr ostevni og fiti(serst. havt sum viðskeri),kæsa ost(gera)2slag av stórum rundum svampi ið veksur á havbotninum(Geodia),tað var nógvur ostur, teir kalla, í trolinum;sbr.ostabotnur;sms. t.d.blak-,geitar-,ketil-,smelti-,smyrji-
osum	sívær
ota	førka (afturel.fram), føra, flyta, skumpa, troka,ota e-n út á sjógv;ota burtur;ota seg fram;ota seg undantaka seg aftur;ota seg inn á e-nganga á e-n;standa og otastikki tora at nærkast, aftra seg við at nærkast
otan	trokan,tað var ein otan av fólki framman fyri skivuna
o.tíl.	stytting fyriog tílíkt
otur	(dj.)súgdjór av marðarætt við fitjum(Lutra vulgaris)
oturskinn	skinn av otri,mín kjóli skal vera av oturskinn'(í tátti)
o.u.	stytting fyriokkurt um,t.e.um leið
ov	(nýtt sum áherðing, stundum eisini sum forskoyti á sagnorðum, lýsingarorðumo.tíl.)í meira lagi, heldur enn ikki, í (ov) stóran mun,ov mikiðheldur nógv, í meira lagi;ov mikið og ov lítið;ov tíðliga;ov seinur;ov ungur;ov gamal;teir vóru ov nógvir á báti;børnini komu ov seint í skúla í morgun;(kvæð.)ov seint vart tú nú á ferð
ovanfyri	(sj.)omanfyri
ovarbeiða	arbeiða meir enn evniel.orka loyvir, arbeiða av forverkum, overva seg,doktarin segði, at hann hevði ovarbeitt seg
ovarbeiði	tað at ovarbeiða,andsperri av ovarbeiði
ovari	1l miðstsum er longri uppi (av tveimum), hægri, evri,ovari vegur;ovari munnuryvirmunnur,hann hevði enn flestar tenninar í niðara munni, men næstan alt var burtur í ovara munni;ovara hæddin er útleigað2hj miðstlongri uppi(enn e-t annað),hægri,reiður høvdu vit einki sæð, kanska tey vóru ovari;teir sova í hópi báðir, Lokki ovari og risin fremri(innari, aftari);sbr.niðari
ovarla	(sj.)ovarlaga
ovarlaga	rættiliga høgt uppi,móts.niðarlaga,húsini standa ovarlaga í bygdini
ovarliga	ovarlaga
ovast	longst uppi, hægst, evst,móts.niðast,hevur tú ligið ovast(innastel.aftast í song)
ovastaloft	óinnrættað rúm yvir loftinum(til goymslu),hanabjálkaloft
ovasti	(herm.)hægsti yvirmaður í heri, heryvirmaður á serstøkum (høgum) stigi
ovastur	ið er longst uppi, hægstur, evstur,ovasta hæddin í húsinum;ovastur embætismaður;ovastur av læknunum er landslæknin
ovát	tað at eta ov mikið
ovbardur	ov mikið bardurel.flongdur,(orðt.)eingin biskupur er ovlærdur og eingin skúladrongur ovbardureingin fær ovmikið av tí ið tørvar(Sv);(orðt.)ikki er hundur ovbardurhin ólýdni verður ikki ovmikið agaður(Sv);sbr.hálvbardur
ovbeiðsla	tað at biðja ov stóra bøn 1(1), ov stórt krav
ovbit	tað at hagi er avbitinel.avetin,verður áhaldandi ovbit, kann vøksturin broytast fullkomiliga
ovboðið	meir enn ein er mentur(t.d. at gera, tolao.tíl.),ov nógv kravt, ógjørligt, ov mikið, ov nógv,hon hevði roynt at berjast ímóti, verið djørv, men nú var ovboðið;vera ovboðiðbera av, ganga av skriðuni;vera e-m ovboðiðvera út um tað ein orkar;honum var einki ovboðið;hann helt einki vera ovboðið(hættaði sær undir alt);hesi orðini hava verið honum, donskum manni, ovboðin;(orðt.)øllum er ovboðiðeingin megnar alt, mark er fyri øllum
ovbyrja	leggja ov mikið áel.fyri (e-n), díkja undir,ikki vildi hann ovbyrja tingið;ovbyrjaður1ovklyvjaður, undirdíktur,ovbyrjaður avel.við e-m (t.d.arbeiði);vit vóru ovbyrjað av gestum;hann hevði í fleiri dagar gingið ovbyrjaður av sorg og gremjan(tyngdur)2tarnaður, heldur tjúkkur og tungur á sær(og orkar ikki nóg vælt.d.at ganga)
ovbýldur	ovfólkaður,ovbýldur býarpartur
ovdirvi	hugmóð, stórlæti, dramblæti,eg haldi tað vera ovdirvi av tygum at tala um slíkt fyri mær
ovdjarvur	ov djarvurel.vágin, ovurdjarvur,hann læt ikki hesar ovdjørvu og harðrendu lærurnar hava seg av fótum
ovdrekka	drekka ov nógv(av rúsdrekka)
ovdrukkin	ið hevur drukkið ov nógv, deyðadrukkin, dýrandi fullur,hann varð ovdrukkin og datt av
ovdrykkja	tað at drekka ov nógv,ikki gonguførur av ovdrykkju
overva	ovmøða,overva segspreingja seg, arbeiða av forverkum;overvaðurútervaður, útlúgvaður
overvan	tað at overva (seg), sprongd, overving, yvirerving,overvan seinastu dagarnar hevði sett síni spor í andlitið á honum;andlig og kropslig overvan
overving	overvan,í ørviti av náttarvekri og overving
oveta	s72:oveta seg (av e-m)eta ov mikið, stóreta, eta seg yvir rygg
ovfara	gera ov nógv av(í orðumel.gerðum);í osb. sumhonum tyktist ovfarið(ov nógv avgjørt);hann tóktist at hava ovfarið(Sv)
ovfarakátur	ógvuliga kátur, í sera góðum lag, vælhýrdur, ovurkátur
ovfarakæti	tað at vera ovfarakátur, fárakæti,ovfarakæti var á ungdóminum
ovfarin	illa við, bilsin, forfardur, tikin á bóli, skelkaður,hann støkk aftur eftir hæli, so ovfarin var hann;tey vóru øll ovfarin og undraðust;teimum tókti ovfarið(ov nógv avgjørt);sbr.ovfara
ovfarni	tað at gerast ovfarin, bilsni, undran
ovfegin	ovurfegin,hin gamli varð mestsum ovfegin;eg var ovfegin til at fara á fjall
ovfermdur	við ov nógvum farmi, ov nógv fermdur,skipið er ovfermt
ovfiska	fiska meir enn stovnurin tolir
ovfisking	tað at fiska meir enn stovnurin tolir, ovveiða,fiskaloysi av ovfisking og veðurlagsbroytingum;fiskastovnarnir eru hóttir av ovfisking
ovfólkaður	við ov nógvum fólkiel.íbúgvum,landið er ovfólkað
ovframleiðsla	tað at framleiðsla er størri enn eftirspurningur,ovframleiðsla av olju fær prísin at lækka
ovfullur	1fyltur meir enn rúm er fyri, ovfyltur,báturin var ovfullur og sakk2deyðadrukkin, ovdrukkin,hann tømdi fleiri fløskur og legðist ovfullur
ovfylla	fylla meir enn rúmast,tveir bátar gingu burtur, teir høvdu ovfylt seg av fugli;ovfylla marknaðin við vørumlata vørur floyma yvir marknaðin
ovganga	s51í osb.ovganga segganga ov hart(og fáa innvortis mein av tí),hann er ein eldri maður og skilagóður, so hann ovgongur seg ikki
ovgiftur	ið fær ov nógv av e-m(og ikki fær løntel.víst virðing afturfyri),ikki gott at verða ovgiftur(fáa ov nógv í gávu);vit vóru mest sum ovgift av hesum dreingjunum, ið komu inn(fingu nóg mikið av teimum)
ovgjørt	l hí osb. sumikki var tað ovgjørtikki var ov nógv kravt,tað hevði ikki verið ovgjørt, um slíkt loyvi hevði verið givið
ovgonga	tað at ganga alt ov skjóttel.hart
ovgongd	gongd ið hevur overving við sær,bæði vóru tey pøst av ovgongd
ovgoyma	goyma ov leingi(t.d.so at spilla kemur í)
ovhita	hita meir enn gott er
ovhiting	tað at ovhita
ovkeypa	s2í osb.ovkeypa segkeypa ov dýrt
ovklyvjaður	undir ov tungari byrði, ovbyrjaður, tarnaður,kobbin er uppaftur meira ovklyvjaður av kroppinum enn menniskjan;børnini eru eisini ovklyvjað av grind
ovkóka	kóka ov nógv,eplini eru ovkókað
ovkyrktur	l5í osb. sumhann verður ovkyrktur av honumhann verður honum ein tungur kleppur (3)
ovlaða	laða (4) við ov nógvum farmi, ovfylla,teir høvdu ovlaðað seg, og báturin gekk burtur
ovlaðin	ov nógv laðin, ovfermdur,ovlaðin bátur
ovleiður	alt ov leiðiligur,gera e-m ovleittgera e-n leiddan og keddan
ovlýsa	lata fáa ov nógv ljós,ansið eftir ikki at ovlýsa filmin[da.overeksponere]
ovlærdur	ov mikið lærdur;sbr.ovbardur
ovmannaður	1við ov stórari manning,skipið var ikki ovmannað2ovfólkaður,roykstovan var ikki so ovmannað um náttina
ovmeta	meta ov mikiðel.høgt, gera av,ovmeta virðið í e-m;latið okkum ikki ovmeta týdning fundarins
ovmeting	tað at ovmeta
ovmetta	geva ov nógv at eta,tað nýtist ikki at ovmetta okkum av tí
ovmettur	alt ov mettur, steinmettur, steinstappaður
ovmikil	ov mikil,símikil
ovmøða	leggja ov nógv á (e-n), overva,árin ovmøddi røðaran
ovmøði	møði av overvan, maktarloysi, máttloysi,svímaður av ovmøði
ovna	(sj.)verma í bakarovni(sovorðið sum smittuvandi er av),bøkur og pappír úr húsinum hjá honum vórðu ovnað, eftir at hann var deyður av tuberklum
ovnastova	stova við ovni,sum í eini ovnastovuheitt og fjálgt inni;eis.(flutt m.)hetta er sum í eini ovnastovu(sagt um fjálgt bundnaturriklæði)
ovndyggur	ið tolir (nógvan) hita í ovni, eldfastur,ovndygt fat
ovnshurð	hurð á ovni
ovnsskuffa	skuffa í bakarovni(at bakael.steikja í),steikin stendur í ovnsskuffuni mitt á borðinum
ovnsverta	evni at sverta ovnar og komfýrar við
ovnur	1afturlatin eldstaður(til hitingar í húsumo.tíl.);sbr.komfýrur2hitaútbúnaður (við heitum vatni) sum er knýttur at miðstøðarhita, radiatorur3bakarovnur;sms. t.d.bræðingar-,kol-,olju-,rusk-,smelti-
ovnýtsla	tað at nýtael.brúka ov nógv, ótamd nýtsla, ovurnýtsla,ovnýtslan er fíggjað við lántøku og studningi;ovnýtsla av rúsdrekka er skaðilig fyri heilsuna
ovnørast	nørast ov nógv, fjølgast meir enn gott er,nátin kann fara at ovnørast, so at hann verður meira til skaða enn til gagns
ovrasin	ovrásin
ovrasni	tað at vera ovrasin
ovrásaður	ovrásin
ovrásin	ógvisligur, ódligur, busutur, óskoytin
ovrásni	tað at vera ovrásin, ovrasni
ovrendur	ið hevur so nógva ferð at hann fer framum ella útfyri har sum hann ætlaði at steðga,við tað at eg var ovrendur, kom eg móti eini song og datt endalangur í hana
ovrenna	s48:ovrenna segrenna ov hart
ovrokaður	við ov stórum roka, ovfyltur,nakað ovrokað borð var tað ikki
ovróður	ov harðurel.ov strangur róður
ovrógva	s33:ovrógva segrógva meirael.harðari enn ein orkar(og fáa mein av tí),hann hevði ovróð seg
ovsagt	l hí osb.tað er ikki ovsagttað er einki avgjørt at siga, tað er ikki ov mikið sagt
ovsiga	s70í osb.ovsiga seg1siga e-t ið betur var ósagt, gera ov nógv av í orð og tal,hon var ikki tann, sum ovsegði seg2vera mismæltur
ovsintur	(sj.)ovursintur
ovskipa	hava ov stóra skipan (4),ovskipa hagan
ovskipan	tað at hava ov stóra skipan (4) í haga, ov stór áseyðaskipan, ovurskipan,ovskipan veldur annaðhvørt hungur ella hagarán
ovsleip	overvan, sprongd(av kropsligum arbeiði),tað man bert vera ovsleip, ikki sjúka;avlagaður av gikt og ovsleipi
ovsleipaður	útslitin av hørðum arbeiði
ovslit	ovsleip
ovsova	s62í osb.ovsova seg1sova ov nógv2forsova seg, sova ov leingi
ovstaðin	ov mikið staðinel.búgvin,vínberini vóru ovstaðin og kroystust sundur í sekkinum;ovstaðið korn
ovsteikja	steikja ov nógv
ovsúpa	s40í osb.ovsúpa segsúpa ov nógv (av e-m);ovsúpa seg av góðari ertnasúpan
ovtaka	s60í osb.ovtaka segfáa mein av at lyfta tungt;(tilt.)letingi ovtekur seg
ovtala	talael.siga ov nógv;í osb.ovtala segkoma at siga ov nógv, orðleypa seg,sjálv hevði hon ikki ovtalað seg fyri nøkrum;e-m verður ovtalaðein kemur at siga ov nógv
ovtøvdur	ov nógv tøvdur,vaðmalið er so ovtøvt, at hetta er lykkjuskotið
ovur-	sera, ógvuliga, framúr,sms. t.d.-bágin,-bilsin,-bjartur,-djúpur,-feitur,-fínur,-góður,-heitur,-langur,-ljótur,-mettur,-ríkur,-smæðin,-sterkur,-svinnur,-tjúkkur,-tungur,-vakur,-vandin,-varin
ovuransur	sterk ávirkan ávís hending hevur á e-n[da.sensation]
ovurást	serligur kærleiki, inniligur tokki,sprottið úr ovurást
ovurbráður	(lækn.)óvanliga bráður,ovurbráð brunagerð[da.hyperakut]
ovurdirvi	ovurstórt dirvi
ovurdjarvur	ómetaliga djarvur, vágamikil,tveir ovurdjarvir smádreingir
ovurdrykkja	drykkjuskapur uttan hógv, ringur drykkjuskapur, ovdrykkja,mangt eitt heim er niðurbrotið av ovurdrykkju
ovurfegin	sera fegin, findarglaður, himmalfegin,ovurfegin uppi yvir e-m;hann er ovurfegin uppi yvir dálanum;ovurfegin um e-t
ovurfegni	tað at vera ovurfegin
ovurfeitur	óvanliga feitur, spikafeitur
ovurfisking	ovfisking, ovveiða,ovurfisking í føroyskum sjógvi orsakað av ov stórari veiðiorku
ovurfiti	óvanlig fiti
ovurgivin	býttisliga djarvur, ið við lítlum skili leggur nógv til
ovurglaður	í sera góðum hýri, findarfegin, himmalglaður,ovurglatt fuglalát
ovurgleði	tað at vera ovurglaður
ovurhonds	ógvuliga, øgiliga, ómetaliga, sera,ovurhonds stórur
ovurhugaður	yvirhugaður, sprækin, heitur (3),í ovurhugaðum stríði;ongantíð havi eg verið so ovurhugaður uppi í leikum
ovurhugaleysur	við ongum ovurhuga, líkasælur,ovurhugaleys kannan
ovurhugaloysi	tað at vera ovurhugaleysur
ovurhugi	1yvri, yvirhugi,gera e-t av ovurhuga(uttan fyrilit, í óðum verkum)2(ným.)ovurmikil kensla, brennandi áhugi[da.lidenskab]
ovurhýrur	(sálfr.,lækn.)óvanliga góður hýrur. órættvorðin kæti,við hvørt sinnistyngd, við hvørt ovurhýrur
ovurkast	(kvæð.)heiti á turriklæði,turriklæðið kallar hon ovurkast
ovurkátur	sera kátur, ovfarakátur
ovurkæti	tað at vera ovurkátur
ovurleiðari	(ravm.)evni sum leiðir ravmagnsstreym við ongari mótstøðu tá ið hitin fer niður um ávíst hitastig[en.superconductor]
ovurlond	(stb.)ovastu hús í eini bygd,niðan í ovurlondini;hann býr í ovurlondunum
ovurlættur	1íðin, hugagóður, ágrýtin,(tilt.)hin lati ber seg í hel, hin ovurlætti gongur seg í hel2sera lættur
ovurmaður	(kvæð.)yvirmaður (2),hvar vitið tær mín ovurmann?
ovurmaki	(kvæð.)ovurmaður
ovurmenni	maður ið skarar framúr, yvirmenni, frágerðarmaður
ovurmikil	ómetaliga stórur, ómetaligur, ovurstórur, øgiligur
ovurmorgin	kí osb.í ovurmorgindagin eftir morgindagin, um tveir dagar
ovurmóð	(bíbl.)hugmóð
ovurnógvur	í sera stórum tali, ovurhonds nógvur,tað hevur ovurnógv at týða(ómetaliga nógv)
ovurnýtsla	ovnýtsla,her er einki til ovurnýtslu
ovurnøgd	ómetaliga stór nøgd, ørgrynni, yvirnøgd,hann var ikki vanur við slíka ovurnøgd á borði
ovurprísur	ósámiligur prísur, okurprísur,teir seldu brennivín í loynisølu fyri ovurprís
ovurraskur	meira enn vanliga raskur, sera raskur,teir vóru allir tríggir ovurraskir menn
ovurrenta	ósámilig renta, okurrenta
ovurríkur	ógvuliga ríkur, steinríkur, fullríkur,hann kom til eina ovurríka konu at vera
ovursinni	tað at vera ovursintur, øði, reiði 1, hernaður (3),ganga kykur í ovursinni
ovursintur	frá sær sjálvum, spinnandi óður, í øðini, sansaleysur
ovurskipan	ovskipan
ovursterkur	ógvuliga sterkur, krútsterkur,dagurin stendur og glógvar sum ein ovursterk blá glæma(ógvuliga bjørt)
ovurstórur	ómetaliga stórur, ónatúrliga stórur, veldigur,ovurstórur salur;ovurstór tøl;Sahara er ein ovurstór sandoyða
ovurtal	ótal, ørgrynni,í ovurtalií sera stórum tali, í margatali
ovurundra	háundra, hávirða, hámeta,eg ovurundri teir og lofti við gleði hvørjum orði, teir siga
ovurundran	tað at ovurundra, hámeting, hávirðing, undranarhávirðing
ovurvaksin	ómetaliga stórur, risavaksin,ein ovurvaksin, dimmur kópur
ovurvakur	sera vakur, sjáldsama vakur, undurvakur,um varrarnar liggur eitt so ovurvakurt bros
ovurveður	ódnarveður, himmalódn,ikki ráðiligt at halda til sjós í hesum ovurveðrinum;hesir veiku lívsneistarnir stirðna í ovurveðrinum
ovurviðkvæmi	(lækn.)tað at vera ovurviðkvæmur
ovurviðkvæmur	(lækn.)ið ikki tolir ávís (føðslu)evniel.at koma í samband við ávís evni(allergia)
ovurvirkin	(sálfr.)ið er virknari enn vanligtel.gott er, óstýriligur[da.hyperaktiv]
ovvaksin	vaksin ov skjóttel.knappliga, avskapaður(t.d. um epli ið eru opin innan)
ovvágin	ið vágar (alt) ov nógv, ov vágamikil(Sv)
ovveiða	tað at veiða ov nógv, ránveiða, ovfisking
ovvekraður	ið hevur vakt ov leingi, útlúgvaður av ov lítlum svøvni, vekraður, yvirvekraður
ovvekur	tað at vera ovvekraður
ovvit	1serstakt vit og skil, serliga góðar gávur,einki ovvit krevst til at gera tað2ein ið er serliga vitugur, flogvit,hann er einki ovvit, men býttur er hann heldur ikki
oy1	tvíljóðsstavir (nevndir[ɔi])
oy2	(kvæð.,stn.)oyggj;sms. t.d.Borð-,Eystur-,Fugl-,Kals-,Kun-,Nóls-,Sand-,Skúv-,Streym-,Suður-,Svín-,Við-
oy3	mðlv(til at vísa bilsni, gleði, samkenslu, pínu, sorgo.s.fr.),oy, oy, hann var um at gráta;oy, eg veit fullvæl, at mín neyðar trani er ein meinbogi
oyða1	1oyðið øki, oyðin staður,teir hildu lív í tveimum kúm og hestum í hesari oyðuni;teir drógu upp og løgdu aftur, men sama oyðan(fiskaloysi)2oyðið pláss í bergi(har fuglurin er oyddurel.rikin burtur),pláss í bergi við ongum búfugli(men oyðifugli um náttina)3leið uttan fyri mið har einki ýti er at halda seg til,stórur fiskur, sum er veiddur úti í oyðuni4oyðimørk;sms. t.d.eyr-,sand-,stein-
oyða2	1leggja í oyði, oyðileggja, beina fyri, týna,oyða rottuna í oynni2spilla burtur, søpla burtur,oyða arv;oyða burtur;oyða tíðina burtur(spilla);oyða pening(blaka burtur);oyða upp;oyða útavoyða, ørdrepa;sms. t.d.al-,av-
oyðari	1oyðsl (2), oyðiland, amari,aftan á ein samlara skal ein oyðari komaamari kemur aftan á sparara2(herm.)skjótsiglandi krígsskip(ið skal oyða før hjá fígginda)
oyðdráp	tað at oyðdrepa
oyðdrepa	beina fyri, oyða 2(1), týna, ørdrepa,verður lomvigin oyðdripin, so byggir fuglur aldrin aftur har
oyðeta	(um dýr)eta upp, súlunda,oyðeta grasið av jørðini
oyði	tað at vera oyðin,leggja í oyðioyðileggja;staðurin verður lagdur í oyði;tað var tað turra oyði(fiskaoyði, fiskaloysi);sms. t.d.fiska-,fiski-
oyðiberg	berg har ið eingin fuglur eigur,av omanlopi er har nú oyðiberg
oyðibygd	bygd ið fólkið er flutt burtur úr, fólkaoyðin bygd
oyðidrepa	oyðdrepa,bara fá pláss í bjørgunum, sum eru oyðidripin
oyðifuglur	bjargafuglur ið ikki verpur, geldfuglur, fleygafuglur,aftan á ræningina kemur oyðifuglurin í bergið
oyðigarður	útl. garður oyðin við fólk, fólkatómur garður,oyðigarðarnir vóru nógvir í tali beint eftir svartadeyða
oyðijørð	jørð ið liggur oyðin og óvelt, óbygt lendi, oyðilendi,tað var loyvt monnum at taka upp oyðijørð
oyðiland	1oyðið og óbygt land, oyðistaður,tí fór eg í oyðilond2(um fólk)ein ið er argur at søpla burtur(t.d. pening, lutiro.tíl.),oyðsl (2), amari,eitt oyðiland
oyðilandsvætti	oyðiland (2),hatta eru tey oyðilandsvætti, ið eru
oyðilegging	tað at oyðileggja, oyðing, týning, herverk,kríggið hevði ómetaligar líðingar og oyðileggingar við sær
oyðileggja	leggja í oyði, gera til einkis, oyða 2, spilla, týna
oyðilendi	ódyrkað lendi, oyðið landslag,velta oyðilendi(ið ikki er velt áður)
oyðimási	(fugl.)mási ið ikki byggir (4)
oyðimold	mold ið ongantíð er velt
oyðimørk	óbygt og oyðið lendi, bert landslag(við lítlumel.ongum gróðri),oyða 1(4);sms. t.d.sand-
oyðin	við ongum, óbygdur, berur, tómur,jørðin var oyðin og tóm;bergið er oyðið við fugl;húsið er oyðið(mannleyst);sms. t.d.fólka-,fugla-,guds-,hálv-,mann-
oyðing	tað at oyða 2, oyðilegging, týning, sorl, herverk,oyðing Jerúsalems;vit frætta um orrusturnar og oyðingarnar;sms. t.d.rottu-
oyðingarhugur	hugur at oyðileggja, týningarhugur,hann var fullur av oyðingarhugi
oyðingarverk	oyðilegging, herverk,stormurin framdi sítt oyðingarverk við sama lag
oyðini	(skaldsk.)oyðin,í oyðini høll(oydnari)
oyðioyggj	óbygd oyggj,teir, sum søkja drangar og oyðioyggjar, fara til báts
oyðipallur	pallur oyðin við fugl, oyðirók,allar oyðipallar tekur fleygafuglurin undir seg
oyðipláss	pláss (5) har ið eingin býr, oyðin staður,hann skuldi fáa oyðiplássið at liva og blóma
oyðirók	óbygd rók í fuglabergi, rók oyðin við fugl
oyðisandur	sandoyðimørk
oyðiskógur	oyðin skógur, óbygt skógarlendi,so langt eygað rakk, sást ikki annað enn oyðiskógur;(kvæð.)burt á oyðiskóg
oyðiskrápur	(stb.)1geldskrápur2geldkokkur
oyðistaður	(bíbl.)oyðin staður, oyðipláss,hann fór burtur á ein oyðistað og helt bøn har
oyðistrond	oyðin og óbygd strond,leggja at á onkrari oyðistrond
oyðisúla	(fugl.)súla til hon er fýra ára gomul
oyðræna	ræna so at oyðið verður í fuglabergi, blóðræna (2)
oyðsl	1tað at oyðsla, oyðslan2ein ið oyðslar, oyðiland (2), amari,eitt oyðsl
oyðsla1	(um konufólk)oyðsl (2),hon er eingin oyðsla
oyðsla2	nýta óneyðuga nógv av e-m, spillael.søpla burtur
oyðslan	tað at oyðsla, oyðsl (1)
oyðslari	ein ið er ringur at oyðsla, oyðari (1), skrutt 1,tað oyðslarans lív, á hesum skipi varð ført
oyðslusamur	oyðslutur
oyðslusemi	tað at vera oyðslusamur, oyðsl (1),oyðslusemi við lít
oyðslutur	ið oyðslar illa, oyðslusamur, amutur
oyðublað	blað at fylla útel.seta inn í upplýsingar av ymsum slag, útfyllingarblað, umsóknarblað,ognaruppgerðin er eitt oyðublað
oyðuleið	fiskileið uttan fyri ytstu havmið(so langt til havs at ýti ikki tekst á landi),teir róðu út á ytstu havmið ella oyðuleiðir;sbr.oyða 1(3)
oyður	(gl.,sj.)oyðin, eyður,lat teirra bústað verða oyðan
oygdur	sms. t.d.bjart-,blá-,blíð-,brún-,dimm-,djarv-,djúp-,ein-,fjar-,gjøll-,góð-,grá-,hvass-,kát-,kyk-,mor-,opin-,rang-,rædd-,stór-,tóm-,tætt-,út-
oyggj	1land við sjógvi í allar ættir(størri enn hólmur og sker),á oynniovast áel.uppi á oynni;hann á oynna til Havnar(eftir fjøllum);vit mugu á oynna við tær til doktaran;tvær bygdir eru í oynni;vera burtur í oyggj(í aðrari oyggj, av oynni);løgið at hann skuldi av oyggj at fáa sær konu;oyggjanna millum;undir oynni(á sjónum í báti)undir bjørgum,tað er brim undir oynni;teir róðu runt um oynna2fólkið í eini oyggj,øll oyggin kom, alt, sum ragga kundi3(flutt m.,niðr.)stórt og menniligt konufólk, snekkja,hon var tjúkk sum ein oyggj4(ným.)mark millum tvær koyribreytir við ferðslu báðumegin við;sbr.vegøksl;sms. t.d.flot-,gos-,granna-,hálv-,oyði-,út-
oyggjabúgvi	ein ið býr í oyggjasamfelag,hjá einum oyggjabúgva er altíð áhugavert at koma til onnur oyggjasamfeløg
oyggjaflokkur	flokkur av oyggjum,ein lítil oyggjaflokkur
oyggjafólk	fólk ið býr í oyggjumel.oyggjalandi
oyggjagleiv	(skemt.,speis.)ein ið ferðast nógv um landið, landastrok
oyggjahav	(landafr.)hav við mongum smáoyggjum[da.arkipelag]
oyggjaland	land av oyggjum,Føroyar eru oyggjaland
oyggjaleikir	ítróttastevna fyri oyggjatjóðir[en.Island Games]
oyggjarbátur	(Hvlb.)bátur sum brúktur varð at fara til Lítlu Dímunar við(Oyggin er Lítla Dímun)
oyggjarbrúdleyp	brúdleyp sum øll oyggin (2) er boðin í;sbr.sóknarbrúdleyp
oyggjarendi	endi á oyggj,sjóvarilskan við oyggjarendarnar gjørdist ov stór fyri opnar bátar;eingi líkindi at fara út um oyggjarendarnar í dag
oyggjaríki	ríki av oyggjum
oyggjarkyrra	(stb.)kyrra so at farandi er í oyggj
oyggjarmaður	maður íel.úr somu oyggj(sum ein sjálvur),vit eru oyggjarmenn;sbr.bygdarmaður (2)
oyggjarnavn	navn á oyggj
oyggjarskeggi	ein sum býr í oyggj, oyggjarbúgvi
oyggjarviður	(stb.)bóndaviður, bóndatræ
oyggjasamfelag	oyggjaland
oyggjaveðurlag	(landafr.)veðurlag í oyggjalondum, havveðurlag
oygla	hyggja við grommumel.brellutum eygum (at e-m),oygla eitt burtur frá e-mstara at e-m við øvundareygum
Oyndarfjørður	(stn.)bygd í Eysturoynni,í/úr Oyndarfirði,til Oyndarfjarðar
oyndfirðingur	fólk íel.úr Oyndarfirði
oyra1	oyri 1
oyra2	1yrkisgagn at hoyra við(hjá fólki og dýrum),góð oyru;ring oyru;stór oyru;lánael.læna e-m oyralurta eftir e-m;lurta við hálvum oyralurta hálvavegna;hava oyra við (e-m)lurta eftir (e-m);hav eitt oyra við teimum, meðan teir spæla í kjallaranum;har sum einki er fyri oyrað annað enn spógvalát(hoyrist);leggja e-t fyri oyruni á e-mlata e-n hoyra e-t;berast e-m fyri oyruhoyra, frætta;hann er í skuld upp um bæði oyru;halda í oyruni á e-mansa væl eftir at ein ber seg rætt at;liggja í oyrunum (á e-m)staðiliga og støðugt minna á,hon lá í oyrunum á honum, at hann mátti vera ein góður og lýðin smádrongur;(tilt.)tað svíður ikki at hjartanum, ið oyrað ikki hoyrir;munnurin aftur at oyrunum(um ein, ið skræðir seg);(orðt.)tunn eru móður oyrumóðir hoyrir væl hvat (barni) bagir,lava við oyrunumel.lava oyruni (niður)vera hámur, illa við;flóna um oyruniverða illa við;geva e-m ein undir oyrað(ein undir vangan);lýttael.lýða e-m (e-t) í oyraðsiga ljódliga so at onnur ikki hoyra;stinga e-m e-t í oyrasiga e-m e-t í loyndum2førleiki at hoyra, tað at hoyra, hoyrn,hava oyra fyri tónleiki;tað var komið fyri oyruni á teimumtey høvdu frætt, hoyrt graml um;fyri alla manna oyrummeðan øll hoyra3honk, hald (9) á síðuni á ílati(t.d. dylluel.krukku)4horn á nót,á nót eru grunnur, flotlína, kálvi, kjálki og oyra;sms. t.d.bekkjar-,bitar-,bjálka-,garnmørs-,manna-,mál-,ólis-,seingjar-,skølings-,stál-,stein-,syllar-,válgars-
oyra3	11/100 av krónu2(lítil) pengi, myntur,har kom ein fátæk einkja og legði tveir smápeningar, sum er eitt oyra;upp á oyraðheilt neyvt,eg kann ikki siga tær upp á oyrað, hvussu nógv tú skyldar;sms. t.d.eitt-,fimm-,gjald-,kopar-,tíggju-,tvey-
oyrabolli	bolli 2(1) ið kostaði eitt oyra,eitt fat við oyrabollum
oyrabrósk	(lívfr.)brósk í oyralepa
oyrafika	1tað at takael.royta í oyra (á e-m), ein undir vangan, lúsingur2(skip.)stertur á viðferðini aftan á (breið)fokku,hann loysti kvikliga oyrafikuna
oyrahol	(lívfr.)op inn í oyra, oyrnahol
oyraklaffur	klaffur fyri oyra(at verja fyri óljóði, kuldao.tíl.)
oyralepi	oyrnalepi
oyralippa	niðasti (bleyti) partur á oyralepanum
oyralust	1op inn í oyra, gong inn at ljóðhinnu, lust2tað feita um oyrað(á seyðarhøvdi)3rótel.tað niðasta av avskornum oyra(Sv)
Oyrarbakki	(stn.)bygd í Eysturoynni,á/av Oyrarbakka,til Oyrarbakka
oyrarmaður	1maður áel.av Oyri2(stb.)norðoyrarmaður3(stb.)norðdepilsmaður
Oyrarsund	1sund millum Sælands og Skáni2(ným.)føroyskt navn á studentagarði á Amager,tey búgva á Oyrarsundi[da.Øresundskollegiet]
oyraskógvur	(sj.,gl.)spenniskógvur,hann var í fastkneptum koti og oyraskóm
oyrasnippur	oyralippa
oyrastong	stong ið heldur oyrunum á (seiða)nót sundur, oyrnastong, oyratræ(stendur upp og niður í sjónum)
oyratog	tog á oyranum á seiðanót
oyratræ	oyrastong
oyratøppur	lurtitól at hava í oyranum(t.d. hjá sjónvarpsfólki)
oyravaks	brúnligt vakskent flot úr kertlum í oyralust, oyrnavaks
oyrhúgva	(stb.)húgva ið gongur niður um oyruni
Oyri	bygd í Eysturoynni,á/av Oyri,til Oyrar
oyri1	slættiel.tangi (av eyriel.sandi) fram við strondiniel.út í sjógv, oyra 1(serst. við áarósa);sms. t.d.sand-,vatn-
oyri2	(søg.)peningur (1/8 mørk)
oyring	endi á bjálka groyptur niður í syll,oyringarnar vóru slitnar av bjálkunum í dansistovuni
-oyringur	sístand-
oyrlittur	(seyðal.)oyrnalittur
oyrnabruni	(lækn.)bruni í oyraserst.miðoyra
oyrnadropar	(lækn.)flótandi heilivágur til at dryppa í oyruni(otoguttae)
oyrnagull	(bíbl.)oyrnaringur, oyrnaprýði
oyrnahol	(lívfr.)oyrahol
oyrnahúgva	(stb.)húgva við oyraklaffum, oyrhúgva
oyrnalepi	(lívfr.)oyrað uttan, oyralepi
oyrnaleysur	1við ongum oyrum,Óli oyrnaleysi2ið ikki hoyrir, deyvur,ljóðið í honum vekur undran hjá øllum, sum eru ikki oyrnaleys
oyrnalippa	oyralippa
oyrnalittur	(seyðal.)við liti um oyruni(t.d. um hvítan seyð)
oyrnalokkur	prýði í oyranum;sbr.oyrnaringur
oyrnalust	(lívfr.)1op inn í oyra, oyralust (1),kópur fær latið aftur bæði oyrnalustir og nasagluggar, tá ið hann kavar2oyralust (2),tað besta á seyðarhøvdinum er oyrnalustin og eygað
oyrnalækni	(lækn.)serlækni í oyrnasjúkum
oyrnamørur	mørur (1) um oyrað,á seyðarhøvdi eru eygnamørur og oyrnamørur
oyrnaringur	lítil gyltur ringur 1(1) í oyra(til prýðis);sbr.oyrnalokkur
oyrnarust	(á neyti)stykkið uttan um oyrað(frá geilatíkunum og aftureftir)
oyrnasjúka	(lækn.)sjúka í oyrunum
oyrnastavur	stavur í keraldi sum oyra er í
oyrnastingir	(lækn.)verkur í oyrael.oyrum
oyrnastong	oyrastong
oyrnastykki	oyrnarust
oyrnatræ	oyratræ, oyrastong
oyrnavaks	(lækn.)oyravaks
oyrnavágur	(lækn.)vágur 2(1) úr oyranum
oyrnavernd	(lækn.)hoyrnarvernd
-oyrt	símis-
oys	(at vísa harm, undran, gleðio.tíl.)ádú, nei álvara, dekan fari,oys, hvat er hent?;oys tit eru fittsum tit eru fitt!
oysa1	ílat(ymist til støddar)við skafti at oysa við, oysari
oysa2	1taka e-t flótandi úr e-m við oysuel.eyskari, tøma,oysa bát(in);oysa bát uppoysa bát sum er fyltur við sjógv(so at hann flýtur væl aftur);oysa uppúrtaka súpimat upp úr potti;sbr.leggja uppúr;teir tóku at oysa, men einki batti – báturin sakk2floyma, fossa, streyma,regnið oysti niður(díkti);oysa (ein) undirdíkja (ein) undir (í vatni, skarnio.tíl.);oysa (e-n) undir í ókvæmisorðum;menninir róðu, og sjógvurin oysti enn frekari inn á teir;oysandi regn;regnið østi áirnar upp, so tær komu bóltandi og oysandi oman úr fjøllunum;hann kom oysandi inn(garterandi)3oysa útsøpla burtur;oysa út pengar4(um ross)sláa afturúr (sær), renna gumpin upp úr sær,rossið oysti;ryssan hevur ikki nógva mjólk og oysir fylið frá sær5deila, skelda,hon fór at oysa um skarnsungarnar;sms. t.d.turr-
oysari	oysa 1
oysing	1tað at oysa,helst hava gingið fleiri tímar við hesari pumping og oysing2(lækn.,stb.,sj.)oysingarkensla av nógvum hita ið breiðir seg í kroppinum(ofta við sveitta),konan gramdi seg fyri læknanum um, at hon hevði sovorðnar oysingar[da.hedeture]
oysregn	(sera) nógv regn, sturtningur, grimdarregn, glopraregn, áarføri (2),í oysregni og stormi
oysregna	regna (sera) illa, stoyta niður
ozon	(alisfr.,evnafr.)litleyst eitrað loftevni(avleiðing av at súrevni og ljósgeislar frá sólini møtast)(teknO₃)
ozonlag	(alisfr.,evnafr.)lag av ozon í lofthavinum kring jørðina(ið virkar sum ein skjøldur móti ultraviolettum strálingum)
o.ø.	stytting fyriog øðrum
