y	1(málfr.)sjálvljóðsstavur (nevndurseinnael.sj.langa[i:])2[y:]1(støddfr.)heiti á ókendari stødd(t.d. á seinna ókenda í líkning)2tekin fyri virði á seinna liði (í krossskipan)3(stundum í tøkuorðum)
y-ás	(støddfr.)uppás
ydda	(handv.,Mikld.)gera odd á(serst. seym el. nagla),tá ið seymur varð smíðaður, var at ydda hann til seinast;bara rekseymur var yddaður;ydda knív(gera spískari)
yðja	vera til í nøgd,yðja avel.í (e-m)vera nógv til av,býurin yður av fólki;har yður í fólki;yðjandi lívlívligt virki;yðjandi fult av (e-m)murrandi fult av;tá vaskaðu fólk sær sjáldan og uddi tí í øllum livandi(lúsum);sbr.ýðja
yðjan	tað at yðja, ørgrynni
yksna-	(sj.,stn.)øksna-,Yksnagjógv
ylast	(sj.,stb.)orna,nú ylast hjá tær;sbr.ylna
ylblot	ylbloti
ylbloti	(stb.)væta av yli
ylheitur	1sum heldur leingi hita,hesar gløðurnar eru so ylheitar2sera heitur, glóðheitur, gløðandi,eg kendi blóðið ylheitt brenna mær í barmi;hann helt eina ylheita verjurøðu
ylja	(sj.)geva yl frá sær, fløva, verma
ylliniviður	(plfr.)stórvaksin runnur í slektiniSambucus, hyllitræ
ylmikil	(stb.)heitur í sær sjálvum, ið tolir væl kulda,smábørn eru so ylmikil
ylna	hitna, flóna, orna,nú er farið at ylnael.nú er ylnað inni(t.d. av hita frá ovni);ylna um oyrunigerast illa við, orna um skallan;hann ylnaði við(hitnaði um hjartað);(flutt m.)so ylnandi heit var hjartakenslan
ylsvarmi	(stb.)varmi av yli
ylur	1mildur hiti (sum heldur sær leingi), innigoymdur hiti,ylur er í hoynum;hoyggið tók ylylur kom í hoyggið;hamsalopið er korn, sum sáðurnar detta uttan av av roti og yli2kvalin, klumrutur hiti,ylur í luftini3í osb. sumylur rann at honumhann varð illa við, ræddist;tað dró ylur at honumhann ilskaðist4flógv góðkensla,ein ylur av gleði streymaði ígjøgnum hana;tað fer ylur gjøgnum ein at síggja konufólkaandlit aftur;(skaldsk.)ein ylur í barmi mær brann;sms. t.d.hjarta-,krops-,sátu-
ymis	ymissur
ymiseksingur	k6(plfr.)ymiseksingarbólkur av stør við kallblómum og kvennblómum hvørjum á sínum aksi(heterostachyae)
ymisháttaður	háttaður ymisliga,jørðin er ymisháttað innan
ymiska	mótgangur, mótgongd,hann hevur havt (liðiðel.tolað) manga ymisku;hann hevur so mangar ymiskurnar havt
ymiskur	1sum ikki er einsháttaður, skiftandi, ólíkur, ymissur,ymiskar útreiðslur;ymiskt innihald;hon hevur havt ymiskar dagarnar(ikki bara havt góðar dagar);nú kundi tað koma at verða so ymiskt við tí;(kvæð.)hvør sum siglir í Vesturhavi, ymiskum man hann møta2(gl.)ivasamur,tað er ógvuliga ymiskt(sera ivasamt);teir verða ymiskir at fáa(ivasamt um teir fáast);ymiskt var, hvør leikurin fór(hvussu);hava ymiskar tankarhava illgruna
ymisleiki	tað at vera ymiskurel.ymissur
ymisliga	á ymsan hátt, skiftandi,orðið er ymisliga stavað;ymisliga staddurymsastaðni, her og har,teir eru ymisliga staddir í skorini
ymisligur	ymist háttaður, ymiskur,ymisligt góðgæti;(skaldsk.)ymislig er eydnan(skiftandi)
ymislitaður	ymislittur,tú hoyrir nógv tungumál og sært ymislitað fólk
ymislittur	við ymsum liti, ymislitaður
ymissur	1ymiskur (1),á ymsan hátt;ymsar leiðir;av/úr ymsum ættum;streingir, ið hava ymiss ljóð2aðruhvørju ferð, til skiftis,hann vindur haftið um ymsar hendur(um báðar hendur til skiftis);hann kysti hana á ymsar kjálkar;tríggir brøður skiftust um, ymsir at fara til útróðrar og ymsir at vera heima;(kvæð.)Sigmundur gongur í ymsi borð;(kvæð.)hann ymsar litir fekk(rodnaði og bliknaði til skiftis);(kvæð.)hann snúðist til ymsa handa(til báðar síður til skiftis);ymsir undir og ymsir ábáðir undir og á til skiftis(í bardaga)
ymisvorðin	ymisháttaður
ymja	súsa, brúsa, dynja,(kvæð.)munnur og nasar umdu í blóði(blóðið fossaði)
ymsastaðna	(stb.)ymsastaðni,bátar komu ymsastaðna frá
ymsastaðni	á ymiskum støðum, her og har,børnini spæla ymsastaðni
ymsumegin	nú hesumegin nú hinumegin, báðumegin til skiftis,ymsumegin vegin
ynda	1kína,hon bispaði einum barni, yndaði tað og tosaði við tað2hava yndi til, vera góður við,hon yndar hann so;hann hevði ongantíð yndað dóttur sína nógv;yndastelskast, unnast
yndi	1kærleiki, alskur, góðska 1(2), tokki,fáa yndi til (e-n)gerast góður við, leggja ástir við;hann fekk sterkt yndi til hennara;(kvæð.)ei fært tú nakað yndi av mær;(kvæð.)elur teir upp við yndi2yndisleiki, vænleiki,kvinnuligt yndi
yndigur	yndisligur,hoyr tað, yndiga ríka frú
yndiligur	(kvæð.)yndisligur, dárandi,mítt yndiliga sprund
yndis-	ið e-m best líkar, onka-,sms. t.d.-blóma,-borg,-brá,-bros,-fljóð,-navn,-sangur,-sjónd
yndisbarn	ein ið ein hevur serstakt yndi til, eygnasteinur (3)
yndisbrúður	(kvæð.)yndislig kvinna,tú yndisbrúður ver nú kát
yndisdjór	djór ið ein hevur yndi til,hesturin var yndisdjór teirra
yndisdýr	heimadýr havt til hugnael.stuttleika
yndisfagur	(skaldsk.)sera fagur, yndisligur
yndisfullur	yndisligur
yndislag	1e-t við fólki ið ger tað dámligt, tokkalæti[da.charme]2(tóna)lag ið e-m dámar best
yndisleiki	tað at vera yndisligur, vænleiki, yndi (2),várið við sínum fríska yndisleika
yndisligur	vakur og tølandi,summarsins yndisliga blídni;har er yndisligt bæði á sumri og á vetri;hj-liga
yndisnæmingur	næmingur sum lærari hevur serligan tokka til(og velur fram um aðrar)
yndisorð	1orð við yndi, alskmikið orð,tey teskaðu yndisorð2orðel.máliska ið e-m dámar væl at hava á munni
yndistokki	yndi (2), yndisleiki, vænleiki
yndisvænur	yndisligur og vænur
yndugur	yndigur,her er yndugt sum í himmiríki
yngd	ungur aldur, ungdómur,móts.elli
yngdur	1vorðin sum ungur aftur;síyngja2ungaður,eggini eru (nógv) yngd;19. juni vóru vit eftir eggjum fyrstu ferð, og vóru tey einki yngd;sms. t.d.upp(aftur)yngdur
ynging	1tað at yngjast2tað at seta kríatúr við(serst. neyt)
yngja	1gera ungan (aftur), nýggja uppaftur,maðurin er yngdur uppaftur;tað knípir við at fáa yngt fólkahjálpina á garðinum;teir eru farnir at yngja tað uppaftur at halda veitslu súludagin;teir yngja uppaftur klandrið millum flokkarnar;(tilt.)yngjast sum ørnin,síørn;yngjast upp(aftur)gerast ungur aftur2seta (kríatúr) við og føða upp, ala,tað gamla var fýra neyt og so eitt at yngja;røktingarmaðurin hevur loyvi at hava eina gimbri út yvir tær fimm at yngja3eggið er nógv yngtstórur ungi er í egginum
yngla	fáa avkom
yngri	avungur
yngstur	avungur
yngul	avkom hjá ávísum djórum og fiskum(serst. hjá smádýrum við ótaldum avkomi)
yngulkanning	(fisk.)kanning við fínmeskaðum flottroli ið hevur til endamáls at meta um hvussu nógv er undankomið í gýtingini ávíst ár
-ynna	síav-
ynna1	ynda (2), elska,(orðt.)tá ið tvey ynnast, tey væl finnastel.tey, ið ynnast, tey finnasttvey ið eru góð finna altíð okkurt høvi at hittast
ynna2	1(stb.)unna,tey ynna sær ikki at liva;ikki ynna tað svarta undan naglinum2(kvæð.)ynnastkenna seg væl, unna (3),aldri skalt tú ynnast
ynniligur	(kvæð.)verdur at ynna, elskuligur, yndisligur,tað ynniliga sprund
ynnisligur	(skaldsk.)ynniligur
ynski	vilji, hugurel.tráan eftir e-m, longsil eftir at fáa e-t,hon bar fram ynski sítt;hægsta ynski hennara var at sleppa út at ferðast;nú er mítt innasta ynski útint;ynski um góða eydnu;sms. t.d.eydnu-,góð-,lukku-
ynskisdreymur	dreymkent ynski (uttan støði í veruleikanum), dreymur (2), skýborg,droyma ynskisdreymar
ynskisháttur	(málfr.)hugsháttur (2)(optativus)
ynskisseðil	seðil við ynskjum
ynskissetningur	(málfr.)setningur við umsøgn í ynskisháttiel.hugshátti
ynskja	hava ynski, leingjastel.tráa (eftir e-m), biðja (2),ynskja særel.e-m e-t:eg ynski mær nógvar gávur til jóla;lurtarar kunnu ringja inn og ynskja sær eitt lag;einar gleðiligar páskir ynski eg tygum;ynskja (e-m) gleðilig jól;eg hevði ynskt, at hann kundi skikkað sær betur;ynskja eftir e-mynskja sær e-t,tú slapst í brúdleyp, sum tú ynskti eftir;tað er ikki eftirynskjandi;ynskja e-t (oman) yvir e-n:konan ynskti ilt yvir hann(bað ilt);hon hevði ongantíð ynskt nakað ringt oman yvir tey
ynskur	(stb.)ynski,hvør ynskur skal ganga út;hann kundi ynskja sær ein ynsk
ynta	(stb.)øna, ønta,hann ynti ikki aftur
yppa	1hevja upp(frá),yppa økslel.akslirhveppa akslarnar(at vísa iva);(í skjaldri)inn kemur gula toppa, yppir hon sínum veli;yppa kálvstinga kálv og heingja hann upp við skinninum á2kippa,yppa fugl;hann(t.e. hanin)ber ikki høvdið, so má hann yppa hann3yppa segel.sær (upp)fetta sær á, spíla seg út, gera seg upp,hann ypti seg upp, og andlitið blíðkaðist í einum hálvum brosi;hann stóð eisini har og ypti sær4virka til, valda 2(1),yppa klandur;ypp ikki!fá ikki klandur í!;teir gjørdu honum ónáðir, men hann yppaði altíð upp undir tað sjálvur;yppasttaka seg upp,(kvæð.)yppist nú ráð av illari dáð
yppingartak	tak um hálsel.kvørkrar (til at yppa (2)),hann fær hendur á hanan og tekur yppingartøk á hann
-yrði	síhittin-,mein-,ný(ggj)-,sár-,van-
yrkadagur	gerandisdagur, arbeiðsdagur,ganga í pussinum yrkadagar;sbr.halgidagur
yrkakvøld	gerandiskvøld,at hann hvørt yrkakvøld sat við bókini, tað dámdi honum lítið
yrki	1arbeiði, starv,konufólkið fór til sítt dagliga yrki bæði inni og úti;skeinkjararnir røkja yrki sítt alla tíðina2virki, starv,bankayrki3(sj.)yrking,tað er eitt so vakurt yrki;sms. t.d.banka-,garð-,heima-,hvønndags-,høvuðs-,lívs-,urtagarðs-
yrking	1tekstur í bundnum máli2tað at yrkja;sbr.kvæði;sms. t.d.afturat-,eftir-,endur-,høvis-,kvæða-,tátta-,tilburðar-,um-
yrkingabók	bókel.savn við yrkingum, yrkingasavn
yrkingarførur	førur fyri at yrkja, sum hevur yrkingargávur
yrkingargávur	gávur at yrkja, skaldagávur,sígáva (2)
yrkingarháttur	(bókm.)háttur at yrkja
yrkingarlag	(bókm.)yrkingarháttur,yrkingarlagið er einfalt, stundum eitt sindur turt;flestu yrkjarar eru ikki eintáttaðir í yrkingarlagi
yrkingarlist	(bókm.)yrking sum listagrein, skaldskaparlist
yrkingasavn	yrkingar savnaðar í bók, yrkingabók
yrkis-	yrkisligur,sms. t.d.-fótbóltur,-hermaður,-ítróttamaður
yrkisbókmentir	(bókm.)bókmentir um yrki, yrkisligar bókmentir;sbr.fagurbókmentir
yrkisbróðir	starvsbróðir, starvsfelagi (ið er maður)
yrkisevni	1(gl.)serst.fltamboð, reiðskapur2(bókm.)evni at yrkja um
yrkisfelag	felag fyri løntakarar í sama yrki(røkir yrkisligu og fíggjarligu viðurskifti teirra)
yrkisfelagi	starvsfelagi
yrkisgagn	(lívfr.)1partur av manna-el.djórakroppi ið hevur ávíst (lívsneyðugt) yrki(t.d. hjarta, livur og lungu),lívgagn, gagn (2)2partur av plantu ið hevur ávíst yrki[da.organ]
yrkisgrein	greinel.slag av yrki, vinnugrein,ungdómur lærdur í øllum yrkisgreinum
yrkisítrótt	(ítr.)yrkisítróttur
yrkisítróttur	(ítr.)ítróttur sum yrki, yrkisítrótt
yrkiskunnleiki	kunnleiki um ávíst yrki
yrkislag	háttalag, starvslag
yrkisleið	framiel.framgongd í yrkiel.starvi, virkisleið, starvsbreyt[da.karriere]
yrkisleikari	1ein ið hevur sjónleik sum yrki2(ítr.)ein ið hevur ítrótt sum yrki,nógvir smádreingir droyma um at gerast yrkisleikarar í útlendskum fótbóltsfeløgum
yrkisleysur	við ongum yrki, óvirkin, virkisleysur,honum leiddist við hetta yrkisleysa arbeiði umborð;hann varð sitandi yrkisleysur tann líðilanga dag;hann gekk yrkisleysur(fyri einki)
yrkisligur	viðv. yrki, fakligur;hj-liga[da.professionel]
yrkisloysi	tað at vera yrkisleysur,nívdur av sjúku og yrkisloysi;sukku vit longri og longri niður í yrkisloysi
yrkislærdómur	lærdómur viðv. yrki (e-s)
yrkislærdur	lærdur í ávísum yrki[da.faglærd]
yrkismaður	ein ið er yrkislærdur
yrkismentan	yrkislig mentan,at føroyska árabátinum er knýttur ein stórur partur av okkara yrkismentan
yrkisnavn	heiti á yrki,"skraddari" og "smiður" eru yrkisnøvn
yrkisnevnd	nevnd ið ásetur útbúgvingarreglur fyri yrkisútbúgving,viðkomandi yrkisnevnd samtykkir útbúgvingarreglur, herundir reglur um útbúgvingartíð, býtið millum verkliga læru og skúla
yrkisorð	(málfr.)frøðiheiti, frøðiorð, yrkorð
yrkisráð	ráð (2) sum veitir ráðgeving í yrkisligum spurningum,í lógini verður sagt, at eitt yrkisráð við fimm limum skal setast, sum skal ráðgeva landsstýrismanninum
yrkissjúka	(lækn.)sjúka ið stendst av ávísum yrki, vinnusjúka
yrkisskúli	(skúl.)skúli ið veitir útbúgving í ávísum yrki[da.fagskole]
yrkisspælari	(ítr.)yrkisleikari
yrkisútbúgving	(skúl.)útbúgving innan eitt ávíst yrki,møguleiki er at taka yrkisútbúgving innan fiskavirking og aling
yrkja	1gera yrking,yrkja kvæði, tátt;yrkja um e-n;yrkja afturímóti;(kvæð.)eg kann ikki kvøða tað, ið ort er ikki longur;(orðt.)tað, ið illa er yrkt, verður illa kvøðið,síkvøða 22(kvæð.)tala,yrkja orði á e-ntala á e-n;yrkja (orðum) ábyrja at røða,Ragnar yrkir orðum á3(flutt m.)finna uppá, spinna í, skrøgga,hann man sjálvur hava yrkt hatta;sms. t.d.kapp-,endur-
yrkjari	ein ið yrkir(t.d. yrkingar, kvæði el. tættir),skald, rímari;sms. t.d.eftir-,kjøt-,kvæða-,tátta-
yrkorð	(málfr.)yrkisorð(terminus technicus)
yrkudagur	(gl.)yrkadagur
yrkur	(um dag)ikki heilagur, gerandis-,yrkan daggerandisdag;teir stóðu hendur í hupp yrkan dag;heilagt sum yrktbæði og halgi- og gerandisdag;tú vaskar við sama lag, antin tað er heilagt ella yrkt;lítið man hann hava sovið - situr uppi yrkar nætur
ysta	1hita mjólk so at hon rennur samanel.loypist(varð kókað upp og súr mjólk, blak el. loypingur latið útí),ysta mjólk2ystael.ystastleypa saman til ost, klumpast(um mjólk ið hevur staðið ov heitt el. hevur staðið ov leingi),sum mjólk er skjót at ystast;súr mjólk ystir, tá ið hon verður koyrd út í heitt drekka;sbr.leypa (5),undirløga
ysting	tað at ysta,henda mjólkin var til ystingar og henda til mat
ystingur	(mjólk.)kókað yst mjólk,ystingur var vanligur nátturðamatur ta tíðina, mjólkin var nógv
ystur	(um mjólk)vorðin til ost, lopin,yst mjólk
ytri	1l miðstuttari (av tveimum),(stn.)Fjallið Ytra;Ytralíð2hj miðstlongri úti, uttari
ytrimissión	trúboðan uttanlands,hon varð kallað til ytrimissión í Etiopia,móts.heimamissión
ytst	longst út(i), uttast,húsini stóðu ytst á bakkanum;ytst á halanum;(kvæð.)fylgdi síni fosturdóttur ytst á flóðarstein;(kvæð.)ytst við hallardyr
ytstifingur	(stb.)lítlifingur
ytstur	sum er longst úti, uttastur,út á ytstu gátt;út í ytstu æsirút í odd og egg;tað ytsta miðið;(kvæð.)risin rør nú á ytsta klakk
yvan	1hj(stb.)í osb.yvan fyrihinumegin, handan fyri,yvan fyri vatnið;yvan fyri fjørðin:meðan sólin kann síggja so væl og yndisliga yvan fyri fjørðin2fs(Vág.)yvan landsyðri armur á Vágsfirði
yvir	1(við hvnf um rørslu el. flyting á stað og hvmf um dvøl á stað)móts.undir,yvir havum hav;yvir dalar og fjøll;ferðast yvir land(eftir landi);posturin varð sendur yvir land, sum siður var tá;(kvæð.)yvir tann breiða fjørð;fáa tak yvir høvdið;heingja pottin (upp) yvir eldin;líta yvir landið;áirnar floyma yvir áarbakkarnar;reiggja stavin yvir høvdið(oman fyri høvd);syfta (bóltin) yvir múrin(upp um);(flutt m.)stíga yvir e-nvera betri enn ein annar;(kvæð.)sum ein yvir allar ríður;at Harrin vil halda hondina yvir soninum(verja, varðveita);svørðið hekk yvir teirra høvdi;yvir koyggjunum er tó sum oftast nævurtakt;tað liggur altíð ein sólglæma yvir børnum;(kvæð.)Sigmundur yvir hans herðum stár2(um ljóð)sálmasongurin hoyrist yvir havið;reyður hani skuldi gala yvir Neystagarð3(um plagg)uttan á(kvæð.)leysa hav tú skikkjuna í morgin yvir tær4(tlm.)longurel.meir enn,í yvir fjøruti ár5sum fevnir um, sum lýsir, um,talva er yvir grindirnar6undir ræði e-s,hava ein harðan yvir sær;kongur setur at honum fyri, so lítið hann hevur yvir monnum sínum;hann hevði ongan yvir sær(ráddi sær sjálvum);(skaldsk.)drotning yvir Atlants oyggjum;nú sigi eg, sum Gud er yvir mær,síGud7(í ymsum føstum sambondum)biðjael.ynskja ilt yvir e-n;dugael.kunna yvir at stilla;fella dóm yvir e-n(døma);geva skarvin yvir;eta seg yvir rygg(um kúgv);keypa seg yvir rygg;komael.reisa yvir høvur(upp eftir enda),tá ið steinarnir vóru komnir so mikið yvir høvur, at jarnbrotini vildu ikki makta meir;(ikki) taka vatn yvir høvurel.høvdið,sívatn;svørja hevnd yvir e-n(at hevna);tað er ikki yvir at dyljatað er eyðsæð, einki dulsmál;(kvæð.)tað er ikki yvir at tiga(einki at loyna);yvir høvur og herðarel.yvir háls og herðar(av grimd)(sísagnorðel. navnorð)8(saman við sagnorði)bera yvir við (e-m);draga yvir (e-t);grunda yvir (e-t);ráða yvir (e-m);undrastel.undra seg yvir (e-t);vaka (uppi) yvir (e-m)(sísagnorð)9(saman við hjáorði)aftur yviroman á,leggja lok aftur yvir e-t;renna korka aftur yvir steinamosa;skava aftur yvir (e-t)taka útyvir við, bera í bøtuflaka fyri;fram yvirfram um,spjótið flýgur fram yvir hann;oman yvir:koma oman yvir (e-n)koma á,ótti kom oman yvir meg;uppi yvir1um,hjúkla uppi yvir e-m;vera feginel.gleða seg uppi yvir e-m;Tummas er ovurfegin uppi yvir súkkluni;láta væl at uppi yvir e-m2sita uppi yvir e-m,sísita;uttan yviruttan á,kot uttan yvir troyggjuni;út yvir:fjala út yvir e-t;skava út yvir e-t;leggja út yvir e-t(oman á);langt út yvir havvíða um hav;út yvir landið(út um);skoða út yvir e-t;taka út yvir e-t,sítakahj10tvørtur umt.d.gólv, tún, lendio.tíl.,hon fór yvir at vindeyganum;hann fór yvir til grannan;kemur tú yvir eina løtu?11(saman við sagnorði)t.d.flóta yvir;ganga yvir;geva seg yvir;ríða yvir12(saman við fyriseting)yvir at:hann gongur yvir at seingini;yvir aváraka,hann sat yvir av mær;yvir á:hann kveitir yvir á Gunnhild;yvir eftir:hon fór yvir eftir vegnum;bólturin fór sendandi yvir eftir vøllinum;yvir fráyvir av,beint yvir frá grøvini;yvir í:e-m tykir yvir í,sítykja;yvir móti:síðan varð farið í ein útnyrðing yvir móti Íslandi;yvir um:hann fór yvir um ánna;yvir um fjørð13(í smb. við staðanøvn o.tíl.)upp um oyggjel.um fjørðel.um hav til annað land,vit komu yvir í øllum góðum(til Grønlands);yvir á Strendur(av Toftum);(kvæð.)yvir á Ferjubakka;yvir á land(um fjørð);yvir til Havnar(av Velbastaðel.úr Kirkjubø);yvir til Kvívíkar(úr Vestmanna);yvir til Leynar(úr Kvívík);yvir til Sandavágs(úr Sørvági);sms. t.d.aftur-,fram-,niður-,suður-,upp(i)-,uttan-
yvirals	yvirplagg við brókum og klaffi upp fyri framman(vanl. nýtt til arbeiðsbrúk),yvirhál
yviralsklæði	arbeiðsklæði av bláum bummullarklæði
yviralsur	yvirals
yvirarbeiði	arbeiði uttan fyri regluliga arbeiðstíð;sbr.yvirtíð
yvirav	yvir av (e-m), áraka (e-t), hinumegin,húsini stóðu yvirav
yviráls	yvirals,eitt yviráls
yvirbekkur	(sj.,bát.)leysabekkur
yvirbit	tað at framtenn í yvirmunni koma væl fram um framtenn í undirmunni,móts.undirbit,hava yvirbit
yvirbjóðing	tað at bjóða yvir
yvirboð	hægri boð (3) enn ein annar gevur,hava yvirboð
yvirborð	yvirflati, ýta,yvirborð jarðar;(bíbl.)vøtnini harðna sum grót, og havsins yvirborð stirðnar
yvirborin	væl í holdum, feitur,sum lítil var hon heldur yvirborin(heldur tjúkk)
yvirbragd	1útsjónd, atferð2bragd (5), andlitsbragd,skifta yvirbragd;eitt tunglynt yvirbragd breiðir seg um andlit hansara;(kvæð.)kallmanna hevur hon yvirbrøgd3eygnabrá, -bragd,yvirbragdið var flákrandi og óvíst, viknað av aldrinum;sbr.yvirbregði 2
yvirbragð	yvirbragd
yvirbrá	yvirbragd, bragd (5),eitt barnsligt yvirbrá;eitt stolt yvirbrá;eitt so líðandi yvirbrá hevði hon onga tíð sæð fyrr;hon hevði fingið eitt strangari yvirbrá;(flutt m.)áin gevur bygdini yvirbrá
yvirbregði1	ein ið er mætari, sterkariel.fremri enn annar, ein ið er við yvirlutan, yvirmaður (2),tú fært hvørki líkamann ella yvirbregða;hon heldur seg neyvan fáa sín líka ella yvirbregða við vevin
yvirbregði2	tað ið eyguni sýna, eygnabrá, -bragd,yvirbregði av sakloysi;hava gott yvirbregðihyggja opið upp í eyguni á fólki;hava ringt yvirbregðihava ringa uppsikt,hann hevur ringt yvirbregði, situr og kveitir útundan(hevur lúnskt eygnabrá)(Sv);(kvæð.)kvinnu hevur hon yvirbregði, kallmans hevur hon mál
yvirbregðin	sum heldur nógv um seg sjálvan, stórur í ondini, hástórur,stoltur og yvirbregðin
yvirbrigdi	yvirbregði 1(Sv)
yvirbrigði	yvirburður,hon hevur yvirbrigðan(er uppaftur betri (enn hin), er við yvirlutan);í ídnaði og fíggjarmálaheimi hava stórfyritøkurnar yvirbrigðan
yvirbrøkur	yvirbuksur
yvirbuksur	buksur at hava uttaná,móts.undirbuksur
yvirburður	tað ið ein hevur fram um e-n annan (í dygd, dugnaskapi, styrkio.tíl.),hava yvirburð yvir e-n
yvirbúnaðarstevna	(løgfr.)fimmmannanevnd við sorinskrivara sum formanni ið dømir um úrskurð hjá búnaðarstevnu
yvirbygdur	(um skip)við yvirbygningi,skipið er nógv yvirbygt(høga brúgv o.a.)
yvirbygningur	1e-t ið er bygt oman á e-t annað(t.d. á fari)2(búsk.)fyrisitingar-, tænastu- og mentanarstovnar(ið ikki hava beinan lut í framleiðslu)
yvirbyrjaður	(stb.)ovbyrjaður
yvirdeild	(gl.)ovari partur á serki(var av lørifti)(Sv)
yvirdráttur	(búsk.)tað at taka ov nógv út av konto í peningastovni
yvirdýna	(í song)dýna til at hava yvir sær,móts.undirdýna
yvireftir	á leiðel.á veg yvir,hann fór til gongu yvireftir
yvireingil	(bíbl.)fremsti eingil, høvuðseingil, erkieingil
yvirerving	(sj.)overvan, overving
yvirferð	1ferð yvir um hav (til annað land),teir høvdu kastað saman um yvirferð og heimferð2í osb.yvirferðin er av1(um streym)broddurin er av2(um arbeiði)tað tyngsta er av3(um fólk)manndómsárini eru liðin(ein er farin at eldast og vikna)
yvirfetil	(í reiðing)fetil ið liggur yvir(fetlinum á hinum leypinum),yvirfetil liggur um undirklyvberan;sbr.undirfetil
yvirflati	flati sum avmarkar lutel.evni úteftir, tað uttasta á e-m, útsíða, ýta 1, yvirborð,friður lá um yvirflatan, men í dýpinum var eitt yðjandi lív(av fiski)
yvirflóð	stór mongd, ørgrynni,hava (í) yvirflóð av e-m;yvirflóð av mati;her er yvirflóð av øllum, ið tær tørvar;sørvingar fingu finningarfiskin, men hann var lítið umvirdur, nú sovorðin yvirflóð var til(av grind)
yvirfólk	fólk ið stendur yvir øðrum (í starvi)
yvirfrakki	frakki at hava uttaná,í yvirfrakka
yvirfriðingarnevnd	(løgfr.)kærustovnur í náttúrufriðingarmálum
yvirgangsatsókn	eirindaleys og blóðug atsókn móti ósekum fólkum(oftafyri at fáa eftirlíkað politiskel.átrúnaðarlig krøv),amerikanska stjórnin hevur fingið upplýsingar um, at víðgongdir persónar fyrireika yvirgangsatsóknir móti amerikanskum áhugamálum
yvirgangskroppur	ein ið fremur yvirgang, ein ið nýtir harðskap,hann er ein harðligur maður, mest sum ein yvirgangskroppur
yvirgangsmaður	yvirgangskroppur
yvirgangsverk	verk framt í yvirgangiel.harðskapi, valdsgerð
yvirgangur	eirindaleys framferð móti ósekum fólki(oftafyri at fáa eftirlíkað politiskumel.átrúnaðarligum krøvum),ágangur (1), harðskapur, bonskleiki,verja e-n móti yvirgangi;kríggið í Irak og altjóða yvirgangur vóru evni í sjónvarpaða kjakinum;hellan var mestan avoydd(fyri fugl)av tí yvirgangi, ið menn høvdu havt har undir landinum
yvirger	(evnafr.)ølger ið flýtur omaná;sbr.undirger
yvirgeraður	(evnafr.)geraður við yvirger
yvirgerðarmaður	(bíbl.)yvirgangsmaður,øvunda ikki yvirgerðarmannin
yvirgeva	1fara frá e-m,vit hava yvirgivið alt og fylgt tær(eru farnir frá øllum);yvirgivin av Gudi og menniskjum2yvirgeva seggeva seg yvir
yvirgivin	arggivin,vera yvirgivin til (e-t)hava til last, hava til (ringan) vana,hann er so yvirgivin til at klintrast;hann var yvirgivin til bøkur
yvirgonga	1fjallgonga 8 til 14 dagar eftir mikkjalsmessu(at taka veðurlomb og tey smæstu gimburlombini)(Sv Indb.816)2skiftistíð,hetta tíðarskeið (1538 - 1571) er ein yvirgonga frá tí katólsku tíðini til trúbótina
yvirgongd	yvirgonga (2)
yvirgrind	(húsasm.)yvirsyllar og bitar;sbr.undirgrind
yvirhagi	ovari (bratti) partur av haga, ervahagi(summarbit hjá seyði);sbr.undirhagi
yvirhallur	ið vil ríða yvir, við vanda fyri at missa javnvág,hin nógv yvirhalla handilsjavnvágin
yvirhál	(stb.)yvirals
yvirhála	1fara fram um (e-n annan), leggja (e-n annan) afturum(serst.um akfør),hann yvirhálaði meg við øgiligari ferð2kanna og umvæla
yvirháling	1tað at yvirhála (1)2tað at yvirhála (2), høvuðseftirlit og -umvæling
yvirhiti	hiti í erva í bakarovni
yvirhonds	í alstóran mun, ógvuliga, ovurhonds
yvirhoyra	(skúl.)spyrja (næming) um setningin, hoyra (7)
yvirhoyring	1(skúl.)tað at yvirhoyra2tað at hoyra yvir seg
yvirhugaður	eldhugaður, ovurhugaður, yvrigur
yvirhugi	ovurhugi, yvri, øsing,Barba var rómareyð av yvirhuga;tað svitast sjáldan, at ungarnir í yvirhuga koma sær á veingirnar;av yvirhugauttan fyrilit,mest sum av yvirhuga kom hann at leggja upp í prátið teirra millum
yvirhúð	(lívfr.)forhúð, hetta 1(3)
yvirhús	(stjm.)ovara deildin í bretska tinginum(ikki fólkavald);sbr.undirhús (1)
yvirhøvd	ovari partur á høvdi,yvirhøvdið var so stórt á henni
yvirhøvur	sum heild, í alstóran mun,soleiðis er vorðið yvirhøvur;yvirhøvur ikkials ikki
yviri	1longri burturi (át.d.gólvi, túni, lendio.tíl.),hon stóð yviri við vindeygað;hann var yviri hjá grannanum;vit búgva longri yviri;har yviri2á staðt.d.hinumegin oyggj, fjørðel.hav,yviri á Kirkju;yviri í Havn;yviri í Noregi
yvirísaður	(sjóm.)fjaldur undir ísi, klakaður
yvirísing	(sjóm.)tað at skip er yvirísað,tað gjørdist eitt øgiligt illveður við kavaroki og yvirísing av skipinum
yvirjarðligur	ið ikki er av hesi jørð, guddómligur, himmalskur, himniskur,ein yvirjarðlig sjón
yvirjekari	(herm.,søg.)yvirmaður hjá jekarunum(skansaliðinum í Havn);sbr.jekari
yvirkarði	ovari karðin,móts.undirkarði
yvirkast	(gl.)sjál, herðaturriklæði
yvirkjaftur	ovari partur á kjafti,móts.undirkjaftur,fram úr yvirkjaftinum standa tvær tenn(um fíl),húkurin stóð í yvirkjaftinum(á fiski)
yvirklyvberi	tann parturin av klyvbera ið liggur inn yvir hin(í umskaringini);sbr.undirklyvberi
yvirklæði(r)	klæði at hava uttan á øðrum klæðum(t.d. jakki, frakki),tey lata seg í yvirklæði(r), áðrenn tey fara út;sbr.undirklæði(r)
yvirkokkur	hægsti kokkur (t.d.í matstovu);sbr.høvuðskokkur
yvirkola	ovara skál á kolu(har ið lýsið og veikirnir eru),móts.undirkola
yvirkoyggja	(skip.)koyggja yvir aðrari, ovarael.ovasta koyggja,móts.undirkoyggja
yvirkroppur	kroppur upptil, kroppur oman belti;sbr.niðurpartur
yvirleður	partur á skógvi ið gongur upp á fótin og yvir ristina
yvirlendi	brattlendi í erva,móts.undirlendi
yvirliður	(málfr.)høvuðsorð í orðalagsheild,"bátur" er yvirliður í t.d. "ein gamal bátur"
yvirliggjari	(ítr.,tlm.)tvørstong (á máli 2(12))
yvirlit	1úrdráttur (2) við denti á høvuðsinnihaldi,yvirlit yvir Føroya søgu;ársuppgerð er yvirlit yvir inntøkur og útreiðslur fyri eitt ár2greið áskoðan á allar síður á e-m, heildarinnlit,hava gott yvirlit;sms. t.d.evnis-,fólka-,innihalds-,landsfólka-
yvirlitsgóður	sum er góður at hava yvirlit yvir, greiður
yvirlitslestur	tað at lesa e-t skjótt og leysliga(til at gera sær heildarmynd av innihaldi í teksti)[da.skimming]
yvirlitstroling	(fisk.)troling hjá havrannsóknarskipi til at fáa heildarmynd av støðuni hjá fiskastovnum,havrannsóknarskipið Magnus Heinason ger árligar yvirlitstrolingar, har broytingarnar í nøgd og aldri av ymsu fiskasløgunum undir Føroyum verða kannað
yvirlitur	litur uttan yvir grundmáling
yvirlíki	(Suð.)yvirbregði 1, yvirmaður (2),hann hevur ikki sín yvirlíka;hann helt seg ikki fáa sín yvirlíka
yvirluti	yvirbrigði, yvirburður,hava yvirlutanel.vera við yvirlutanvinna á e-m, hava munin,mótloysið var við yvirlutan;bera yvirluta yvir e-nel.hava yvirluta yvir e-m(hava munin, hava yvirvág)
yvirlýsa	(stb.)ljóst í erva meðan mjørki er í neðra;sbr.undirlýsa
yvirlýsing	(almenn) kunngerðel.fráboðan, váttan, ummæli
yvirlækni	(lækn.)lækni ið stendur fyri sjúkrahúsdeild
yvirlærari	(skúl.)1lærari við meira enn 10 ára starvstíð2(gl.)hægri stig í lærarastarvi
yvirlæti	lótir, hjáputur,tað er fjalt undir følskum yvirlæti
yvirmaður	1ein ið er yvir øðrum í starviel.tign(t.d. í heri og umborð á skipi),Fiskimannafelagið treytaði sær, at fiskimenninir skuldu bera helvtina og yvirmenninir hina helvtina av niðurskurðinum2ein ið er betri enn annar (ít.d.brøgdum, styrki), yvirbregði 1, yvirlíki,nú hevði hann fingið sín yvirmann;sms. t.d.her-
yvirmaki	(kvæð.)yvirmaður (2),vær vitum ongan í verðini at vera hans yvirmaka
yvirmakt	yvirvald, yvirveldi,fáa yvirmakt yvir e-mverða við yvirlutan
yvirmannafelag	felag fyri yvirmenn (1),Fíggjarmálaráðið og yvirmannafeløgini, Skipara- og Navigatørfelagið og Maskinmeistarafelagið, hava gjørt sáttmála fyri yvirmenn
yvirmáttugur	sum er sterkari,hann tapti fyri einum yvirmáttugum mótstøðumanni
yvirmenni	ein ið hevur yvirmenskar eginleikar
yvirmenska	tað at vera yvirmenskur
yvirmenskur	ið erel.megnar meir enn vanlig menniskju,yvirmensk megi;yvirmensk sálarstyrki;stór yvirmensk gleði
yvirment	tað at vera yvirmentur
yvirmentur	sum megnar meir enn annar, sum hevur yvirbrigðan,vera yvirmentur e-m:hann bar orð fyri at vera honum yvirmentur í øllum, sum nart við keyp og sølu;ein yvirmentur herur vildi teimum ann;yvirmentir í talií meiriluta
yvirmeta	meta meiri verdan enn í royndum er, halda (8) nógv um, hámeta, ovmeta
yvirmeting	tað at yvirmeta,móts.undirmeting
yvirmógvur	ovara hædd av mógvi;sbr.undirmógvur
yvirmuður	yvirmunnur
yvirmunnur	1ovari partur á munni, ovari munnur,móts.undirmunnur,ongar framtenn í yvirmunninum2leysatenn í yvirmunni (1)
yvirnatúrligur	ikki bundin av náttúrulóg,yvirnatúrligur skapningur;á yvirnatúrligan hátt
yvirnet	(skip.)ovari partur á troli
yvirnev	(fugl.)ovari partur á nevi,móts.undirnev
yvirnøgd	ovurnøgd, yvirflóð, ørgrynni
yvirpartur	1ovariel.ovasti partur á e-m,móts.undirpartur2ovari partur á kroppi, yvirkroppur,móts.niðurpartur,hava tjúkkan yvirpartvera bulstórur
yvirplagg	klædnaplagg at hava uttaná
yvirprenta	(prent.)prenta oman yvir (e-t ið prentað er)(t.d. frímerki)
yvirprenting	tað at yvirprenta
yvirráð	tað at ráða yvir e-m, yvirvald
yvirrekkjuváð	(gl.)rekkjuváð at hava oman yvir sær,móts.undirrekkjuváð,helvtarmunur skuldi vera á tyngdini og harvið á tilfarinum til eina yvirrekkjuváð og eina undirrekkjuváð
yvirrið	tað at ríða yvir,hann fekk yvirrið og reyk eftir høvdinum fyri borð[da.overbalance];sbr.ávøga
yvirrómi	(mjólk.)tjúkkur rómi ið legst oman á mjólk;sbr.undirrómi
yvirræði	(stjm.)tað at ráða yvir (e-m), hægsta ræði, yvirvald,yvirræði á havinum;undir bretskum yvirræði
yvirrættardómari	(gl.,løgfr.)dómari í yvirrætti
yvirrættarsakførari	(gl.,løgfr.)sakførari við rættindum til at flyta mál fyri yvirrætti
yvirrættur	(gl.,løgfr.)dómstólur (í Danmørk) sum dómur við undirrætt kundi verða skotin inn fyri(nú er landsrættur komin í staðin)
yvirsetningur	(málfr.)setningur ið er yvirskipaður øðrum setningi,ein eykasetningur kann vera yvirsetningur hjá øðrum eykasetningi
yvirsinni	tað at vera yvirsintur, ovursinni,ríðir av yvirsinni
yvirsintur	frá sær sjálvum av øði, ovursintur,hann var ikki óndur, men yvirsintur
yvirsjón	1tað at síggja (4), yvirnatúrlig sjón,hava yvirsjónir;faðir hennara hevði sæð húsfrúnna í yvirsjón;hon var frá barni so fongd við yvirsjónum;gentan var fortrongd av yvirsjónum;tey síggja yvirsjón fyri neyð tað sama sum fyri deyð2sjónhvørving, sjónarvilling,hann var so ringur, at yvirsjónir fóru at gykla seg fyri honum[da.hallucination]
yvirsjónd	yvirflati, ýta
yvirsjúkrasystir	(lækn.)sjúkrasystir ið stendur fyri sjúkrahúsdeild
yvirskegg	skegg á yvirvørr,móts.undirskegg
yvirskering	(bát.)reising (2);sbr.yvirskorin
yvirskeyti	(bát.)áskeyti,móts.undirskeyti
yvirskipaður	1við meiri seyði enn hagi ber,móts.undirskipaður,flestallir hagar hava verið yvirskipaðir2sum er á hægri stigi(í ávísum kervi)3(málfr.)ið er á hægri stigi,yvirskipaður setningurel.setningsliður
yvirskipan	1tað at hagi er yvirskipaður,so at seyðurin doyr í raki av yvirskipan2(málfr.)tað at vera yvirskipaður (3)(um orð el. setning)
yvirskjúrt	(uttara) skjúrt,móts.undirskjúrt
yvirskoðan	yvirlit
yvirskorin	sbr.yvirskering
yvirskot	fíggjarligt avlop, vinningur,móts.undirskot,fyritøkan gevur yvirskot
yvirskógvur	galosja
yvirskrift	tittul (vanl. við størri støvum) yvir teksti
yvirskørr	loftskørr,høvdini á lomvigunum komu upp undir yvirskørrina
yvirstaddur	(plfr.)við blómureivi og sáðberum ið vaksa út úr ovara enda á eggleguni,yvirstødd blóma;sbr.kringstaddur,undirstaddur
yvirstaðin	(tlm.)liðugur, lokin
yvirsteinur	ovari kvørnarsteinur,móts.undirsteinur
yvirstempla	(postm.)(á frímerki)stempla nýtt virði oman á hitt gamla;sbr.yvirprenta
yvirstivli	stivli til at hava uttan yvir góðum skógvi
yvirstjórn	yvirvald, yvirræði
yvirstúka	(gl.)sjóstúka
yvirstykki	(gl.)frakki(hjá konufólki og børnum),nú vóru fleiri, sum høvdu fingið sær yvirstykki
yvirstýrimaður	(sjóm.)stýrimaður við hægsta myndugleika (á farma-el.ferðamannaskipi)
yvirstætt	stætt ið er hægst sett í samfelagnum, hástætt
yvirsvinnur	sera svinnur (1), álvarsamur,konan kemur inn, ikki petti uppøst, men yvirsvinn
yvirsyll	(húsasm.)ovara syll (1),móts.undirsyll
yvirtak	1(í glímuserst.flt-tøk)tak í erva(um arm ella øksl á mótstøðumanni),móts.undirtak;sbr.brókatøk2(tlm.)hava yvirtakiðhava munin, hava yvirbrigðan,hann vildi hava yvirtakið í tosinum;her hevði hon yvirtakið
yvirtaka	(stjm.)taka yvir(t.d.málel.málsøki undir føroyska fyrisiting)
yvirtal	tað at vera fleiri í tali, meiriluti,havael.fáa yvirtalið;standa ímóti stórum yvirtali
yvirtala	fáa at skifta hugsan, (royna at) sannføra,(ikki) lata seg yvirtala;hon letur seg yvirtala til at vera longur
yvirtaling	tað at yvirtala,við yvirtalingum
yvirtikin	sera illa fyri (av sjúkuo.tíl.), hart tikin,yvirtikin av krími (hosta, møði);hann er yvirtikin av eygnaverki;hann var so yvirtikin av møði, at hann orkaði hvørki at flenna ella dansa;tær duldu kenslur, sum hann var so yvirtikin av
yvirtíð	tíð uttan fyri regluliga arbeiðstíð
yvirtíðarløn	løn fyri yvirtíð
yvirtími	arbeiðstími arbeiddur í yvirtíð
yvirtollari	hægstur av tollarum
yvirtorva	ovarael.ovasta torva í reisu,tey brúktu tríggjar torvur til hvørja reisu, eina undirtorvu og tvær yvirtorvur;sbr.torvreisa,undirtorva
yvirtóni	(tónl.)tóni ið ljóðar veikt saman við grundtóna,móts.undirtóni
yvirtráður	(á seymimaskinu)tráður sum úr erva gongur niður í nálina, ovari tráður í seymi (1),móts.undirtráður
yvirtrom	1trom í erva(t.d. á kari, spann)2(húsasm.)tekja á húsi við sperrum, skjøldrumo.s.fr., reising (1)
yvirtroyggja	troyggja at hava uttaná(t.d. skjúrtu, blusu),móts.undirtroyggja,til yvirtroyggjur og annað, sum stóð fyri sliti, brúktu tey trítáttað;hon bant bæði yvirtroyggjur og undirtroyggjur
yvirtryggja	(trygg.)tryggja hægri enn virðið er
yvirtrýst	(alisfr.)hægri lufttrýst enn uttanumt.d.í ílati,móts.undirtrýst
yvirtænari	hægstur tænari(ið m.a. hevur eftirlit við borðreiðing)
yvirtøka	tað at taka yvir(t.d. ábyrgd av e-m),yvirtøka av sermálum
yvirtøkulóg	(stjm.)lóg ið heimilar løgtingi at yvirtaka málsøki undir føroyska fyrisiting
yvirum	yvir hinumegin, tvørturum,hann leyp yvirum;(flutt m.)fara yvirumandast, doyggja
yvirumsjón	hægsta umsjón,løgtingið hevur yvirumsjón
yvirupphita	1bera so í bandið at e-t verður ov heitt, hita ov nógv2(flutt m.,búsk.)hava við sær inflatión tá ið vaksandi eftirspurningur ber við sær hægri prísir heldur enn størri útboð,størri skattalættar seta enn meiri ferð á búskapin, og vandin fyri at búskapurin verður yvirupphitaður gerst størri
yvirupphiting	(búsk.)tað at e-t er yvirupphitað,yvirupphiting av búskapinum
yvirvaksin	risastórur, ovurstórur, frávaksin,yvirvaksin kalvi
yvirvald	1fullkomið vald, yvirræði, harradømi, yvirmakt,útlendskt yvirvald;hava yvirvald á e-m;at endanum góvust teir fyri yvirvaldinum(teimum ið sterkaru vóru);við tað sama breyt hann seg upp og fekk yvirvald á huldukonuni2yvirvaldiðteir ráðandi, myndugleikarnir,so kom yvirvaldið upp í leikin;ein nevnd, ið yvirvaldið hevur sett
yvirvaldsmaður	maður í yvirvaldinum (2)
yvirvág	kv2e:hava yvirvág í e-m(t.d. leiki)hava munin, hava leiðsluna,heimaliðið hevði yvirvág í leiki allan dystin
yvirváni	k1eí osb.hava yvirvána (yvir e-m)(yvirbrigðan);teir bardust leingi, at endanum hevði Pætur yvirvána(varð við yvirlutan);bæði kotini eru góð, tó haldi eg hetta hava yvirvána(vera hitt betra);vit vóru við yvirvánan í fjør(viðv. fiskiskapi)
yvirvánir	yvirbrigði, yvirluti;(kvæð.)góðar hevur tú yvirvánir í allari ásjón
yvirvekraður	(stb.)ovvekraður
yvirvekt	1størri vekt enn vanligt2ov stór vekt(t.d. á viðføri)
yvirveldi	yvirvald (1),(skaldsk.)danskir undan yvirveldi rukku tá heim til landa
yvirvinna	vinna á,hann, ið deyðan yvirvann
yvirvóni	k1e(stb.)í osb.verða við yvirvónan(við yvirlutan),tað var bara ein maður, hann óttaðist fyri kundi fara at verða við yvirvónan
yvirvrakari	hægsti vrakari
yvirvøkstur	(plfr.)slokkur,tað er so øgiligur yvirvøkstur á eplunumslokkarnir eru so høgir
yvirvøld	(gl.)yvirvald
yvirvørr	1vørr á yvirmunninum,móts.undirvørr2(plfr.)ovari partur á varravaksnari krúnu 1(3),móts.undirvørr;sbr.varravaksin
yvri	øði, snurr, øsing,eg hevði av berum yvri gloymt at skonkt;hon sá, hvussu yvri dró at honum;(kvæð.)yvri dregur at Sjúrði unga
yvrigur	ilskur, østur,bóndin var ongantíð illur, men hann kundi vera eitt sindur yvrigur við hvørt;sbr.ivrigur
