á1	(málfr.)tví-el.einljóðsstavur (nevndur[ɔa])
á2	natúrlig lægd í lendinum við rennandi vatni, løkur,(skaldsk.)áir renna vakrar har;áirnar standa á svølgi(um stórt áarføri);áirnar ganga eftir bøkkum;um áir og gjáir(ferðast) langan veg;hann er komin bæði um áir og gjáir í morgun;tað rekur sum eftirel.í ánni(rekur hart);tað gekk sum eftir ánni(sera væl og lættliga);fara yvir um á;(flutt m.)fara yvir um á(nna) eftir vatnigera sær óneyðugt stríð;(orðt.)fyrr trýtur streymur í á, enn kvinnu tróta ráð;(Vágar)farael.ganga í áirfiska síl í vøtnum;(Vágar)standa í áumfiska síl;hann hevur verið í ánni;(sj.)fara fyri áirfiska síl har sum áir renna út;Við Áir(stn.)pláss millum Hvalvík og Hósvík,fyrr søgdu hósvíkingar inni at Áum
á3	1(um stað, lut, leið)legg bókina á borðið;bókin liggur á borðinum;hann fer umborð á skipið;hann er umborð á skipinum;skriva e-t á talvuna;tað stendur á talvuni;fara á fjall;vera á fjalli;á grønum vølli;hann sprakk á dyr;fara á ting;vera á tingi;báturin gekk á stýriborð;fara á fund;vera á fundi;á miðjuni;á vinstru hondtil vinstru2(í smb. við ávís bygdarnøvn, staðanøvn o.tíl.),móts.av,á Eiði;á Glyvrum;á Kirkju;á Skála;á Velbastað;á Sunnanágarði;á bygd3(um vág, fjørð, havno.tíl.)skipið kom á Vestmanna;skipið kom á Havnina;skipið lá á Havnini;sbr.av (3)4(um sjógvin út fyri ávísum stað á landi)tá var tann fyrsti báturin á Flesini;teir róðu norður á Nevið5(í smb. við vindætt)á landnyrðingi;á øllum ættum;á vestri (eystri, suðrio.tíl.)6(í smb. við streym)her er streymhart, helst á vestfallinum;far á vestfallið!7(í smb. við sjóvinnu)á dyrging (floti, saltfiskaveiðu, útróðrio.s.fr.)8um(viðv. tíð á samdøgrinum)tá ið liðið var á morgunin (dagin, kvøldið, náttinao.tíl.);á morgni (degi, degnum, kvøldi, nátt(ini)o.s.fr.)(um)9(viðv. tíð)nú á døgum;á jólum, páskumo.s.fr.;á fjørutá ið fjøra er;á flóð(ini)tá ið flóð er;á ólavsøku;á pætursmessu;á sumri10(viðv. aldri)á ungum árumel.á ungum aldri;á tólvta áriellivu ára gamal11(umskriving fyri hvsf)aldurin á roykstovuni;tromin á húsunum;tey hoyrdu málið á Harranum;hann rendi knívin í lærið á honum;hann róði til syðra endan á oynni12(um likamslutir)fóturin (beinini, armurin) á mær;halt munnin til á tær13(um eginleika, eyðkenni, viðv.el.við atliti at e-m)1(um fólk og dýr)fimur á fót(un)umfótfimur;fastur á hondinikargur;tungur á hondinitunghentur;kimilig og vøkur á kropp;dimmur á liti;hásur á málinum;lættur (tungur) á sær;vænur á útsjónd;tað sæst á øllum brøgdum2(um mát)á støddtil støddar3(um tungumál)á føroyskum;á fronskum14(viðv. sinni, kenslum, kærleika o.tíl.)hava hug á e-m;leggja ást á e-n;hon hevði einki álit á honum;vita á sær;tá kom illgruni á teir;ikki var friður á honum;ótti var á teimum;vera á gosi;nú var geylan á honum15fyri hvønn,eitt árið skar hann 36 á mørkina;teir komu ikki longri enn upp í 40 á bát;tríggir kassar á 15 kr.16í osb.á kroppiat kroppi(rennvátur, ígjøgnum);á lívi(livandi);á leistum;á odda(fremst);á tremur;maður á manniel.kropp á kropphvør í hølunum á øðrum;nevna á navni;bíta á kampi;bróta á háls;ganga á illum;gevast á hendur;hava á orðiel.munni(siga);hava barn á brósti;leggja á blik;standa á berum;sita eftir á berum;(vera) á fótumframmi, frá seingini(sísagnorðel. navnorð)17(saman við hjáorði)aftan á:Jógvan var bóndi aftan á Pætur;hann tók húsini aftan á pápan;aftur á:mala aftur á blóðið,síblóð;rógva aftur á mið(tá ið bátur er rikin av);fram á:koma fram áraka við,nú hann gongur, kemur hann fram á tveir tjóvar;inn á:trý turkaskip komu inn á Hvalbiarfjørð;teir eru komnir inn á Barmin;hetta er ikki tíð at koma inn á fólk;teir slitu inn á Selberg;vera óður inn á e-n;gera seg inn á e-n;ganga inn á e-n;inni á:einaferð vóru nógv hetlandsskip inni á Miðvági;liggja inni á øðrumvera øðrum til byrðu;niðan á:ganga niðan á heyggin;oman á:oman á bakkan;rómi legst oman á mjólk;hvat skulu vit hava oman á døgurða?;upp á1fyri hvønn,tvey epli upp á mannin2upp á seg[ʊˈpɔase:]:hava nógv/lítið upp á seg(stóran/lítlan týdning);upp á seg[ʊp:ɔaˈse:]lutfalsliga,leggjalangur verður sagt um ein, sum hevði styttri yvirpart upp á seg3í osb.bera upp á e-tfalla saman við,høgtíðisdagurin bar upp á sunnudag;bera upp á rím,sírím 2;bjóða e-m upp á máltala á e-n;ikki vilja taka e-t upp á tunguna;leggja upp á vev;lærael.rætta upp á e-nharta e-n;vera upp á sítt bestael.tað besta(í bestu árum);tá ið kópurin var upp á tað mestatá ið mest var til av kópi;lættur upp á sporiðlættur á fóti, fótlættur;uppi á:hava e-t uppi á særbera (í lummumo.ø.);vera uppi á gosi(østur);út á:gera út á(javna);byggmjøl varð havt út á súpan(havt til javning);úti á:ein dagin, sum teir vóru úti á havi;úti á sundinum;yvir á:hann kveitir yvir á Gunnhildhj:tað er áfiskur er á húkinum;tað er nógv (lítið) á(nógv/lítið gras)18í osb.ilt liggur ásama ger;ikki eiti á!hygga síggj!;leggja lívið ávága lívið;mær varð á at bróta tráðuna(var so óheppin);av og ástundum19(fs/hj saman við sagnorði)t.d.aftra sær á;berast á;bíta á;brenna á;bresta á;bretta sær á;díkja á;draga á;dríva á;falla á;gerast á;geva á;halda á;kenna (e-m) á;koma á;kasta sær á;koyra á;leggja á;leypa á;leika á;linna á;renna á;skjóta á;snara sær á;skyna á;spøkja á;standa(st) á;steðga á;taka á;venda sær á(sísagnorð);sms. t.d.aftan-,aftur-,eftir-,eystur-,framman-,har-,inn-,niðan-,niður-,norður-,oman-,tvørtur-,upp(i)-,uttan-,út(i)-
á4	1mðlv(til at vísa m.a. iva, ovfarni, spurningo.tíl.)á, heldur tú tað?;á, var tað ikki hon?;á, var tað bara tað?2ljóðh(um ljóð hjá lunda)lundin sigur á, á, á
á5	síeiga 2
áa	1(um lunda)láta, siga "á",lundin áaði2herma eftir lunda, láta sum lundi,drongurin áaði eftir lundapisuni
áararvi	(plfr.)slag av arva 1(Stellaria uliginosa)
áarbakki	bakki 1(3) á á 2
áarbotnur	botnur í á
áardalur	dalur sum á rennur ígjøgnum
áardun	dun ið hoyrist frá á
áarduni	áardun,áardunin hoyrist langan veg
áardúnurt	(plfr.)slag av dúnurt(Epilobium alsinifolium)
áareyrur	eyrur íel.úr á
áarfar	farvegur eftir upptornaðari á, áarrás
áarfiskur	(fisk.)fiskur ið livir í áum, vatnfiskur
áarfossur	fossur í á,skeggið hekk sum áarfossur niður á bringuna;tað var sum eftir áarfossi(um hart rák)
áarføri	1stórur áarvøkstur í nógvum regni, vatnføri2sera nógv regn, grimdarregn, áarstoytingur, grovregn, bermiligregn,áarføri í regni
áarførisdagur	dagur við áarføri
áargangur	(stb.)áarføri,tað er ein øgiligur áargangur í dag;tað var sum ein áargangur(um hart rák á sjónum)
áargil	gil sum á rennur í
áargrót	grót íel.úr á,grótið er runt eins og áargrót
áarhestur	(dj.,sj.)áarross
áarhylur	hylur í á
áarkoppur	(plfr.)hóvblað
áarliða	liða á bøgarði sum á rennur ígjøgnum
áarliði	áarliða
áarlop	tað at ein á loypur(t.d. í toybili og rívur grót, eyr og mold við sær),stórur skaði av skriðu og áarlopi
áarløka	(stb.)áarløkur
áarløkur	lítil á, løkur
áarmaður	(Vágar)maður sum fiskar síl á vøtnum
áarmeldur	meldur undir fossiel.í hyli í á
áarmosi	(plfr.)álvagras(Fontinalis antipyretica,Astrophyllum punctatum,Mnium serpyllifolium)
áarmunni	(stn.)áarósi
áarmylla	áarmylna
áarmylna	mylna ið gongur við vatni
áarneliksrót	(plfr.)slag av neliksrót(Geum rivale)
áarósi	ósi;(stn.)Áarósibýur í Jútlandi(Aarhus)
áarpisa	1lundapisa ið kemur oman eftir á(komin inn yvir land og mist flogið)2(flutt m.)smádrongur ið liggur nógv í áum og hyljum og spælir,hatta er ein sovorðin áarpisa
áarpláss	(Vágar)staður við vatn har ið menn sita og fiska síl
áarrás	farvegur hjá á
áarrok	tað at áir og fossar fúka upp í stormi
áarross	(dj.)stórt óskapiligt dýr í ætt við svín(livir í vatni),áarhestur, vatnhestur(Hippopotamus amphibius)
áarsandur	(grovur) sandur íel.úr á, eyrur (1)
áarsíl	(fisk.)síl ið livir í áum,áarsíl og sjósíl eru sama slag
áarsjóð	áarsuð,lurta eftir áarsjóðinum til at ætla um, hvaðan ættin kom
áarskrubba	(fisk.,stb.)sandsprøka
áarskúm	skúm í á
áarskúmur	(stb.)áarskúm
áarslýggj	(plfr.)slýggj í áum
áarsteinbrot	(plfr.)slag av steinbroti(Saxifraga rivularis)
áarsteinur	steinur íel.úr á
áarstoytingur	áarføri (2)
áarstrekkur	streymur í miðjari á
áarstreymur	streymur í á
áarstubbi	stutt á
áarsuð	suð frá á
áartræ	stórt (reka)træ sum brúgv um á
áartrøll	(dj.)ormvera hjá heksmanni
áartunga	tunga 1(6)
áartutl	tutlandi ljóð frá á
áartúsundblað	(plfr.)slag av túsundblað(Myriophyllum alterniflorum)
áarvatn	vatn íel.úr á;sbr.kelduvatn
áarvegur	(stn.)vegur fram við á
áarvøkstur	áarføri (1),um náttina kom áarvøkstur;tá ið áarvøkstur er, verður vatnið brúnt av mold
ábart	(óregl.)->ábært
ábati	vinningur, úrtøka
ábeint	beint yvir av, áraka,ábeint e-n;eitt vindeyga ábeint prædikastólin;hann bíðar har, til djórið kemur ábeint hann;hann kom ábeint Vágar
ábekkur	(stb.,bát.)leysabekkur
ábending	tað at bendael.vísa (e-m) á (e-t),hann gav honum manga ábending um tað
áberandi	sbr.bera á
áberi	(løgfr.)ákæri, atsóknari(í rættarmálum)
ábersla	(lit)dámur,hann hevði hvítt hár við gulari áberslu;sbr.bera á
ábinding	tað at binda á(t.d. teym á línu)
ábindingarknútur	(sjóm.)knútur sum teymur verður knýttur í teinateyggju við[da.flagknob]
ábindisknútur	(sjóm.)ábindingarknútur
ábit	1fyrsta máltíð á degnum, morgundrekka, morgunmáli,jólamorgun fekk alt húsfólkið ábit: kaffi, smør og breyð og jólakøkur;sbr.morgunmatur (2)2(stb.)lítil máltíð framíhjá, argjamáltíð,hann fær sær e-t til ábit
ábitaleysur	sum einki hevur leskað um morgunin, fastandi
áblástur	(málfr.)blástur 1(3)
áborin	l26:væl áborinvæl fyri, ið hevur nakað av at standa,onkur var so væl áborin við døgurðamati;tá ið seyðinum veit væl við á vári, verður sagt, at hann er væl áborin
áborist	síberast á
ábót	1umvæling, umbøting,hann læt gera stóra ábót á kirkjuna2(gl.)ískoyti, viðbót
ábreiða	(sj.)teppi, áklæði
ábreiðsla	1deilan, hartan, skortfleingja, atfinning,geva e-m ábreiðslu2e-t breitt á bøin til taðingar, áburður (3)
ábrek	skaði, løstur, snuddur,tað er ikki so væl vorðið, tá man hevur fingið ábrek(tá ið heilsan er farin at bila)
ábrenning	tað at brenna á (við ódnarveðri),upp undir ábrenning tíggjar streymurin sær ofta illa
ábreyt	(gl.)áarbakki
ábundin	síbinda á
áburður	1kneysiel.kongur 2(1) at leggja bandel.línu um(serst. í bjørgum)el.at binda bát við2(stb.)bandel.lína løgd um áburð,leggja áburð;áburðurin hekk fyri summarið3tøð breidd á bøin, ábreiðsla (2)4tilfar á vegir
áburra	(fisk.)útl. vatnfiskur(Perca fluviatilis)
ábúgvi	(gl.)íbúgvi,landsins ábúgvar
ábygdur	sum bygt er á
ábyrgd	1tað at vera ábyrgur, ábyrgsla, andsvar,hava ábyrgd av e-m2(løgfr.)borgan[da.kaution]3(løgfr.)veð, trygd(t.d. seljara fyri at lutur er í lagi)[da.garanti]
ábyrgdarblaðstjóri	blaðstjóri við ábyrgd av blaði (3)
ábyrgdarbræv	(postm.)innskrivað bræv merkt "R"
ábyrgdarfullur	við stórari ábyrgd(arkenslu),ábyrgdarfullir borgarar
ábyrgdari	(búsk.)1ein ið veitir veð fyri e-m2fólk ið hevur sett ábyrgdarpening í sparikassa[da.garant]
ábyrgdarkensla	kensla fyri egnari ábyrgd og skyldu
ábyrgdarleysur	við ongari ábyrgd(arkenslu)
ábyrgdarloysi	tað at vera ábyrgdarleysur
ábyrgdarloysingur	ábyrgdarleysur persónur
ábyrgdarmaður	(løgfr.)ein ið gongur í ábyrgd fyri e-n[da.garant]
ábyrgdarmikil	ið leggur (mikla) ábyrgd á e-n,ábyrgdarmikið verk
ábyrgdarpeningur	(búsk.)peningur til ábyrgdar (trygdar) fyri e-m
ábyrgdarprógv	(búsk.)skrivligt prógv um ábyrgd (3)
ábyrgdartrygging	(trygg.)trygging ið tekur við ábyrgd av skaðagerð
ábyrgdarvandi	(trygg.)hættael.váði í samb. við trygging
ábyrgdarvitska	tilvit um ábyrgd
ábyrgdarøki	øki (2) sum ein hevur ábyrgd av,økini, ið frameftir gerast kommunal ábyrgdarøki heilt ella partvíst, eru barnavernd, stuðlar innan dagstovnaøkið, stuðul til umsorganararbeiði o.s.fr.
ábyrgdast	(óregl.)->ábyrgjast
ábyrgjast	taka ábyrgd av, svara fyri,ábyrgjast e-n;ábyrgjast lán fyri e-n
ábyrgsla	1ábyrgd,eg skal gera tað, men eg taki tað ikki í ábyrgslu2varðveitsla(við serst. ábyrgd),vit hava kannuna í ábyrgslu her í húsinum
ábyrgur	sum ber ábyrgd
ábæri	staður har sum ábært er, andglettur
ábært	opið fyri vindi, ástatt,har er (so) ábært;sbr.ábærur
ábærur	(sj.)opin fyri vindi,hagin er berligur og ábærur;tær ábæru brekkurnar;sbr.ábært
ábøting	umbót, ábót
Ádam	(bíbl.)mansnavn(eis.Adam[a:dam]ogÁdómur),(plfr.)Ádam og Evabørkubóndi(hann myrkur, hon ljós);(tilt.)nú er Ádam deyður(sagt tá ið e-t er liðugt sum hevur verið leingi í gerð)
ádamsskógvar	k flt37:í ádamsskómberføttur, skóleysur,ikki dámligt, at tey komu í ádamsskóm á veltu, tí tá skuldi veltan verða berlig um heystið
ádeinging	hørð ríðing
Ádómur	síÁdam
ádráp	váttel.dripið hoyggj uttan á sátuel.des, dráp 2;sbr.drepa (5)
ádrigin	(veðurfr.)við spjøddum skýggjum á luftini,ádrigið og regn;sbr.draga á luftina
ádú	(til at vísa undran o.tíl.)nei, álvara!
áðni	í áðni[ʊiˈjɔanɪ]fyri løtu síðan, nýliga
áðrenn	1sbfyrr enn, áður enn, innan 2(1),áðrenn langt um líður;flundran var komin undir høgg, áðrenn hann kom á føtur2fsfyri (12), undan (7),áðrenn døgurða
áður	1hjfyrr, í forðum,áður í fyrndinií avgomlum døgum;áður ennáðrenn (1)2sbáðrenn (1),(kvæð.)fyrri hugsaði tú fals og svik, áður tú mælti hetta
áðurnevndur	fyrrnevndur
áeggjan	tilstudling, eggjan, ákoyrsla
áfall	(kvæð.)brotasjógvur,har var brim og áføll stór;áfall var hitt mesta
áfallin	1ið sær bara gott við summum og ilt við øðrum,hann er so áfallin2(um metal)sum fallið er á,gullið er áfallið;sífalla á3(um turt kjøt)blámað,áfallið kjøt er einki borðprýði(RJ Ymist90)
áfast	fast (við),áfast við húsið
áfastaseyður	(stb.,sj.)áseyður
áfastur	1sum hongur saman (við), samfastur,hólmurin og oyggin hava verið áføst áður;áfastur viðfastur í;Ytstastova er áføst við húsini úti í Stovu2saman í bardaga (glímu)el.deiling,teir vóru áfastir3(um hund og tík ið makast),hundurin var áfastur við tíkina;tey eru áføst
áfatt	l h:vera áfattbila, vera galið,okkurt er áfatt;nú skilti hann, hvat áfatt var
áfella	áfelli
áfelli	(bát.)lítil hill millum bondini at leggja agn á(Ev);sbr.álag (5)
áfesti	(alisfr.)tað at e-t festist á, loðarel.tekur við(adhæsion)
áflatur	(heldur) flatur,summi gera drýlin áflatan;ærin hevur áfløt horn
áfløði	(jarðfr.)tað at sjógvurin skjýtur seg inn yvir land(tí at landið søkkurel.sjógvurin rúmøkist)[da.transgression]
áfok	(jarðfr.)vindborið tilfar ið legst á lendi
áfram	longri fram, áleiðis,halda áframhalda fram
áfýsn	lyst, trá, girnd,syndin kallar á tínar ringastu áfýsnir
ágangandi	1áleypandi, frekur,teir eru so ágangandi og ljótir í munninum2lh nút:koma ágangandikoma (av hending) framvið
ágangin	ágangandi (1)
ágangsmaður	álopsmaður, yvirgangsmaður
ágangur	1trýst, hóttan, hørð viðferð,plantan tolir nógvan ágang;standa stinnur móti útlendskum ágangi2pína, verkur,tá ið ágangurin var harðastur;hann liggur við ágang(eymkar seg)3har ið rákið er harðast,ágangurin fór skáldandi eystur eftir Fjørði;skipið fór gravandi gjøgnum allan ágangin;uttan fyri ágangin var nógvur seiður at fáa
ágarnarbruni	(lækn.)bruni í ágørnini(appendicitis)
ágáva	1samsýning fyri veittan beina[da.sportel, gebyr]2(søg.)skattur sum kongsbøndur skuldu lata triðja hvørt ár(avtikin við lóg 23. apríl 1897)
ágeingin	(upprfr.)->ágangin
ágerð	(alisfr.)kraft ið virkar á e-t,ágerð og andgerð[da.aktion]
ágirnd	sterkur hugur at fáa, grammleiki(eftir ognum)
ágiti	frægd, giti, umrøða (um e-n)
ágonga1	ágangur 1,órørd av allari ágongu
ágonga2	(stb.)skipan (av seyði)
ágongd	ágangur (1)
ágongdur	1ágangin,ósmæðið og ágongt2sum ein lættliga (av óvart) kann ganga seg á (og snáva um), árendur,steinurin er so ágongdur
ágonguseyður	(stb.)áseyður
ágóði	1serstakar sømdir, fyrimunur, umloysur (1),ein skipan, har teir fyrimunir og ágóðar, vit hava av at vera í ríkisfelagsskapi, eru varðveittir;skattgjaldarin hevði fingið fríar ágóðar, bil, íbúð, ljós og hita, og hann hevði ikki uppgivið hesar ágóðar á sjálvuppgávuni2vinningur(av handlio.tíl.),ágóðin av søluni fer til ungdómsarbeiði
ágrýtin	fullur av ágrýtni og virkishugi, virkisfúsur, íðin, raskur
ágrýtni	tað at vera ágrýtin, ídni, íðinskapur
ágørn	1ágarnarslintrur(4 í tali)á kalvagørnum;(tilt.)hetta er gott at fáa niður á ágarnarnar(niður á hjartað);sbr.skúvgørn2(lívfr.)blindtarmur, langabotnur (2)(á fólki)
áh	(til at vísa gleði, samkenslu og sorg)
áhald	áhaldni,eg átti ikki tykkara áhald
áhaldandi	1sum heldur leingi á, seigur2varandi, drúgvur,áhaldandi stríð, veðuro.s.fr.
áhaldin	áhaldandi (1)
áhaldingarblað	áhaldsblað
áhaldni	tað at vera áhaldin, seiggi;sbr.áhald
áhaldsblað	1(kortsp.)høgt kortablað(t.e. blað, ið vert er at halda á),fært tú eitt áhaldsblað, so fá tær gávuna2(flutt m.)hent hjálparamboð, álit,prukkan er áhaldsblaðið hjá mær
áhaldsi	e-t(jarn, træ el. tíl.)ein fær sær upp í hondina til verjuel.amboð
áhaldsin	1snáva á, misstíga seg,hann hevur verið áhaldsin og gliðin útfyri;vera áhaldsin á sporinumstíga skeivt og glíðael.snáva2ikki fáa fatur á, ikki røkka,hann var áhaldsin, og hondin glapp av og misti takið;hann var áhaldsin á seyðinumhann misti takið á seyðinum
áheitan	tað at heita á, bøn
áherðing	1dentur, tyngd, áherðsla(t.d. á e-t ið sagt verður)2(málfr.)herðing (3), trýst (3), tyngd (3),áherðing á fyrsta stavilsi
áherðsla	áherðing (1),leggja áherðslu á
áhildin	(Suð.)áhaldandi,hann svimur skjótt, men ikki er hann áhildin;veðrið er so áhildið
áhittin	ið dugir væl at finna uppá, uppfinningarsamur
áhoyrandi	hjí osb. sumtiltikin bæði áhoyrandi og avhoyrandi(bæði meðan hann var hjá og frá)
áhoyrari	ein ið lýðir á, lurtari
áhoyriligur	verdur at hoyra(Ev)
áhugabólkur	bólkur av fólki við somu áhugamálum
áhugaður	við áhuga, íðin(fyri e-m),vera áhugaður íel.fyri e-m
áhugafelag	felag av fólki við somu áhugamálum(sjónleiki, ítróttio.tíl.)
áhugaleikari	sjónleikari ið leikar av áhuga í fríløtum(ikki yrkislærdur);sbr.yrkisleikari
áhugaleysur	við ongum áhuga, líkasælur
áhugaloysi	tað at vera áhugaleysur, ansaloysi
áhugamál	1e-t sum hevur áhuga e-s2mál ið liggur e-m frammarlaga í huga, málevni ið ein vil fáa framt[da.interesse]
áhugamikil	sera áhugaður
áhugasamur	áhugaður
áhugaverdur	sum vekur áhuga, forvitnisligur
áhugi	hugur (fyri e-m), vilji (til at fáast við e-t),hava áhuga í e-m;hava áhuga á e-m;hava áhuga fyri e-m;eiga áhuga e-s
ája	so, meðni(sipar til uppgávu el. gremjing),ája, tungligt er;ája, ája, eg meini tað;ája, kom so meðni(jánkaslig játtan)
ájavnt	1í somu hædd sum, javnhøgt og, til hæddar sum,kovareisingin lá ájavnt við teigin oman fyri húsini;(flutt m.)koma upp ájavnt við danir2(sj.)javnfjart við, við síðuni til,húsini standa ájavnt við ánna
ájátta	geva samtykki sítt, játta
ájáttilsi	ájátting
ájátting	samtykki, játtan
áje	á Gud!
ájú	jú vist!
ákall	áheitan (á Gud), bøn
ákalla	heita á, biðja til,Harranum lovið, ákallið hans navn
ákallan	ákall
ákarði	ovari karði, yvirkarði
ákast	kast (eftir e-m),hatta var eitt ordiligt ákast, hann fekk(ein sátustein millum herðarnar);sms.jarð-
ákenn	tað ið ein kennir á særel.hevur varhuga av
ákenning	ákenn,skýmingin hevði eina nívandi ákenning í viðføri
áklæði	1(gl.)ullint vovið seingjarteppi;sbr.rekkjuváð2klæðing á húsgøgnum
ákoma	e-t ið er komið á(t.d.smitta, sjúka),tann, ið gav sær far um hesa løgnu ákomu
ákomandi	1l óbið hendir, kemur á,ákomandi brek2l óbbyrjandi,ákomandi gott lag3lh nút:ikki ákomandi(hjá fugli)ikki sleppandi á reiðrið(t.d. fyri ófriði)
ákomin	síkoma á
ákoming	(No.)staður(á sjónum)har ið eystfall og vestfall møtast
ákoyring	1tað at koyra á, skunda undir2serst.fltábreiðsla, deiling,hann fekk ákoyringarnar
ákoyrsla	áeggjan
ákæra1	uppáhald um at ein er sekur í e-m, kæra 1, klaga 1, kærumál
ákæra2	kæra, reisa ákæru ímóti, klaga 2(serst. fyri rættinum)
ákæri	(løgfr.)tann ið ákærir, atsóknari, áberi,móts.verji
ákærubonkur	í osb. sumsita á ákærubeinkinumvera ákærdur(í einum máli)
ákæruleysur	(løgfr.)ikki ákærdur(Tingb. 1615-5433)
ákærurit	(løgfr.)skrivlig ákæra 1 at leggja fyri rættin, klagurit
ákæruvald	(løgfr.)hitt almenna sum ákæri(hevur rætt til at seta fram ákæru í ávísum málum)
ál	1smøl leingjael.reim(serst. av húð el. roð),álur 2(1),(orðt.)gott er at rista breiðar álir av annans (annars) mans húð(um)tað er gaman í at gera sær til góðar av tí ið onnur eiga2húðál, stunga (á ongli)3bukt av neytahúð í endanum á bátslínu4rípa, strípa,eftir búkinum gongur ein smøl ál5tað seinasta av sjóvarfallinum í einum firði tá ið vent er við bæði londini, streymál, tráður (av streymi)6leingja sum hoyggj verður lagt upp í(í staðin fyri klúkar),sperðil (4),leggja upp í álir;sms. t.d.áttati-,húð-,onguls-,streym-
ál-	síal-
ála	1ríva, skræða(sundur í álir),ála sundur;ála (klæðini) burtur av e-m;gluggatjaldið er álað(skrætt, í lepum)2tað álar í streyminumtað er ógvuligur meldur í rákinum;tað álaði upp frá botni(bullaði ógvuliga í streyminum);sbr.áling
álag	1listiel.hill at leggja e-t á(t.d. fjøl negld upp undir loftsbitar),bókin liggur á álagnum2belti (6) um hjall innan3hellael.træ yvir smogu í seyðarætt, smogusteinur,álagið er ein hella;álagið er úr rekatræ(RJ Ymist67;70)4(bát.)tvørtræ sum leysabekkur hvílir á(Sv)5(bát.)fjøl skorðað millum knøini (6) at hava agn á;sbr.áfelli
álagdur	1sum lagdur er á,álagdar treytir;sekt, sum honum var áløgd;(bát.)stokkarnir vóru álagdir;(Suð.)við spent og álagtvið nógvari ferð, í størsta skundi(Sv);sbr.spentarál,áløgd2rúnabundin,malargrótið í Fámjin er álagt(flytur seg ikki);síleggja á
álagras	(plfr.)slekt í krossblómuætt(Subularia);sms.tjarnar-
álakálvur	(fisk.)lítil álur(heldur størri enn álvinda)
álakkur	(sj.,stb.)ein sum er uppi í øllumel.leggur seg út í alt, framligt fólk
Áland	oyggjaland millum Finnlands og Svøríkis
álandsvindur	vindur inn á land, havætt,móts.avlandsvindur
álaroðsla	slipa av áli,(fólktr.)álaroðslu út í drekka(móti drykkjulysti)
álasipa	1fleingja(við koyrli)(Sv)2harðlig deiling(Sv)
álaslipa	slipa av áli
álating	tað at lata (løg) á
álát	álating
álegging	1tað at leggja (línu) á,hann var oddamaður við áleggingini2tað at leggja (hendurnar) á,álegging handa mína3tað at áleggja (e-m e-t), (strong) boð,tænari hevði álegging um at nýta kalt vatn, um kongur vildi ikki vakna
áleggja	1geva (strong) boð, krevja,áleggja e-m e-t:hann álegði teimum ikki at siga nøkrum frá2(um greðing)makast við (ryssu),hesturin álegði ryssuna;ryssan varð áløgd(av hestinum);síleggja á;sbr.áløga
áleiðis	1á veg fram, á leið, ávegis,koma (e-m) áleiðisfáa í lag, fáa framt,tað, hin gamla kom áleiðis, var ikki mikið;ikki koma áleiðisikki koma útfyri,skipið kom ikki áleiðis at føra allar vørurnar2fs(sj.)áraka,marknasteinurin stendur áleiðis lyktarsteyran
áleikandi	sum leikar á, tíðarbærur,áleikandi spurningur[da.aktuel]
álendingur	fólk íel.úr Álandi
álendskur	íel.úr Álandi
áleypandi	1framførur, ágangandi, frekur2(um lit, mynstur)bramsligur, ágangandi;sbr.leypa á
áleypari	(ítr.)framherji
áliðin	útliðin
áling	(Suð.)streymhart øki, meldur av streymi,teir komu í eina øgiliga áling;seiðurin tekur best úti undir álingini;sbr.ála
álinjusamband	(teld.)samband á linju (3),bankin hevur álinjusamband(við teldumiðstøð)[en.online]
álit1	1tað at líta á (e-n), tað at trúgva (e-m), lít, troyst,hava álit á e-m2eginleiki hjá e-m(fólki el. luti)ið vekur álit,einki álit er í honumel.tí3tað ið ein hevur at líta á,sjógvurin var álitið;lærarar okkara, álitið hjá Føroya fólki
álit2	skrivlig frágreiðingel.meting(t.d frá nevnd ið hevur viðgjørt e-t mál),nevndarálit,nevndin hevur lagt fram álit um málið
álitis-	álítandi, ið ein kann líta á, dyggur,sms. t.d.-bátur,-fólk
álitisband	(bjarg.)band ið lítandi er á(t.d.til lesning),hetta verður ikki brúkt til álitisband aftur(hevði verið havt til rossatjóður)
álitisfólk	1álítandi fólk2fólk ið umboðar starvsfelagar sínar
álitisfulltrúi	(sj.)umboðsfulltrúi
álitiskvinna	1álítandi kvinna2kvinna ið umboðar starvsfelagar sínar
álitismaður	1álítandi maður2maður ið umboðar starvsfelagar sínar
álitismikil	sum hevur álit á øðrum, ið trýr øðrum væl
álitisprógv	(sj.)álitisváttan
álitisstarv	starv (oftaólønt) ið ein verður valdur til av fólki ið hava álit á e-m,formansskapurin er ólønt álitisstarv
álitisváttan	váttan um álit á e-m(serst. í stjórnmálum),tingið ger stjórnini álitisváttan
álits-	(sj.)álitis-
álíkna	s30:álíkna skattrokna út og áseta skatt
álíkning	1tað at álíkna skatt2tann skattur ið er álíknaður eitt fíggjarár,kommunan skyldar tvær álíkningar
álíkur	(kvæð.)sum líkist (e-m), líkur,álík var hon tygara brúður;vit eru tvær systrar álíkar
álítandi	at líta á, lítargóður, dyggur
áljósur	(óregl.)->alljósur
álka	(fugl.)slag av svartfugli(Alca torda);(tilt.)sum álkanillsintur;(tilt.)tað stóð sum millum álkuna og lomvigan(á jøvnumt.d.í kappróðri);sms.gras-
álkubøli	stað har ið álka eigur
álkuhol	(bjarg.)hol har ið álka eigur,hann legði fyri eitt álkuhol
álkukneppi	(Suð.)álkutyssi
álkuligur	l(skemt.)í osb. sumnú fer tað álkuliga at síggjast hjá okkumvit eru so smátt farnir at grána um vangarnar
álkunópur	(fugl.)krókur niður úr yvirnevinum á álku,álkunópur og skrápskrókur, tað havi eg hoyrt frá fyrnd, og aftasta klógv á lunda, tað eru trý skaðilig ting
álkupisa	(fugl.)pisa hjá álku
álkustebba	(fugl.)álkusteffa
álkusteffa	(fugl.)ung álka (veturgomul), urðnakona (2)
álkutyssi	tríggjar álkur samanbundnar, álkukneppi, álkuvørða
álkuvørða	álkutyssi
állabotnur	bleytur havbotnurel.mórubotnur við súgálli
álladrumbur	(No.,fisk.)lítil (ungur) állur, álakálvur, álvinda;sbr.maðkadrumbur
állakálvur	(Saks.,fisk.)álladrumbur, álvinda
álli	(Sørv.,fisk.)állur, álur
állur	(fisk.)langur mjáur fiskur(Anguilla anguilla);sbr.álur;sms. t.d.blank-,faks-,gul-,klænk-
álm	1álma (1)2álma (2)
álma	1eyga (4) á húki(sum teymurin verður drigin útí),álva 2(1), álv 1(1), álmur 22(stb.)flati endin á húki har ið bundið verður um, flíggj (2), álva 2(2), álv 1(2)(á húki við ongum eyga)
álmanakkaár	árið roknað frá 1. jan. til 31. des.
álmanakki	árligt rit við upplýsingum um dagatal í árinum, gongu sólar og mána, sjóvarfallo.a.;sbr.kalendari
álmunakkavís	(skemt.)í álmunakkavísí hópatali
álmunakki	álmanakki
álmur1	1(plfr.)leyvtræ í slektiniUlmus2viður av hesum træ
álmur2	(stb.)álma
álmussa	olmussa
álmviður	almviður
áloðin	(óregl.)->alloðin
álogandi	(óregl.)->allogandi
álop	1tað at leypa á, atsókn(t.d. í kríggi el. harðskapi)2(ítr.)1atsókn, roynd at fáa mál,málið kom í e-m skjótum álopi2leikarar sum leika frammi á vøllinum (og royna at fáa mál),móts.verja 1(2);sms. t.d.bumbu-,loft-,mót-,slys-,snar-,snið-
álopsherur	herur til álops
álopskendur	(ítr.)við denti á álopsspæl,liðið leikti álopskendan fótbólt
álopsland	land ið loypur á
álopsleikari	(ítr.)framherji
álopsmaður	maður sum loypur á;(flutt m.)hann er eingin álopsmaður(friðarligur, stillførur)
álopsmál	(herm.)bygninguro.tíl.sum ætlanin er at raka(í hernaðarligari atsókn),Big Ben var álopsmál hjá Al Qaeda
álopsmegi	megi til álops
álopsspæl	(ítr.)spæl sum fer fram í álopinum(t.d. hjá fótbóltsliði),móts.verjuspæl,teir vunnu dystin við góðum álopsspæli
álopsvápn	vápn ætlað til álops
áloypari	(ítr.)framherji
álur1	(fisk.)állur;sms. t.d.búgv-,faks-,hav-,súg(v)-
álur2	1reim(av húð el. skinni),ál (1),hevði tú verið flongdur við skørpum áli2mjáur geiriel.leingja á sjónum við hørðum ráki, strongur,(kvæð.)flotin kom frá Eystnesi gjøgnum álin harða;ein morreyður álur sást langt út á víkina;sms.streym-;sbr.ál (1),ál (5)
álutur	(sj.)ríputur, stríputur(Ev)
álv1	1álma (1)2álma (2)
álv2	(stb.)álvur 2
álva1	(gl.)alvi 3,leggja íel.á álvunakynda upp í smiðju
álva2	1álma (1),á stóronglum tóku teir oftast húðarstungu út í álvuna2álma (2),leggja um álvunaleggja um endan á húkinum tá ið hann skal rørast
álva3	álvamoy, álvafljóð,(skaldsk.)har sum álvan býr
álvabruni	(fólktr.)húðsjúka, útbrot, rivja
álvafljóð	(kvæð.)álvamoy
álvagras	(plfr.)áarmosi(ráð fyri álvareldi)(Conferva)(Landt455)
álvaland	(skaldsk.)land har ið álvar búgva
álvaleikur	(kvæð.)leikur hjá álvum(t.d. dansur og spæl)
álvalættur	ógvuliga lættur,Erla kongsdóttir komin er, álvalætt hon um garðar fer;ritur struku álvalætt framvið
álvamoy	(kvæð.)huldugenta
álvapíl	(stb.)álvapílur
álvapílur	leys lítil og kløn beinflís ið stundum er at finna í kjøtinum á langleggi á seyði(RKR Heimaráð72)
álvara	álvarsemi,móts.gaman,gaman og álvara;av álvararættiliga;nú eg av álvara fór undir at savna;gera álvara av (e-m)veruliga fara í holt við (e-t), fremja e-t í verki;hann gjørdi álvara av ætlanum sínum(setti ætlanir sínar í verk);siga, meina e-t í álvara(veruliga, av fullum huga);taka e-t í álvaratrúgva e-m(sum sagt er í skemti);tað er einki álvara í honumhann hevur onga ábyrgdarkenslu, er líkasælur;nei álvara!(at vísa at ein er bilsin el. ovfarin)at hugsa sær! hvat sigur tú!;sms. t.d.-fólk,-maður,-orð,-tungur
álvaramikil	álvarsamur,ein álvaramikil heimur;í slíkum álvaramiklum føri
álvarann	(kvæð.)álvabústaður, álvahús(t.d. í heyggi el. hóli),fann hann upp á eitt álvarann
álvaratos	1nakað ið sagt verður í álvara,at hetta var álvaratos, var einki at ivast í2hjsatt at siga,eg veit álvaratos ikki, hvat eg skal siga3mðlv(til at vísa at ein hevur mist tolið el. tá ið átalað/hartað verður)álvaratos!nú er ovboðið!;nei álvaratos, hvat ætlar tú?
álvareldur	(lækn.)eitt verri stig av sjúkuni eldkast
álvarhús	(kvæð.)álvabústaður;sbr.álvarann
álvari	(stb.)álvara
álvaringur	(plfr.)ringur (t.d.í vølli) av soppum
álvarligur	álvarsamur;hj-liga
álvarsamur	1fullur av álvara, álvaramikil,hon sat álvarsom og grundaði;hann var álvarsamur og brúnasíður á at líta;skemtisøgur og álvarsamar søgur;eitt álvarsamt evni;(flutt m.)teir álvarsomu tindarnir2(um hending, tilburð, sjúku o.a.)hóttandi, hættisligur, vandamikil,álvarsom sjúkaring sjúka
álvarsemi	álvara
álvarsligur	álvarligur
álvarsmál	mál sum hevur týdningel.er álvarsamt
álvarsmikil	1álvarsamur,so álvarsmikil standa fjøll2hættisligur,fjørðurin var álvarsmikil á at líta
álvarsorð	orðel.prát í álvara,lat meg tala eitt álvarsorð við hann
álvarstala	álvarsom orð(søgd við ein sum rættleiðast skal),pápi helt eina álvarstalu fyri mær
álvarstungur	tungur í huga, álvarsamur, dapur
álvaskot	1(pínufult) hald (8) í lendunum(sum sbrt. fólkatrúnni sigst koma av ørv sum álvur 1(1) hevur skotið)2(gl.)brek hjá kríatúrum(serst. seyði)av lítlari flís ið losnar í legginum og fer inn í mergin;sbr.álvapílur
álvheyggjur	(stn.,fólktr.)íbygdur heyggjur(har álvar búgva)
álvinda	(fisk.)lítil (ungur) állur(so lítil at hann er glærur),klænkál(l)ur
álvindi	(stb.)álvinda
álvindur	(stb.)álvinda,kvikur sum ein álvindur(um e-n ið er kvikur í viðbrøgdum el. til beins)
álvongul	húkur við álvu 2(1), ringongul
álvubein	(dj.)bein uttan á fótlegginum oman frá knæliðinum,álvubeini kundu fólk fáa skaða av, tá ið tey rotaðu seyðaføtur(RJ Ymist116)
álvuligur	1(stb.)sterkur, ramligur,ein álvuligur trífótur2ikki álvuligur1fjáltraður, ikki djarvur, illa við,vit vóru ikki álvuligir, tá ið vit skuldu niður fyri eggina at síga2ikki tespiligur, ógvuligur, øtandi,hann er ikki álvuligur at møta
álvur1	1(fólktr.,kvæð.)yvirnatúrlig vera sum býr í heyggjumo.tíl.(kann tøla menniskju og binda tey til sín),út kom ein av álvum tá;tann hin ríki álvur2(stb.)barn ið gift kona eigur við øðrum manni,hann er ein álvur
álvur2	(stb.)flati endin á húki, álv 2,røra um álvin
álvur3	(sj.)alvi (3) í smiðju
álýðari	áhoyrari
áløg	h flt6:taka ein í áløgunumsissael.teppa e-n (sum ilskast) áðrenn hann fær málið fyri seg
áløga	1á áløgum(sum vil makastel.gongur á graði),ryssan er á áløgum2evni ið legst á e-t(t.d. kálk innan um ketil)3(jarðfr.)tilfar ið legst á botn(og verður til legugrýti)[da.sediment]
áløgd	síáleggja (2)
ámannafatt	(stb.)áfatt
ámarkin	(um seyð)sum loypur upp um bøgarðarnar,menn hava havt geisla av grindahvali at kleppa seyð við, av tí at hann var ámarkin
-ámillum	sísín-
ámin	(gl.)amen
áminna	minna á, vara (e-n) við,hann áminti fólkið, so tey løgdu avgudadýrkanina av
áminni	h24:til áminnistil minnis,hann gav henni ein lut til áminnis;eg goymi hetta til áminnis um faðir mín
áminniligur	verdur at minnast, minniligur
áminnilsi	áminning
áminning	1ávaring, viðvaring, áheitan,(bíbl.)alið tey upp við aga og áminning Harrans2tað at minnast aftur á, minni,(bíbl.)gerið hetta til mínar áminningar;til áminningar um vitjanina
áminningarbræv	bræv til áminningar um e-t sum ein hevur gloymt at gera(serst. at gjalda e-t),rykkjari
áminningarskriv	áminningarbræv
ámmin	mðlví osb.ámmin og júgv eftirgævi tað verður so(Sv);hann hevði ikki annað at siga til hetta enn júgv og ámmin eftir(samtykkja)
ámót	1e-t ið ber ímóti, e-t ið forðarel.tippir(t.d. ein knortil)2nakki(t.d. á jarnbroti)
ámæla	bíta (e-n) í bak, spilla út, baktala,aldri ámælti hann óvinir sínar
ámæli	1bakbit, útspilling, baktal,(tilt.)ámæli doyr ikki(kemur e-m aftur um brekku)2orð (7), giti, ummæli (4),annars hevði ámæli hansara ikki verið so frægt, sum tað er
ámælisorð	brigsl, skuldseting
án	eitt lítið sindur, eitt vet,tað er eina án størri enn í fjør
ána	gruna, vara, hóma, hava varhuga(n) av,eg áni tað ikkieg havi ikki hóming av tí
ánaraskifti	tað at ogn skiftir ánara
ánari	ognari, eigari, eigarmaður,vera ánari at e-m
ánám	1e-t sum møtirel.stendur ímóti,tað er eitt ánám í kjølinumel.í bitanum;fáa ánám ásleppa at,flugan fær ikki ánám á kjøtið, tá ið tað er skránað;brimið fær ikki ánám á garðin;sbr.ánæmi2(í grótlaðing)flati oman á umfari (3),hav nú ánámið so slætt, at tað laðast afturá aftur3lítið øki(har sum nakrir fáir seyðir kunnu ganga)4tekin um at kúgv er til tarvs,tað var eitt ánám á kúnni
ánámi	ánám
áneyðir	orsøk (av týdningi), grund,hann helt ikki, at áneyðir vóru fyri tí;tú hevur ongar áneyðir at gera tað
ánilsi	1kensl, varhugi, grunur,hann hevur so gott ánilsi2kám vitan, hóming,hann hevði ikki ánilsi av tí(visti als ikki av tí);hann hevði ikki ánilsi um, hvar hann var staddur
áning	ánilsi,hann var fullur av pátrúgv og áningum
áningarsamur	(stb.)sum órar ilt
Ánir	(stn.)bygd í Borðoynni,í/úr Ánunum,(norður) í Ánirel.Ánirnar
ánir	(sj.)vánir
ánæmi	1e-t sum møtir, forðarel.stendur ímóti(listi, kantur o.tíl., t.d. listi á durastavi til hurð at ganga ímóti),hann meitlaði sær eitt ánæmi í ta skráu helluna, at steinarnir skuldu ikki rulla á sjógv2knasti, kneysi(t.d. í bergi),hann gleið, men fekk eitt ánæmi fyri fótin, so hann steðgaði;ánæmi í berginum har ritan byggir sær reiður3hakk(t.d. í fleygastong at binda um tá ið netið verður íbundið),telg mær eitt ánæmi á hetta4fyrsta merki(um slit el. burturmatan),ánæmingur (2),nú hevur áin fingið ánæmi á5(Suð.)tað at kenna á sær, varhugi,fáael.hava ánæmi av e-m;eg havi ánæmi, at ein flundra er við snørið;sbr.andnæmi,ánám
ánæmingur	(sj.)1nýásett arbeiði2nýkomið merki um slit, ánæmi (4),tá ið tað fyrst hevur fingið ánæming, fer tað skjótt
áogn	(búsk.)tað at eiga e-t á,rentur av áognum
áognari	ein sum eigur e-t á(hjá øðrum),ognari (2)[da.kreditor]
áognarseðil	(búsk.)uppgerð viðv. aftursendari vøru, ikki veittari tænastu, avsláttio.tíl.[da.kreditnota]
ápok	(sj.,stb.)tað at mánin er longst frá jørðini(apogæum),móts.perikel.pering(ur)
ápostlasøga	1(bíbl.)Ápostlasøganbók í Nýggja testamenti(um lív og virki ápostlanna)(Acta)2(bókm.)ápostlasøgurhalgisøgur um Jesu ápostlar(týddar til norrønt í 12. øld)
ápostolskur	(kirkj.)sum tilhoyrir ápostlum Jesuel.er runnin frá teimumel.starvi teirra,ápostolska signinginserstøk signing eftir prædiku: "Latum okkum við ápostlunum ynskja hvør øðrum ..."
ápostul	1k21(bíbl.)sendiboð, lærusveinur(ein av teimum tólv lærusveinum Jesu),Pætur ápostul2(skemt.)gongulimur á fólki,eg brúki ápostlarnar(fari til gongu)
ár1	(bát.)amboð at rógva við,árin hevur lumm, legg, kálva, blað og skeytar;bera ár á borði(vera førur fyri at) rógva;hann dugir ikki at halda á ár(dugir ikki at rógva);halda í árarnarrógva spakuliga, damla;farael.setast til árarel.leggja út árarel.fara undir árarsetast at rógva;leggja árar í sjógvfara at rógva;(stb.)koma undir árinavera noyddur at rógva(í staðin fyri at sigla);lætturel.góður undir árini(um bát)lættur at rógva, eyðførur;(tilt.)leggja allar árar í sjógvel.útkýta seg, spenna seg út;leggja árarnar inn1gevast at rógva2leggja frá sær, gevast3andast, doyggja;stýra við ár1nýta ár at stýra við2(skemt.)vera dýrandi fullur, vingla(av fyllskapi)
ár2	1tólv mánaða tíðarskeið, 365 til 366 dagar,árliga ársá hvørjum ári;at árinæsta ár;ikki ganga av ári(num)ikki liva árið út;ár eftir árár um ár;í árhetta árið;aftur í áriðtil somu tíð næsta ár,hann livdi ikki aftur í árið;hundur veksur aftur í árið;ár um árel.ár undan árifleiri ár á rað;tað er bæði ár og dagur síðani(langt síðani)2aldur,á fimm ára aldri;seks ára gamal;árini eru kominein er vorðin gamal;vit ganga á einum ári(eru javnaldrar);verael.ganga á sjeynda árivera seks ára gamal;í ungum árum;í góðum árumí góðum aldri;í bestu árum(tá ið fólk er í besta arbeiðsføra aldri);væl til ársvæl við aldur;(stb.)detta niður millum árinisova nýggjársaftan og inn í nýggja árið(sagt skemtandi við børn)
árabátur	(bát.)róðrarbátur
árabil	áramál
árabløðra	bløðra í lógvanum(av hørðum róðri)
árafetil	fetil at lætta um róður 1(fetilin lá um herðarnar undir koti el. troyggju og fetlatogini oman gjøgnum ermarnar við buktum um árarlummarnar);sbr.børufetil
áragamal	fleiri ára gamal
áragangur	áraskrambl
áraglint	áraskrambl,har hoyrdist bara róp og áraglint
áraka	beint yvirav,áraka hoyggjhústakið
áraknarr	knarr av árum(tá ið tollur og borðskeyti eru turrir)
áralag	tað at áratøk fylgjast regluliga,gott/ringt áralag;havið nú so gott áralag;røðararnir halda ikki áralag;sbr.róðrarlag
áralangur	sum varir í nógv ár 2,áralangt stríð
áraleið	(stb.)leið har ið farandi er við árabáti;sbr.bátaleið
áraleysur	(á báti)við ongum árum
áramál	fleiri ár á rað, áratal,eitt ásett áramál
áramálssettur	settur (í starv) í eitt avmarkað tíðarskeið,stjórin er áramálssettur
áramót	tíð tá ið eitt ár endar og annað tekur við, ársskifti
áraplanki	(bát.)viðarplanki at gera árar úr
árarblað	(bát.)fremsti áflati parturin á ár, blað,tað sást ikki út um árarbløðini(tjúkt í kavaroki)
árarleggur	(bát.)leggur á ár(millum kálva og lumm)
árarlongd	(bát.)longd á ár,á fýramannafari er árarlongdin hálv bátslongd
árarlummur	(bát.)lummur (handfang) á ár(o.u. 20 cm langur)
áraróður	(stb.)róður so nær landi at árarnar ganga fríar
árarskeyti	(bát.)eikistykki til verju á ár(har hon liggur móti tolli og borðskeyta),árarskeytarnir (undirskeyti og yvirskeyti) eru úr eik og verða negldir á árarleggin
árarúm	(bát.)rúmel.pláss fyri árunum(millum bátin og land),teir róðu ofta so nær, at teir bert høvdu árarúm
árarúmd	árarúm
áraræði	ræði á báti í róðri,hann misti alt áraræði á tristinum
áraskrambl	skramblel.óljóð av árum(tá ið róð verður),áraglint
áraskrambul	áraskrambl
áraslag	áratak,við seigum og sterkum árasløgum
árasláttur	áraskrambl
árasmiður	maður ið ger árar
árasprek	(bát.)(lítið) áratræ
árastokkur	(bát.)stokkur at gera árar úr
áratak	tað at flyta árina í sjónum aftur við bátinum, tak við ár,taka áratøk
áratal	áramál, tíðarskeið,í eitt áratal
áratíggju	tíggjuáraskeið,eftir fáum áratíggjum
áratræ	(bát.)træ at gera árar úr
áratúsund	túsundára tíðarskeið, ártúsund
áravørrur	vørrur av árasløgum
áráðin	(gl.)sum er avgjørdurel.hevur tikið støðu til e-t,vit eru árádnir at seta okkum í vága
árás	álop, atsókn,føroyingar hava ligið undir árásum av sjórænarum og øðrum ófriðarkroppum
árásin	ógvisligur, rokmikil
árborin	(sj.)nýføddur,í hesum merkiliga árborna sólarljósi
árbók	ársrit
árdegis	tíðliga, við degnum
árdømi	eirdømi
árend	1herðindi,árend av ørskapi2álop(t.d. av flogførum)3stormur,ein slupp lá har árendirnar vóru eina harðastar
árendur	1sum ein lættliga kann renna á,grynnan er so árend;sbr.ágongdur (2)2(bíbl.)álopin,eg árendur varð og komin var til fals3ákoyrdur(t.d. av bili)
árfesta	seta árstalið á (e-t)
árgangur	1(um bløð og tíðarrit)alt sum kemur út í einum ári2hópur (1) sum verður útskrivaður samstundis (úrt.d.skúla),studentaárgangurin 19903(um ávísan fiskastovn)allur tann fiskur sum verður gýttur eitt ár,góður (ringur) árgangur
árhundrað	øld(100 ár)
ári	hj:(í) morgin árií morgin tíðliga, við degnum í morgin
árin1	ávirkan,tað hava eingi sjónlig árin verið;sms. t.d.eyka-,hjá-,vakstrarhús-
árin2	(kvæð.)árnur, eldstaður
árin3	ári,í morgin árin
árinamikil	sum hevur stórt árin (á e-t)
áringur	(stb.)1kornár,góður/ringur áringur2ársgrøði av korniel.eplum3árgangur (2)(t.d.av konfirmantum)
árini	ári,í morgin árini
árinskanning	tað at kanna avleiðingarnar av inntrivit.d.í náttúruna,yvirfriðingarnevndin krevur, at SEV skal gera árinskanningar, áðrenn hon tekur støðu til, hvørt elfelagið skal fáa loyvi at halda fram við vatnorkuútbyggingini
árit	1váttan, átekning,limirnir mugu hava árit um sjúku2áskrift,árit varð sett á minnisvarðan3árit á ferðapassinnferðarloyvi[da.visum]
árínandi	(stb.)áríniligur,regnið var so árínandi, at eg varð ígjøgnum
áríniligur	sum rínur við,ælið er áríniligt(ein verður so skjótt vátur av tí)
áríning	árin, ávirkan
árla	tíðliga (á morgni), snimma,árla á morgni;árla risintíðliga á fótum;(tilt.)hann, ið árla rísur, verður um mangt vísur
árlaður	l6:hann er so árlaður(tíðliga uppi og úti)
árlangt	alt árið, fyri árið;eis.í árlangt
árliðið	liðið út á árið,nógv (lítið) árliðið
árliga	um árið,ár og árliga;árliga árshvørt ár, ár um ár
árligur	1sum hendir hvørt ár, ið er á hvørjum ári,tann árliga útferðin2sum geldur fyri eitt ár,tær árligu útreiðslurnar3(um veður)sum hóskar til árstíðina,tað er so árligt í morgun(stilt og klárt í veðrinum)4hugnaligur, vakur,tað er so árligt, tá ið sólin sær inn;árligt er at hoyra fuglin syngja5birgur,hon er vorðin so árlig aftur(hevur ment seg aftur);hj-liga
árlongd	longd á ári,leigan er fyri árlongd
árna	s30(stb.)árna segárnast,tað árnar seg alt væl
Árnafjørður	(stn.)bygd í Borðoynni,í/úr Árnafirði;til Árnafjarðar
árnast	(um grøði og fenað)roynast, vignast,gæsnar árnast væl;var halin einir átta ungar, segðist bøgan at árnast væl;súlan var ikki væl árnað í ár;tað er væl árnað(fruktar væl, nógv lomb og nógvir ungar, góðir akrar og góð epli)
árnfirðingur	fólk íel.úr Árnafirði
árnhella	(gl.)hella undir fýrstaðiel.eldstaði
árnur	(gl.)eldstaður, grúgva(serst. kulla til gløðurnar),nú er útkalt, eingin eldur á árninum
árógvin	sum ein lættliga kann rógva á, árøddur,boðin er so árógvin á fjøru
árrisin	(sj.)árla risin, tíðliga uppi
ársaðalfundur	árligur lógásettur fundur (í feløgumo.tíl.) fyri allar limir;sbr.aðalfundur
ársarbeiði	arbeiði ið tekur eitt árel.skal gerast í eitt ár
ársavlop	(búsk.)nettoavlop í ársroknskapi
ársbil	eitt ár, ársskeið 2
ársbók	árbók, ársrit
ársbrenni	brenni (torv) í eitt ár, árstorv,summir vóru so fyrivarnir, at teir altíð áttu eitt ársbrenni niðurfyri
ársbrúk	tað sum brúkt verður í eitt ár(t.d. av eplum el. torvi)
ársbyrjan	byrjan at ári
ársdagur	sami dagur fyri einumel.fleiri árum síðan(ávísur dagur tá ið onkur serlig (stór)hending fór fram),ársdagurin fyri fólkaatkvøðuna;á jólum halda vit heilagt hansara ársdag;hetta er ársdagurin, vit vóru í fjør
ársendi	árslok
ársfjórðingur	fjórðingur av ári, fjórðingsár,januar-;apríl-;juli-;oktober-
ársfóður	(bún.)fóður til eina kúgv í eitt ár
ársframleiðsla	framleiðsla gjøgnum eitt ár
ársfrágreiðing	frágreiðing um virksemio.tíl.í farna ári
ársfundur	árligur fundur hjá felagsskapiel.samkomu
ársføði	tað sum ein hevur at liva við í eitt ár,ársgrøði er ársføði
ársgamal	1sum er eitt ár gamal,barnið er ikki ársgamalt2veturgamal(t.d. um seyð)
ársgerð	(sj.)ársarbeiði,(tilt.)eygað er betri enn ársgerðinútsjónd og røkjuskapar eru ikki minni verd enn arbeiðið sjálvt
ársgildi	ársveitsla
ársgjald	árligt gjald til felagel.felagsskap fyri limaskap[da.kontingent]
ársgróður	(plfr.,sj.)ársplanta
ársgrøði	grøði frá árinum,onkur plagdi at hava føroyskan drýl við av ársgrøðini;(orðt.)ársgrøði er ársføði
árshelmingur	hálvt ár
árshúsagras	(plfr.)slag av húsagrasi(Poa annua)
ársinnløga	innløga gjøgnum eitt ár, árlig innløga
ársinntøka	inntøka gjøgnum eitt ár, árlig inntøka
árskjøt	skerpikjøt til eitt ár,árskjøt skuldu tey altíð hava niðurfyri
árskorn	korn til eitt ár,vanligt var at hava (eitt) árskorn niðurfyri
árskringur	(sj.)(í viði)viðing
árslega	(gl.)sjúkulega í eitt ár
ársleiga	leiga fyri eitt ár, árlig leiga
árslok	síðsti dagur í árinum, ársendi,við árslok
ársløn	løn í eitt ár
ársmet	(skúl.)støðumet við skúlaárslok
ársmót	sama tíð næsta árel.árið eftir,sama dagin aftur í ársmótið;sbr.áramót
ársmøti	ársfundur
árspeningur	árlig peningaveiting til tignarfólk(t.d. kong)[da.apanage]
ársplanta	(plfr.)planta sum livir eitt ár(annuel);sbr.ársgróður
ársrit	bók(lingur)el.rit ið kemur út eina ferð um árið
ársroknskapur	(búsk.)roknskapur fyri (farið) ár, ársuppgerð
ársroynd	(skúl.)árlig (ikki endalig) roynd(at vita hvussu støðan hjá næmingi er)
ársská	ársskái
ársskái	1(bún.)(um seyð)lívføri í eitt ár afturat,tað er ikki meir enn ársskái á hesari(má takast næsta ár)2(stb.)lítið hald, eingin haldgóðska(t.d. í kjóla),tunt sum eyrriðanet, ikki ársskái í tí, men dýrt sum fjandin sjálvur
ársskeið	(skúl.)1námskeið(sum varir eitt skúlaár)2tíðarskeið ið varir eitt ár, ársbil,drongurin var á garðinum eitt ársskeið
ársskifti	áramót
ársskurður	(bún.)skurður(t.e. kjøt av seyði)frá árinum,tey rørdu ikki ársskurðin, men ótu tvey og trý ára gamalt kjøt
ársspring	(stb.)ársbrúk(av kjøti, korni, torvi o.tíl.),at hava tvey ársspring av skerpikjøti niðurfyri varð gjørt fyri at kunna tola komandi ringt seyðaár
árstal	tal ið sýnir hvussu mong ár eru liðin frá tí at tíðarrokning byrjar(í kristnum londum frá føðing Krists)
árstíð	partur av árinum (eyðkendur av serstøkum veður- og vakstrarlíkindum),hinar fýra árstíðirnar eru vár, summar, heyst og vetur;arbeiðið fór nógv eftir árstíðunum
árstíðarbundin	bundinel.treytaður av árstíðini,sildafiskiskapurin var árstíðarbundin
árstorv	ársbrenni av torvi
árstøð	tøð frá einum ári,tað eru eini tvey árstøð í køstinum
ársungi	ársgamal ungi,fuglurin var ikki nakar ársungi longur, hann hevði livað tveir vetrar av sær;(flutt m.)eingin ársungivæl við aldur
ársuppgerð	uppgerð fyrit.d.inntøkur og útreiðslur í farna ári, ársroknskapur
ársurt	(plfr.)urt ið livir eitt ár, ársplanta
ársveitsla	(stór) veitsla eina ferð um árið(serst. hjá feløgum, virkjum o.tíl.)
ársverk	1ársarbeiði2arbeiðsorka hjá einum fólki í fulltíðarstarvi í eitt ár
ársvikarur	(skúl.)vikarur eitt skúlaár í senn
ársvinna	ársarbeiði
ársvinningur	1ársinntøka2avlop í eitt ár,felagið leggur helming av ársvinninginum í grunnar
ártíggju	tíggju ára skeið, áratíggju
ártímiligur	1(um veður)sum hóskar til árstíðina, sum er eftir árstíðini,á mariumessu um várið skal kunna vera ártímiligur mjørki2sum (aftur og aftur) hendir ávísa tíð á árinum,kúgvin er ártímilig(er til tarv(s) í rættari tíð aftur í árið)3(stb.)íheimligur, hugnaligur;hj-liga
ártúsund	túsund ára skeið, áratúsund
árundaður	sneiddur, árundur, kúputur,bátarnir eru nú meiri árundaðir í botninum
árundur	árundaður
árunt	í kring, kring um, runt um, umhvørvis,alt árið árunt;tríggjar ferðir varð rógvið árunt sólarrætt, áðrenn lagt varð á fjørðin;hann letur fingurin fylgja fjallagreinini árunt;hann hyggur árunt í stovuni
árvakin	1sum er tíðliga vakin2eftiransin, gáin, skettin
árvissur	sum hendirel.kemur aftur hvørt ár,í flestum bygdum eru epli árviss grøði
áræði	mót, dirvi, treyst, treysti
áræðin	sum hevur áræði, djarvur, vágin, gjøðin,ungur og áræðin
áræðismaður	maður ið hevur áræði, áræðin maður
áræðismikil	sum hevur mikið áræðiel.dirvi,hann var treystur og áræðismikil
áræsin	1ágangandi, árásin, áleypandi,skiparin tók í armin á honum og gjørdist áræsin2ágrýtin, íðin
áræsni	tað at vera áræsin
árætta	1seta kíla í enda á e-m at halda tí føstum við(t.d. trænagla, rívutindi, hamarsskafti o.tíl.),teir settu naglan í og árættaðu hann aftaná2(sj.)beina(á rætta leið),fólkið má sjálvt árætta skúlan
árættari	árætti
árætti	kíli í endanum á e-m at halda tí føstum við(t.d. trænagla, rívutindi, hamarsskafti o.tíl.);sbr.árætta
árøddur	árendur(sum ein tí lættliga kann rógva á),skerið er so árøtt
árøring	(stb.)útágerð,er súpanin ov tunn, gera vit bara eina árøring útá
ás	1træ í hjalli at heingja kjøt á, ásur 2(2)2(á rokki, hjóli o.tíl.)nokki, aksil;sbr.ásur 2(5)3(støddfr.)uppás og útás(í krossskipan)
ásaka	skuldseta, ákæra, leggja (e-n) undir,(bíbl.)teir ilskaðust inn á Móses og Áron og ásakaðu teir fyri at hava gjørt ilt verri
ásakan	skuldseting, ákæra
ásamt	hj:koma ásamtsemjast;koma ásamt við e-n;koma ásamt um e-t;eis.á samt,sísamur
ásamtkoming	tað at koma ásamt, semingur, semja
ásanna	viðganga, játta, vátta, vera við,eg mátti ásanna, at hann hevði rætt
ásannan	váttan, staðfesting, viðurkenning
ásanning	ásannan
ásaroyting	síáseyðaroyting
ásarveldi	(søg.)stjórnmálasamstarv millum Týskland og Italia í seinna heimsstríði (og fyri)
ásatrúgv	trúgv norðbúgva á æsir(undan kristindóminum);sbr.ásur 1
áseta	gera av, fastseta,áseta við løgtingslóg;sbr.seta á
ásetan	áseting
áseting	e-t ið er ásettt.d.við lóg, fastseting, fyriskipan, regla,áseting varð gjørd um byrsuhald
ásettur	1fastsettur, avgjørdur,koma ásetta tíð;ásett áramál;eftir ásettum treytum2sum farið er at taka (eta, skera o.tíl.) av,krovið er ásett;útihoyggj, sum sjøtul er ásettur;síseta á
áseyðaroyting	1tað at royta áseyðin, (ullar)royting,her varð altíð rikið tvær ferðir í áseyðaroyting2tann tíðin á sumri tá ið áseyðurin verður royttur, (ullar)royting
áseyðaskipan	skipan (4)
áseyðatal	tal á áseyði, skipan
áseyður	1skipan (4) av seyði í hagael.hagaparti, ágonga, ígonga, ígangur,til miðalmørkina í Føroyum roknast einir 30 áseyðir2(gl.)ærseyður
áseyma	(handarb.)seyma á klæði ymislittar myndir og mynstur klipt úr øðrum tilfari(til prýðis),áseymað mynd[da.applikere]
áseyming	(handarb.)tað at áseyma[da.applikation]
Ásgarður	(gudal.)bústaður hjá ásum 1
Ásia	Asia
ásia	(plfr.)slag av gurku í slektiniCucumis(vanl. súltað)
ásigldur	sum siglt er á,vit vórðu ásigldir;skipið varð ásiglt
ásigling	tað at siglt verður á
ásin	(dj.)asni, esil
ásíggiligur	verdur at síggja, vakur í útsjónd, ásýniligur (1)
ásjón	1andlit2útsjónd,fríður í ásjón;grefligur í ásjón;ljótur í ásjón;(bíbl.)ásjón hansara var sum snarljósið
ásjónd	ásjón
ásjónligur	vakur, bæriligur,bæði førligur og ásjónligur
áskeyti	(bát.)árarskeyti ið liggur at tollinum í róðri, yvirskeyti, fyriskeyti, bakskeyti,móts.undirskeyti
áskipan	tað at taka vørut.d.inn í vøruvogn,móts.avskipan,av- og áskipan loyvd
áskoðan	hugsan, meining, tykki,við somu áskoðan;við at lesa hesa bókina fekk eg aðra áskoðan á Gamla Testamenti;á hendan hátt arvaði kirkjan eisini eina áskoðan um kvinnuna
áskoðari	ein ið hyggur at(t.d. sjónleiki, fótbólti o.ø.),athyggjari
áskot	1mold sum verður løgd oman á,í reinavelting varð áskot lagt oman á tøðini;var ov lítið av mold, bóru teir áskot á, fyri at dýpið kundi verða so frægt, at epli kundu setast niður2mold, dýpd,nógv áskot;lítið áskotgrunt,har var so lítið áskot, at ikki var veltandi
áskrift	tað ið skrivað er á e-t, árit (2), innskrift
áskriva	(búsk.)avhenda (virðisbræv, kekk, veksilo.tíl.) við at skriva á baksíðuna[da.endossere]
áslag	beslag
ást	kærleiki, tokki, hugur,bera ást til;bindael.leggja ást við;har runnu ástir saman;(skaldsk.)løgdu sínum ástum saman;(orðt.)ást fjalir lýtikærleikin umber;(kvæð.)tungt er at leggja ást við hann, ið onga leggur ímóti
ástaðarfundur	1(løgfr.)fundur "á staðnum" millum partar í rættartrætu,bóndin í Kollafirði undrast á, at yvirfriðingarnevndin hevur havt ástaðarfund við Leynará, uttan at hann, sum partur í málinum, fekk fundarboð2(handv.)fundur á byggiplássi í smb. við útboð av arbeiðumel.um arbeiði sum eru í gerð,ráðgevararnir og handverksmeistararnir avtalaðu ástaðarfund;avtalað varð at halda ein fund á staðnum sama dag, og á hesum ástaðarfundi, har tekniski stjórin ikki luttók, varð staðfest, at vegur uttan stórvegis trupulleikar kundi gerast;sbr.ástaður
ástaðis	til staðar, á staðnum,hann var sjálvur ástaðis
ástaðna	(sj.,stb.)seinnapartin,tað hevur ongan skund, tú kanst koma ástaðna
ástaður	(løgfr.)staður sum rættarmálel.-træta snýr seg um
ástandur	støðael.standur,hin politiski ástandurin fyri 100 árum síðan
ástar-	kærleiks-,sms. t.d.-band,-bræv,-fullur,-kensla,-kossur,-kvæði,-lív,-orð,-skald,-skaldsøga,-sorg,-søga,-ylur,-yrking
ástarbragd	(kvæð.,skaldsk.)kærleiki, kærleikajáttan, váttan um kærleika,við heitum ástarbragdi
ástarbrek	(gl.)hjartasorg (1)
ástarfundur	tað at tvey sum eru góð hittast
ástargerð	holdsligur ástarleikur
ástargudinna	(gudal.)gudinna fyri ást
ástarhugi	ástarhugur
ástarhugur	kærleiki, tokki
ástarleikur	kærleiksleikur,nú er eingin ástarleikur, eingin klekjandi bøga at hjúkla uppi yvir
ástarljóð	yrking um kærleika
ástarmál	málel.spurningur viðv. ást
ástarsamband	samband (millum tvey) borið av kærleika
ástarskaldsøga	(bókm.)skaldsøga um ástarmál
ástarsøga	kærleikssøga
ástartokki	kærleiki, yndi, góðvild
ástartrá	sterkur ástarhugur, longsil
ástarvinur	unnusti, unnusta, elskaður vinur
ástarøvund	øvund elvd av ást, eljusjúka, svartsjúka
ástatt	ábært,har er so ástatt fyri vind;har er ástatt á summum ættum
ástig	pedalur, føtil
ástkærur	sum er e-m kærur,ástkæra mín;ástkæru fosturoyar
ástmoy	(skaldsk.)unnasta, hjartavív
ástoytingarsteinur	1snávingarsteinur2e-t sum ampar, forðan, meinbogi,leggja ástoytingarstein fyri e-n
ástoyttur	1skjótur at fáa stoyt,lítlifingur er ikki so ástoyttur sum hinir fingrarnir2árendur,har er so ástoytt(skjótt at renna ímóti)
ástoytur	e-t sum argar, meinbogi,tað var til stóran ástoyt hjá næstrafólki teirra
ástreinging	tað at streingja á, ágangur,stjórnin hevur verið fyri ástreingingum
ástríki	(bíbl.)kærleiki, alskur,fyri ástríki Harrans at skoða
ástríkur	(bíbl.)kærleikafullur, alskin
ásttikin	sera góður við, skotin í, burtur í, forliptur, forelskaður
ástvinur	ástarvinur
ástøði	1tilhugsan grundað á kanningar og rannsóknir2bóklig læra um e-t evni, yrkiel.vísindi[da.teori];sms. t.d.tilmunar-,vísinda-
ástøðiligur	viðv. ástøði;hj-liga[da.teoretisk]
ástøðingur	ein ið hugsar útel.skilur ástøði[da.teoretiker]
ástøðumaður	(løgfr.)fólk valt av tveimum ósamdum pørtum at taka avgerð um trætumál í gerðarrætti[da.opmand]
ástøtt	(stb.)ábært, ástatt,her er so ástøtt
ástøvund	ástarøvund
ásur1	norrønur gudur(sum sbrt. gudalæruni búgva í Ásgarði),teir kendastu æsirnir eru Óðin og Tórur
ásur2	1bjálki, mønutræ2(í hjalli)træ sum krov verða hongd á at turka, kjøtásur, ás (1),krovini vórðu hongd upp á spritu tvørtur um ásin;hann hevði tikið skerpikrov undan ásinum3kjøtið ið hongur á ásinum í hjallinum,tað verða ikki langir ásarnir í heyst, varir hetta við4kilpur, honk á (træ)byttu5stong sum hjól melur um, nokki, aksil,ásur er tað, ið rokkahjartað melur á6(gl.,sj.)lágur fjallaryggur
ásynja	(átr.)norrøn gudinna;sbr.gyðja
ásýnd	(bíbl.,sj.)útsjónd, skap,Harrin broytir ásýnd jarðarinnar
ásýni	(sj.)tað ið sæst, útsjónd
ásýniligur	1vakur, ásjónligur,tá ið ungin er komin úr egginum, er hann lítið ásýniligur, nakin og dimt hold2sjónskur, sjónligur, eyðsæddur,hann býr í hasum ásýniligu húsunum;lendingin er ásýnilig enn(sæst);tað var ásýniligt fyri øllum, at bóndin sýndi honum meira blíðskap enn øðrum;hj-liga
ásýnligur	ásýniligur;hj-liga
ásýnur	sum sæst (væl), ásýniligur (2)
ásætisrættur	(løgfr.)ávísur arvarættur til (at sita við) jørð,ásætisrættur var, tá ið elsti sonurin fekk garðin, hóast hann bert hevði rætt til ein part av honum(nýtslurætt til garðin)
át1	tað at eta, eting, matarát,(stb.)fleyga gamlan havhest til át;sms. t.d.av-,kjøt-,matar-,ov-,ó-
át2	síeta
áta	(Suð.)æti,ritan fer langan veg eftir átuni
átak	1tað at taka (hart) áel.leggja nógva orku í(t.d. í róðri),teir høvdu tey dýrastu átøk at rógva;brimið var hart í átøkum2serst.flttað at (vilja) spýggja,hon lá við átøkum3(ným.)miðvísar gerðir ið hava til endamáls at ávirka vitan, hugburðel.atburð hjá fólki(vanl. í stutta tíð)[da.kampagne];sbr.átøk
átaka	sbr.taka á
átaksleiðari	ein ið skipar arbeiðið á staðnum í sambandi við eldsbrunael.aðrar vanlukkur,sløkkiliðsmenninir arbeiða eftir boðum frá átaksleiðaranum
átaksøki	økit.d.vinnugrein og útbúgving sum stórur dentur verður lagdur á at menna, vakstrarøki,ætlanin er at raðfesta ávís átaksøki sum t.d. kunningartøkni og biotøkni og eisini at økja um tilboðini um hægri lestur í Føroyum
átala1	tað at verða átalaður fyri e-t, ávaring, áminning,hann skuldi fingið átalu fyri atburð sín;hann fekk átalu fyri røðu sína á tingi
átala2	hava at (e-m), geva ábreiðslu, harta,hann varð harðliga átalaður
átaluverdur	sum hevur uppiborið eina átaluel.ábreiðslu(fyri óhóskandi atburð),slíkur atburður er átaluverdur;tað var átaluvert, at starvsfólkini ikki fingu høvi at greiða nærri frá klaguni, áðrenn avgerð varð tikin
átarabragd	mikið át, stórát,tað var kallað átarabragd at seta á bringuna á válgara
átarahít	átari
átaravætti	matfegið fólk
átari	ein sum etur nógv, átarahít, áturoppa, átufressa, matmaður,(orðt.)átari goymir sær eftirbita;tað er átari, ið ger mun á eggi;ein, ið skar tvey riv av í senn, var kallaður átari;tann, ið etur rossakjøt ... mettast ikki, hann verður átari(RKR Heimaráð21);átari og drykkjumaður
átbærur	(sj.)etandi,hatta er ikki átbært(um vánaligt kjøt)
átekna	(løgfr.)skriva navn sítt á skjal sum váttanel.gera viðmerkingaro.tíl.(so at tað formliga er í lagi)
átekning	(løgfr.)tað at átekna
átepli	(Suð.)epli at eta, etingarepli,móts.setepli
átfrekur	átufrekur
átfundur	(skaldsk.)átveitsla,(ravnar) halda átfund á rotnandi ræ
átgildi	átveitsla
átigur	grammur, slúkin, átufrekur, matigur, matligur
átikið	sítaka á
-átin	sídrúgv-,eyð-,rám-,sein-
átjan	talið 18, í rómv. tølum XVIII, xviij,(kvæð.)átjan alin var bulur hans
átjandi	raðtal av átjan, nummar átjan
átjangarnslína	(bjarg.)bakkatog, lesningsband við 18 gørnum í hvørjum tátti,(Skú.)hann fór í handilin at fáa sær eitt bjargatog, ella lesningstog, sum teir kallaðu átjangarnslínur(vóru 20-25 favnar langar);sbr.tólvgarnslína
átjanskinsfiskur	grindahvalur átjan skinn stórur
átrokan	trýst,eg gav eftir fyri átrokan hansara
átrokandi	bráðneyðugur, alneyðugur;hjinniliga, tráliga,hann tosar lágmælt og átrokandi
átrokin	átrokandi
átrú	(gl.)tað at trúgva á, trúgv
átrúgvandi	trúligur,tað er átrúgvandi, at Sigmundur kristnaði Føroyar
átrúgvin	(gl.)trúfastur, trúgvur,(kvæð.)vera skal eg tygum átrúgvin
átrúnaðarligur	sum viðvíkur átrúnaði;hj-liga
átrúnaðarsøga	søgan um átrúnað,gjøgnum náttúrusøguna, siðsøguna og átrúnaðarsøguna
átrúnaður	tað at trúgva á (e-nel.e-t), trúgv, átrúni,treytaleysur átrúnaður á kirkjuna
átrúnaligur	átrúnaðarligur;hj-liga
átrúni	1átrúnaður2álit,hava átrúna á e-mel.e-t(Ev)
átta	talið 8, í rómv. tølum VIII, viii;(spæl)átta føturel.bein á oksaspæl við tráðstubba, nakað líkt krákufóti;(kvæð.)átta føtur og fjøruti var breiddin millum borða
áttamannafar	(bát.)stórur føroyskur bátur(24 føtur til longdar),áttamannaførini vóru ikki drigin til útróður fyrr enn um allahalguna;áttamannafar varð sjáldan flotað uttan til doktararóður og handilsróður
áttandi	raðtal av átta, nummar átta
áttandipartur	áttingur
áttatal	1talið 82e-t ið líkist áttatali,tá ið ryggurin verður skorin av aftan fyri blóðgeislan, skal eitt áttatal síggjast aftur í benið
áttatalsknútur	knútur átøkur áttatali(serst. á enda á bandi)[da.flamsk knob]
áttati	(gl.)talið 80, í rómv. tølum LXXX, lxxx, fýrs
áttatial	(stb.)áttatiál
áttatiál	(gl.)fýra gyllin í jørð(t.d. í stn.Soyluáttatiálin)
áttatiálur	(sj.)áttatiál
áttatiundi	raðtal av áttati, fýrsinstjúgundi, nummar áttati
áttatíð	kv2e:um áttatíðinaum leið kl. átta(bæði á morgni og kvøldi)
áttermdur	(um høgguslokk)við átta ørmum
áttfarin	lúgvaður, møddur
átthyrningur	skap við átta hornum og átta javnstórum síðum
átthyrntur	(um lutir, bygningar o.tíl.)sum hevur átta horn,skírnarfunturin er átthyrntur og hvítmálaður;kirkjan í Vík er átthyrnt
átti	síeiga
áttingsbrot	ark 1(2) brotið saman í átta,bók í áttingsbroti(in octavo)
áttingur	ein av átta eins stórum pørtum, áttandipartur
áttskillingur	(gl.)peningur(2 skinn = 1/2 markur)
áttstrentur	(bókm.,sj.)átthyrntur
áttund	(teld.,sj.)být
áttundi	áttandi
áttu(r)	(kortsp.)kortablað við talinum átta,eini áttu(r);áttuni
átufiskur	fiskur ið er etandi,el.fiskur ið ein etur sjálvur og ikki avreiðir, matfiskur,kalvin er hin størsti og besti av átufiskum okkara
átufrekur	sum etur nógv, grammur, slúkin, átigur, átutur
átufressa	átari
átufressur	(stb.,sj.)átufressa
átukykna	(lívfr.)kykna ið kann taka upp í segt.d.hvítar blóðkroppar(fagocyt)
átuligur	(um mat)sum fellur e-m væl at eta, leskiligur, smakkgóður, gagnsamligur,hesin nátturðin er ein tann átuligasti, eg nakrantíð havi fingið;maturin sær so átuligur út;lógvin leitar sær eftir ormum og øðrum átuligum
átumatur	(stb.)matur ið verður tugdur(og ikki sopin t.d. kjøt og fiskur),tuggumatur,móts.spónamatur,búðin (í búðarhjalli) varð brúkt til átumat (grindatunnur o.a.)
áturoppa	eitt sum etur nógv, átari,sit nú og keksast, áturoppa tín
átusmørsoppur	(plfr.)slag av smørsoppi(Boletus edulis)
átusoppur	(plfr.)etandi soppur
átutari	etandi tari
átutur	átufrekur
átuvomb	(kvæð.,niðr.)átari
átuvøkstur	vøkstur (planta) ið er etandi
átveitsla	veitsla við nógvum (óhóvsomum) áti, átgildi,mannaátarar høvdu sitið við eina av sínum ræðuligu átveitslum
átøk	tað at vilja spýggja,hann lá íel.við hørðum átøkum;síátak (2)
átøka	(stb.,sj.)(serst. ífltátøkur)átøk,so koma átøkurnar at spýggja tað upp aftur
átøkkur	átøkur
átøkur1	(stb.)átøk,hava átøkurtaka á at spýggja
átøkur2	eitt sindur líkur (e-m), sum sipast (e-m),hon er átøk honum;hann er honum átøkur;(kvæð.)átøk var hon Tóru drotning
áum1	síá
áum2	ávum
ávara	geva ávaring, varskógva,eg ávaraði tey, tí eingin kundi vita, hvat henda kundi
ávaran	(sj.)ávaring
ávaring	1áminning, tekin,hann gevur teimum í erva eina ávaring at draga upp2fyriboðan,teir høvdu fingið eina ávaring um eina stóra fiskatorvu3freist,leigumálið varir, til annar av pørtunum sigur tað upp við tríggja mánaða ávaring
ávaringar-	sms. t.d.-róp,-skot
ávaringarskelti	skelti til ávaringar
ávegis	áleiðis, á leið, á veg, (eitt sindur) fram á vegin,vit fylgja teimum eitt sindur ávegis;hann var á veg í kirkju, komin nakað ávegis sær hann ein bát;(flutt m.)granskingarverkið er nú væl ávegis komið;eg má gera mær okkurt ávegis(niðurfyri)
ávenjing	tað at venjast á e-t
áverk	1(stb.)tað at seta (sjøtul) á (e-t arbeiði), byrjan,gera áverk á;eg vil hava áverk á sum skjótast;nú var áverk komið á, og teigalendið vaks ár undan ári2(bíbl.)valdsgerð, yvirgangur,tann valdsgerð og áverk, sum mær var fyri, komi yvir Bábel!
áverka	seta á, byrja (e-t arbeiði),verkið, sum hann hevði áverkað í fongslinum, var liðugt nú;eg havi áverkað til eina húsagrund;eg havi áverkað smørkrukkuna(sett á hana)
áverkaður	1ásettur, byrjaður2sum hevur fingið lítlan løst,húsini vóru áverkað av vindi
ávik	h3:góður í ávikumbeinasamur og lagaligur, góður at heita á(tá ið e-m tørvar hjálp),hann er góður í ávikum
ávikavist	(í upprokning)í mun til hini, viðv. hvørjum einstøkum(tá ið e-t verður nevnt í raðfylgju sum ofta svarar til eina áður nevnda raðfylgju),tvær gentur ávikavist 10 og 12 ára gamlar;hann hevur gjørt tríggjar túrar og selt fyri 26000 pund, ávikavist 13000, 8000 og 5000 pund fyri hvønn túrin
ávildum	hvmf flt(sj.)í osb. sumav sínum ávildumav egnum ávum
ávindum	hvmf flt(sj.)í osb. sumav hansara ávindum(ávum)
ávinningur	vinningur, inntøka,tey virka eina vøru við stórum ávinningi
ávirka	1broytat.d.hugburð, støðu, meining, gera (e-m) mun,avgerðirnar hjá vinnufeløgunum ávirka politikararnar;børn verða lætt ávirkað av vaksnum(ávirkast);ávirkaður (av rúsdrekka)við kenning2(stb.,sj.)gera, takast við, fáast við;hvat ávirka tit í hesum døgum?3(sj.)áverka,har síggja vit tann nýggja vegin, sum er ávirkaður frá Fútakletti til Oyrargjáar
ávirkan	tað at ávirka, e-t ið ávirkar (e-n), árin,ávirkanin uttaneftir gjøgnum sjónvarp er stór
ávirkandi	(málfr.)sum tekur ávirki,ávirkandi sagnorð(verbum transitivum);sbr.ó-
ávirki	1(málfr.)setningsliður stýrdur av sagnorði(objectum),beinleiðis ávirkisetningsliður ið sýnir tannel.tað ið gerðin er vend ímóti(oftast í hvønnfalli),í setninginum "kettan át rottuna" er "rottuna" beinleiðis ávirki;óbeinleiðis ávirkisetningsliður ið sýnir hvønn gerðin er gjørd fyri, atviki(oftast í hvørjumfalli),í setninginum "hon gav honum bókina" er "honum" óbeinleiðis ávirki2(um klæði)tað at vera áverkaður,bulurin liggur í ávirki3(gl.,sj.)ávirkan4(stb.)fyrimál,hann var kastikleppur og ávirki fyri Mortans skemdarlyst
ávirkiligur	1sum letur seg ávirka2(stb.,sj.)ávíkiligur;hann var frálíka ávirkiligur maður(góður í ávikum)
ávirking	ávirkan
ávíkiligur	góður í ávikum, góður at heita á, beinasamur, gávumildur,tey vóru hjálpsom og ávíkilig
ávíkin	(Svk.)góður í ávikum, ávíkiligur
ávíkindi	áheitan um hjálpel.beina(Sv)
ávísa	vísa á, staðfesta,við sínum landakunnleika og við hjálp frá teimum góðu kortunum ávísti hann leiðina
ávísan	tað at vísa á, ávísing, tilvísing
ávísandi	sum vísir á,(málfr.)ávísandi fornavnávísingarfornavn
ávísi	vísari[da.indikator]
ávísiligur	sum kann ávísast
ávísing	1tað at vísa á2útgjaldingarváttan,rokningar skulu sendast til Føroya Jarðarráð til ávísingar
ávísingarfornavn	(málfr.)fornavn (2) ið vísir á e-t ávístel.e-n ávísan, ávísandi fornavn(pronomen demonstrativum),ávísingarfornøvn eru t.d. tann, hin, hesin, hasin;henda gentan;hatta barnið
ávísur	vissur,ein ávísur persónur;á ávísum støðum
ávum	orsøkum, atvoldum, áum,av mínum ávum;av samfelagsins ávum;sms. t.d.krígs-,manna-
ávøga	(ov stór) tyngd í erva á skipi og báti,báturin hevur ov stóra ávøgu;far ikki upp í flaggstongina, tað verður ov nógv ávøga;sbr.yvirrið
ávøkstur	1grøði, frukt(ir),eitt ársspring av korni, sum var ávøksturin av einum ári;(flutt m.)hann fekk at síggja ávøkst av arbeiði sínum2(sj.)slokkur á plantu, yvirvøkstur,eplini hava ov stóran ávøkstur3renta, vinningur,minni ávøkstur vanst av peninginum
