fakligur	(tlm.)viðv. faki, yrkisligur[da.faglig,en.professional]
fald	(støddfr.)úrslit í falding,valdur ferðir vald er fald[da.produkt,en.product]
falda	(støddfr.)gera mangar ferðir fleiri,fimm faldað við níggjufimm ferðir níggju[da.multiplicere,en.multiply];sms. t.d.fer-,fimm-,fjór-,fleir-,marg-,trí-,tví-
faldari	(støddfr.)tal ið annað tal verður faldað við,í døminum 3 x 5 er 3 faldstovnur og 5 faldari[da.multiplikator,en.multiplier]
falddjúpgrýtingur	(jarðfr.)djúpgrýtingur á faldfláum[da.fakolit]
faldeind	(alisfr.)eind gjørd úr grundeind við at falda við e-m veldi av 10(t.d.km, dm, cm, mm úr eindini m)
faldfjøll	(jarðfr.)fjøll vorðin til við falding 1(2)[da.foldebjerge]
faldhurð	(húsasm.)hurð ið verður latin upp og aftur við samanfalding(eins og harmonika)[da.foldedør,en.folding door]
falding1	(jarðfr.)tað at fláir í jarðarskorpuni skjótast av at verða samanstúgvaðar tá ið fjallagarður við faldfjøllum verður til[da.foldning,en.folding]
falding2	(støddfr.)tað at falda 2[da.multiplikation,en.multiplication]
faldingarmerki	(støddfr.)merki ið sigur frá at tøl verða faldað[da.multiplikationstegn,en.multiplication sign]
faldingartalva	(støddfr.)talva við úrslitum av faldingarmøguleikum av tølum(lítla faldingartalvan við tølum frá 1 til 10 ið eru faldað hvørt við øðrumog stóra faldingartalvan við tølum frá 11 til 20 faldaðum við tølum frá 1 til 10);sífaldari,faldstovnurogfald[da.multiplikationstabel,en.multiplication table]
faldiregla	(støddfr.)regla viðv. falding(t.d.í líkindarokning)[da.multiplikationsprincip]
faldstovnur	(støddfr.)tal ið verður faldað við øðrum tali,í døminum 3 x 5 er 3 faldstovnur og 5 faldari[da.multiplikand,en.multiplicand]
faldur	(jarðfr.)høgur fjallaryggur og samsvarandi dalur(íkomin við falding 1(2))
fallferð	(alisfr.)ferð ið e-t fellur við[da.faldhastighed,en.speed of falling]
fallhamari	(tøkni)tól við fallloddum til at sláa pelar niður í jørðina við, rambukkur[da.rambuk,en.pile driver]
fallhjálmur	(tøkni)hjálmur at verja fyri falli(serst. av (motor)súkklu)[da.styrthjelm,en.protective helmet]
fallhædd	(alisfr.)fall ið e-t fellurel.dettur[da.faldhøjde,en.drop]
falllodd	(tøkni)lodd á fallhamri, rambukskubbi[da.rambukklods,en.pile hammer, ram]
fallrør	(rørsm.)rør ið leiðir regnvatn niður úr takrennu[da.nedløbsrør,en.downpipe]
fallstokkur	(rørsm.)frárenslrør loddrætt[da.faldstamme]
fallstykki	(húsasm.)(í gl. húsum)fjøl sett millum bitarnar í gloppið millum yvirsyll og loft(FA424, 18)
falsa	1(handv.)gera falst.d.á blikkplátu[da.false,en.rabbet]2(bókb.)bróta og leggja saman ark[da.false,en.fold]
falshøvil	(handv.)høvil til at gera fals við;sbr.fellingarhøvil, sýlingarhøvil[da.falshøvl]
falsur	1(handv.)kantur, foyra sum e-t fellur inní (t.d.durafalsur), (dura)geykn, groyping[da.fals,en.rabbet]2(bókb.)brot (á samanløgdum arki)[da.fals,en.fold]
farhøll	(tøkni)høll í floghavn har ið ferðafólk sum skulu uttanlands P|el.| millumlenda kunnu halda til[da.transithal,en.transit shed]
farkleiv	(ravm.)ravmagnsstyrkjari við minst trimum pólum til nýtslut.d.í útvarpslurtum í staðin fyri rør, transistari[da.transistor,en.transistor]
farmynd	(støddfr.)farstrika[da.kurve,en.curve]
farstrika	(støddfr.)strika ið myndar tilgongdel.talvirði í líkning, farmynd[da.kurve,en.curve]
fartelda	(teld.)telda ið ein fær havt við sær, berandi telda[da.bærbar computer, portabel computer,en.portable computer, lap top computer]
fasa	(ravm.)tilvildarlig støða í eini skipan av sveiggingum í mun til aðra skipan[da.fase,en.phase, bevel]
fasing	(ravm.) [da.fasing,en.bevelling]
fastadepil	(tøkni)støði á máliskala P|el.| við málingar, fastapunkt[da.fikspunkt]
fastalinju-	(tøkni)sum stendur í beinum sambandi við miðstadda teldu[da.online,en.on line]
fastalinjusamband	(teld.)støðugt samband P|el.| støðug íbinding í P|t.d.| internet[da.onlineforbindelse]
fastalinjuskipan	(teld.)beinleiðis fast samband um teldu- P|el.| telefonnet, álinjuskipan[da.onlinesystem]
fastalykil	(handv.)slag av skrúvilykli ið ikki kann stillast, gaffillykil[da.gaffelnøgle,en.open end spanner]
fastapunkt	(tøkni)fastadepil[da.fikspunkt]
fastatal	(støddfr.)óbroytt tal[da.koefficient,en.coefficient]
fasuspennbroytil	(ravm.) [da.fasetransformator,en.phase transformer]
fasuspenningur	(ravm.) [da.fasespænding,en.phase voltage]
fasustreymur	(ravm.) [da.fasestrøm,en.phase current]
fasustýring	(ravm.) [da.fasestyring,en.phase control]
fasutvørmát	(ravm.)?tvørmát í eini fasu[da.fasdiameter,en.bevel diameter]
fasuumbroytil	(ravm.) [da.faseomformer,en.phase converter]
fasuvending	(ravm.) [da.fasevending,en.phase inversion]
fasuvinkul	(ravm.) [da.fasevinkel,en.phase angle]
fasuvinkulreiðlag	(ravm.) [da.fasevinkelrelæ,en.phase angle relay]
fatningur	(ravm.)haldari (1) við skrúvugangi til at seta ljósperu fasta í[da.fatning,en.socket]
fán	(alisfr.)umbroyting í geislavirknum evni(sagt um geislavirkin evni: evnið fánar, fáningartal, fáningarlóg)[en.decay]
feilur	brek, mislag[da.fejl,en.defect]
feitt	(evnafr.)1føðsluríkt lívrunnið evni ít.d.tálg, spikio.tíl., fitievni í mati, fiti (1)2oljukent kleimið evni(til at smyrja maskinlut, tól o.tíl. við);sms. t.d.steiki-,svína-[da.fedt]
feittpressa	(tøkni) [da.fedtpresse,en.grease gun]
felagsmál	(løgfr.)(í heimastýrislógini frá 1948)mál(søki) ið eftir samráðingar kann verða yvirtikið undir føroyska fyrisiting[da.fællesanliggende,en.joint matter];sbr.sermál
felagsmongd	(støddfr.)mongd av lutum sum eru bæði í mongdini A og í mongdini B[da.fællesmængde,en.intersection]
felagsnevnari	(støddfr.)samnevnari[da.fællesnævner,en.common denominator]
felga	(tøkni)(á akfari)jarnringur á hjóli sum dekk (4) er spent uppá, gjørð, hjólgjørð[da.fælg,en.rim]
felling	(handv.), sýling[da.sinkeforbindelse]
fellingarhøvil	(handv.), sýlingarhøvil[da.grathøvl]
fellingartappur	(handv.), sýlingartappur[da.sinketap]
fellingaveggur	(húsasm.)veggur samansettur av liðum(nýttur til at býta stór rúm sundur í smærri rúm)[da.foldevæg]
fenol	(evnafr.)eitrandi og etjandi evni (nýtt til at gera plast við), karbol(teknC6H5OH)[da.fenol]
ferðgevi	(tøkni)(í akfari)útbúnaður at eyka ferðina við(P|t.d.| føtil at stíga á),skyndil, spitari[da.speeder,en.accelerator]
ferðmátari	(tøkni)tól ið mátar ferð hjá akfari(verður víst í km/t)[da.fartmåler, speedometer,en.speedometer]
ferðtálmi	(tøkni,byggiv.)ryggur tvørtur um veg til at tálma ferð á akførum[da.fartdæmper]
ferðøking	(alisfr.)dik[da.acceleration,en.acceleration]
ferging	(jarðfr.)tað at grótsløg verða trýst saman av jarðløgumel.jarðrøringum og gerast tættari[da.kompaktion]
ferhyrningur	(støddfr.)flati við fýra hornum, fjórhyrningur, fýrhyrningur, fýrkantur[da.kvadrat,en.square]
ferhyrntur	(støddfr.)fjórhyrntur, fýrhyrntur, fýrkantaður[da.kvadratisk,en.square, quadratic]
fermetur	(støddfr.)ein metur í fýrkant, m²[da.kvadratmeter,en.square meter]
fermingarboya	(oljuv.) [da.lastebøje]
fermingarpumpa	(tøkni)pumpa til at ferma við[da.lastepumpe,en.loading pump]
fermingarventilur	(tøkni) [da.lasteventil,en.loading valve]
ferrót	(støddfr.)onnur rót,ferrótin av 9 er 3;sbr.rót (8)[da.kvadratrod,en.square root]
ferstevamotorur	(tøkni)brennimotorur har ið innsúgving og útblástur verða stillað við ventilum[da.firtaktsmotor,en.four-stroke engine]
festiboltur	(tøkni)boltur til at festa e-t við[da.fæstebolt,en.tie-down bolt]
festidós	(ravm.), íbindingardós[da.samledåse,en.electrical box, junction box]
filtra	(tøkni)síla[da.filtrere,en.filter]
filtsa	(handv.)pussa við filtsibretti[da.filtse]
filtsibretti	(handv.)bretti klætt við filti til at fínpussa múr við[da.filtsebræt]
filtsing	(handv.)tað at filtsa P|el.| tað ið filtsað er
filtur	(tøkni)tilfar P|el.| tøkniligur útbúnaður ið heldur aftur P|el.| savnar saman P|t.d.| smálutir úr vætu P|el.| skitt frá royki[da.filter,en.filter]
filturpatrón	(tøkni) [da.filterpatron,en.filter cartridge]
filturramma	(tøkni) [da.filterramme,en.filter frame]
filturtættari	(tøkni) [da.filterkondensator,en.filter capacitor]
fiskiídnaður	tað at framleiða (mat)vøru úr fiski[da.fiskeindustri,en.fishing industry]
fiti	(evnafr.)feitt, fitievni
fitievni	(evnafr.)lívrunnið evni samansett av glyseroli og fitisýrum, fiti (1)[da.fedtstof,en.fat, fatty substance]
fitisteinur	(jarðfr.)bleytur tættur fitikendur steinur úr tálki;sbr.grøðisteinur[da.steatit]
fitisýra	(evnafr.)sýra í fitievni,fitisýrur í fiski eru argar at trána, tá ið luft sleppur at[da.fedtsyre,en.sebacic acid]
fíl	(handv.)amboð (úr hørðum stáli) við taggum(at fíla metal, træ o.tíl. við)[da.fil,en.file]
fíla	(teld.)savn av dátumel.boðum (at skilja sum ein heild)[da.fil,en.file, data set];sms. t.d.forrits-,tekst-
fílaspón	(tøkni)fínar spønir av metali P|el.| træ avfílaðar við fíling[da.filspån]
fílegg	(tøkni)egg á fíl[da.filehug]
fílubonkur	(tøkni)bonkur har ið lutur sum fílast skal er spentur fastur í[da.filebænk]
fínhøvil	(handv.)fínur slætthøvil(at fínka við),ennispónar og stavnar fingu serliga viðgerð við fínhøvli
fínmekanikari	(tøkni)ein ið arbeiðir við og umvælir fín og smá tól[da.finmekaniker,en.instrument maker]
fínmekanikkur	(tøkni)neyvt gjørt arbeiði við smáum mekaniskum lutum[da.finmekanik]
fínpoknutur	(jarðfr.)við fínum, smáum poknum[da.finporøs]
fjallagarður	(jarðfr.)fjallaryggur,fjallagarðarnir stevna í ein útnyrðing;sbr.fjallgarður
fjallaryggur	(jarðfr.)røð av fjøllum, fjallarøð, fjall(a)garður, rust, kjølur,millum fjallaryggirnar er ein dalur
fjarhitaeind	(tøkni)eind við hitavekslara, heitvatnstanga og øðrum útbúnaði til at flyta hitan úr fjarhitaskipan yvir í hitaskipanina í hvørjum einstøkum húsi[da.fjernvarmeunit,en.district heating unit]
fjarhiti	(tøkni)hiti leiddur frá stórari hitamiðstøðt.d.ruskbrennistøð(til at hita upp hús o.a. á avmarkaðum øki)[da.fjernvarme,en.district heating]
fjarljós	(tøkni)(á akfari)innstilling á forlyktum sum ger at stórt øki verður upplýst[da.fjernlys,en.main beam]
fjarnet	(teld.)net (2) av teldum spjaddum um vítt øki(samanbundnar umt.d.telefonlinju),móts.nærnet[en.wide area network, WAN]
fjarskifti	(tøkni)tað at flyta boð (ljóð og tekn) um langar leiðir(t.d. um telefon, fjarskrivara, útvarp og sjónvarp)[da.telekommunikation,en.telecommunication]
fjarskiftiskápil	(tøkni)kápil til fjarskifti[da.telekommunicationskabel,en.telecommunication cable]
fjarskiftiskervi	(tøkni)kervi til fjarskiftis[da.tele(kommunikations)system,en.telecommunication system]
fjarskiftispultur	(tøkni)pultur til fjarskiftis[da.telekommunikationspult,en.telecommunication desk]
fjarskiftisútgerð	(tøkni)(tøknilig) útgerð til fjarskiftis[da.telekommunikationsudstyr,en.telecommunications equipment]
fjarskiftisverkstaður	(tøkni)verkstaður til fjarskiftis[da.telekommunikationsværksted,en.telecommunication workshop]
fjarstýra	(tøkni)stýra við fjarstýring,fjarstýra rakettum[da.fjernstyre,en.steer by remote control]
fjarstýrari	(tøkni)fjarstýring (2)[da.fjernbetjening,en.remote control]
fjarstýring	(tøkni)1tað at fjarstýra[da.fjernbetjening]2tráðleysur útbúnaður til at stýrael.hava eftirlit við tóli á øðrum staðel.nakað burturfrá(t.d. á sjónvarpstóli),fjarstýrari,sjónvarp við fjarstýring[da.fjernbetjening,en.remote control]
fjarstýringareind	(tøkni)?eind í fjarstýring[da.fjernstyringsenhed,en.remote control unit]
fjarstýringarskipan	(tøkni)skipan til fjarstýring[da.fjernstyringssystem,en.remote control system]
fjøður	1(tøkni)(í akfari)(stál)útbúnaður ið kann geva seg upp og niður[da.fjeder,en.spring]2(tøkni)stálsnyril sum driv(t.d. í uri)
fjøðurkraft	(alisfr.)kraft í fjøður (4)[da.fjærkraft,en.spring force]
fjøðurorka	(alisfr.)støðuorka goymd í fjøður (4)
fjøðurspenniskiva	(tøkni)spenniskriva dánað sum fjøður[da.fjederspændskive,en.flat washer]
fjølfløga	(tøkni)talgild fløga 1(3) við talu, tónum, teksti, myndum (stillum og livandi)o.ø.[en.CD-I(nteractive)]
fjølgeril	(teld.)?telda sum hevur tveir P|el.| fleiri gerlar ið hava atgongd at felags høvuðsminni[da.multiprocessor,en.multiprocessor]
fjølrás	(teld.)?rás sum hevur í sær fleiri møguleikar[da.multikanal]
fjølsamskifti	(tøkni)samskifti gjøgnum fjølmiðlar[da.?mediekommunikation]
fjølvi	(teld.)røð av boðum savnaðum so at tey kunnu innast í einum(í staðin fyri at inna tey hvørt sær,t.d.í tekstforriti, rokniarksforritio.tíl.)[da.makro,en.macro]
flaghald	(húsasm.)torvhald
flaghaldsjarn	(húsasm.,stb.)torvhaldsjarn
flagsperra	(húsasm.)træ lagt (oman og niðan) á flagtekju til at halda flagnum
flakaídnaður	ídnaður ið virkar fiskaflak[da.filetindustri (?)]
flatborur	(handv.)borur við fløtum oddi[da.platbor,en.bradawl]
flatjarn	(rørsm.
flatmynd	(byggil.)tekning (skurður) av húshædd sædd niðurá(so at t.d. skilarúm og útveggir síggjast),móts.tvørskurður (2)
fláaskipan	(jarðfr.)skipan av fláum í landslagnum[da.lagsystem]
flágerð	(jarðfr.)tað at býta sundur í løg, tað at fláskipa[da.stratificering]
flálíming	(handv.)samanlíming av trælistumel.skivum undir stórum trýsti[da.laminering]
fláskipa	(jarðfr.)býta sundur í løg P|el.| flokkar[da.stratificere]
fláskipan	(jarðfr.)uppbýti í løg P|el.| flokkar[da.stratifikation]
fleirnýtarakervi	(teld.)teldukervi til fleiri nýtarar[da.flerbruger system]
fleirnýtsluskipan	(byggil.)opnaskipan[da.åbenplansystem,en.open-plan system]
flíggj	(tøkni)flatur spískur oddur(t.d.á akkeri, skutli),borikrúna,sbr.akkersflíggj,fjøður (7)[da.borekrone]
flís	1(teld.)elektronisk ringrás við nógvum luteindum samanbygdum á sera lítlari silisiumskivu(nýtt í teldum)[da.chip,en.chip]2(handv.)felagsheiti fyri lidnar plátur til at klæða veggir og gólv við[da.flise,en.tile]
flísagrót	(jarðfr.)tunt smátt grót
flísalegging	(handv.)lag av flísum ið fjalir ávíst øki[da.flisebelægning]
flísni	(tøkni)lutfall millum breidd og tjúkt á skervi[no.flisighed]
flísøks	(handv.)øks við spískaðari men óhvassari egg og uml. 1 m longum skafti til at klúgva træ(sprek) við[da.flækøkse]
flogøska	(tøkni)løtt, fín øska flutt við royki frá brendum koli í orkuverki P|el.| við ruski frá brennistøð[da.flyveaske,en.fly ash]
flokkingarmiðal	(tøkni)miðal P|el.| evni til at flokka e-t við P|el.| eftir[da.klassifikationsmiddel]
flokkingarútbúnaður	(tøkni)útbúnaður til at flokka við[da.klassifikationsudstyr]
flokkur	) [da.klasse,en.grade]
flot	(oljuv.)tað ið flótandi boripallur flýtur á[da.ponton,en.pontoon]
flotbrúgv	(tøkni)(báta)brúgv ið flýtur[da.flydebro,en.floating bridge]
flotdokk	(tøkni)flótandi turrdokk[da.flydedok,en.floating dock]
flotkrani	(tøkni)arbeiðskrani á flaka(nýttur í skipahavn)[da.flydekran,en.floating crane]
flotkumpass	(alisfr.)kumpass við vætu í[da.væskekompas,en.liquid compass]
flotkøking	(tøkni)vætukopling[da.væskekobling]
flotmálari	(tøkni)tól ið mátar vætu í e-m[da.væskemåler]
flotsteingil	(tøkni)flótandi steingil P|el.| byrging løgd á sjógv P|el.| vatn(nýtt til at forða fyri at e-t dálkandi breiðir seg)[da.flydespærring]
flotsteinur	(jarðfr.)viksteinur[da.pimpsten,en.pumice (stone)]
flottangi	(tøkni,oljuv.)tangi ið flýtur[da.flydetank,en.buoyancy tank]
flotturrventilur	(tøkni,oljuv.) [da.flodtørventil,en.float valve]
flotvág	(alisfr.)flotvekt[da.flydevægt]
flotvekt	(alisfr.)tól til at máta evnisnøgd í løgi (1), flotvág[da.flydevægt]
floyta	(tøkni)(í akfari)tól til at floyta við[da.fløjte, horn,en.whistle, horn]
flóbelti	(landafr.)belti (3) sunnan fyri og norðan fyri hitabeltið við flógvum hitalagi[da.subtropisk zone,en.subtropical zone]
flógv	(jarðfr.)(tunt) lag, lind, jaður,fláir av royðugróti;sbr.fløga 1[da.plan]
flógvi	(landafr.)breiður munni í firðiel.sundit.d.millum tvær oyggjar(ið víðkast út móti havi)[da.golf,en.gulf]
flóleiki	(alisfr.)hiti (5), hitalag[da.temperatur,en.temperature]
flukt	(handv.)í fluktí beinum rað, í linju[da.i flugt]
flukta	1(handv.)vera í flukt (3)[da.flugte]2(ítr.)sláael.sparka (bólt) á flogiel.lofti
flutningsband	(ídn.)motordrivið bandel.reim at flytat.d.vøru á(t.d. á ídnaðarvirkjum og verksmiðjum)[da.transportbånd,en.belt conveyer, conveyer belt]
flutningskervi	(tøkni)kervi til flutnings[da.transportsystem,en.conveyor system]
flutningstangi	(tøkni)tangi nýttur til flutnings[da.transporttank,en.tote tank]
flúr	(evnafr.)slag av gulligum eiturkendum gassi(frumevni, teknF)[da.fluor,en.fluorine]
flúrglógva	(evnafr.)kasta aftur ljós, geva flúrglógvan[da.fluorescere,en.fluoresce]
flúrglógvan	(evnafr.)tað at evni gevur frá sær ljós tá ið lýst verður á tað[da.fluorescens,en.fluoresce]
flytil	(alisfr.)flytil máttarmáttur faldaður við máttararmi(HDJ Alisfr.25)[da.moment,en.factor]
fløga	1lag av hoyggj í fløgugingnari sátu(rullað saman og lagt á hoyberareip),tvær fløgur í byrðina;sbr.flógv2tjúkk flís,nú fekst tú tær eina fløgu uppá(tjúkt av t.d. rullupylsu, kjøti o.ø. upp á breyð)3(ným.)lítil rund pláta sum goymir ljóðel.dátur á talgildan hátt(lisin við lasarageisla),ljómfløga[da.cd,en.compact disk, CD];sms. t.d.films-,fjøl-,ljóm-,savns-,sjón-,stak-,teldu-,tví-
fløgugosfjall	(jarðfr.) [da.stratovulkan]
fløgugrót	(jarðfr.)smákornut fløgulagt leirgrýti, skifur, talvusteinur[da.skifer, skiffer,en.slate]
fløgugrýtisolja	(jarðfr.)steinolja í fløgugróti[da.skiferolie]
fløgulagdur	(jarðfr.)ið liggur í fløgum,fløgulagt leirgrýti[da.skifret]
fløguleir	(jarðfr.)leir sum liggur í fløgum[da.lerskifer]
fløguleirgrýti	(jarðfr.)veikt fløgulagt leirgrýti[da.skiferler,en.shale]
fløgusteinur	(jarðfr.)steinur av fløgugróti,takt við fløgusteini[da.skifer,en.slate]
fløgustøð	(teld.)støð til teldufløgur[da.CD-station]
forásur	(tøkni)aksil millum framhjól[da.foraksel,en.front axle]
forbjálvaður	(byggiv.)bjálvaður frammanundan,forbjálvað metalrørmetalrør bjálvað á verksmiðju frammanundan[da.præisoleret rør]
forboringarramma	(oljuv.)boringarramma nýtt til at gera boringar frammanundan[da.forboringsramme,en.predrilling template]
forborur	(handv.,tøkni)borur at bora fyri við[da.forbor,en.predriller]
forfiltur	(tøkni) [da.forfilter,en.prefilter]
forinnstilling	(tøkni)innstilling frammanundan[da.forindstilling,en.presetting]
forkanning	(tøkni,jarðfr.)kanning frammanundan[da.rekognocering, forundersøgelse,en.preliminary survey]
forkanningaloyvi	(tøkni,jarðfr.)loyvi at gera forkanning P|t.d.| eftir olju og gassi
forkøling	(tøkni)køling frammanundan[da.forkøling,en.precooling]
forlendisjøkul	(jarðfr.) [da.piedmontgletscher]
formbroyta	(teld.)broyta (telduupplýsingar) til annan form(uttan at innihaldið broytist),formbroyta ein tekst úr eini tekstviðgerð í aðra[da.konvertere, omsætte,en.convert]
formbroyti	(teld.)(rit)búnaður sum broytir eina útgávu av forriti í aðra javngilda útgávu[da.omsætter,en.(data) converter]
formbroyting	(teld.)tað at formbroyta[da.konvertering,en.conversion]
formgáva	tað at formgeva, sniðgerð[da.design,en.design]
formgávumeting	meting av formgávu[da.konstruktionsgranskning,en.design review]
formgeva	gera fyrimyndirel.mynstur til nýtslulutir (klæði, prentlutiro.tíl.), geva hóskandi og vakurt snið[da.designe]
formgevi	ein ið formgevur,arkitektar og aðrir formgevar[da.designer]
formlasavn	(støddfr.)savn við formlum (2)[da.formelsamling]
formsmál	formligt krav ið e-t skal nøkta fyri at vera í lagi[da.formalitet,en.formality]
formur	(byggiv.,handv.)amboð ið gevur luti ávísan form(til at stoypa el. forma e-t í)[da.forskalling,en.shuttering]
fornøld	(jarðfr.)øldin eftir upphavsøld(fyri 600-225 milliónum árum síðan),jarðarsøgan verður býtt sundur í upphavsøld, fornøld, miðøld og nýøld[da.paleozoikum]
forpumpa	(tøkni) [da.booster pumpe]
forrit	(teld.)heild av boðum (2) ið verða løgd inn í teldu(til at loysa ávísar uppgávur),forrit til orðabókagerð[da.program,en.programme];sms. t.d.nýtslu-,tekstviðgerðar-
forrita	(teld.)gera forritserst.til dátuviðgerð í teldu[da.programmere,en.program(me)]
forritan	(teld.)tað at forrita[da.programmering,en.programming]
forritanarmál	(teld.)serstakt (tøkni)mál nýtt í forritan[da.programmeringssprog,en.programming language]
forritanarútgerð	(tøkni,teld.)útgerð nýtt til forritan[da.programmeringsudstyr,en.programming aids]
forritari	(teld.)ein ið ger forrit[da.programmør,en.programmer]
forritasavn	savn av forritum[da.programbibliotek,en.programme library]
forritsfíla	(teld.)fíla ið virkar sum forrit[da.programfil,en.programme file]
forritskota	(teld.)kota í forriti[da.programkode,en.programme code]
forritsmótul	(teld.)mótul til forrit[da.programmodul,en.programme modular]
forrættari	(tøkni)ein ið setur vevin til rættis fyri arbeiðaran á vevstovu[da.forretter,en.performer (?)]
forsamantrýsta	(tøkni)samantrýsta (e-t) frammanundan[da.forkomprimere]
forskalla	(byggiv.)stoypa e-t í einum formi P|el.| gera skilavegg av brettum[da.forskalle,en.cover with laths]
forskalling	(byggiv.)tað at forskalla P|el.| tað ið er forskallað[da.forskalling,en.laths]
forskrift	1(teld.)?undirforrit[da.formular, procedure]2) [da.specifikation,en.specification]
forsniða	(teld.)sniða[da.formatere,en.format]
forsniðan	(teld.)tað at sniða[da.formatering,en.formatting]
forstoypa (?)	(byggiv.)(fyri: prestoypa)
forstoyptur (?)	(byggiv.)(fyri: prestoyptur)
fortendring	(tøkni)(í motori)tendring frammanundan[da.fortænding]
forvangi	(húsasm.)(á trappu)vangi (3) ið vendir út,móts.bakvangi[da.forvange]
forveljari	(tøkni)tól ið velur e-t frammanundan[da.forvælger,en.preselector]
forvirka	(tøkni)framleiða frammanundan, undanframleiða[da.præfabrikere,en.prefabricate]
forvirkaður	(byggiv.)(um bygningslut)gjørdur liðugur áðrenn hann kemur á byggiplássið[da.præfabrikeret,en.prefabricated]
fosfat	(evnafr.)salt av fosforsýru[da.fosfat,en.phosphate]
fosfor	(evnafr.)eiturkent eldfimt evni(m.a. nýtt til svávulpinnar og spreingievni, frumevni, teknP)[da.fosfor,en.phosphorus]
fóðring	(tøkni)búsningur[da.bøsning,en.bush, bushing]
fótbend	(byggiv.
fótbremsa	(tøkni)bremsa at stíga á;sbr.handbremsa[da.fodbremse,en.foot brake]
fótlisti	(húsasm.)listi fram við veggi niðri við gólv, gólvlisti[da.fodpanel, gulvliste,en.skirting board]
fótventilur	(tøkni,oljuv.)ventilur stýrdur við fótinum[da.fodventil,en.pedal valve]
framgervi	(tøkni)framgir[da.fremgear]
framgir	(tøkni)gir nýtt tá ið (ak)far skal koyra frameftir, framgervi[da.fremgear]
framhjól	(tøkni)(í akfari)hjól framman[da.forhjul,en.front wheel]
framhjólsbremsa	(tøkni)bremsa ið bremsar á framhjóli (P|el.| -hjólum)[da.forhjulsbremse]
framhjólsdráttur	(tøkni)tað at motorurin á akfari er koplaður til framhjólini[da.forhjulstræk,en.front wheel drive]
framhjólsrikin	(tøkni)rikin við framhjólsdrátti[da.forhjulstrukken,en.front wheel driven]
framleidni	(tøkni)mát fyri hvussu munadygg framleiðsla er(t.e. lutfallið ímillum tað sum lagt verður í framleiðsluna og framleiðsluúrslitið)[da.produktivitet,en.productivity]
framleiðari	(tøkni,oljuv.)fólk P|el.| virki ið framleiðir eina vøru[da.producent,en.manufacturer]
framleiðin	(tøkni)sum framleiðir P|el.| skapar nógv[da.produktiv,en.productive]
framleiðsluavgjald	(oljuv.)avgjald latið tí almenna eftir framleiðslunøgd[da.royalty,en.royalty]
framleiðsluboring	(oljuv.)boring sum liður í framleiðslu P|t.d.| av gassi P|el.| olju[da.produktionsboring,en.production drilling]
framleiðslubrunnur	(tøkni,oljuv.)brunnur nýttur í P|t.d.| oljuframleiðslu[da.produktionsbrønd,en.production well]
framleiðslukota	(tøkni,oljuv.) [da.produktkode,en.product service code]
framleiðsluleiðing	(oljuv.)(á oljuboripalli)leiðing ið leiðir oljuna upp á boripallin av havbotninum[da.produktions/udførselsstigeledning,en.production/export riser system]
framleiðsluloyvi	(tøkni,oljuv.)loyvi at framleiða P|t.d.| olju og gass[da.produktionstilladelse, forhåndsdispensation,en.production license, production permit]
framleiðslupallur	(oljuv.)oljuboripallur har ið olja verður framleidd[da.produktionsplatform,en.production platform]
framleiðslurør	(tøkni,oljuv.)(á ventiltræ),rør til oljuframleiðslu[da.produktionsrør,en.tubing]
framleiðslutíðarskeið	(tøkni,oljuv.)tíðarskeið ið framleitt verður[da.produktionsperiode,en.production life]
framleiðsluútbúnaður	(tøkni)útbúnaður nýttur til at framleiða við[da.produktionsanlæg,en.production plant]
framleiðsluveingjaventilur	(oljuv.)veingjaventilur nýttur í framleiðslu[da.produktionsvingventil,en.production wing valve]
framleiðsluøki	(tøkni)øki har ið framleiðsla fer fram[da.produktionsområde,en.production area]
framsíðuklædningur	(húsasm.)klædningur á framsíðu (á húsum)[da.facadebeklædning]
framsíðumynd	(byggil.)tekning av framsíðu(P|t.d.| á húsum)[da.facadetegning]
framskák	(teld.)skákstrika (2) ið lútar fram (/),móts.bakskák[en.forward slash]
framstig	(menningar)stig móti e-m betri, framburður, framtak, menning
framvøkstur	tað at vaksa fram og mennast, menning, framstig
frádragari	(støddfr.)tal ið drigið verður frá øðrum tali,í frádráttinum5 - 2er2frádragari;sbr.frádráttarstovnur[da.subtrahend,en.subtrahend]
frádráttarmerki	(støddfr.)merki ið sigur frá at tal verður drigið frá øðrum tali, minus 1(skrivað - , áður ÷)
frádráttarstovnur	(støddfr.)tal ið annað tal verður drigið frá,í frádráttinum5 - 2er5frádráttarstovnur;sbr.frádragari[da.minuend]
frádráttur	(støddfr.)tað at draga eitt tal frá einum øðrum;sbr.draga frá[da.subtraktion,en.subtraction]
frálandsboring	(oljuv.)boring eftir olju P|el.| gassi ið fer fram burtur frá landi[da.offshore boring,en.offshore drilling]
frálandsbrunnur	(tøkni,oljuv.)framleiðslubrunnur til havs[da.offshore brønd,en.offshore well]
frálandsídnaður	(oljuv.)ídnaður í sambandi við olju- og gassútvinning til havs(leiting, boring, útvinning og veiting),oljuútvinningarvirksemi til havs[da.offshoreindustri,en.offshore industry]
frálandsoljuvinna	(oljuv.)oljuvinna á havinum(langt úr landi)[da.offshore olievirksomhed,en.offshore oil industry (?)]
frálandsútbúnaður	(oljuv.)útbúnaður til frálandsídnað[da.offshoreudstyr (?)]
frálandsvinna	(oljuv.)oljuvinna úti á havi[da.offshore,en.offshore]
frárenning	(tøkni)holel.ræsi til vatno.a.at renna frá ígjøgnum, frárensl,í botninum skal vera góð frárenning[da.afløb,en.drain (?)]
frárenningarrør	(tøkni)afturrenningarrør[da.returrør]
frárenningarstrútur	(tøkni)dýsa har ið væta streymar burtur, útstreymingardýsa[da.udstrømningsdyse]
frárenningarøki	(jarðfr.)øki til frárenning[da.afvandingsområde,en.catchment area]
frárensl	(tøkni)frárenning, útrensl[da.afløb,en.drain (?)]
frárenslbakki	(tøkni)lægd beint við vaskið og úr sama tilfari[da.afløbsbakke]
frárenslinnlegging	(handv.)skipan av rørum til at veita burtur vatn og aðra vætu[da.afløbsinstallation]
frárenslleiðing	(tøkni)frárenslrør[da.afløbsledning,en.discharge line]
frárenslpumpa	(tøkni)pumpa ið sýgur spillvatn upp til neyðugt stig[da.afløbspumpe]
frárenslrør	(tøkni)rør ið eru partur av frárenslinnlegging, rør til burturveiting av vatni o.ø.(frá vaski og vesi),frárenslleiðing[da.afløbsrør,en.discharge line]
frárenslrørskipan	(tøkni)rørskipan til frárensl, frárenslskipan[da.udløbsrørsystem,en.discharge piping]
frárenslskipan	(byggiv.)frárenslrørskipan[da.afløbssystem,en.drain system]
frárenslveit	(tøkni)veit til frárensl[da.afløbsrende,en.gutter]
frárenslventilur	(tøkni)ventilur í frárensli P|el.| til frárensl[da.udløbsventil,en.discharge valve, outlet valve]
frárenslvæta	(tøkni)væta ið rennur frá[da.afløbsvæske,en.drain fluid]
frástøðuávísi	(tøkni)tól ið vísir frástøðu[da.afstandsindikator,en.proximity indicator]
frástøðufølari	(tøkni)tól ið við ljóði sigur frá frástøðu[da.afstandsføler,en.proximity sensor]
frástøðustykki	(tøkni)stykki ið heldur frástøðu ímillum tveir partar P|el.| tvey punkt[da.afstandsstykke,en.spacer]
frátøkustað	(ravm.)stað haðant.d.streymur, hitiel.luft verður tikin, úrtak[da.udtag]
frávik	) [da.afvigelse,en.nonconformity) [tiltøk í sambandi við frávik[da.disponering vedr. afvigelse,en.disposition of nonconformity]
frensur	(handv.,skemt.)tað at e-t er sum tað ikki eigur at vera, mistak, brøkur 2, kiska 1(2),har er frensur í(sperðil í)
freon	(evnafr.)slag av gassi ið ikki brennir(m.a. nýtt sum kuldaløgur í kuldaskápum og sum rekevni í sirmdósum)[da.freon]
freonfiltur	(tøkni)filtur til (at savna saman) freon[da.freonfilter,en.freon filter]
freonløgur	(tøkni,evnafr.)løgur av freoni[da.freonvæske,en.freon liquid]
fresa	(tøkni)nýta fresara, arbeiða við fresara[da.fræse,en.mill]
fresaraamboð	(tøkni)amboð nýtt at fresa við P|el.| til fresara[da.fræserværktøj,en.milling tool]
fresaramaskina	(tøkni)fresari[da.fræsermaskine,en.milling machine]
fresaraskógvur	(tøkni)skógvur á fresara[da.fræsersko,en.milling shoe]
fresari	1(tøkni)maskina við hvøssum malandi knívum(til at skera við el. metal við),fresaramaskina[da.fræser,en.milling machine]2(bún.)maskinamboð til at saksa við
frittur	(handv.)lítil navari, tvari
fríbreidd	(húsasm.)breidd ímillum handlista og vegg[da.fribredde]
frígangur	(tøkni)tómgongd[da.frigang,en.clearance]
frígervi	(tøkni)frígir,seta í frígervi[da.frigear,en.neutral (gear)]
frígir	(tøkni)gir ið nýtt verður tá ið (ak)far er í tómgongd, frígervi[da.frigear,en.neutral (gear)]
frostløgur	(tøkni)løgur at lata í kølara á akfari til at forða fyri frosti, kølaraløgur[da.frostvæske,en.antifreeze]
frostmark	(alisfr.)hiti sum væta hevur tá ið hon frystir,vatn hevur frostmarkið 0° C;hitin er um frostmarkið[da.frysepunkt,en.freezing point]
frostmarksvarnari	(tøkni,oljuv.)tól ið ávarar tá ið hitin nærkast frostmarkinum[da.frysepunktdetektor,en.freezing point detector]
frostmýri	(jarðfr.)mýrilendi við varandi frosti í lítlum dýpi, tundra[da.tundra,en.tundra]
frosttrygging	(tøkni,oljuv.)trygging móti frosti[da.frostsikring,en.frost control]
frosttryggur	(tøkni)tryggur móti frosti[da.frostsikker,en.frostproof]
frostverja	(tøkni)verja fyri frosti[da.frostbeskyttelse,en.frost protection]
frumbitil	(alisfr.)kjarnabitilt.d.nevtron og proton
frumevni	(evnafr.,alisfr.)ósamansett evni, evni við bert einum atomslagi í mýlunum, grundevni[da.grundstof,en.element]
frumlívsøld	(jarðfr.) [da.proterozoikum]
frumløðing	(alisfr.)løðing sum proton og elektron hava,proton hevur positiva og elektron negativa frumløðing
frummongd	(støddfr.)lutir sum avmyndanel.funktión virkar á
frumtal	(støddfr.)tal ið bert er deilandi við 1 og sjálvum sær, primtal(2, 3, 5, 7, 11, ...)[da.primtal,en.prime number]
frymil	einfaldað framseting av einum ástøði(sett upp sum algildur formil)[da.teoretisk model]
frystari	(tøkni)frystiskáp, frystiboks[da.fryser,en.freezer]
frystiboks	(tøkni)útbúnaður (líkur stórum kassa við loki) til at djúpfrysta matvøru í, frystari[da.fryser,en.freezer]
frystikompressari	(tøkni)kompressari ið ger kalda luft í frystiskápi, frystirúm P|o.tíl.|[da.frysekompressor,en.freezer compressor]
frystiskáp	(tøkni)frystiboks lík skápi[da.fryser,en.freezer]
fuga1	(handv.)samankomingt.d.millum múrsteinar[da.fuge,en.joint]
fuga2	(handv.)fyllat.d.sement í fugu 2[da.fuge,en.joint]
fuging	(handv.)tað at fuga
fuguskeið	(handv.)sera smøl múrskeið(jøvn allan vegin)[da.fugeske,en.joint filler]
fullvirkaður	(ídn.)liðugt virkaðurel.viðgjørdur,móts.hálvvirkaður,fullvirkað vøraliðugvøra
funka	(teld.)tilgongd gjørd virkin við funkuknappi (stundum saman við øðrum knappi)[da.funktion,en.function]
funktión	(støddfr.)forskrift sum til hvønn lut í eini mongd (frummongdini) knýtir júst eitt tal[da.funktion,en.function]
funkuknappur	(teld.)knappur 1(3) ið stýrir funku(m)[da.funktionstast,en.function key]
fúrsti	(jarðfr.)leirlind í kolalind
fylgiaksil	(tøkni)fylgiásur[da.medløbsaksel]
fylgiásur	(tøkni), fylgiaksil[da.medløbsaksel]
fylgisteljari	(tøkni)tól heima við hús ið telur telefonsamrøður javnt við teljara á støðini
fylgisveinur	(tøkni)manngjørdur himinknøttur sendur í ringrás um jørðina, mánanel.aðra gongustjørnu(t.d. at gera mátingarel.at senda sjónvarps- og útvarpsbákn)[da.satellit,en.satellite]
fyllimongd	(støddfr.)mongd av lutum í grundmongd G sum eru ikki í A,fyllimongdin hjá A í grundmongdini G eru teir lutir í G, sum eru ikki í A
fylling	(handv.)spegl[da.fyld(n)ing]
fyriboðan	(oljuv.)boð P|el.| tekin um at e-t ávíst fer at henda[da.forvarsel,en.prewarning]
fyriboðanarljós	(tøkni,oljuv.)ljós til fyriboðanar[da.forvarslingslys,en.predischarge beacon]
fyrihaldari	(tøkni)amboð at halda fyri við tá ið klinkað verður[da.modholder]
fyrisitingarkervi	(tøkni)kervi til fyrisiting[da.administrativt system,en.administrative system]
fyriskipan	(oljuv.)e-t sagt P|el.| skrivað ið ein skal P|el.| eigur at halda seg til[da.forskrift,en.regulation]
fyristøðufelag	(oljuv.)felag sum rekur P|el.| samskipar e-t(P|t.d.| oljuútvinning)[da.operatør, operatørselskab,en.operating company]
fyritøka	búskaparliga sjálvstøðug samtøka sum framleiðir og selur vørur og tænastuveitingar[da.virksomhed, organisation,en.organization]
fyritøkubygnaður	háttur ið fyritøka er skipað[da.organisationsstruktur,en.organizational structure]
fyrni	(jarðfr.)gamal harðnaður kavi oman fyri kavanámið[da.firn]
fýrrúm	(rørsm.)rúm har ið oljufýr er í húsi[da.fyrrum,en.boiler room]
føðsluligur	viðv. føðslu[da.ernæringsmæssig]
følarablað	(tøkni) [da.følerblad,en.sensor gauge]
følararør	(tøkni) [da.følerrør,en.sensor tube]
følari	(tøkni)útbúnaður ið skrásetur hita og sendir upplýsingar til hitastillara[da.føler,en.sensor]
førleikatilgongd	tilgongd til at menna førleika[da.kvalifikationsproces,en.qualification process]
førleikauppbygging	(ídn.)tað at byggja upp og útvega førleika[da.kompetanceopbygning,en.qualification build-up]
føtil	(tøkni)pedalur, ástig[da.pedal,en.pedal]
