a	1(lingv.)vokal2(lingv.)1. bogstav i det færøske alfabet (kaldes(fyrra)el.)3(musik)tone og tilsvarende node
A	1romersk taltegn for 50002fork. forampera
abbaba	(barn.)grandonkel
abbabarn	(en mands) barnebarn
abbabeiggi	grandonkel,abbabeiggi mínmin grandonkel
abbadidd	(barn.)grandtante
abbadidda	(barn.)grandtante
abbadissa	abbedisse
abbadóttir	sønnedatter, datterdatter
abbaligur	gammel af udseende el. væsen;-liga
abbasonur	sønnesøn, dattersøn
abbasystir	grandtante
abbati	abbed
abbi	bedstefar,ein gamal abbien gammel mand
abrikosa	(bot.)abrikos
adjunktur	(skole)adjunkt
admirálur	1(militær)admiral2(zoo.)admiral(Vanessa atalanta)
adressa	adresse
advent	(kirk.)advent
adventistur	(rel.)adventist
adventskransur	adventskrans
advokatur	(jur.)advokat
aðal-	hoved-, general-
aðal1	adel
aðal2	rent og godt korn
aðalbláber	(bot.)blåbær(Vaccinium myrtillus)
aðalborin	adelig
aðalendamál	hovedformål, hovedsigte
aðalevni	hovedemne, hovedtema,aðalevnið í hesi bókhovedtema i denne bog
aðaleyðkenni	hovedkendetegn
aðalfundur	(i forening o.lign.)generalforsamling
aðalgrann	(bot.)vanligt aðalgrannædelgran(Abies alba)
aðalhugsan	hovedtanke, grundtanke
aðalhyrnissteinur	(bibl.)hovedhjørnesten
aðalkonsul	generalkonsul
aðalkorn	1det bedste korn2(overf.)det bedste (af noget),aðalkornið í bókmentum okkaradet bedste i vores litteratur
aðalligur	adelig
aðallyndi	ædelt sind
aðalmál	hovedsag
aðalmið	hovedformål,aðalmiðið hjá flokkinumpartiets hovedformål
aðalmunur	hovedforskel
aðalnevnari	(mat.)generalnævner
aðalregla	hovedregel, princip
aðalritari	generalsekretær
aðalroynd	(teater,musik)generalprøve
aðalsfólk	adelsfolk
aðalsfrúgv	adelsfrue
aðalskrivari	generalsekretær
aðalsmaður	adelsmand(fx greveel.baron)
aðalspurningur	hovedspørgsmål, hovedsag,aðalspurningurin snýr seg um støðuna hjá málinumhovedspørgsmålet gælder sprogets situation
aðalstavur	(militær)generalstab
aðalstjórn	hovedbestyrelse(fx i politisk parti)
aðalsætt	adelig slægt
aðalsøgn	(lingv.)hovedverbum
aðaltáttur	væsentlig faktor, hovedtræk, hovedpunkt, hovedfaktor
aðalumboð	generalagentur, hovedagentur
aðalverk	hovedværk,eitt aðalverk í føroyskum bókmentumet hovedværk i færøsk litteratur
aðalverkfall	generalstrejke
aðra	seannar
aðramáta	ellers, i øvrigt
aðrar	seannar
aðrastaðni	andetsteds, andre steder,her og aðrastaðniher og andetsteds
aðrir	seannar
afganari	afghaner
afgani	afghaner
Afganistan	Afghanistan
afganskur	afghansk
Afrika	Afrika
afrikanari	afrikaner
afrikani	afrikaner
afrikanskur	afrikansk
aftan1	1(kvad)aften,síðla var um aftanindet var sent om aftenen2dagen før en hellig-el.højtidsdag,jólaaftanjuleaften;nýggjársaftannytårsaften
aftan2	1bagfra,aftan fleyg ein svartur fuglurbagfra kom en sort fugl2bagpå,aftan og frammanfor og bag3(sammen med præp.)aftan á(bag) efter,hann tók húsini aftan á pápanhan overtog huset efter faren;hon gekk aftan á hann / honumhun gik bag efter ham;aftan fyriel.fyri aftanbag (ved),aftan fyri oyraðbag øret;hendur fyri aftan bakhænderne bag ryggen;aftan undanbagud fra,aftan undan hekkunibagud fra hækken;aftan úragter fra,aftan úr rongagter fra bagstavnen  / /4bag ved (nogenel.noget),hendur aftan bakhænderne bag ryggen
aftaná	1bagefter,vit fingu nógvan vind beint aftanávi fik megen vind bagfra2(om tid)senere,aftaná helt hann tað vera stuttligtbagefter syntes han det var morsomt
aftanbøn	(rel.)aftenbøn, aftenandagt
aftanfyri	1bagved2bagud(fx i idrætskonkurrence),liðið var aftanfyri fyrra hálvleikholdet var bagud i første halvleg
aftaní	agterud,báturin hongur aftaníbåden hænger agterud
aftanífrá	bagfra, fra ryggen,hann leyp á hann aftanífráhan angreb ham bagfra
aftanlestur	(rel.)andagtslæsning om aftenen
aftanskin	aftenmørke
aftantil	bagtil,aftantil á hálsinumbagtil på halsen
aftantíð	(kvad)aftenstund
aftanúr	bagud,dragna aftanúrsakke bagud
aftanvert	1(lidt) bagved,aftanvert við (e-n)lidt bagved (nogen)2aftanvert (e-t)bag på (noget), på bagsiden (af noget)
aftari	1længere bag(af to),hann vildi ikki vera aftari enn granninhan ville ikke stå tilbage for naboen2længere tilbage,hon setti seg eitt sindur aftarihun satte sig lidt længere tilbage
aftarlaga	lidt tilbage,hann var altíð aftarlaga í flokkinumhan var altid lidt tilbage i klassen;(overf.)standa aftarlagavære sent udviklet
aftarumegin	bagved
aftast	bagest
aftastur	bagest
aftna	blive aften, mørknes,dagur aftnardagen går på hæld
aftra	i ordforb.aftra segel.særbetænke sig, vige tilbage, afstå fra sit forsæt;hon aftraði seg fyri at fara innhun betænkte sig ved at gå ind
aftran	tøven, betænkelighed,uttan aftranuden tøven
aftrat	1foruden, i tilgift2ekstra, i tillæg
aftur	1tilbage, agter, bag;aftur eftir hælibaglæns;aftur í skuti bagstavnen;hyggja afturse tilbage2tilbage, igen,gjalda afturbetale tilbage;aftur og framfrem og tilbage3lukket;lata vindeygað afturlukke vinduet;hurðin er afturdøren er lukket4atter, igen, på ny,sovna afturfalde i søvn igen5(sammen med verbum)fxbeina aftur;benda aftur;bøta aftur;fara aftur;fáa aftur;ganga aftur;spyrjast aftur;taka aftur;venda aftur(se verbum)6(sammen med præp. / adv.)aftur aftur1tilbage hvor en kommer fra2om igen;aftur at1i tilgift til, foruden,aftur at tíved siden af det, foruden det2op ad, imod,hon stóð aftur at bróstinumhun stod op ad væggen;halda seg aftur at e-mholde sig til en;aftur á:aftur á bakpå vid gab;hurðin stendur aftur á bakdøren står på vid gab;aftur eftir:aftur eftir hælibaglæns;aftur fyritil gengæld, som vederlag,hvat fái eg aftur fyri at hjálpa tær?hvad får jeg til gengæld for at hjælpe dig?;lata e-t aftur fyri e-tgive noget til gengæld for noget andet;aftur í:aftur í rongi bagstavnen;aftur um:aftur um hurðarbakbag døren;aftur undirude af syne, gemt bag noget,sólin fór aftur undir skýggiðsolen gik bag skyet;aftur við(om mad)sammen med, til,breyð aftur við drekkanumbrød sammen med en kop te;se ogsåafturat,afturav,afturáosv.
afturat	i tilgift, som tillæg, som tilføjelse, ekstra,har afturatendvidere, desuden, derudover;byggjael.gera afturatbygge til;leggja afturattilføje(i fortælling);okkurt gott afturatnoget godt til(fx en kop te)
afturatbygging	tilbygning
afturatkoma	(med.)komplikation
afturatløga	tilføjelse
afturatyrking	tildigtning
afturav	bagover (og ned),benda e-n afturavbøje en bagover;fara afturavbøjes bagover
afturá	1tilbage, baglæns, bagud;ganga afturáblive værre,tað gekk afturá við honum dag frá degihans tilstand blev værre for hver dag2(sita) upp afturásidde med rank ryg3henover,lúkan lá afturálugen lå henover;leggja afturádø
afturáaftur	rógva, siglael.leggja afturáafturroel.sejle tilbage på fiskeplads hvorfra strømmen har ført en væk
afturábendur	bøjet bagud,við afturábendum høvdimed hovedet bøjet bagud
afturáboygdur	tilbagebøjet
afturbein	(zoo.)bagben(på firbenede dyr)
afturbeindur	(lingv.)relativ,afturbeint fornavnrelativt pronomen;afturbeindur eykasetningurrelativ bisætning
afturbendur	(lingv.):afturbent fornavnrefleksivt pronomen
afturbering	tilbagebetaling, refundering
afturbleytur	(om får)med diarré
afturblíðkaður	formildet, blevet god igen
afturboðan	feedback(fx i apparatel.organisme)
afturbót	erstatning
afturbragd	(biol.)refleks
afturbregðiligur	(biol.)arvelig
afturbøtandi	som kan gøres god igen,skaðin er ikki afturbøtandiskaden kan ikke gøres god igen
afturbøting	reparation
afturdekk	(skib.)agterdæk
aftureftir	tilbage, baglæns, bagud
aftureining	genforening
afturendi	bagende(fx på bådel.skib)
afturfall	(skib.)rum bag ved kahyt(på slup)
afturfarin	1gået tilbage, forringet, svækket,eyguni eru afturfarinøjnene er svækket2som har tabt sig,hann er afturfarinhan har tabt sig
afturferð	1tilbagerejse, tilbagevej2tilbagegang i styrke, kræfterel.evne,hann er í afturferð
afturfit	(zoo.)baglem på sæl
afturfitja	baglem på sæl
afturfitjing	baglem på sæl
afturfjórðingur	bagfjerding(af oksekrop)
afturfótur	(zoo.)baglem, bagben(på firbenede dyr)
afturfrá	detta afturfrásakke bagud;leggja e-n afturfráoverhale en(til fods)
afturfyri	1som vederlag,fáa afturfyrifå som vederlag2lukket, låst,hvør loka var afturfyrialle slåer var for
afturfyrisegkomin	kommet sig, udhvilet(efter sygdom, hårdt arbejde osv.)
afturgiftur	gift igen
afturgjald	1vederlag, erstatning2tilbagebetaling
afturgjalding	tilbagebetaling
afturgjørdur	repareret
afturgonga	1tilbagegang2spøgeri3spøgelse, genfærd
afturgongd	tilbagegang
afturgrasaður	græsbevokset på ny(fx efter dyrkning)
afturhald	1måde(hold),(ordsp.)tá ið vesalamaður (el.fátækur maður) fær vald, kann hann sær ikki afturhaldnår skidt kommer til ære, ved det ikke hvor det skal være2konservatisme(spec. i samfundsforhold)3tilbageholdelse (af løn)
afturhaldandi	1konservativ2tilbageholdende, beskeden, reserveret
afturhaldin	tilbageholdende, lidt genert,við einum afturhaldnum smílimed et lidt genert smil
afturhaldsblað	konservativ avis
afturhaldsflokkur	konservativt parti
afturhaldshugaður	konservativ
afturhaldsmaður	konservativ (mand)
afturhaldssinnaður	konservativ
afturhaldsstevna	obskurantisme
afturheilsan	genhilsen
afturhildin	1tilbageholdt,sendingarnar vórðu afturhildnarforsendelserne blev tilbageholdt2mådeholden, moderat
afturhittur	tú skalt verða afturhitturdet skal du få betalt
afturhjól	(på køretøj)baghjul
afturhokin	hængende bagud
afturhond	1(zoo.)baghånd(på abe)2í afturhondbagud (med noget);koma í afturhond við e-mkomme bagud med noget
afturhorvandi	retrospektiv, tilbageskuende,skaldskapur hansara hevur afturhorvandi dámhans digtning har et retrospektivt præg
afturhógvur	(zoo.)hov på bagben(på hovdyr, hest o.lign.)
afturi	agter, bag, længere tilbage,har afturiagter(i et fartøj)
afturíaftur	igen(om noget som har været væk),koma afturíaftur1komme frem igen2blive godt igen(når der har været en kurre på tråden),tað kom afturíaftur hjá teimumde blev gode venner igen;komael.spyrjast afturíafturblive fundet igen,skipið komel.spurdist ongantíð afturíafturskibet forsvandt med mand og mus;taka afturíafturtage tråden op igen, fortsætte en bemærkning, hvor man slap
afturíafturkomin	genfundet
afturímóti	1igen på sin side, som svar, som gengæld,sláa afturímótislå tilbage2sammenlignet med,veiðan í ár er einki afturímóti veiðuni í fjørfangsten i år er ingenting sammenlignet med fangsten i fjor
afturjakslur	(biol.)molar
afturkast	noget man ikke bryder sig om, noget man kaster vrag på
afturkastaður	vraget
afturkasting	(fys.)refleksion(af lys, lyd o.lign.)
afturkembing	smerte der kommer igen
afturkenning	genkendelse
afturkensla	genkendelse
afturkeyp	genkøb, tilbagekøb
afturkleyv	(zoo.)bagklov(på klovdyr, ko o.lign.)
afturklógv	(zoo.)bagklo(på krebsdyr o.lign.)
afturkoma	tilbagekomst, genkomst
afturkoming	tilbagekomst, genkomst
afturkroppur	bagkrop
afturlabbi	(zoo.)baglem, bagpote
afturlating	lukning(fx af butik)
afturlatingartíð	lukketid
afturleið	tilbagevej,á afturleiðinipå tilbagevejen
afturleistur	hæl på en strømpe
afturlimur	(zoo.)baglem
afturlit	retrospekt
afturlítandi	retrospektiv,afturlítandi listaframsýningretrospektiv kunstudstilling
afturljóð	genlyd, ekko
afturljós	(på fartøj)agterlanterne
afturlykt	agterlanterne
afturlæstur	låset, lukket med lås
afturløning	gengældelse
afturmastur	(skib.)mesanmast
afturmenning	bedring, rekreation
afturnørdur	igen blevet talrigere,kópurin er nú afturnørdursælerne er igen blevet talrigere
afturopin	i ordforb.falla afturopinfalde bagover
afturpartur	bagdel(især på dyrel.menneske)
afturreising1	(båd.)bådens rejsning bagpå
afturreising2	genrejsning,móðurmálsins afturreisingmodersmålets genrejsning
afturrenning	det at benbrud gror sammen igen
afturrikin	vraget, forsmået
afturrindan	tilbagebetaling
afturrong	(båd.)sæde i bagstavnen på båd
afturróður	1det at ro tilbage på fiskepladsen når strømmen har ført en væk2roet strækning3tilflugt,afturróðurin man verða higarhertil søger han tilflugt når det gælder4emne som man hyppigt vender tilbage til, kæphest,hatta var altíð afturróðurin hjá honumdet var hans kæphest
afturrunnið	(om benbrud)groet sammen igen
afturrútur	bagrude
afturs	til afturstil agters, ned ad bakke,koma til aftursblive svag, svækkes
aftursegl	(skib.)mesan
aftursending	returnering
aftursetstur	1som har sat sig igen2som har opgivet at tage af sted
aftursettur	(om båd)tungt lastet agter
afturseymaður	syet sammen (igen)
aftursigin	(om grøft)sammensunket
aftursíður	med hængende buksebag, hængerøv
aftursjúgvaður	sum aftursjúgvaður hundurmeget skamfuld
afturskin	genskin, genskær, refleks
afturskip	(skib.)agterskib
afturskoðandi	retrospektiv,afturskoðandi framsýningretrospektiv udstilling
afturslag	(skydevåbens) tilbagestød, rekyl
aftursnúður	dobbelt snoning
aftursókn	(jur.)regres
afturspegling	genspejling
aftursperra	underben
afturstavnur	(båd.)agterstævn (på båd)
afturstevni	(båd.,skib.)agterstævn (på skib)
afturstig	1(i kædedans)skridt i tilbagegående retning2(med.)tilbagefald,fáa afturstigfå et tilbagefald3(overf.)tilbagegang,blaðið fekk afturstigavisen gik tilbage4tilbageskridt
afturstigshiti	(med.)tilbagefaldsfeber(febris recurrens)
afturstingur	(håndarb.)(i syning)bagsting, stikkesting
aftursvar	(gen)svar, replik
aftursøgn	genfortælling
afturtjúkkur	(om dyr)med tyk bagkrop
afturtog	(båd.)line som båd er bundet i agter
afturtrá	nostalgi
afturtungur	tung bagtil
afturtæri	(på en tørret fårekrop)låret med siden
afturtøka	1tilbagekaldelse2tilbagetrækning
afturum	1over på den anden side (af noget), bag ved noget(så det er usynligt)2bagom,fara afturumgå bagom3om igen,slætta afturumglatte om igen
afturumaftur	på ny, igen,koma afturumafturgenoptage omtalen af noget, optage til revision el. videreførelse, oprippe, revidere, gengælde;kom nú ikki afturumaftur við hasumlad nu det ligge;tað er ikki gott at koma afturumaftur har1det er ikke let at være en så enestående persons efterfølger2det er ikke morsomt at fortsætte eller gøre om et forkert begyndt el. dårligt udført arbejde;tað kann koma afturumafturdet kan hævne sig;onkuntíð vænti eg at koma tær afturumaftur fyri hattajeg skal nok engang gengælde dig det;kína afturumafturkærtegne efter slag;hyggja afturumaftur at e-mse endnu engang på noget;ganga afturumafturgøre noget bedre
afturumfarin	1(om skib)passeret2(om tiden)gået
afturumsigldur	(overf.)alene, tilsidesat, ringeagtet
afturundir	1ud(e) af syne,fara afturundirgå ud af syne(bag om noget),ganga afturundirgå af syne;krúpa afturundir;kasta afturundir(om vind)slå tilbage, give forkerte stød2bagved, bagom, i skjul el. læ
afturundirgerð	strøm inde ved land gående i modsat retning af hovedstrømmen
afturúr	bagud,dragna afturúrsakke bagud
afturúrsigldur	1(om sømand)som skibet er sejlet fra(især i fremmed havn)2(overf.)alene, tilsidesat, ringeagtet
afturval	genvalg
afturvaldur	genvalgt
afturveggur	bageste væg
afturvegur	tilbagevej, hjemvej,á afturvegnumpå hjemvejen
afturvend	i ordforb. somhar er eingin afturvenddet bliver ikke anderledes
afturvending	tilbagevenden
afturvendur	1vendt om, kommet tilbage(fra rejse)2sat til vægs, gendrevet,tú kanst svara, men tú verður afturvendurdu kan svare, men du får svar på tiltale
afturvið	1oveni, i tilgift(om pålæg o.lign.),køkur afturviðkager til kaffeel.te2forbi(på bådel.skib),tað man longu vera rikið afturviðdet er vist allerede drevet forbi
afturvirkandi	retroaktiv,(forsikr.)afturvirkandi dagfestingretroaktiv dato
afturvitjan	genvisit
afturvitjing	genvisit
afturvongur	(zoo.)bagvinge
afturyvir	over, henover,skupla mold afturyvirskovle jord henover igen
afturæsing	(båd.)endestykke af rælingen agter
afturøvut	baglæns,ganga afturøvutgå baglæns
afturøvutur	faldende bagover,detta afturøvuturfalde bagover
aga	1ave, revse2holde i ave, holde styr på3aga undir (e-n)skubbe til (nogen),tað agar so undir megdet piner mig
agafastur	disciplineret
agaleysur	uvorn, selvrådig, respektløs, udisciplineret,drongurin er agaleysurdrengen er respektløs
agat	(geol.)agat
agg	1uvilje, nag,hava agg til (e-n)bære nag (til en)2fortræd,eg havi sovorðið agg av honumjeg har ondt af ham
agga	1agga á (e-n)1bære nag til en2give stikpiller, drille, håne2ærgre, pine,tað aggaði hanndet pinte ham
aggandi	(talesp.)i ordforb.aggandi gamalældgammel
agi	ave, tugt, disciplin,hava e-n undir agaholde en i ave
agn	1madding,sild til agnssild som madding;(ordsp.)eymur er maður, ið agn sparirden mand er ussel, som sparer på madding;(talem.)har eru mangir murtar um agniðder er megen rift om det2(overf.)noget at lokke med,valagnvalgflæsk
agnadungi	dynge akseskæg
agnaneit	i ordforb. somikki agnaneitin eftir ásom har tabt agnene af fiskekrogene
agnar	seøgn
agnarorð	stiklende ord, skoser
agngágga	(zoo.)konksnegl(Buccinum undatum)
agnhald	hage på en fiskekrog
agnleysur	uden madding
agnloysi	mangel på agn
agnneyð	mangel på agn
agnsettur	som mangler agn
agnsetur	mangel på agn,í agnsetri
agnsild	sild til at bruge som madding
agnskerari	(mar.)mand som skærer agn
agntrot	mangel på agn
agnvandin	(om fisk)kræsen mht. madding
agnvandur	(om fisk)kræsen mht. madding
agurka	agurk
ahorn	(bot.)ahorn(Acer pseudoplatanus)
ai	(for at vise smerte);jf.oy 3
ak	eitt aken der kommer dryssende bagefter
aka	1kælke, køre på kælk,aka (á) skíð(i)kælke;fara út at akagå ud og kælke2skubbe sig frem, skride,aka uttan um eldinsidde og drive den af;(overf.)aka á knøunumvære på knæerne;aka reyvardrive den af;aka undanvige tilbage,dagarnir koma akandien dag går, en anden kommer;tíðin ók aftur eftir hælitiden gik meget langsomt3skubbe,aka ein steinskubbe en sten;aka segskubbe sig;akast1skubbe sig af sted, flytte sig (siddende el. liggende)2ligge og dovne,akast á beinkinumligge og dase på bænken
akademi	(univ.)1akademi, videnskabelig forening2højere læreanstalt, akademi
akademikari	(univ.)akademiker
akademiskur	(univ.)akademisk
akarn	(bot.)agern
akbreyt	kørebane
akfar	køretøj
akferð	køretur
akker	1(skib.)(skibs)anker,kasta akker(i)kaste anker;liggja fyri akkeriligge for anker2(elektr.)anker
akkeri	(skibs)anker
akkersarmur	ankerarm
akkersbotnur	ankerbund,góður / ringur akkersbotnurgod / dårlig ankerbund
akkersboya	ankerbøje
akkersbundin	bundet til anker
akkersflíggj	ankerflig
akkersgrunnur	ankerbund,tryggur akkersgrunnursikker ankerbund
akkersketa	ankerkæde
akkersleið	ankerplads
akkersljós	(skib.)ankerlanterne
akkersspæl	(skib.)ankerspil
akkuleya	(bot.)akeleje(Lychnis)
akkumulatorur	(fys.)akkumulator
akkurát	1akkurat, netop, præcis,tað er akkurát taðdet er præcis det2lige, lige netop, med nød og næppe,hann kláraði akkurát próvtøkunahan bestod lige akkurat eksamen;vit vunnu akkurát niðanávi klarede med nød og næppe op på højden
akkurátur	nøjeregnende
akneyt	okse som trækdyr, trækokse
akramaður	person fra bygden Akrar
Akrar	(stedn.)bygd på øen Suðuroy,á / av Økrum,á Akrar
akrýl	akryl
aks	(bot.)aks(spica)
aksaklumpur	forkrøblet aks
aksaknokkur	dværgaks
aksarúgva	dynge aks(fx efter afrivningen)
aksaryski	(bot.)aks-frytle(Luzula spicata)
aksaskjótast	(om kornmark)(begynde at) sætte aks
aksaskotin	(om kornmark)som har sat aks,akurin var aksaskotinmarken havde sat aks
aksast	(om kornmark)sætte aks,akurin er við at aksast
aksatungur	(om kornmark)med tunge aks
aksbærur	(bot.)med aks i spidsen
aksgrógvin	(bot.)vivipar(viviparus)
aksil	aksel(på vogn etc.)
aksla	aksla seg framskuldre sig frem, bane sig vej(ved hjælp af skuldrene)
akslabreiður	bredskuldret, skulderbred
akslahallur	med hængende skrå skuldre, hængeskuldret
akslahædd	skulderhøjde
akslar	seøksl
akslarblað	(bot.)akslarbløðakselblade(stipulae)
akslarknúta	(biol.)skulderledshoved(Caput humeri)
akslarliður	(biol.)skulderled
akslarseymur	(håndarb.)skuldersøm
akslarslíðri	(bot.)kræmmerhus, ligula(ochrea)
akslaskjótast	1bevæge skuldrene(som tegn på opstemthed)2trække på skuldrene3mase sig frem ved hjælp af skuldrene
akslasmalur	smalskuldret
akslasneiddur	med skrå skuldre, hængeskuldret
akslatræ	bøjle (til tøj)
akslaypp	skuldertrækning
aksleggur	(bot.)stilk,aksleggurin er rísin og hærdur
akslir	seøksl
akslíkur	(bot.)som ligner aks
aksmynta	(bot.)grøn mynte(Mentha spicata)
akstólur	1sæde i hestevogn2kørestol
akstur	kørsel
aksturvinna	kørsel som erhverv
aksøgn	(bot.)aksagnaryderavne(glumae)
akt	agt, agtpågivenhed,geva e-m aktgive agt på noget;taka daginel.morgunin í aktbegynde dagens gerning fra morgenstunden
akta	1adlyde,akta e-nadlyde nogen2bemærke, lægge mærke til, ænse,akta eftir (e-m)ænse nogenel.noget;akta um (e-t)lægge mærke til noget;akta upp á (e-t)3tage vare på, vogte,tú akta væl synir tínartag godt vare på dine sønner
aktarær	hunfår som løn for at genne fårene ud fra indmarken
akting	det at genne fårene ud fra indmarken
aktingarhundur	hund der vogter ager og hjemmemark
aktingarlamb	lam som løn for at genne fårene ud fra indmarken
aktingarløn	løn for at genne fårene fra hjemmemarken
aktingarmaður	mand der har som arbejde at genne fårene fra hjemmemarken
aktingarær	hunfår som løn for at genne fårene ud fra indmarken
aktýggi(r)	seletøj
aktær	hunfår som løn for at genne fårene ud fra indmarken
akul	(kirk.)(messe)hagel
akur	ager, kornmark,skera akurmeje korn;(overf.)skera góðan akur av e-mhøste fordel af en
akurbládepla	(bot.)mark-ærenpris(Veronica arvensis)
akurfólk	høstfolk
akurhoylús	(bot.)mark-forglemmigej(Myosotis arvensis)
akurhøna	(ornitol.)agerhøne(Perdix perdix)
akurhøsn	(ornitol.)agerhøns
akurknívur	kniv til at skære korn med, segl
akurkøka	første brød af kornhøsten
akurlendi	agerjord
akursinnopur	(bot.)ager-sennep(Sinapis arvensis)
akurskrift	(ornitol.)vagtelkonge(Crex crex)
akurskritt	(ornitol.)vagtelkonge(Crex crex),ríkja sum akurskritt(siges om en der ikke kan lade være med at snakke)
akurskurðarfólk	høstfolk
akurskurðarmaður	høstkarl
akurskurður	1(korn)høst2høsttid
akursvínamjólk	(bot.)ager-svinemælk(Sonchus arvensis)
akurtistil	(bot.)agertidsel(Cirsium arvense)
akurull	(bot.,kvad)smalbladet kæruld
akurveður	vejr (med skiftende solskin og regn) som er gunstigt for kornvæksten
akvavitt	akvavit
akvegur	kørevej
ala	1føde, opfostre,væl aldurgodt opfostret2(om fugl og dyr)føde op,ala fiskopdrætte fisk3lokke til sig (el. til huset), få (især et dyr) til at holde af sig,ala upp at særel.upp í seglokke til sig;hon aldi fólk at handlinumhun lokkede folk til forretningen  / /ala at:ala at særlægge ind under sig;ala av:ala av særskabe, føde;ala framdyrke, avle,tað er lætt at ala fram nýggj sløgdet er let at dyrke nye sorter;ala uppopdrage;ala upp áel.í segel.upp at særlokke til sig
alabastur	(geol.)alabast
alabasturkrukka	alabastvase
alari	1fiskeopdrætter2(mar.)den første fisk der fanges og som man lader blive liggende hos sig for at bevare fiskelykken
alaskalupin	(bot.)alaskalupin(Lupinus nootkatensis)
alátin	altædende,strutsurin er alátinstrudsen er altædende
albanari	albaner
albani	albaner
Albania	Albanien
albann	totalforbud
albanskur	albansk
albatrossur	(ornitol.)albatros
albeittur	fuldstændig dækket med græs som kan tjene (især får) til føde,albeittur hagistenfri udmark med græs over det hele
albilsin	overrasket, forbavset, forbløffet
albirgur	fuldstændig raskel.kraftig,hon er albirg ennhun er stadig fuldstændig rask
alblóðigur	blodig over det hele
albogaleggur	(biol.)albueben(ulna)
albogaliður	(biol.)albueled
albogasjál	mindre sjal
albogaslag	albuestød
albogastoytur	albuestød
albogi	albue,albogin er slitinalbuen er slidt
albrynjaður	1i fuld rustning,albrynjaðir hermennsoldater i fuld rustning2tykt klædt på fra top til tå
albúgvin	fuldstændig udrustetel.parat,svullurin er albúgvinbylden er fuldt moden til at skæres
albygdur	fuldt bebygget
alda1	(stor, høj) bølge, bølgegang,stór aldastore bølger;(koll.)tung aldahøj(e) bølge(r);síð aldahøj(e) bølge(r);alda í sjónumbølger i søen
alda2	1bølge,tað aldaði frá bógnumder var bølger fra boven2være i bølgende bevægelse3(om lyd)lyde skiftevis stærkere og svagere,fagnaðarrópini aldaðu kring vøllinjubelråbene lød skiftevis stærkere og svagere omkring stadion
Aldafaðir	(poet.)Gud
aldagamal	århundreder gammel
aldalangur	århundreder lang,aldalangar royndirerfaringer gennem århundreder
aldamót	århundredskifte,um aldamótið 1900-1901ved århundredskiftet 1900-1901
aldan	(kvad)olden
aldanskur	pæredansk
aldar	seøld
aldargamal	et århundrede gammel, 100 år gammel
aldarlilja	(bot.)plante i slægtenAgave
aldaskifti	århundredskifte
aldavinur	trofast ven
aldeilis	aldeles, helt, fuldkommen,heilt og aldeilishelt og aldeles
aldin	1(kvad)olden2frugt
aldinbori	(zoo.)oldenborre(Melolontha melolontha)
aldingarður	(bibl.)have
aldinløgur	most
aldintræ	frugttræ
aldinviður	frugttræ
aldraður	gammel
aldrandi	gammel
aldri	aldrig
aldrin	aldrig,so aldrinaldeles ikke, slet ikke
aldubára	mindre bølge
aldubrot	bølgebrydning, bølge der bryder i toppen,tey spæla sær í aldubrotinumde leger i bølgebrydningen
aldudalur	også(overf.)bølgedal
aldudrabb	små tætte bølger,lotið loypti eitt lítið aldudrabb í sjógvinvinden gjorde små tætte bølger i søen
aldudráttur	bølgeslag mod stranden
aldugerð	bølgedannelse
aldukambur	bølgekam
aldukendur	bølgeagtig
aldulongd	også(tekn.)bølgelængde
aldur1	1alder,á seks ára aldrived seks års alderen;ungur á aldri(num)ung af alder;teir eru um ein aldurde er omtrent jævnaldrende;hann er um sama aldur sum honhan er jævnaldrende med hende;við aldurinmed alderen;um miðjan aldurmidaldrende;hann slítur ikki hálvan aldurhan dør før tiden(fx af overanstrengelse);allan hennara aldurhele hendes liv;nakað við aldurret gammel;væl við aldurgammel;á gamals aldrii alderdommen2alderdom,aldur er dottin á hannhan er begyndt at se gammel ud;komin til aldursblevet gammel;deyður av aldridød pga. alder3tid, periode,aldur og alla ævitid og evighed
aldur2	seala
aldurdómsbrek	alderdomsskrøbelighed
aldurdómur	alderdom
aldurið	stor bølge,báturin slongdist upp á einum alduriðibåden blev slynget op på en stor bølge
alduringur	ringformet lille bølge
aldursbólkur	aldersgruppe
aldursbrek	alderdomsskrøbelighed
aldursbýti	aldersopdeling
aldursformaður	alderspræsident
aldursgreina	aldersbestemme,aldursgreina forngripiraldersbestemme arkæologiske fund
aldursmark	aldersgrænse,20 ára aldursmark20 års aldersgrænse
aldursmerktur	alderdomsmærket
aldursmunur	aldersforskel
aldursskifti	aldersfordeling
aldurstíð	frá aldurstíðfra arilds tid
alduryggur	bølgekam
aldurøð	bølgekam
aldurøring	bølgende bevægelse
aldusig	dønning
alduskol	skyllen af bølger
alduskot	bølgeslag
alduskvatl	bølgeskvulp
aldusuð	susen af bølger
aldutoppur	bølgekam
aldutur	(om søen)urolig, med høje ubrudte bølger
alfaðir	(rel.)alfader, Gud
alfagur	(poet.)meget fager, underskøn, skøn,tú alfagra land míttdu mit underskønne land;alfagurt
alfaravegur	alfarvej
alfegin	hjertelig glad
alfevndur	universel
alfólkaligur	folkelig
alfriða	totalfrede,vit eiga at alfriða lomviganvi bør totalfrede lomvierne
alfrøði	leksikon
alfrøðibók	leksikon
alfundur	plenarforsamling
alfúsur	meget ivrig
alføroyskur	rent færøsk
alga	(bot.)alge(Alga)
algeri	algerier
Algeria	Algeriet
algerskur	algerisk
algilda	generalisere
algildi	generalisering
algildistekn	(datal.)jokertegn
algildur	generel
algjørdur	total
algloypandi	altopslugende,hungurin var algloypandisulten var altopslugende
algongdur	almindelig, gængs,algongt fyribrigdialmindeligt fænomen;orðið er algongt í føroyskumordet er almindeligt i færøsk
algoystur	1som styrter voldsomt af sted,hann rennur algoystur eftir teimumhan styrter efter dem2meget ivrig, meget opsat på noget,hann var algoystur at sleppa av staðhan var meget opsat på at komme af sted3åndeløs, forpustet,algoystur og uppøsturforpustet og ophidset
algóður	meget god
alhalgan	i ordforb. somum alhalgunaomkring allehelgensdag
alhalgunadagur	allehelgensdag (1. nov.)
alhanda	allehånde(krydderi)
alheims-	verdens-, universel, international
alheimsgerð	globalisering
alheimsheilsustovnur	verdenssundhedsorganisation(WHO)
alheimsligur	universel, international;-liga
alheimur	1(astronomi)univers2hele jorden
ali	1egenskab, natur (i noget)2styrke, kraft,tað er gott ali í honumder er megen styrke i ham
alibrúk	avlscenter
alidjór	husdyr, tamt dyr
alidýr	husdyr, tamt dyr
alifiskur	opdrætsfisk(fx laks og ørred)
alifóður	foder til opdrætsfisk
alifuglur	fjerkræ, et stykke fjerkræ(høns, ænder etc.)
alikar	kar til fiskeopdræt
aliker	akvarium
aliknappur	(bot.)ynglelegeme, yngleknop(bulbillus)
alikorn	(bot.)løgknop
alin1	(mål)alen(dvs. 62,77 cm)
alin2	seala
alinartjógv	fårelår en alen langt
aling	opdræt(af dyr, fisk o.lign.)
alinlangur	en alen lang
alinstjógv	fårelår en alen langt
alipisa	tam (sø)fugleunge
aliringur	dam(til fiskeopdræt)
alisfrøði	(fys.)fysik
alisfrøðiligur	(fys.)fysisk;-liga
alisfrøðingur	(fys.)fysiker
alisligur	(med.)fysisk;-liga
alistøð	avlscenter(til fisk, dyr o.lign.)
alisviðgerð	(med.)fysioterapi
alisviðgeri	(med.)fysioterapeut
alivinna	fiskeopdræt
alivøkstur	kulturplante
alkavað	fuldstændig dækket med sne,nú er alkavað
alkendur	som alle kender, meget kendt
alklakaður	1helt dækket af våd sne,alklakaður maður;alklakaður seyður2(overf.)helt skjult, ganske bedækket
alklæddur	i fuld mundering, i fuld påklædning,liggja og sova alklæddurligge og sove i fuld mundering
alkohol	(kem.)alkohol
alkomin	kommen helt, kommen fuldstændig,nú er alkomið várnu er det helt blevet forår;tjøldrini eru alkominstrandskaderne er fuldtallige;vestfallið er alkomiðnu har strømmen (mod vest) nået sin stærkeste fart
alkrem	universalcreme
alkunnugur	1fuldkommen stedkendt2almindelig bekendt,tað er alkunnugtdet er almindelig kendt
alkønur	fuldstændig (sag)kyndig
alla	i ordforb.við / med allafor bestandig, uigenkaldelig;tey fóru avstað við / med allade rejste for bestandig
allahalgan	allehelgensdag
allahalgannadagur	allehelgensdag (1. nov.)
allahanda	allehånde (krydderi)
allahandamaður	altmuligmand,hann er allahandamaður í fyritøkunihan er firmaets altmuligmand
allarbestur	afgóðurallerbedst
allareiða	(talesp.)allerede
allarmestur	afmikil,nógvurallermest
allarstørstur	allerstørst
allastaðni	alle vegne, overalt,allastaðni á jørðinioveralt på jorden
alleingi	meget længe
allíkur	kongruent, som dækker hinanden
allítil	meget lille
alljósur	(om dag)helt lys, højlys,á alljósum degived højlys dag
alloðin	1fuldstændig lodden,eitt alloðið høvdet fuldstændig loddent hoved2overgroet(med græs),hólmurin er alloðin í síðum grasiholmen er overgroet med højt græs
allogandi	helt i flammer,allogandi eldurild i store flammer
alloysing	fuldkommen løsrivelse
allur	og1hel, ubegrænset,allan daginhele dagen;alla náttinahele natten;alt fólkiðhele befolkningen;alt gjørdi túdet var din skyld alt sammen;alt eftir einari ferðdet hele på en gang;tað var alt at gera, at...det var med nød og næppe, at...;av øllum1fuldstændig, ganske2for bestandig,hon er komin av øllumhun er kommet for at blive;hatta er móti øllumdet er bedre end alt andet;fyri alt taðfor resten;við øllumfor altid2færdig,nú er søgan øllnu er fortællingen slut;hann verður at siga "alt"han bliver nødt til at sige stop;so var altdet var det hele, nu er fortællingen til ende
allýsa	definere
allýsing	definition
almakt	almagt,av almaktaf al magt
almangur	almangirsærdeles mange
almanna	1offentlig, almindelig2social
almanna-	offentlig
almannafæ	offentlige midler
almannagagn	almennytte,almannagagnið hongur í lukkuni hjá tí einstakaalmennytten afhænger af lykken hos den enkelte
almannagagnligur	almennyttig,almannagagnlig málalmennyttige formål;-liga
almannagøta	alfarvej
almannahjálp	socialhjælp(iht. lov)
almannahugsan	opinion, almindelig opfattelse
almannakendur	almindelig kendt
almannakunnigur	almindelig bekendt
almannakunnugur	almindelig bekendt
almannaleið	alfarvej
almannamál	(pol.)sociale anliggender
almannaogn	hver mands eje
almannapláss	(fx på passagerskib el. fly)turistklasse
almannaráðgevi	socialrådgiver
almannastova	socialkontor
almannatal	hvad alle siger
almannatos	hvad alle siger
almannavegur	alfarvej
almannaveiting	socialhjælp, socialydelse
almannaverk	1noget enhver beskæftiger sig med2socialvæsen
almáttugur	almægtig,almáttugur Guð
almáttur	almagt,almáttur Guðs
almenni	offentlighed,borgaraligt almenniborgerlig offentlighed
almenniligur	offentlig, almindelig;-liga
almenningur	1alminding, stykke jord som alle besidderne i en bygd har lige ret til at benytte(fx til kvæggræsning)2almenhed, offentlighed, publikum,framsýningin er opin fyri almenninginumudstillingen er åben for offentligheden
almennur	almindelig, offentlig, officiel,almenn hugsanoffentlig mening;almennar reglurgenerelle regler;almennur dansuroffentlig dans;alment innlitoffentlig indsigt;alment starvoffentlig stilling;hitt (el.tað) almennadet offentlige, myndighederne
almenskur	almenmenneskelig
almerkiligur	enestående, fremragende
almikil	ret stor,almikiðrigtig meget
almur	elm(etræ)
almúgufólk	almue
almúgumaður	almuesmand
almviður	tømmer af elm
almyrking	(astronomi)total formørkelse
almyrkur1	totalformørkelse
almyrkur2	helt mørk,nú var almyrktnu var det helt mørkt
alnalangur	alenlang
alnarlangur	en alen lang
alnartjógv	fårelår en alen langt
alnet	(datal.)internet
alneyðugur	absolut nødvendig
alnógvur	ret meget
alnýggjur	splinterny
aloftast	som oftest, som regel
aloyða	ødelægge totalt
alpuhúgva	alpehue
alpurósa	(bot.)alperose, rododendron
alrabestur	afgóðurallerbedst
alrasin	fuldstændig rasende,hann var so alrasin og ovursinturhan var fuldstændig rasende
alráðandi	enerådende,hitt gamla samfelagið hevur mist sín alráðandi týdningdet gamle samfund har mistet sin enerådende betydning
alreyður	fuldstændig rød,sólin kom so alreyð úr havisolen kom fuldstændig rød op af havet;alreyður í andlitifuldstændig rød i ansigtet
alríkur	meget rig
alrím	(litt.)helrim
als	helt, fuldkommen, fuldstændig, aldeles,orðið er als ókent hjá okkumordet er fuldstændig ukendt hos os;als einginslet ingen;als ikkislet ikke, ingenlunde
alsamt	1stadig (væk),hon svevur alsamthun sover stadig2bestandig, stedse, jævnlig,vindurin vaks alsamtvinden tog bestandig til
alsamur	stadig, bestandig,alsamur streymur av vatnistrid strøm af vand;(elektr.)alsom streymveitingkonstant elforsyning
alseta	plenum, plenarforsamling
alsettur	helt skjult, ganske bedækket (af noget),klæðini vóru alsett við hártøjet var fyldt med hår
alsjálvvirkin	fuldautomatisk
alskhugaður	forelsket
alskhugsmikil	kærlighedsfuld
alskhugur	kærlighed, elskov
alskiligur	elskelig,ungin er so alskiligurungen er så elskelig;-liga
alskin	1(om dyr)kælen,kúgvin var so alskinkoen var så kælen2(om personer)kærlig, hengiven;hon hugdi alskin upp á hannhun så kærligt på ham
alskkona	elskerinde, frille
alsklingur	yndlingsbarn, yndling,alsklingur mínmin yndling
alskmikil	forelsket,hitt alskmikla eygnabragdiðdet forelskede blik
alsktikin	forelsket
alskur	kærlighed, hengivenhed,leggja alsk á e-nel.at e-mkaste sin kærlighed over en
alskyns	alskens, al slags,fuglur og alskyns djórfugle og al slags dyr
alslættur	meget jævn,alslættur vegur
alspentur	1(ventende) i yderste spænding,dreingirnir sótu alspentir og lurtaðu eftirdrengene sad meget spændte og lyttede2som anstrenger sig meget3udspændt, udspilet,alspentur bogiudspilet bue
alspurin	nysgerrig
alstórur	meget stor
alsveittur	gennemsvedt
alsýndur	let at se, ganske tydelig
alt1	11i ordforb. somalt at gerapå nippet til, lige ved, tæt på,tað var alt at gera, vit vunnu upp landdet var lige akkurat at vi nåede land2fyri alt taðaltså, ellers,fyri alt tað hevði tað ongan týdningdesuden var det uden betydning3lige, ens4mere og mere, bestandig,alt nærkaðist hann bjørninihan nærmede sig bjørnen mere og mere5lige indtil,alt til heimsbardagin brast á í 1939lige indtil verdenskrigen brød ud i 1939;alt at markinumlige til grænsen6alt fyri eittstraks, med det samme;alt í einumpludselig;alt í senni samme øjeblik7stadig, fremdeles,brugdan lá alt í frið og fleytbrugden lå stadig i fred og flød21til trods for, selv om, skønt,hann mátti dvína, alt hann var størrihan måtte give op, selv om han var større2alt summens,alt sum drongurin vaksmens drengen voksede
alt2	(musik)alt, altstemme
altal	(mat.)altølreelle tal
altan	altan
altanur	altan
altar	(kirk.)alter,fara til altarsgå til alters,standa fyri altarinumstå for alteret(gifte sig med en person i kirken)
altarborð	(kirk.)1selve alteret2altergang
altarbók	(kirk.)alterbog
altarbreyð	(kirk.)nadverbrød, oblater
altardagur	(kirk.)altergangsdag
altardúkur	(kirk.)alterdug
altarfótur	(kirk.)knæfald, (alter)skammel,brúðgómurin leiðir brúðrina innar til altarfótinbrudgommen fører bruden ind til alterskammelen
altargangsdagur	(kirk.)altergangsdag
altargangur	(kirk.)altergang
altargonga	(kirk.)altergang
altargongd	(kirk.)altergang
altarklæði	(kirk.)alterklæde, alterdug
altarljós	(kirk.)alterlys
altarsálmur	(kirk.)altersalme
altarsbrúk	(kirk.)til altarsbrúktil alterbrug;eitt vakurt silkiturrklæði til altarsbrúket smukt silketørklæde til alterbrug
altarsdagur	(kirk.)altergangsdag
altarsfólk	(kirk.)altergangsfolk
altarsfótur	(kirk.)knæfald, (alter)skammel
altarsgestur	(kirk.)altergangsfolk, altergangsgæst
altarsklæddur	(kirk.)i altergangstøj(dvs. det bedste tøj)
altarsklæði(r)	(kirk.)altergangsklæder (ens bedste tøj), kisteklæder
altarslag	(kirk.)hold altergæster
altarsskari	(kirk.)hold altergæster
altartalva	(kirk.)altertavle
altarvín	(kirk.)altervin, kirkevin
alting	(pol.)Islands parlament
altíð	1altid2som oftest, jævnlig,hann er altíð so tvørurhan er altid så besværlig;altíð og stundevig og altid;eg hugsaði tað altíðdet tænkte jeg nok3i hvert fald, i det mindste,hann er altíð nóg gamal at fara til skipshan er i hvert fald gammel nok til at tage på fiskeri
altjóða	international,altjóða samstarvinternationalt samarbejde;altjóða viðurkenninginternational anerkendelse
altjóða-	international
altjóðadómstólur	(jur.)international domstol under FN
altjóðaður	international
altjóðafelagsskapur	international sammenslutning,ST er altjóðafelagsskapurFN er en international sammenslutning
altjóðagerð	internationalisering, globalisering
altjóðaligur	international;-liga
altjóðan	internationalisering, globalisering
altjóðarættur	(jur.)folkeret, international ret,í samsvari við altjóðarætti henhold til folkeretten
altráur	1(om vind)vedvarende,hann lá so altráur inn gjøgnum fjørðinvinden lå vedvarende ind gennem fjorden2yderst opsat, ivrig (efter),tey vóru altrá eftir at vita, hvørji tíðindi vórude var meget ivrige efter at høre, hvad nyt der var
altso	1(talesp.)altså,hann er altso tjóvurinhan er altså tyven2(sagt når man er forbløffet, vred el.lign.),altso, altso;nú er altso nóg mikiðnu kan jeg ikke mere;(barn.)altso, altso, tú ert fínih, hvor er du fin
altumráðandi	altafgørende,tað er altumráðandi at fáa tað gjørt núdet er altafgørende at få det gjort nu
altur	(musik)1alt, altstemme,syngja altsynge alt2altsanger(inde)3altinstrument(fx altfløjte, altklarinet)
altvaldandi	almægtig
altýðandi	altafgørende
altøgn	fuldstændig tavshed
altøkur	universel, total, absolut,smittuvandin er ikki altøkursmittefaren er ikke total
altørvandi	umistelig
aluminium	(kem.)aluminium
alún	(kem.)alun
alúna	behandle med alun
alv	styrke, kropsstyrke, legemlig kraft,av øllum alviaf al kraft;stórur maður á vøkstri og mikil at alvistor mand af vækst og kropsstærk
alvakin	lysvågen
alvaksin	overgroet (med), tilgroet,urtagarðurin er alvaksin við illgresihaven er tilgroet med ukrudt
alvakur	yndig, dejlig
alvald	almagt,(bibl.)alvald Guds og miskunnGuds almagt og barmhjertighed
alvaldandi	(rel.)almægtig,hin alvaldandiGud den almægtige
alvaldur	(rel.)almægtig,(bibl.)Guð faðir hin alvaldiGud fader den almægtige
alvallaður	helt dækket med grønsvær,stórur alvallaður hagistor grøn udmark
alvarligur	alvorsfuld, alvorlig;-liga
alvápnaður	fuldstændig bevæbnet, fuldt rustet,alvápnaðir hermenn komu innfuldt bevæbnede soldater kom ind
alvegis	fuldstændig, overmåde,eg, sum hevði so alvegis nógv at tosa við tygum umjeg, som havde så meget at tale med Dem om
alverjaður	fuldt bevæbnet, i fuld rustning
alverkfall	generalstrejke
alverktøka	(tekn.)totalentreprise
alvi1	mandighed, sjælskraft
alvi2	1ildsted, esse2væg mellem smedje og skorsten
alvinur	oprigtig ven
alvitandi	alvidende
alvitska	alvidenhed,Guds alvitskaGuds alvidenhed
alvitur	alvidende
alvísur	1som er alle bekendt,tað var alvíst um bygdina, at so vardet var kendt i hele bygden, at det var sådan;tað er alvíst um allar leiðiralle ved det2alvis, alvidende
ama	1ødsle bort2gøre fattig, plyndre, udsuge,órímiligir prísir ama keyparanurimelige priser udsuger køberen;ama útudbytte
amari	ødeland,(ordsp.)amari kemur aftan á spararaefter en samler kommer en spreder
amast	1amast upp á e-nkredse om en, gnide sig op ad en;teir amaðust upp á genturnarde holdt sig tæt op ad pigerne;maturin amast aftur á megmaden bevirker opstød2knokle, anstrenge sig
amboð	redskab,(overf.)uppreistrarmenninir nýttu sjónvarpið sum amboð í kollveltinginioprørerne benyttede tv som redskab i revolutionen
amboðsfall	(lingv.)instrumentalis
amboðskassi	(håndv.)redskabskasse
amboltur	ambolt
ambra	ambra
ambæta	(om kreatur)opvarte,ambæta neytumpasse køerne (give dem vand osv.)
ambætari	(datal.)server
ambæting	røgt (af kvæg)
amen	amen,(talem.)tað er sum amen í kirkjunidet er fuldstændig sikkert;vit fáa ikki amen í kirkjuni(om noget som ingen ende tager);ikki fáa amen (við) í kirkjunikomme for sent til noget
Amerika	Amerika
amerikanari	amerikaner
amerikanskur	amerikansk
amerikumaður	amerikaner
ameriskur	amerikansk
aminosýra	(kem.)aminosyre
amma	stor tønde
ammoniakk	(kem.)ammoniak(tegnNH3)
ampa	hindre, forhindre, være til ulejlighed,halt uppat við at ampa mær!hold op med at forhindre mig!;ogsåampast;hon gekk og ampaðist fyri honum:ampa eftir e-mlænges efter, plage,børnini ampast eftir góðgætibørnene plager om slik
ampaleysur	1uden bekymring, tryg,har kanst tú fara ampaleysurder kan du trygt gå;ampaleys kor at arbeiða undirtrygge kår at arbejde under2uhindret
ampaloysi	frihed
amper	(elektr.)ampere
ampera	(fys.)ampere(forkortetA)
amperumetur	(fys.)amperemeter(målt i ampere)
ampi	hinder, besvær, ulejlighed,hava ampa á særvære urolig, være nervøs;eg havi sovorðnan ampa á mær, tá ið eg skal ferðast við flogfarijeg er så nervøs, når jeg skal rejse med et fly;hava ampa av (e-m)være bange for, være nervøs for,hon hevði ampa av manninum, tá ið hann var á sjónumhun var nervøs for manden, når han var på havet;til ampatil besvær;vera e-m til ampavære én til besvær
ampilára	fortrædige
amt	(pol.)amt,Føroyar vóru danskt amt 1816-1948Færøerne var et dansk amt 1816-1948
amtmaður	(pol.)amtmand
amutur1	uøkonomisk, ødsel
amutur2	som holder sig tæt op ad (nogenel.noget)
an	sendrægtig, langsommelig person
ana	1lyseel.brænde svagt,ljósperurnar ofta bara andutit lyste lyspærerne kun svagt2(om mennesker og dyr)være i live endnu skønt svag og skrøbelig,so leingi sum hin gamli andi, gjørdist einkiså længe den gamle var i live, var der intet at gøre3føre et hensygnende liv,standa og anavære ledig, være uden arbejde
analfabetur	(talesp.)analfabet
ananas	(bot.)ananas(Ananas sativus)
anda	1(om folk og dyr)ånde, trække vejret,hann andaði tungan og suffaðihan åndede tungt og sukkede;(overf.)anda at e-mgive en trængende noget;anda flótt at e-mhjælpe en, være god imod en, vise en kærlighed;anda innånde ind;anda útånde ud;ikki andað orðikke ondt ord;hann tolir ikki andað orðhan bliver let fornærmet;andastopgive ånden, udånde, dø, hensove;andaðursom har opgivet ånden, død2(om vind)blæse svagt,eitt lítið lot andaði oman úr fjøllunumdet blæste svagt ned fra fjeldene
andablástur	(bibl.,poet.)pust,andablástur hins alvaldapust fra den almægtige
andaborin	beåndet, åndrig, inspireret,søgan varð skrivað í eini andabornari løtuhistorien blev skrevet i et inspirerende øjeblik
andadráttarvernd	åndedrætsværn
andadráttur	åndedræt,til seinasta andadrátttil det sidste
andadýrkan	(rel.)åndedyrkelse
andagøgn	(biol.)åndedrætsorgan
andaheimur	åndeverden
andahjálp	(med.)kunstig åndedræt,gevael.veita  andahjálpgive kunstigt åndedræt
andakt	1(rel.)andagt2stor interesse, beundring,lurta við andaktlytte med stor interesse
andalag	(poet.)åndedræt
andaleið	(biol.)luftvej
andaleyp	sidste åndedræt,liggja í andaleypiligge på sit yderste, strides med døden;(overf.)nú lá tann fyrr so virkna rørslan í andaleypinu lå den før så aktive bevægelse til det sidste
andaleypsbrot	dødskamp,liggja í andaleypsbrotumstrides med døden
andaliga	åndeligt
andaligur	åndelig;-liga
andarblak	luftning, vindpust
andarhald	1den tid man kan holde vejret,hon lurtaði við opnum munni og við andarhaldi2øjeblik,bíða mær eitt andarhaldvent et øjeblik3pusterum, pause;hann fekk ikki andarhald fyri henni, sum hon dreiv áhan fik ikke nogen pause pga. hende, så meget kørte hun på4(om vejr)kort stille pause i stormfuldt vejr
andarið	(med.)anfald af åndenød,hon sloknaði eina náttina í einum andariðihun døde en nat i et anfald af åndenød
andaris	standa (uppi) í andarisi(om hår)stritte;í andarisigal, rasende,hann var í andarisihan var rasende;havið stóð í andarisihavet rejste bølger imod vinden
andarúm	1mulighed for at trække vejret frit,eg má sleppa mær út, so eg fái andarúmjeg må komme ud, så jeg kan trække vejret frit2atmosfære3stemning
andaræl	í hvørjum andarælived enhver lejlighed,tað er ikki neyðugt at hava tað á munni í hvørjum andarælidet er ikke nødvendigt at tale om det ved enhver lejlighed;í sama andarælii samme åndedræt
andatak	øjeblik
andatoka	synlig ånde(i kulde)
andatrongd	(med.)anfald af åndenød
andatrúgv	(rel.)animisme
andborin	åndrig, åndfuld, inspireret,ein andborin røðaen inspirerende tale
andbráður	1rank2stolt, værdig
andeitur	(med.)modgift
andevni	(med.)antistof
andfóta	i ordforb.sova andfóta(om to personer)sove med hovedet i hver sin retning(for at give bedre plads i en trang seng)
andføtlingur	antipode
andgerð	(fys.)reaktion,ágerð og andgerðaktion og reaktion
andgeri	(fys.)reaktor
andgletti	sted hvor vinden står på
andglettur	sted hvor vinden står på,(overf.)vera í andglettivære i skudlinien
andhall	(geol.)sadel, antiklinal
andheiti	(lingv.)antonym;gleði og sorg eru andheitiglæde og sorg er antonymer
andi	1ånde,andin reyk av brennivíniånden lugtede af spiritus;draga andatrække vejret;halda andanumholde vejret;skjóta andan (frá sær)ånde ud;vera trongur fyri andanumhave åndedrætsbesvær2livsånde,geva upp andadø3(rel.)Helligånd, Guds ånd,Guds andi lá á vøtnunumGuds ånd svævede over vandene4(rel.)overnaturlig gudeskikkelse,illir andaronde ånder5(rel.)tanke, sjæl,eg hugsi meg um og rannsaki mín andajeg tænker mig om og ransager min sjæl6ånd, inspiration, begejstring,tá ið andin kemur yvir e-nel.er yvir e-mnår ånden kommer over en7ånd, geni,ein andans maðuren åndens mand8tænkemåde, tankegang,andin í tíðinitidens tænkemåde9stemning,andin á fundinum var góðurstemningen på mødet var positiv
anding	ånding
andingargøgn	(biol.)åndedrætsorgan
andingartól	(med.)respirator
andingarvernd	åndedrætsværn
andkast	kast (imod nogen)
andkollvelting	(pol.)modrevolution
andkoma	inspiration
andkveikja	inspirere
andlát	død, dødsfald
andleysur	1åndløs,andleys røðaen åndløs tale2død, livløs,andleyst føtt barndødfødt barn
andligur	åndelig;andligar gávuråndelige gaver;andligt frælsiåndelig frihed;andligar bøkuråndelige bøger;andligur songursalmer o.lign.;-liga
andlit	ansigt,reyður í andlitirød i ansigtet
andlitsbein	(biol.)ansigtsben
andlitsbragd	ansigtsudtryk,við tungum andlitsbragdimed dystert ansigtsudtryk
andlitsbrá	ansigtsudtryk
andlitsdrag	ansigtstræk,andlitsdrøgini vóru heldur grefligansigtstrækkene var ret grove
andlitsdæmi	ansigtsfarve, teint
andlitsfríður	med smukt ansigt
andlitsgrein	profil,hon hevur sera vakra andlitsgreinhun har en meget smuk profil
andlitsgríma	ansigtsmaske, maske
andlitshúð	(biol.)ansigtshud
andlitskrem	ansigtscreme
andlitslitur	sminke, ansigtsfarve
andlitsmynd	portræt
andlitsputur	ansigtspudder
andlitsrukka	ansigtsrynke,andlitsrukkurnar vóru so sjónskar í sólarljósinumansigtsrynkerne var så synlige i sollyset
andlitsskap	ansigtstræk,hann líktist pápanum í andlitsskapihan lignede sin far i ansigtstrækkene
andlitssmyrsl	sminke, ansigtsfarve
andlitstváttur	ansigtsvask
andlitsyvirbragd	ansigtsudtryk
andlív	kulturliv
andlættur	som ånder let
andmerktur	(lingv.)med modsat betydning, antonym,orðini eru andmerktordene er antonymer
andmót	hindring, modstand
andmælingur	opponent(fx til doktordisputats)
andnegl	såre neglerødder
andnes	pynt
Andorra	Andorra
andorrari	andorraner
andorri	andorraner
andorskur	andorransk
andrasarmessa	30. november
andrasmessa	30. november
andriða	ørred
andríkur	åndrig, åndfuld, inspireret,ein andrík samrøðaen inspirerende samtale
andrísin	uvillig, genstridig, stivsindet, stædig,næmingarnir vóru so andrísnireleverne var så genstridige
androk	modvind,(overf.)hetta mikla androk, hann var komin ídenne megen modvind, som han var havnet i
andróður	1roning imod vinden,tungt er at rógva andróðurdet er hårdt at ro imod vinden;hava andróðurro imod vinden2(overf.)modgang i livet,hon hevur havt mangan andróðurinhun har haft megen modgang i livet
andróðursstykki	(noaord)(på kreaturer)bagdel
andsjógvað	med modstrøm
andskræmiligur	frygtelig, forfærdelig, skrækkelig,eitt ýl so andskræmiligtet frygteligt brøl;-liga
andsperra	stivhedel.ømhed i lemmerne(af uvant arbejdeel.stærk, besværlig gang)
andsperri	stivhedel.ømhed i lemmerne(af uvant arbejdeel.stærk, besværlig gang)
andstaddur	modsat1(mat.)andstaddar síðursider(fx i firkant)modsat hinanden;andstødd hornhjørne modsat hinanden2(bot.)andstødd bløðmodsatte blade;jf.kringstaddur,samstaddur3(overf.)andstødd ølvmodsatte kræfter
andstreymur	modstrøm,teir hittu bæði andstreym og sterkan stormde kom i både modstrøm og hård storm
andstroymi	modstrøm,rógva andstroymiro imod strømmen
andstroymt	med modstrøm,tað er andstroymtder er modstrøm
andstygd	1vederstyggelighed, modbydelighed, afsky,hava andstygd fyri (e-m)afsky nogenel.noget2modbydelig gerning,teir framdu somu andstygdirde gjorde samme modbydelige gerninger
andstyggiligur	vederstyggelig, afskyelig,ein andstyggilig gerðen afskyelig gerning;-liga
andstøða1	1modstand, opposition2(pol.)oppositionsparti(er)3(astronomi)í andstøðu viðover for
andstøða2	(mest i negativ anvendelse)svare igen,hon vildi einki andstøða honumhun ville ikke have noget med ham at gøre
andstøðingur	(pol.)folk i opposition, antagonist, opponent
andstøðis	modsat, lige over for,standa andstøðis hvør øðrumstå lige overfor hinanden;tað er beint andstøðis tí, ið vardet er lige modsat det, som var
andstøðublað	(pol.)oppositionsavis
andstøðuflokkur	(pol.)oppositionsparti
andsvar	1gensvar, tilsvar,veita andsvargive svar, svare igen2(talesp.)ansvar, ansvarlighed
andsýnis	over for,áhugi andsýnis Føroyuminteresse for Færøerne
andsøgn	modsigelse
andsølis	mod solen
andvarpa	være i tvivl,andvarpast1være tvivlrådig,nú er hann farin at andvarpastnu er han begyndt at tvivle2kaste sig urolig omkring i sovendeel.halvvågen tilstand,eg svav ikki, eg lá og andvarpaðistjeg sov ikke, jeg lå og halvsov
andveður	modvind
andveikur	(psyk.)åndssvag
andvekur	søvnløshed,hava andvekurligge søvnløs;fáa andvekurmiste søvnen;leggja seg í andvekur(prøve på at) holde sig vågen
andvekursnátt	søvnløs nat
andviðaður	(om træ)med tværgående årer
andvirði	modværdi,tú kanst lata meg fáa andvirði í fiskidu kan lade mig få fisk i stedet
andvirki	1afgrøde(korn, græs, kartofler, høstetel.uhøstet),(talem.)sum kúgv (el.neyt) í andvirkiikke til at holde væk fra noget, som ikke er tilladt2arbejde,hann er altíð í andvirkihan arbejder altid;vera e-m (uppi) í andvirkinumvære i vejen, være til hinder(spec. ved arbejde)
andvirusforrit	(datal.)antivirusprogram
andøva	1ro langsomt imod vindel.strøm(så at båden ikke driver ud af kurs)2(overf.)holde sig på samme sted uden at drive for strømmen,andøva ímótiopponere
andøving	det at ro langsomt imod vindel.strøm
andøvsár	åre til at ro langsomt imod vindel.strøm med
andøvsfiskur	fisk som andøvsmaður får ekstra i løn for sit arbejde,andøvsfiskur var størsti fiskurin
andøvsgul	1(om vindstyrke)jævn brise2(meteorol.)vindstyrke 5,5 - 7,9 m / sek.;stívt andøvsgulfrisk brise, vindstyrke 8,0 - 10,7 m / sek.
andøvsmaður	(på båd)mand der ved hjælp af to årer hindrer båden i at drive mens de andre fisker
andøvssessur	(båd.)den plads som andøvsmaður har i båden under roningen ud på fiskemedet
anga	lugte (behageligt), dufte (om hø),angandi blómurduftende blomster
angahoyggj	stærkt duftende hø
angaleysur	duftløs
angaluktur	god duft
angan	(poet.)duft
angaroykgras	(bot.)vellugtende gulaks(Anthoxanthum odoratum)
angaroykur	god duft
angasøtur	(poet.)som dufter sødtel.godt,ein gróðurmikil, grønur og angasøtur heimuren frodig, grøn og velduftende verden
angaurt	velduftende plante
angavatn	parfume
anghoyggj	stærkt duftende hø
angi1	duft (især af hø),nýsligið hoyggj hevur góðan anganyslået hø dufter godt
angi2	1knoglespids(fx af ribben, hvirvel, tandrod),metturel.fullur upp undir angar(nar)fuld, overfyldt, overmæt, stoppet;full upp undir angarnarhøjgravid, højfrugtsommelig;(overf.)teir vóru undir angarnar av tíðindumde havde mange nyheder at fortælle2uopdragent barn,hasin lúsa anginden uopdragne unge
angist	angst,angist kom á teirde blev angst
angistróp	angstråb
Angola	Angola
angolari	angolaner
angoli	angolaner
angolskur	angolansk
angorageit	(zoo.)angoraged
angorakanin	(zoo.)angorakanin
angorakøttur	(zoo.)angorakat
angoraull	angorauld
angra	angre,mestur fert tú at angra hesa gerðdu vil sikkert komme til at angre denne handling
angur	anger, fortrydelse
angurbitin	angerfuld, skyldbetynget
angurfullur	angerfuld, skyldbetynget, brødebetynget, brødefuld
angurstár	angertåre,eygu hennara fyltust við angurstárumhendes øjne fyldtes med angertårer
aningarstrá	spredte høje græsstrå hvor der ellers er bart
aningur	1svagt lys, vågekone2uklart lys
ank	stønnen
anka	stønne,anka segvånde sig
ankar	(skib.)anker
ankiliga	ynkeligt
ankra	(mar.)ankre
ann	i ordforb.vilja e-m annville hævne sig på en
annað	seannar
annaðhvørt	i ordforb.annaðhvørt ... ellaenten ... eller;annaðhvørt hon er frá ella hjáhvad enten hun er til stede eller ikke
annaðkvøld	i ordforb.í annaðkvøldi morgen aften
annaðlagsvinna	sekundært erhverv
annaðslíkt	lige så meget (stort) til,(kvad)tríati átti hann synir, annaðslíkt í døtrum;tað skal annaðslíkt til enn smápengarder kræves mere end småpenge, der skal mere til end småpenge
annan	seannar
annar	1anden, nummer to,annan maianden maj;annan dag(in)anden højtidsdag(især anden juledag),aðru vikuugen efter næste uge;(talem.)eitt er orðið, annað er høggiðder er kort fra ord til handling21en af to,annar hundurin er svartur og annar (hin) hvíturden ene hund er sort og den anden er hvid2ikke den samme (som fx den nævnte),og annað tílíkt(forkorteto.a.tíl.)og andet lignende;annan vegin ... hin veginbåde ... og;annan vegin samdur við hann, men hin vegin í ivabåde enig og uenig med ham;hann var annar maður eftir hettahan var en anden mand efter dette;tað ber ikki annað tildet kan ikke være anderledes;tú skalt fáa annað at síggjadu skal få andet at se3(i forsk. ordforb.)hvørki annar ella annarhverken den ene eller den anden;annað ennuden;ikki annað enn taðkun det,teir lærdu hvør av øðrumden ene lærte den anden,dag eftir annanhver dag;tað er hvørt eftir øðrumdet passer sammen;hvør hjá øðrumsammen;í aðrar mátarellers, i øvrigt;millum aðrarsammen med andre, blandt andre;millum annað(forkortetm.a.)blandt andet, for eksempel;eg kann nevna millum annað, at ...jeg kan for eksempel nævne, at ...;úr enda í annanfra den ene ende til den anden;hvør við annansig imellem, indbyrdes
annarhvør	1hver anden,annaðhvørt árhver andet år;annanhvønn daghver anden dag2mange, næsten alle,annarhvør maður kallar seg stjóranæsten alle præsenterer sig som direktør;aðruhvørja løtuofte, tit,hon skiftir meining aðruhvørja løtuhun er vægelsindet
annarleiðis	anderledes
annarligur	sekundær
annars	1ellers, i øvrigt, for resten,skunda tær, annars verður tú ov seinurskynd dig, ellers kommer du for sent2på den anden side,annars eri eg samdur við hannpå den anden side er jeg enig med ham
anoda	(fys.)anode
anorakkur	anorak
ansa	røgte, passe,hvør skal ansa honum?hvem skal passe ham?;ansa børnumbabysitte;ansa særpasse på sig selv, tage sig i agt;ansa eftir (e-m)1lægge mærke til, opdage,nú ansi eg eftir, at eitt konufólk kemur ímóti mærnu lægger jeg mærke til, at en kvinde kommer imod mig2se til, passe på,fútin skal ansa eftir, at lógirnar verða hildnarfogeden skal se til, at lovene overholdes3passe (på),ansa eftir børnumpasse børn
ansaleysur	hensynsløs
ansaligur	overlegen (i ord og optræden), vigtig, med påtaget væsen,stjórin er altíð so ansaligurdirektøren er altid så overlegen;-liga
ansalótir	forstillelse, påtaget væsen
ansalæti	forstillelse, påtaget væsen
ansin	agtpågivende,verið ansnir!pas på!
ansingarstovnur	daginstitution
ansingarverdur	interessant, bemærkelsesværdig,tað er ansingarvertdet er interessant
ansjós	(fisk.)ansjos(Engraulis encrasicolus)
ansmikil	bemærkelsesværdig
ansni	omhyggelighed, omhu,orðini eru vald við umhugsan og ansniordene er valgt med omtanke og omhu
ansur	1interesse,geva e-m ansvære opmærksom på noget;vekja ansvække interesse;fyrilesturin vakti miklan ansforelæsningen vækkede stor interesse2forståelse, opfattelse,prestur hevði ikki ans fyri tí, ið ungdóminum tørvaðipræsten havde ikke forståelse for det, som ungdommen havde brug for3omsorg, røgt, pleje,barnið er ússaligt og treingir til góðan ansbarnet er svækket og har brug for god pleje4opsyn,hermenn hava eisini ans við kanónunumsoldaterne har også opsyn med kanonerne5vera í ansivære på nippet til;eg eri í ansi at farajeg agter at gå
antabus	(med.)antabus
antakrist	(rel.)antikrist
antar	seont
antaregg	æg fra vildand
antarfuglur	(ornitol.)andefugl
antarpar	vildandepar
antarsteggi	han hos vildand
antarungi	unge hos vildand
antast	kredse om, gnide sig op ad (noget),hvørjum gongur tú her og antast eftir?hvad går du og spidser mund efter?
antenna	(radio)antenne
antennustyrkjari	antenneforstærker
Antiguaog Barbuda	Antigua og Barbuda
antiguari	antiguaner
antigui	antiguaner
antiguiskur	antiguansk
antikrist	antikrist
antilopa	(zoo.)antilope(i Afrika og Asien)
antin	1enten,i ordforb.antin ...ellaenten ...eller2om, hvorvidt,hon fer at vita, antin ljósið er sløkthun går for at se, om lyset er slukket
apa1	(zoo.)abe
apa2	1apa segel.sær (eftir e-m)efterabe, efterligne, imitere en,tey apaðu seg eftir teimum fínude efterlignede de fine2apast (upp á e-n)kredse om en, gnide sig op ad en;kópurin apast upp á bátinsælen kredser om båden
apaldgarður	abildgård, æblehave
apaldur	(bot.)æbletræ(Malus sylvestris)
apokrýfiskur	(bibl.)apokryfisk,apokrýfiskar bøkurapokryfiske bøger
apotek	apotek
apotekari	apoteker
apparat	1(talesp.)apparat2(hån.)(om person)títt býtta apparatdin tosse, dit nar
appilsin	(bot.)appelsin
appilsingulur	(barn.)orange
appilsintræ	(bot.)appelsintræ(Citrus sinensis)
appilsinvatn	1appelsinsodavand2flaske med appelsinsodavand
aprikosa	abrikos
apríl	april,sendael.lokka apríl(aprilsnar)
aprílmánaður	april
apublóma	(bot.)abeblomst(Mimulus),gul apublóma(M. guttatus)
apukattur	1abe2(hån.)abekat, nar
apuspjað	nar, naragtig person
apuspjót	(ironi)nar, naragtig person
apuspæl	1fjantet opførsel, naragtighed, skaberi2nar, naragtig person
aputur	1dum, tåbelig, enfoldig, ubegavet2som efteraber, naragtig
aputýggi	nar, slubbert, skurk
ar	(mål)arela, flademål: 100 m2, 1 / 100 hektar
arábi	araber
arábiamaður	araber
arábiskur	arabisk,arábisk tølarabiske tal(fra 0 til 9)
arbeið	arbejde
arbeiða	1arbejde,arbeiða í handliarbejde i en forretning;arbeiða útiarbejde ude2virke, bearbejde, forarbejde, tilvirke,arbeiða bøinbearbejde marken;arbeiða ullforarbejde uld;arbeiða (e-t) undangøre færdig, færdiggøre;arbeiða upp á e-tforarbejde noget(fx sten);arbeiða upp á bilinreparere bilen,arbeiða seg framarbejde sig frem3bevæge sig, ryste, sitre,skipið arbeiðir í sjónumskibet bevæger sig i søen
arbeiðarafelag	arbejderforening, arbejderorganisation
arbeiðaraløn	overenskomstløn for arbejdere
arbeiðararørsla	arbejderbevægelse
arbeiðarastætt	arbejderklasse
arbeiðari	(alm. ufaglært)arbejder
arbeiði	arbejde,hann hevur nógv fólk í arbeiðihan har mange folk i sit brød;fara til arbeiðisgå på arbejde
arbeiðis-	arbeiðs-
arbeiðsandi	arbejdslyst, arbejdsvilje,góður arbeiðsandigod arbejdsvilje
arbeiðsávísing	arbejdsanvisning, arbejdsformidling(spec. til arbejdsløse)
arbeiðsbólkur	arbejdsudvalg, arbejdsgruppe
arbeiðsbuksur	arbejdsbukser
arbeiðsbýti	arbejdsfordeling
arbeiðsdagur	arbejdsdag,8 tíma arbeiðsdagur8 timers arbejdsdag
arbeiðsevni	arbejdsevne
arbeiðsfelagi	arbejdskollega
arbeiðsformaður	arbejdsformand
arbeiðsfólk	arbejder
arbeiðsfriður	arbejdsro
arbeiðsførur	arbejdsdygtig,illa arbeiðsførurnæppe arbejdsdygtig
arbeiðsgenta	husassistent, pige (i huset)
arbeiðsgevari	arbejdsgiver
arbeiðsgongd	arbejdsgang
arbeiðsgrev	person som arbejder ihærdigt,hann er eitt arbeiðsgrev
arbeiðsháttur	arbejdsmåde, arbejdsmetode,nýggir og betri arbeiðshættirnye og bedre arbejdsmetoder
arbeiðshestur	arbejdshest
arbeiðshugaður	med lyst til arbejde
arbeiðshugur	arbejdslyst
arbeiðsjarn	arbejdsbi
arbeiðsklæddur	i arbejdstøj, arbejdsklædt
arbeiðsklæði(r)	arbejdstøj
arbeiðskona	husassistent, pige
arbeiðskor	arbejdsvilkår,vánalig arbeiðskordårlige arbejdsvilkår
arbeiðskraft	arbejdskraft
arbeiðskroppur	slider
arbeiðskvinna	kvindelig (ufaglært) arbejder
arbeiðskvinnufelag	fagforening for (ufaglærte) kvindelige arbejdere
arbeiðslag	måde at arbejde på, arbejdsmetode,gott (ringt) arbeiðslaggod (dårlig) arbejdsmetode
arbeiðsleysur	arbejdsløs
arbeiðsligur	1som er let at arbejde i,tað er arbeiðsligari í nýggju skrivstovunumdet er bedre at arbejde i de nye kontorlokaler2bearbejdelig;-liga
arbeiðslíkindi(r)	arbejdsforhold
arbeiðsljóst	så lyst at man kan se at arbejde,nú er eisini arbeiðsljóst alla náttina
arbeiðsloysi	arbejdsløshed, ledighed, arbejdsledighed
arbeiðsloyvi	arbejdstilladelse
arbeiðslýsi	så meget lys at man kan se at arbejde
arbeiðsløn	arbejdsløn
arbeiðsløta	kort periode med vejr egnet til udendørsarbejde
arbeiðsmaður	arbejder
arbeiðsmannafelag	fagforening (af arbejdere)
arbeiðsmarknaður	arbejdsmarked
arbeiðsmegi	1manddomskraft, arbejdsevne2arbejdskraft,sjálvboðin arbeiðsmegifrivillig arbejdskraft
arbeiðsnáðir	arbejdsfred
arbeiðsnevnd	arbejdsudvalg
arbeiðsneyt	kvæg som trækdyr
arbeiðsond	meget energisk menneske, dygtig arbejder
arbeiðsorka	arbejdskraft
arbeiðsósemja	arbejdskonflikt
arbeiðspláss	arbejdsplads(fx på filetfabrik)
arbeiðsross	1arbejdshest2(overf.)arbejdsbi
arbeiðsrót	arbejdsbi
arbeiðsrúm	arbejdsrum
arbeiðsrættur	(jur.)arbejdsret
arbeiðssamur	arbejdsom
arbeiðssemi	arbejdsomhed
arbeiðssetningur	kommissorium
arbeiðsskaði	(forsikr.)arbejdsskade, erhvervsskade
arbeiðsskelti	arbejdsskilt
arbeiðssteðgur	arbejdsnedlæggelse,lýsa arbeiðssteðgvarsle arbejdsnedlæggelse
arbeiðstakari	entreprenør
arbeiðstarn	spild af arbejdeel.arbejdstid
arbeiðstarni	spild af arbejdeel.arbejdstid
arbeiðstíð	arbejdstid
arbeiðstól	arbejdsredskab
arbeiðstrygd	arbejdssikkerhed,stórur dentur er lagdur á arbeiðstrygdinader er lagt stor vægt på arbejdssikkerheden
arbeiðstøka	entreprise
arbeiðstøkur	arbejdsledig, ledig, arbejdsløs
arbeiðsveður	(godt) vejr til udendørsarbejde
arbeiðsvika	arbejdsuge,40 tíma arbeiðsvika40 timers arbejdsuge
arbeiðsvit	(neds.)ikki hava arbeiðsvitvære småtbegavet, være enfoldig
arbeiðsøki	virkefelt, arbejdsområde
arga	drille, tirre, ophidse,argastblive gal på, irriteres af
argapisa	1drillepind, drillevorn person2en som bliver drilletel.som er let at drille3arrig person
argasjón	forargeligt irriterende syn
Argentina	Argentina
argentinari	argentiner
argentini	argentiner
argentinskur	argentinsk
arggivin	slem (til noget),arggivin at argaslem til at drille
argiligur	forargelig;-liga
argilsi	arrigskab, raseri,rødd hansara var full av háð og argilsihans stemme var fuld af hån og raseri
arging	drilleri
argingarsamur	drillesyg
Argir	(stedn.)bygd på øen Streymoy,á / av Argjum,(út) á Argir
argjamaður	person fra bygden Argir
argjamáltíð	mellemmåltid
argjamunnur	mellemmåltid
argleiki	arrigskab, raseri
argur	1ond, slem,hann var argur at stjalahan var slem til at stjæle;argur at drekkadrikke meget;argasti ósiðurværste uvane2vred, rasende, forbitret,tá var keypmaðurin argurda var købmanden rasende;vera argur (inn) á e-nvære vred på en3grådig,argur eftir ræðigrådig efter magt4hin argastidjævelen, fanden
-ari	-er(suffiks)1(i ord afledt af substantiver)fxátari, dómari, klokkari2(i ord afledt af verber)fxbakari, flekjari, skrivari
ark1	1papirark2folio
ark2	(bibl.)ark
arkabrot	folio,bók í arkabrotibog i folioformat
arkir	seørk
arkitektur	arkitekt
arma	arma útudarme,hungurin skal arma landið útsulten skal udarme landet;armastsvækkes, blive svag el. svagelig,hann armast dag frá degihan svækkes for hver dag der går
armadovin	træt i armene
armadómur	fattigdom, elendighed
armadømi	fattigdom, elendighed,liva í armadømileve i fattigdom
armakot	armhule
armalangur	med lange arme
armasterkur	med stærke arme
armastuttur	med korte arme
armaveikur	med ringe kræfter i armene
armband	armbånd(til pynt)
armbandsur	armbåndsur
armbind	armbind(fx hos blinde)
armbrot	armbrud
armenari	armenier
armeni	armenier
Armenia	Armenien
armenskur	armensk
armingi	1stakkel,armingin!din stakkel!2(bot.)fredløs(Lysimachia)
armlangur	med lange arme
armleggur	(biol.)overarmsben(humerus)
armóð	1armod, fattigdom, nød,(talem.)armóð ger mangan skálkin (el.til skálk)fattigdom gør mange til tyve;(ordsp.)mangt er í neyðini nýtt, sum ikki er í armóðini gitiði trang hjælper man sig, som man kan2elendighed, stærk udmattelse, sølle tilstand,koma í armóðkomme i en sølle tilstand
armóðarlamb	afkræftet lam
armóðsligur	1fattig, kummerlig,eitt armóðsligt húset fattigt hus2dårlig;-liga
armóðsmaður	fattigmand
armringur	armring(til pynt)
armsterkur	med stærke arme
armstólur	lænestol
armstuttur	med korte arme
armstyrki	styrke i armene
armsveiggj	(idr.)armsving(i gymnastik)
armur1	1arm,ganga undir arm(om to)gå arm i arm;brettael.smoyggja upp um armar1smøge ærmerne op2(overf.)tage fat på noget,tak armarnar frá tærse nu at få lavet noget2(zoo.)fangarm3side af en vig,syðri armur á víkiniden sydlige side af vigen4flanke(den ene side af en hær el. en troppeafdeling)5(husbyg.)fløj, længe, udbygning6arm (på lænestol)7fod(fx på lysestage),bladstilk(fx på kvan)8stjert(styre- el. trækstang på en hestevogn)
armur2	1fattig,armur sum ein kirkjurottaludfattig2arm, stakkels, ynkværdig,armi stakkalden arme stakkel
armveikur	med ringe kræfter i armene
armvøddi	armmuskel
arnar	seørn
arnarbøga	hunørn
arnarklógv	ørneklo,drekka av arnarklógvdrikke vand som en ørneklo har ligget i(råd mod gulsot)
arnarnev	ørnenæb
arnarnøs	ørnenæse
arnarreiður	ørnerede
arnarungi	ørneunge
arnarvongur	ørnevinge
arr	ar, blivende mærke af bindevæv på hudel.organ efter (helet) sår
arrutur	med mange ar
arsbøllur	endebalde
arsenikk	(kem.)arsenik
arshol	endetarmsåbning, anus
arsur	ars, bagdel
art	1(gemyts)art, beskaffenhed, egenskab, karakter,hesin friður er av himmalskari rót og artdenne fred er af himmelsk rod og beskaffenhed2(om kreatur)natur3sæd(hos kreatur)(sperma)
arta	arta seg1trives,best arta geitirnar seg í fjallalondumgeder trives bedst i bjerglande2vokse3opføre sig, te sig,børnini arta seg vælbørnene opfører sig godt4(om vejr)arte sig,um veturin artaði veðrið seg so, at tað ikki var útiverandiom vinteren artede vejret sig sådan, at det var ikke til at være udendørs
artaður	af et vist gemyt,væl artaðuraf et godt gemyt
artargóður	1af godt gemyt2som gerne vil gengælde en tjeneste
arva	arve, få i arv,hann arvaði garðin aftan á pápa sínhan arvede gården efter sin far;hon arvaði abba sínhun fik arv efter sin bedstefar;arvastarves;arvast sundurblive fordelt ved arv;(overf.)hann hevði arvað tað lætta sinnalagið frá mammunihan havde arvet moderens lette sind
arvaborin	født til arv, som har arveret
arvabræv	(jur.)testamente
arvadúnurt	(bot.)dværg dueurt(Epilobium anagallidifolium)
arvaeginleiki	(biol.)arveanlæg
arvafesti	fæstegård som går i arv
arvafíggindi	arvefjende
arvafrøði	(biol.)genetik
arvagjald	(jur.)arveafgift
arvagóðs	arvegods
arvagrein	arvelod, arvedel,(kvad)hann hevur vigið faðir mín og tók mína arvagreinhan har dræbt min far og tog min arvelod
arvagrógvin	overgroet med ukrudt
arvaklandur	arvestrid
arvaklógv	(bot.)udløber af ukrudt som slår rødder
arvaleivd	(bibl.)arvelod, arvedel,arvaleivd okkara lutaðist øðrumvores arvelod gik til andre
arvaleysur	arveløs, uden arveret,verðael.gerast arvaleysurmiste arveretten
arvalutur	arvelod, arvedel
arvalæra	(biol.)genetik
arvamál	(jur.)sagel.spørgsmål vedr. arv
arvapartur	arvelod, arvedel
arvaríki	kongerige som arves
arvarættur	1arveret,hann hevði arvarætt fram um hin bróðurinhan havde arveret frem for broderen2(jur.)arveretsregler, arvelove, arveret,hann er serkønur í arvarættihan er sagkyndig i arveret
arvaskifti	arvefordeling,hann helt seg vera órættaðan av bróður sínum í arvaskiftihan følte sig forfordelt af sin bror i arvefordelingen
arvaskjal	(jur.)testamente
arvaskotin	overgroet med ukrudt
arvastríð	arvestrid
arvastrongur	(biol.)kromatin
arvastykki1	arvestykke(gennem generationer),arvet genstand
arvastykki2	stykke indmark overgroet med ukrudt
arvasynd	(rel.)arvesynd;ljótur sum arvasyndinmeget grim
arvasøgn	gammelt mundtligt overleveret sagn
arvavaksin	overgroet med ukrudt
arvborin	født til arv, som har arveret, arveberettiget
arvbærur	(biol.)som kan arves
arvfeingi	(biol.)genpulje
arvfrøði	(biol.)genetik
arvi	(bot.)ugræs, ukrudt
arviligur	arvelig,arvilig sjúkaarvelig sygdom;-liga
arvingi	arving
arvingur	arving
arvland	land som arves
arvleggjari	(jur.)en som efterlader arv
arvleysur	arveløs
arvmentir	tradition(fx kvad, sagn o.lign.),sagnir og aðrar arvmentirsagn og anden mundtlig tradition
arvorð	(lingv.)nedarvet ord
arvsynd	(rel.)arvesynd
arvtakari	(jur.)arvtager
arvtaki	(jur.)arvtager
arvtøka	1det at arve2tradition,í óslitnari arvtøkui ubrudt tradition
arvur	1arv,fáa (e-t) í arvarve noget;ganga í arvgå i arv2(overf.)(kulturel) arv
as	stærkt arbejde, hårdt arbejde,(talem.)hann er uppi í hvørjum asi og vasihan er med overalt
asa	ase,asa seg útoveranstrenge sig;asast burturafkræftes;(út)asaðurudaset
Aserbadjan	Aserbajdsjan
aserbadjanari	aserbajdsjaner
aserbadjani	aserbajdsjaner
aserbadjanskur	aserbajdsjansk
asfalt	asfalt
asfalta	asfaltere
asfaltera	asfaltere
asfalting	asfaltering
asfaltsføroyingur	(spøg.)færing bosat i Danmark(spec. i København under krigen)
Asia	Asien
asiati	asiater
asiatiskur	asiatisk
ask	(bot.)asketræ, asketømmer
askarmastur	(båd.)mast af ask
askarstavur	stok af ask
askorbinsýra	askorbinsyre, C-vitamin
askur	(bot.)asketræ, asketømmer
askviður	asketræ, asketømmer
asnafoli	æselføl
asnafyl	æselføl
asni	(zoo.)asen, æsel(Equus asinus)
aspargus	(bot.)asparges(Aspargus)
ass1	1for pokker!2lige meget!
ass2	vera í assivære lige ved (at gøre noget),hon var í assi at geva andsvarhun var lige ved at svare igen
assistentur	assistent, medhjælp
assýri	assyrer
astma	(med.)astma
at1	urolighed i søen, oprør i søen,tað er at í sjónumhavet er oprørt
at2	med(om bevægelse til et stedel.i en bestemt retning)1til, imod,koma at borði (á skipinum)komme til borde (på skibet);at húsumtil huset, hjem;leggja at bryggjulægge til kaj2(om ændring)til,av mold ert tú komin, at mold skalt tú verðafra jord er du kommet, til jord skal du blive3(om tid)imod,at árisamme tid næste år;nú er dagurin at endanu er dagen forbi;at kvøldihen imod aften4(omskrivning for genitiv, fx om børn og forældre),abbi at dreinginum;gumman at barninum5i ordforb.verða manni at banael.skaðadræbeel.skade en mand;upprunin at e-moprindelsen til noget;væl at sær komindygtig;leggja nógv at sær (til arbeiðis)være god til arbejde6(med adverbium)aftur at:tey komu aftur at húsumde kom tilbage til huset;fram at:hann helt seg fram at borðinumhan holdt sig til bordet;inn at:barnið legði seg inn at mammunibarnet lagde sig ind til moderen;niðan at;niður at;oman atned til;upp atop imod;yvir athen til,vit runnu yvir at ánnivi løb hen til åen;hon gongur yvir at seinginihun går hen til sengen  / /vera at1fejle, være galt;hvat er at?hvad er der galt?2vera at e-mvære i gang med noget3vera at at gera e-tvære tilbøjelig til at,hann er at at erpa særhan er tilbøjelig til at blære sig7(med verbum)fxbera (skjótt) atskynde sig;finnast at (e-m)dadle, kritisere, udsætte på;hava at (e-m)udsætte på, irettesætte;koma atrøre ved;kenna at;láta at;leggja at;sansa at;tala at(se verbum)
at3	(ofte i bisætning)1at,bera tey boð, at hetta var olmussa;væl var tað, at tú slepti hestinum2således at,hann ansaði bara sær sjálvum, at hann skuldi ikki fallahan passede kun på sig selv, således at han ikke faldt3for at,hon opnaði gluggan at vita, hvat tað var, hon hoyrdihun åbnede vinduet for at se, hvad det var, som hun hørte;eg var sendur at keypa mjólkjeg blev sendt for at købe mælk4når, mens,sunnudagin um ta tíð, at prestur er í kirkjusøndag ved den tid, når præsten er i kirken5(som udråb)at tú vágar tær!;at tú torir!;at hann ikki skammast!
at4	1(infinitivsmærke)at;at lesa, at skriva,osv.at læse, at skrive osv.2(før  i konjunktivisk betydning)vit áttu at vent bátinum;stuttligt hevði verið at fingið øði í læraran
ata	seøt
atajólur	(bot.)blomsterstilk af øt
ataleggur	stængel på (af) øt
atamjaðarurt	(bot.)mjødurt(Filipendula ulmaria)
atatyssi	klynge øt
atborið	gjort, udført,skjótt mátti verða atboriðder måtte handles hurtigt
atburðarlag	adfærd, opførsel, fremgangsmåde,útlendsk býarmentan er hættislig fyri gamlan sið og atburðarlagudenlandsk bykultur er farlig for gammel skik og opførsel
atburður	adfærd, opførsel, fremgangsmåde,hann hevði merkiligan atburð á særhan opførte sig mærkeligt;góður (ringur, ljótur) atburðurgod (dårlig, usømmelig) opførsel;(rel.)vit avnokta djevulin, allar gerningar hans og allan atburð hansvi forsager Djævelen og alle hans gerninger og alt hans væsen
atdjúpur	dyb tæt ind til land,har er atdjúptder er dybt helt ind til kysten
atdráttarkraft	(fys.)tiltrækningskraft, tyngdekraft,atdráttarkraft mánansmånens tiltrækningskraft
atdráttarlóg	(fys.)tyngdeloven
atdráttarmáttur	(fys.)tiltrækningskraft, tyngdekraft
atdráttarmegi	1tiltrækningskraft, appeal,hon hevur sjáldsama atdráttarmegihun har en utrolig tiltrækningskraft2(fys.)tiltrækningskraft, tyngdekraft
atdráttarmikil	tiltrækkende,hon var so atdráttarmikil og kvinnulighun var en meget tiltrækkende kvinde
atdráttur	tiltrækning,atdráttur at heimstaðnumtiltrækning til hjemstedet
atfangadagur	(rel.)dagen før højtidsdagel.hviledag
atfangakvøld	aftenen før højtidsdag,atfangakvøldið fyri jól
atfeingi	1materialer(fx til bygning af stengærder)2(overf.)emne fx til digt,heimbygdin er atfeingi í yrkinginihjembygden er emne i digtet
atferð	adfærd, fremgangsmåde, væremåde, væsen,hann var erpisligur í atferðhan var stolt i sin væremåde
atferðarfrøði	(psyk.)etologi
atfinnari	kritiker
atfinning	1indvending, anke2kritik
atfinningarsamur	tilbøjelig til at dadleel.kritisere, kritisk
atfinningarsemi	tilbøjelighed til at dadleel.kritisere, kritiksyge
atfinningarverdur	kritisabel
atfinsla	1indvending, anke2kritik
atflutningur	tilførsel
atgeingi	fri adgang, tilgængelighed
atgerð	1angreb,fara til atgerðargå til angreb2foranstaltning, tiltag, initiativ,at vinna á hesum vansum krevjast serligar atgerðirdet kræver særlige foranstaltninger at overvinde disse ulemper3(datal.)operation
atgerðaloysi	uvirksomhed, mangel på foretagsomhed
atgjørt	forgjort,einki er atgjørt, um vit nú royna at bøta um skaðander er ingen skade sket, (selv)om vi prøver at udbedre skaden
atgongd	adgang,atgongd bannaðadgang forbudt;ørindaleys onga atgongduvedkommende forbydes adgang;atgongd at bað og køkiadgang til bad og køkken
atgongdur	tilgængelig,har er atgongtdet er tilgængeligt;bókin er týdd og atgongd hjá øllumbogen er oversat og tilgængelig for alle
atgongugjald	adgangsbetaling
atgongumerki	billet, adgangsbillet
atgongupeningur	adgangsbetaling
atgonguprógv	adgangsbevis
atgrunnur	med lavt vand inde ved kysten,har er atgrunt
athugaverdur	interessant
athugdur	som der bliver set på,verður gjølliga athugt, síggjast vøddarhvis man kigger nøje, kan man se muskler
athugi	interesse
athygging	eftersyn, kontrol
athyggjandi	værd at se (på),hasum partinum er ikki athyggjandidenne del er ikke værd at se på
atknýti	tilknytning
atkoma	1mange fugle på vingerne,tað er eingin atkoma í dagder er ikke mange fugle på vingerne i dag2adgang,vit høvdu atkomu at øllum skjølunumvi havde adgang til alle dokumenter
atkomandi	tilgængelig,har er ikke atkomandi við líggjanumder kan man ikke komme til med leen
atkomin	lagt til,báturin er atkominbåden har lagt til kaj
atkomuligur	tilgængelig,handritini eru ikki atkomulighåndskrifterne er ikke tilgængelige
atkomupláss	anlægsplads
atkomustaður	anlægsplads
atkomuvegur	vej ind til (fx hus)
atkúpa	(med.)kontaktlinse
atkvøða1	(pol.)stemme (ved afstemning)(mundtlig, skriftlig el. ved at række hånden op),greiða atkvøðuafgive stemme;hann fekk ov fáar atkvøðurhan fik for få stemmer;geva atkvøðustemme for (nogetel.nogen)
atkvøða2	(pol.)stemme, afgive stemme,vit atkvøddu fyri sama valevnivi stemte på samme kandidat;atkvøtt varð við navnakallider blev stemt ved navneopråb
atkvøðugreiðsla	(pol.)afstemning, stemmeafgivning
atkvøðuhøli	stemmeboks
atkvøðujavni	stemmelighed
atkvøðukassi	stemmeurne, valgurne
atkvøðurættur	stemmeret
atkvøðuseðil	stemmeseddel
atkvøðuslúkur	(spøg.,pol.)stemmesluger
atkvøðutal	antal stemmer, stemmetal
atlagaður	naturaliseret
atlagari	(datal.)adapter
atland	(pol.)associeret land, biland,atlond Evropasamveldisins (ES)
Atlantshav	(stedn.)Atlanterhavet(mellem Amerika, Europa og Afrika)
atlantsorð	ord som har sin oprindelse i lande i Nordatlanten,einki av hesum orðum eru til eystur í Noregi, tey eru atlantsorð
atlantssamgonga	(militær)forsvarsunion mellem lande på begge sider af Atlanterhavet(især Nordatlanten),Nato
atlas	atlas
atlát	1signal ved drivning af får,fær gemsan tev av veiðimanni, gevur hon atlát at ávara hinarhvis gemsen får tæft af en jæger, giver den signal for at advare de andre;(overf.)februarkollveltingin gjørdist atlátið til kollveltingar í øðrum londumfebruarrevolutionen blev startskuddet til revolutioner i andre lande2(datal.)password
atleggjandi	tilgængelig (med bådel.skib)
atlimaskapur	associeret medlemskab
atlimur	associeret medlem
atlit	henblik,við atliti at (e-m)med henblik på, vedrørende
atløga	1angreb,í einari dyggari atløgu fekk hann hirt mótstøðumann sín fyri borð2omgang, fremstød,í (el.við) fyrstu atløgui første omgang3(om en båd)det at lægge til land;jf.atløgubryggja4indtægt
atløgubrúgv	anlægsbro
atløgubryggja	anlægsbro
atløgupláss	anlægsplads
atom	(fys.,kem.)atom
atombumba	(militær)atombombe
atomorka	(kem.)atomkraft
atomøld	atomalder
atra	betænke sig, vige tilbage
atsetur	1(fast) bopæl, adresse2(datal.)adresse(hvor data bliver gemt)
atskoyti	(lingv.)affiks
atsmakkur	bismag,atsmakkur gongur at e-mdet har en bismag
atsókn	1angreb,veita atsóknangribe;tjaldrið veitir ravninum atsóknstrandskaden angriber ravnen2besøg
atsóknarmaður	angriber
atstoytur	stærk strømdrift ind imod land
atstøða1	1hjælp,gera e-m eina atstøðuhjælpe en2behandling, pleje
atstøða2	assistere, hjælpe
atstøðari	assistent, hjælper
atstøðingur	assistent, hjælper
atstøður	omstændigheder, forhold,tað eru ikki atstøður til
atstøðuskip	(skib.)standbyskib
atsøkin	pågående, anmassende, aggressiv,orðalagið í røðuni var atsøkiðudtryksmåden i talen var aggressiv
atsøkjari	angriber, aggressor
attala	(jur.)reklamation
atvent	(kirk.)advent
atvik	(lingv.)indirekte objekt
atviki	(lingv.)indirekte objekt
atvinna	erhverv
atvold	grund, årsag,vera atvold at e-mvære årsag til noget,hetta var atvoldin at sjúku hansaradet var årsagen til hans sygdom;vera atvold til e-tvære grunden til noget
atvoldin	som er skyld iel.ophavsmand til noget,i ordforb. somvera atvoldin í e-mvære skyld i noget
august	august,í augusti august måned
augustmánaður	august
auktión	(talesp.)auktion
av	med1(om bevægelse fra et sted el.lign.),av bygdfra bygd;bygd av bygdfra bygd til bygd;av fundifra møde;hann flýddi av landihan flygtede ud af landet;hon fór av seinginihun gik ud af sengen;hon setti byrðuna av særhun satte byrden fra sig;maður av húsialle tog af sted2(i forbindelse med bestemte bygdenavne, stednavne o.lign.);av Eiði;av Glyvrum;av Húsum;av Kirkju;av Selatrað;av Skála;av Strondum;av Velbastað3(om våg, fjord, havn o.lign.)Smyril fór av Havnini;skipið fór av Fuglafirðiskibet sejlede fra Fuglafjørður4(vedr. oprindelse)hon var av tí fólkinum;svii av ætt5fra, af,teir tóku hvalin av honumde tog hvalen fra ham;teir kravdu lykilin av bóndanumde forlangte at få nøglen fra bonden;hann høgdi greinina av trænumhan huggede grenen af træet;tey høvdu ikki hoyrt tað av nøkrum;nógv var keypt av útlendskum skipum;hann kendi hitan av henni;hann fekk ikki eyguni av hennihan kunne ikke lade være med at se på hende;báturin var leysur av landi;teir fingu lívd av landide fik dækning af land6om, vedrørende,boða av stormi;deyðsboð av e-m;hann fekk at vita av Jesusi7(om vindretning)av eystri, norðri, suðri, vestri;hann liggur av beinum norðri;stormur av landnyrðingi;vindurin lá av landi;suður av Munkagrunninum8(om materiale som anvendes til noget),reiður av greinum;av træ;stavnur og stýri av reyðargulli;lesningur av húðálum9(omskrivning for genitiv, fx om del af større helhedel.om mængde og indhold)bygdin var av bestu kornplássum;av besta mati;sjálvur ellivti av monnum;hann var av ídnastu monnum;fimastur av øllum;hann var av frægastu monnum;tann av teimum;teir áttu helvtina av bygdini;einastur eftir av mongum;tað, ið leyp upp um garðin av seyði;tað, ið verður keypt av útlendskari vøru;ein pottur av brennivíni;missurin av bróður;við hondum fullum av gróti;nógv av hoyggi, ullo.lign.;væl av jørð;teir løgdu at landi at løða seg av kastigróti;teir fyltu seg av kongafiski;tunna av korni;mál av lýsi;hann fylti seg av mati og drekka;líkið av Ólavi;fylgi av seyði;báturin var fullur av sjógv;lítið var inni av torvi;eitt glas av vatni10(om årsag)på grund af,av aldri;av elli;av gleði;av illsinni;av møði;av neyð;av ræðslu;av sorg;teir róðu av makt;lundin er avoyddur av dráttri;illa komin av hungri;ringur av pokum;húsið er útdeytt av sjúku;lítið gott at liva av;dimma av náttel.kvøldi;myrkja av nátt;tað ýlir av stormi;halda ímóti bæði av grimd og vreiði;dómarin var illa í øgn við hann av hesum;taka sær tykni av e-m;hava skomm av e-m;vinningur av partabrøvum;gáloysni av tykkum;av veðri kann tað ikki vera;tey vóru um at skrædna í látri av henni;hon var sjúk og bleik av at sita inni;av ótta fyri e-m11(vedr. egenskab, fx karakter, udseende, alder, vækst)stórlátin og harðligur av sinnalag;eyðmjúkur av hjarta;góðsligur av lyndi;góður av sær;ræddur av sær;stórur av vøkstri;eitt reystmenni av sínum aldri;av tí mesta (besta, ringasta, tættasta);av tí illa (ónda, góða);kavar av møkum12(om tid, alder)klokkan er farin av átta;foreldrini vóru bæði farin av 70;koma av tíðkomme efter fastsat tid;farið av tíð;av fyrstu tíð;av fyrstum;av fyrstan tíð;vera av tí bestahave levet sine bedste år13(i forbindelse med passiv)(kvad)knørrur varð bygdur av norðmonnum14i ordforb.taka sær av løttum,selættur;av nýggjumpå ny, om igen;av órættummed urette;av røttumfaktisk, i virkeligheden;av sonnumvirkelig, faktisk;av øllum,seallur (1);verða av ongumikke blive til noget;hvørt av sínumforskelligt15(med adverbium)aftan av(fåremærke)aftan av sýling;aftur av:kassin datt aftur av bilinum;burtur av:reka burtur av leið;framman av(fåremærke)framman av stúvi;niður av:hann leyp niður av garðinum;upp av:upp av sofuni;út av:bilurin fór út av vegnum;yvir av:hann sat yvir av mærhan sad overfor mig;beint yvir av durunum16(som led i konjunktion)av tí atfordi;hann slapp ikki við, av tí at hann orkaði ikki at ganga  / /17færdig, overstået,allur vandi var av;dimmið var av;(talem.)ikki er tað eftir, sum av er;(ordsp.)nú er alinin av og sponnin eftir,sealin 1;(talem.)tá ið eitt er av, er annað á18i ordforb.av og áaf og til19(præp / adv sammen med verbum)fxberja av;bjóða av;brotna av;falla av;fara av;ganga av;gera av;leggja av;lesa av;loysa av;renna av;siga av;taka av;tola (nógv / lítið) av;varða av;verða av;vinna av;vita av;ýta av(se verbum)
avafturrunnin	blevet ædru igen,kenningin er avafturrunninman er blevet ædru igen;nú er avafturrunnið
avát	(om kreatur)det at spise ulden af sig
avbardur	1afbanket2nedslået (af vejr),eplagrøðin er avbardkartoffelhøsten er nedslået
avbeklaður	(om sko)trådt skæv,avbeklaður skógvursko som er trådt skæv
avbendingur	1skævhed i halsen(fx efter at man har båret en tung byrde)2får med halsskævhed(torticollis)
avbendur	med kinden på hæld
avbera	særdeles, i høj grad
avbitin	afgræsset,hagin er avbitinudmarken er afgræsset
avbjóðandi	udfordrende
avbjóðari	udfordrer(fx til brydning, skak o.a.)
avbjóðing	udfordring,tað er ein stór avbjóðingdet er en stor udfordring
avblástur	ren og ryddelig,har var alt so avblástdet hele var så rent og ryddeligt
avblomstra	(bot.)afblomstre
avblóma	(bot.)afblomstre
avboð	afbud,geva avboðmelde afbud
avbreiddur	dækket med noget,bøurin var avbreiddurgræsmarken var dækket med gødning
avbrek	afbræk, skade
avbrendur	(om ild)liggende i gløder
avbrigdi	variant,avbrigdi av søgninien variant af sagnet
avbrongla	bringe af lave, fordreje
avbronglaður	bragt af lave, fordrejet,navnið er misskilt og avbronglaðnavnet er misforstået og fordrejet
avbronglan	fordrejning, forvanskning
avbrotin	brækket, i stykker
avbrótari	(elektr.)afbryder
avbrýndur	glat slebet,grótið er avbrýntstenene er glat slebet
avbukaður	afbanket,tú skalt verða avbukaðurdu skal få tærsk;sebuka av
avburðarmaður	ypperlig, fremragende mand(fx i styrke og tapperhed)
avburðarseyður	ypperligtel.ypperlige får
avbygd	afsides bygd
avbygdarfólk	folk fra andre bygder
avbygdarligur	(om udenlandske forhold)provinsiel
avbygdarmaður	mand fra en anden bygd
avbygdarskapur	(om udenlandske forhold)provinsialisme
avbygdur	1fuldstændig bebyggetel.besat,bøurin er avbygdur við húsder er kommet huse overalt i indmarken2helt skjult, ganske dækket,hellan var avbygd av fugliklippen var helt fyldt med fugle
avbyrgdur	isoleret
avbyrging	isolation, afsondrethed
avbæra	særdeles, i høj grad, meget,avbæra góður, ríkur, vakurmeget god, rig, smuk
avbærur	udmærket, ypperlig
avdagast	blive rent borte (om dagen), blive nat,syftunsøkudag avdagast ongastaðni í Føroyum;nú avdagast ikkinu ses dagskæret hele natten(dvs. ved højsommer)
avdalur	afsides dal
avdankaður	(om huse, bygder)blevet øde, forladt,neystið er avdankaðbådehuset er forladt
avdankast	blive øde, forladt
avdálkaður	meget beskidt,illa avdálkaður
avdetting	det at falde i søvn pga. beruselse
avdeyða	(om kreaturer)udtjent,kúgvin er avdeyðakoen er udtjent
avdeyðaaldur	den tid et får regnes for at være udtjent(6-8 år)
avdeyðahundur	aflægs hund
avdeyðakúgv	gammel udtjent ko
avdeyðalag	komin í avdeyðalag1(om får)som er blevet så affældigt at det ikke kan følges med de andre op til bjerggræsgangene2(om folk)som ikke kan følge med i det hårde arbejde
avdeyðalamb	lam af et udtjent hunfår
avdeyðaneyt	udtjent kreatur (kvæg)
avdeyðaross	udtjent hest
avdeyðaseyður	gamle udtjente får
avdeyðaskrinda	dårligt gammelt udtjent hunfår
avdeyðaær	gammelt udtjent hunfår som slagtes i 6-8 års alderen
avdeyði	1gammelt hunfår2(spøg.)ældgammel person
avdeyður	(om får)udlevet(6-8 år gammelt),tá ið ærin er 7 vetrar á aldri, verður hon roknað at vera avdeyðnår hunfåret er 7 år gammelt, regnes det for udlevet
avdottin	faldet i søvn af beruselse
avdoymi	deodorant
avdráttarfríur	(økon.)afdragsfri,lánið er avdráttarfrítt í lestrartíðinilånet er afdragsfrit i studietiden
avdráttarskái	(økon.)afdragshenstand
avdráttur	(økon.)afdrag,rentur og avdráttirrenter og afdrag
avdrivin	(mar.)drevet ud af kurs,skipið er avdriviðskibet er drevet ud af kurs
avdubba	(militær)afvæbne, nedruste
avdubbaður	1varmt påklædt, godt indpakket(mod kulde),óvitarnir gingu avdubbaðir í heitum troyggjumbørnene gik godt indpakket i varme trøjer2afvæbnet, nedrustet
avdubbing	(militær)afvæbning, nedrustning,stórveldini eru farin undir avdubbingsupermagterne er begyndt på nedrustning
avdúka	afsløre,løgreglan avdúkaði tjóvarnarpolitiet afslørede tyvene;elsti maður í bygdini avdúkaði minnisvarðanden ældste mand i bygden afslørede mindesmærket
avdúking	afsløring
avdýpi	1sted hvor der er meget dybt ned til bunden2(overf.)afgrund,á leiðini móti avdýpinumpå vej imod afgrunden
avdøma	fordømme,tað vóru mest tey eldru fólkini, ið avdømdu hanadet var mest de gamle, som fordømte hende
avdøming	fordømmelse
avegna	tage madding av fiskekrogen
avegndur	som har tabt maddingen af fiskekrogene,eg eri avegndur
aveldast	forældes
aveldur	forældet,hesin hugsanarháttur er aveldur núdenne tankegang er forældet nu
avetin	1afgræsset,hagin er avetinudmarken er afgræsset2som har mistet maddingen af fiskekrogene
avfaksa	skære manke- og halehår af en hest
avfall	nedbør (regn, sne),avfall og mjørkinedbør og tåge;loysa avfalliðbegynde at sneel.regne
avfallin	1forfalden, skrøbelig,húsini vóru avfallinhuset var forfaldent;grasið er avfalliðgræsset er falmet;hann visti, at hann sjálvur var gamal og avfallinhan vidste, at selv var han gammel og skrøbelig2faldet i søvn af beruselse
avfaraskját	dårligt skind af et i udmarken dødt får
avfarin	gået af, forladt,hann er avfarinhan er gået i land (fra skib);hønan var avfarin reiðrinumhønen havde forladt reden;kl. var avfarin 9klokken var over 9
avfáing	(med.)afføring, åbning
avfáingarevni	(med.)afføringsmiddel
avfeitta	affedte(fx maskiner, cykler o.a.)
avfeitting	affedtning
avferma	losse
avfita	afmagre,sjúklingarnir verða avfitaðirpatienterne bliver afmagret
avfjaðra	fjerne finnerne (på fisk)
avfløði	(geol.)regression
avfýstur	(kortspil)(i visse kortspil)udgået for fus
avgaddaður	afgræsset,hagin er avgaddaðurudmarken er afgræsset
avgamal	meget gammel, ældgammel,avgamal maðurældgammel mand;í avgamlari tíði meget gammel tid
avgangandi	1skrånende,botnurin er avgangandibunden skråner2kileformet,ílátið er avgangandikarret er kileformet3(meteorol.)(om nordlig vind)som skifter og bliver mere sydlig
avgangur	afgang, ende, slutning,men so var avgangurin, at hann læt har sítt lívmen slutningen var, at han døde der
avgapaður	for storel.vid,hatta er so avgapaðdet er så stort og vidt;avgapað
avgapiliga	meget, ekstremt,hatta er so avgapiliga stórtdette er ekstremt stort(fx om stykke tøjel.hus)
avgerandi	afgørende
avgerð	1afgørelse, beslutning, bestemmelse,avgerð varð tikin á fundinumbeslutningen blev taget på mødet;uppskot til avgerðarforslag til beslutning2overdrivelse,tann, ið ikki hevur upplivað tað, heldur tað kanska vera avgerðden, som ikke har oplevet det, synes måske, at det er en overdrivelse
avgerðarrættur	bestemmelsesret, beslutningsret,avgerðarrættin í uttanríkismálum hevur danska stjórninbestemmelsesretten i udenrigsanliggender har den danske regering
avgingin	1besejret i kapgang,avgingin í kappgonga2(om solen)gået bag ved fjeldet,sólin er avgingin3(om klokken)passeret,klokkan er avgingin seksklokken har passeret seks4overstået, foregået, sket, hændt,tað er avgingið í friðidet er overstået i fred og ro
avgirdur	indhegnet,avgirt økiindhegnet område
avgjald	(økon.)1afgift,tollur og onnur avgjøldtold og andre afgifter;árligt avgjaldårlig afgift2afbetaling
avgjørdur	1afgjort, fastsat, bestemt,tað er avgjørt, at gamli skúli skal takast niðurdet er bestemt, at den gamle skole skal rives ned2kategorisk (i sine udtalelser), bestemt,hann hevði sínar avgjørdu meiningar um althan havde bestemte meninger om alting;hann er altíð so avgjørdur í tí, hann sigurhan er altid så kategorisk i det, som han siger3færdig, som har noget overstået,nú eri eg avgjørdur(fx færdig med eksamen)4(om dyr)som har aborteret;ærin er avgjørdhunfåret har aborteret5overdrevet,tað er nógv avgjørtdet er overdrevet6absolut, sandelig,tað er avgjørt neyðugtdet er absolut nødvendigt
avglaring	(geol.)devitrifikation
avglering	(geol.)deglaciation
avgonga	1(meteorol.)omslag i vejret(især fra snevejr og nordlig vind under klart og stille vejr)2sædafgang, ejakulation
avgongudagur	dag med omslag i vejret
avgreiða	1gøre klar, ekspedere,avgreiða viðskiftafólkekspedere kunder;málið varð avgreitt á seinasta fundisagen blev afgjort på seneste møde2betale
avgreiðsla	1ekspedition2sted for ekspedition
avgreiðslugjald	ekspeditionsgebyr
avgreiðslumaður	ekspeditør
avgreiðslutíð	ekspeditionstid
avgrevstrarflag	(stykke) afgravet grønsvær (ved tørveskær)
avgrevstur	1afgravning, bortgravning2afgravet grønsvær,har er nógvur avgrevstur
avgrund	afgrund
avgudadýrkan	afgudsdyrkelse, afguderi, idolatri
avgudadýrkari	afgudsdyrker, hedning
avgudamynd	afgudsbillede
avgudatempul	afgudstempel
avgudatrúgv	tro på afguder
avgudur	afgud
avgustahøvd	1kaskelothoved2(om person)stort deformt hoved
avgustahøvur	kaskelothoved
avgustur	kaskelot(Physeter macrocephalus),(talem.)sum at sjaggael.sjabba avgust(om et besværligt arbejde der går yderst langsomt, fx roning mod strømmen)
avgýttur	færdig med at gyde,fiskurin var avgýtturfiskene har kastet rognen
avgøta	afvej,teir ganga inn á eina lítla avgøtu í skóginumde går ind på en lille afvej i skoven
avhald	afholdenhed (fra spiritus)
avhaldsfelag	afholdsforening
avhaldsmaður	afholdsmand
avhalga	vanhellige
avhamaður	påtrængende, ude af sig selv (af forelskelse), vildt forelsket,hon er so avhamað í honumhun er smaskforelsket i ham
avhálkaður	overordentlig glat,har var alt so avhálkaðder var så overordentlig glat
avhenda	afhænde, overdrage
avhending	afhændelse, overdragelse
avhendingarbræv	overdragelsesdokument
avhendingardagur	overdragelsesdag
avhendingarskjal	overdragelsesdokument
avhildin	afholdt, vellidt,hann var nógv avhildin maðurhan var en meget vellidt mand
avhoyra	(jur.)afhøre, forhøre,dómarin avhoyrdi vitninidommeren forhørte vidnerne
avhoyrandi	i ordforb.bæði (á)hoyrandi og avhoyrandibåde tilstedeværende og fraværende,bóndin er ein góður maður, tað skal hann hava bæði hoyrandi og avhoyrandibonden er en god mand, både når han er til stede og fraværende
avhoyring	(jur.)afhøring, forhør
avhæsaður	endt, overstået, færdig,prátið var ikki avhæsað ennsnakken var endnu ikke forbi
avhøvda	skære hovedet af(især om fisk)
avhøvdaður	som hovedet er skåret af
avhøvdari	1(mar.)mand der skærer hovedet af fisk(ombord på skib)2(stor) kniv til at skære hovedet af fisk med3maskine til at skære hovedet af fisk med(fx på filetfabrik)
avillur	i ordforb. somtað er avilt í brimider er stærk brænding inde ved land
A-vitamin	(med.)A-vitamin
avís	(talesp.)avis
avísaður	dækket med is,hagin er avísaðurudmarken er dækket med is
avjaglaður	afgnavet
avjavnaður	fuldstændig jævnet,avjavnað við kavafuldstændig jævnet med sne
avkanna	frasige sig ejendomsretten til noget,(jur.)avkanna sær ognarrættinfraskrive sig ejendomsretten;avkannastfradømmes
avkanning	(jur.)afkald
avkappari	(mar.)(stor) kniv til at skære hovedet af fisk med,hann brýnir avkapparan
avkast	(kortspil)det ikke at bekende kulør,hann fekk eitt avkast
avkavað	dækket med sne,tað hevur ongantíð verið avkavað enndet har endnu aldrig været dækket med sne
avklakaður	helt dækket af våd sne
avklárnað	opklaret,nú var avklárnað, og einstakar stjørnur sóustnu havde det klaret op og enkelte stjerner kunne ses
avklyvja	tage byrde af hest
avklæðast	tage (tøjet) af
avkolaður	fuldstændig nedbrændt,húsini vóru avkolaðhuset var fuldstændig nedbrændt
avkom	(om mennesker og dyr)afkom
avkomin	forkommen,avkomin í hungrihårdt medtaget af sult;avkomin í svøvnimeget søvnig
avkotari	dekoder
avkoyrdur	(mar.)jaget bort, afskediget,avkoyrdur skipinumjaget bort fra skibet
avkókaður	udkogt
avkristna	afkristne,avkristna e-n
avkrókur	afkrog,ein burturgoymdur avkrókur av heiminumen isoleret afkrog af verden
avkubbaður	1afhugget, afskåret2stumpet, stump
avkvista	skære vinger, hale og fødder af en (plukket) fugl
avkvisting	det at skære vinger, hale og fødder af en (plukket) fugl
avkvøðin	overgået i at synge til kædedans,hann verður ikki avkvøðinhan overgås ikke i at synge til kædedans
avkyrktur	avkyrktur í krímisnotforkølet
avkøvdur	avkøvdur í krímisnotforkølet;avkøvt í mjørkamed tæt tåge overalt, overmåde tyk tåge
avlaga	bringe af lave, forvanske, fordærve,avlagastforvanskes, fordærves
avlagaður	bragt af lave, forkvaklet, fordrejet,avlagaður hugsanarhátturforkvaklet tankegang
avlagan	forvanskning
avlaging	1forvanskning2(geol.)dislokation
avlamdur	mørbanket,hundurin er avlamdurhunden er mørbanket
avlami	invaliditet
avlamin	helt lammet(fx af sygdom el. ulykke),invalideret
avlamingi	invalid
avlamisakfar	invalidekøretøj
avlamisbilur	invalidebil
avlamiseftirløn	invalidepension
avlamisendurgjald	invalideforsikringssum
avlamisfólk	invalid
avlamislag	invaliditet,hesar sjúkur bóru við sær deyða ella avlamislagdisse sygdomme medførte død eller invaliditet
avlamismaður	invalid
avlamistrygging	invalideforsikring
avlamni	invaliditet
avlamningur	invalid
avland	afsides liggende land(sdel),eitt satt avland
avlandsvindur	fralandsvind,avlandsvindur tók teir til havsfralandsvinden førte dem til havs
avlandsætt	fralandsvind
avlangur	aflang,avlangt eygaaflangt øje
avleggur	(talesp.)aflægger
avleiðing	følge, konsekvens
avleiðis	på afveje, afsides,rásir, ið hava ført avleiðisstier, som har ført på afveje
avleiðsla	(lingv.)afledning(muligvis med omlyd)
avleiðsluending	(lingv.)afledningsendelse
avlembdur	færdig at læmme
avlendis	ude af landet, borte fra landet
avliðin	forløben,avliðin tíðforløben tid
avlima	skære lemmerne af(dræbt dyr)
avlittur	afstikkende i farven,plaggið er avlitt
avlíva	aflive,hann hevði avlívað nógvar hvalirhan havde aflivet mange hvaler
avlívis	i ordforb. somskera, stinga seg til avlívisskære, stikke sig meget slemt
avljóð	(lingv.)aflyd
avlogaður	(om ild)udbrændt (kun gløder tilbage),eldurin var avlogaðurilden var udbrændt
avlop	1hvad der bliver tilovers, overskud,til avlopstilovers2(økon.)fortjeneste,avlopið av søluni fer til eitt gott endamálfortjenesten af salget går til et godt formål
avlopsbiti	smuler, krummer
avlopsmegi	overskudskræfter
avlopsmongd	(mat.)differensmængde, mængdedifferens
avlopspeningur	overskudspenge, restbeløb
avlopsskattur	(økon.)restskat, overskydende skat
avloysa	afløse(om vagt på skib),vikariere (for)
avloysarastarv	vikariat
avloysari	afløser,hann var avloysari hjá mær í summarfrítíðinihan var min afløser i sommerferien
avloysing	1vagtskifte(fx ombord på skib)2(rel.)absolution
avlógvaður	(om tøj)luvslidt,jakkin er gamal og avlógvaðurjakken er gammel og luvslidt
avluta	give afkald på, afstå (fra)
avlúsa	afluse
avlýsa	aflyse,fundurin er avlýsturmødet er aflyst
avlýsing	aflysning
avlæsing	1(håndarb.)det at lukke af(i strikning),komin til avlæsingar á stokkunum2afslutning, konklusion,slík brøv høvdu ofta yvirskrift, inngang og avlæsingsådanne breve havde ofte overskrift, indledning og afslutning
avmaktaður	(blevet) kraftløs
avmaktast	miste kræfterne
avmanna	1omringe(og siden fange),tarvurin varð avmannaðurtyren blev omringet og fanget2affolke,bygdin verður skjótt avmannaðbygden bliver snart affolket
avmannað	(om drivning af får)besat med folk for at drive får i fold,nú er avmannað
avmarka1	ændre et øremærke
avmarka2	1være grænse for, fastsætte grænse for2afgrænse, begrænse,tað er umráðandi at avmarka oljunýtslunadet er vigtigt at begrænse olieforbruget3definere
avmarkaður	1afgrænset2begrænset,avmarkað talufrælsibegrænset talefrihed;avmarkað ábyrgdbegrænset ansvar
avmarkan	begrænsning
avmarking	1begrænsning2definition
avmarvaður	slidt (af), afgnavet
avmáaður	slidt (af), afgnavet
avmáttaður	afkræftet, afmægtig, udmattet, kraftesløs, kraftløs
avmegingur	1afkræftet får2(om person)svækling
avmergja	udmarve, svække,sjúkan hevði avmergjað hanahun var svækket af sygdommen
avmergjaður	udmarvet, afkræftet pga. magerhed,veðrurin er avmergjaðurvædderen er udmarvet
avmóður	udhvilet
avmynd	afbillede
avmynda	1fotografere, afbilde,allir næmingarnir eru avmyndaðiralle eleverne er fotograferer2beskrive med ord,høvundurin avmyndar lívið í bygdiniforfatteren beskriver livet i bygden
avmyndan	fotografering, afbildning, gengivelse
avmyrking	mørklægning
avmæltur	hæs, ru, rusten
avmæri	1vantrivsel2vantrivning,eitt avmæri
avmæringur	får som ikke trives
avmærisær	gammelt udtjent hunfår som slagtes i 6-8 års alderen
avmøddur	som har mistet sin kraft
avmøðingur	moderløst lam
avnalvaður	som har kastet navlestrengen,kálvurin er avnalvaðurkalven har kastet navlestrengen
avnokta	ganske nægte, fornægte en,(bibl.)avnoktar tú djevulin og allar gerningar hansara?
avnoktan	fornægtelse, dementi
avnoktari	gudsfornægter, ateist
avnor	vantrivning
avnutaður	afgnedet, slidt af
avokado	(bot.)avokado(Persea gratissima)
avoldaður	forældet
avoyða	ødelægge, udrydde,fuglurin er avoyddurfuglene er udryddet
avoyraður	hankeløs
avparta	(talesp.)ganga avpartagå for sig selv, gå alene
avpartaður	(talesp.)aparte,hann sá rættiliga avpartaður úthan så ret aparte ud
avpiðaður	afpillet,hann var avpiðaður av rakihan var afpillet af magerhed
avpláss	afsides sted
avráddur	við avráddum hugamed vilje
avráða	1bestemme,vit avráddu at faravi bestemte os for at gå2fraråde,hann avráddi henni at fara, men hon fór kortinihan frarådede hende at gå, men hun gik alligevel
avráðing	beslutning, afgørelse,tá ið vit gjørdu hesa avráðingnår vi tog denne beslutning
avreiða	sælge,avreiða fisk, ullosv.sælge fisk, uld osv.
avreiðari	sælger (af egne produkter)
avreiðing	det at afhænde varer
avreiðingarprísur	salgspris(fra producent (fisker, fangstmand el.lign.) til opkøber)
avreksgerð	heltegerning, heltedåd
avrekskappi	tapper helt
avreksmaður	fremragende mand
avreksverk	storværk, bedrift
avrenning	rus der er ved at dampe af,tað var í avrenning hjá honumhan var ved at blive ædru
avrik	præstation
avrika	udrette, fuldføre,teir avrikaðu stórverkde udrettede storværk
avrikaføri	kapacitet
avrikamikil	som udretter meget
avriksarbeiði	(økon.)akkordarbejde
avriksløn	(økon.)akkordløn
avriksótti	præstationsangst,hava avriksóttalide af præstationsangst
avrit	kopi, afskrift,avrit til kunningarkopi til orientering
avrita	afskrive, kopiere
avritsvardur	(datal.)kopibeskyttet
avroð	indmad og hoved(især af får),eini avroð
avrokin	(om ild)som ikke ryger længere
avrokna	afregne
avrokning	afregning
avrovaður	(med.)hudløs
avrók	afsides klippeafsats,plantan veksur í avrókumplanten vokser i afsides klippeafsatser
avrundaður	afrundet,steinurin er avrundaðurstenen er afrundet
avrúm	afsides rumel.værelse
avryski	skarnsknægt, bæst
avrætta	henrette
avrætting	henrettelse
avrøkja	avrøkja fuglforstyrre en fugl så den forlader reden (og ikke kommer igen),æðan avrøktist av tyrluni;(overf.)avrøkja fólkskræmme folk væk,nú varðst tú avrøktur
avsag	(håndv.)(ved tømmerarbejde)afsavede stumper der ikke anvendes
avsagdur1	(om dyr der volder besværel.skade)dømt til at fjernesel.aflives,hundarnir vórðu avsagdirhundene blev fjernet
avsagdur2	(kortspil)overmeldt,nú varð eg avsagdur
avsaka	undskylde,hetta avsakar ikki høvundindette undskylder ikke forfatteren
avsakan	undskyldning
avsanna	benægte, dementere, afkræfte,hann kundi ikki avsanna møguleikanhan kunne ikke benægte muligheden
avsannan	dementi
avsáddur	oversået
avseta	(ved tørring af hø)det at duggen fordamper
avseting	1(ved tørring af hø)det at duggen fordamper2(økon.)henlæggelse (af penge)
avsettur	1afsat (fra embede)2(om græs)som vædeel.dug er fordampet fra,nú er avsett
avsiga	skaffe sig af med(især hund)
avsigast	lade sig overtale, give efter,læknin avsegðist ikki, hann varð við síttlægen var ikke til at overtale
avsintur	afsindig (af raseri)
avsissaður	bragt til ro, endt,stríðið var avsissaðstriden er bragt til ende
avsíðis	afsides
avskapa	fordreje, forvanske,við einum fremmandum, avskapaðum eygnabragdimed et fremmed forvansket blik;navnið er avskapað til eitt heilt annað navnnavnet er forvansket til et helt andet navn
avskapan	1fordrejning, forvanskning2(fys.)deformation
avskapiliga	overmåde, forskrækkelig,avskapiliga stórur skógvurovermåde stor sko
avskapiligur	misdannet, deform;-liga
avskarving	formindskelse, afskrivning, nedsættelse
avskeiklaður	blevet skæv, af lave
avskelvtur	dækket af (is el.) sne
avskepla	fordreje, forvrænge
avskeplaður	fordrejet, forvrænget, deform, misdannet,muðurin var avskeplaðurmunden var forvrænget
avskeplan	fordrejning, forvanskning
avskepling	fordrejning, forvanskning
avskila	særdeles,avskila vakursærdeles smuk
avskilaður	afdelt i rum(ved skillevæg, tæpper el.lign.),afsondret
avskildraður	afsondret(ved skillevæg, tæpper el.lign.)
avskipa	(mar.)indskibe, laste (et fartøj),fiskurin varð turkaður og avskipaður í góðari tíðfiskene blev tørret og lastet i god tid
avskipast	miste besætningen af får
avskiping	(mar.)afskibning, lastning
avskjaldraður	afsondret,inni í bulinum eru tvey stór rúm væl avskjaldrað við einum vødda, sum eitur tindin
avskotin	(om kornmark)som har sat aks
avskrift	afskrift
avskriving	1afskrivning, kopiering(fx i skole)2(økon.)afskrivning, nedskrivning(af kapital etc.)
avskræmiligur	frygtelig, afskyelig,avskræmiligur gangurfrygteligt spektakel;-liga,avskræmiliga ljóturafsindig grim
avskøða	avskøða segtage skoene af
avsláttarkort	rabatkort
avsláttur	rabat
avsleipin	(fx om klippe)glat (og stærkt skrånende)
avslipaður	(om klippe)dækket med slim,hellan var avslipaðklippen var dækket med slim
avsmurdur	gennempryglet
avsmurningur	prygl
avsmyrjing	prygl
avsneiddur	1skrå, konisk2svigtet
avsovnaður	død
avstað	af sted,hann leyp avstaðhan for af sted;eg havi gloymt tað avstað afturjeg har svedt det ud;um rætt er farið avstaðhvis man har handlet ret
avstaðfaring	bortrejse, afsked
avstaðferð	bortrejse, afsked
avstaðsfólk	folk fra andre bygder(fx bryllupsgæster)
avstarvaður	1udmattet(af alderdom)2død
avstikaður	indhegnet,stykkið er avstikaðjordstykket er indhegnet
avstilt	(om vejr)blevet stille,nú er avstilt
avstokkin	i stykker
avstoktur	avstoktur í krímisnotforkølet
avstoyping	afstøbning
avstoyttur	overiset
avstrali	australier
Avstralia	Australien
avstraliari	australier
avstralskur	australsk
avstroyddur	helt skjult, ganske dækket,himmalin var avstroyddur við stjørnumhimlen var ganske dækket med stjerner
avstubbaður	1afstumpet, studset,gentan mátti standa brúður við avstubbaðum hári2(overf.)studs,hann er altíð so avstubbaðurhan er altid så vred og afvisende
avstøða	konsekvens, følge
avstøka	1ubetydelig del af noget2hvad der bliver tilovers ved deling3svind, omkostninger, manko
avsvarðaður	som grønsværen er forsvundet fra,har er alt avsvarðaðgrønsværen er forsvundet overalt(i udmarken)
avsýnis	ude af syne
avsýra	afsyre(fx gamle møbler for maling)
avtaglaður	helt skjult, ganske tildækket,har hekk alt avtaglað við fiskdet hele var ganske tildækket med fisk
avtaka	afskaffe,avtaka lóginaafskaffe loven
avtakafólk	fremragende person,hon var eitt avtakafólkhun var en fremragende kvinde
avtakamaður	ypperlig mand,hann var avtakamaður til bakkagonguhan var en ypperlig mand til at færdes i fuglefjeldene
avtakandi	aftagelig(fx hætte)
avtakaveður	voldsomt uvejr
avtakin	helt skjult, ganske tildækket,borðini vóru avtakin við fløskur og gløsbordene var helt tildækket med flasker og glas
avtaking	fotografering
avtaksmaður	ypperlig mand
avtala1	aftale
avtala2	1afskedsprædiken2ligtale
avtala3	aftale, enes om, entrere
avteyggjaður	tæt behængt
avtikin	1ophævet,einahandilin varð avtikinmonopolhandelen blev ophævet2(fx om får)dræbt,tað árið varð hetta slagið avtikið3øm, hudløs, irriteret,barnið er avtikið um rumpunabarnets bagdel er hudløs4fotograferet,avtikin myndfotografi5som har tabt sig,hann var nógv avtikin í veturhan har tabt sig meget denne vinter
avtoftaður	som står som ruin, blevet ruin,húsini eru avtoftaðhuset er en ruin
avtrivnast	vantrives
avtuskaður	udaset, udkørt
avtøka	1(håndarb.)indtagning(ved strikning)2afskaffelse, ophævelse,avtøka av einahandlinummonopolhandelens afskaffelse3hudløshed, ømhed, irritation4(kortspil)aftagning5hvad der bliver tilovers når udgifterne er betalt
avtøkumaður	ypperlig mand
avtøkustjóri	(jur.)likvidator
avtøkutekn	(musik)opløsningstegn
avundsjúka	misundelse, jalousi
avundsjúkur	misundelig, skinsyg, jaloux
avvaksin	overgroet (med),urtagarðurin var avvaksin við grasi og lokihaven var overgroet med græs og ukrudt
avvallaður	helt dækket med grønsvær
avvandur	afvænnet (med),avvandur við e-t
avvarðandi	pårørende, vedkommende,tey avvarðandide pårørende;avvarðandi myndugleikarvedkommende myndigheder
avvarra	(lingv.)delabialisere
avvarran	(lingv.)delabialisering
avvavdur	tilhyllet,við avvavdum høvdimed tilhyllet hoved
avvápna	(militær)afvæbne, nedruste
avvápnan	(militær)afvæbning, nedrustning
avvápning	(militær)afvæbning, nedrustning
avvegis	på afveje, afsides,bygdin lá avvegisbygden lå afsides
avvegur	omvej,hann gjørdi ein stóran avveghan gjorde en stor omvej
avveiting	dræning
avveittur	(om fx indmark)afgrøftet, tørlagt,bøurin varð ruddaður og avveitturindmarken blev ryddet og tørlagt
avvenjing	afvænning
avviðaður	(om træ)med årer som går på tværs
avvik	1afvigelse,avvik frá tí vanligaafvigelse fra det almindelige2sidespring (fra emne), digression
avvitandi	bevidst, medvidende,hon valdi avvitandi at ganga aðra leiðhun valgte bevidst at gå i en anden retning
avynnubarn	smertensbarn
avynnudýr	1stakkel, stakkels person, usselt menneske2uartig dreng, skarnsknægt
avynnuligur	ynkelig, kummerlig, elendig,øll vóru avynnulig á at lítaalle var elendige at se på
avynnumaður	stakkels mand
avynnuting	usselt kræ,hatta er eitt avynnuting
avýting	afpejling(af fiskeplads)
