g	1(lingv.)konsonant2(lingv.)8. bogstav i det færøske alfabet (kaldes )3(musik)tone og tilsvarende node4fork. forgramm
gabb	1pral, praleri2pralhals, blærerøv
gabba	prale, brovte, blære sig, skvadronere,hann gabbaði sær av tíhan pralede med det
gabbari	pralhals, blærerøv
gabbi	pralhals, blærerøv
gabbutur	pralende,hann er so gabbuturhan er så pralende
Gabon	Gabon
gabonbúgvi	gaboneser
gabonskur	gabonesisk
gadda	1klippe tæt,gadda omanav;alt (hárið) varð gaddað omanav2afbide græs nær ved roden,rossini gadda hagan;hagin er avgaddaðurudmarken er afgræsset;gadda niður í rótinabide græsset ned til roden3overfiske,hann gaddaði plinkin
gaddajørð	tyndt jordlag på stengrund
gaddur	tyndt jordlag på stengrund
gaddutur	(om terræn)vildt og stenet,har er harðlent og gaddutjordbunden er hård og stenet
gaffil	1gaffel(til spisning),eta við knívi og gaflispise med kniv og gaffel2gaffel på truck3(mar.)rundholt der sidder skråt ud fra masten på et skib(og som bærer den øverste kant af et gaffelsejl)
gaffilbiti	gaffilbitargaffelbidder
gaffilsegl	(skib.)gaffelsejl,stórseglið og mesanurin eru gaffilsegl
gaffiltrukkur	gaffeltruck
gagg	(om mallemukkens lyd)
gagga1	1læderstøvle med træbund(spec. til sømænd),træskostøvle2fodboldstøvle med knopper
gagga2	(barn.)lus
gagga3	(barn.)høne, and
gagga4	lyde som en mallemuk
gagguskógvur	læderstøvle med træbund(spec. til sømænd),træskostøvle,hann hirdi annan gagguskógvin inn í skinnabeinið á honumhan kastede den ene læderstøvle lige på hans skinneben
gagn	1gavn, nytte, hjælp,verða e-m at gagnivære til gavn for nogen;koma e-m til gagnsel.at gagni;gera gagngøre nytte;røkja sítt yrki til gagnspasse sit arbejde helt og fuldt2(biol.)organ
gagna	gavne, nytte, være til gavn,gagna e-mvære til gavn for en;e-t gagnast e-m væl / illanoget bekommer en vel / dårligt;maturin gagnast mær ikkimaden smager mig ikke;væl gagnist teimum tað, teir fáadet er dem vel undt;væl gagnist!velbekomme!;(neds.)væl gagnist honumdet har han godt af!
gagnfiskur	nyttefisk
gagnfuglur	nyttefugl
gagngera	forædle,virki, sum gagnger seið, livur og slógvfabrik, som forædler sej, lever og fiskeaffald
gagngóður	nyttig, fordelagtig,bøkurnar hava verið gagngóðarbøgerne har været nyttige
gagnleysur	unyttig, nytteløs
gagnligur	gavnlig, nyttig
gagnlist	brugskunst
gagnlítil	som ikke er til megen gavn, nytteløs
gagnloysi	nyttesløshed
gagnlutur	nyttegenstand
gagnmeta	kritisere,gagnmeta listaverk, bókkritisere et kunstværk, en bog
gagnmetari	kritiker
gagnnýta	udnytte,gagnnýta fiskastovnarnarudnytte fiskebestandene
gagnnýtsla	udnyttelse,fáa eina skynsamliga gagnnýtslu av fiskastovnunumfå en ordentlig udnyttelse af fiskebestandene
gagnplanta	nytteplante,gagnplantur sum epli og maisnytteplanter som kartofler og majs
gagnsamligur	appetitlig,ein gagnsamlig máltíðet appetitligt måltid;-liga
gagnsemi	gavn, nytte
gagnsleysur	unyttig, uproduktiv
gagnsmál	nytte, fordel,røkja egin gagnsmálpleje egne interesser
gagnsverk	nyttigt arbejde,háskúlin hevur gjørt gagnsverkfolkehøjskolen har gjort et nyttigt arbejde
gagnturrur	gennemtør,hoyggið er gagnturthøet er gennemtørt
gagnvegur	genvej
gagnviður	gavntømmer
gakk	seganga
gal	galen, skrig, skrålen
gala	(spec. om høns)gale,hanin gelurhanen galer;hann datt, so tað gól í kroppinumhan faldt så det sang i kroppen;nú er tað tað, sum gelur í honumnu er det det, der kører rundt i hovedet på ham;títt bartrog, gól í læraranumdin møgunge, råbte læreren
galda	1gælde, være gældende,lógin skuldi galda fyri Føroyarloven skulle gælde for Færøerne;vera galdandi2hænde, ske,vatn máttu teir hava, hvat tað enn skuldi galdavand måtte de have, uanset hvad;men hvat galt?men hvad skete?;tað galt tað samadet var lige meget, det havde ingen betydning;hon visti, hvat ið um galthun vidste, hvad der stod på spil
galdra	snakkeel.skrige op, støje,er sonurin farin at tosa? Nei, men hann galdrarer sønnen begyndt at tale? Nej, men han pludrer;hjartað fór upp at galdrahjertet begyndte at banke
galdran	skrigen, støjen,við róp og galdranmed råb og skrigen
galdrutur	støjende
galdur	trolddom, hekseri
galileari	(bibl.)galilæer
galileiskur	(bibl.)galilæisk
galin	1gal, fra forstanden, forrykt, rasende,pápi verður galin, tá ið hann frættir taðfar bliver rasende, når han hører det2gal, forkert,her var okkurt spinnandi galiðher var noget splintrende galt
galipinnur	(biol.)kildrer, klitoris
gall1	(biol.)1galde,tá var gallið tað besta í mærda var jeg rasende;oysa gall og gor út yvir einudøse sin galde over én2galdeblære
gall2	segjalla
galla	(skib.)kabys
gallarí	galleri
gallbeiskur	(om smag)bitter som galde, overordentlig bitter
gallbløðra	(biol.)galdeblære(vesica fellea)
gallfrystur	stivfrossen
gallharður	stivfrossen
galliskur	gallisk
gallróp	gjaldende råb, hyl,skera í gallrópsætte i et hyl
gallræsi	(biol.)galdegang(ductus choledochus)
gallsótt	(med.)galdesyge
gallsteinur	(med.)galdesten
gallsúrur	1bitter som galde, eddikesur2(om folk)meget sur, meget gnaven
gallsýra	(biol.)galdesyre
galossja	galoche
galt	segalda,gjalda
galtartonn	tand der vokser ud gennem tandkødet,hava galtartennhave stærke tænder
galti	(zoo.)galt (kastreret orne)
galtur	(zoo.)1galt2overmåde fedt og korpulent kreatur
galvabátur	(båd.)båd med gavl bagpå
galvanisera	galvanisere
galvflógv	tørvestabel lagt ved stenhusets gavl
galvur	1(husbyg.)gavl, gavlfelt (på hus),frá galvi til gátt(ar)om hele huset;(poet.)innan galvs og gáttainde i huset2gavl(for enden af seng, kiste, trug etc.)3(stedn.)højt, bredt og stejlt næs,Kalsoyar-
gamal	1gammel,hvat / hvussu gamal ert tú?hvor gammel er du?;fimm ára gamalfem år gammel;gamal maðurgammel mand;gomul konagammel kone;hann er gamal í garðihan er en gammel rotte;hin gamli / gamladen gamle mand / kone;teir gomluforfædrene;(talesp.)tey gomluforældrene;(talesp.)bilurin hjá gamlafars bil;hann verður ikki gamal harhan bliver der ikke længe(fx i nyt job),eg verði ikki gamal burturjeg bliver ikke længe væk;(ordsp.)góður er gamal í ráðumel.ráðiden gamle giver gode råd2gammel, arkaisk, antik,gomlu jóljul efter den gamle kalender (6. januar);gamlar gøturgamle stier;í gamlar dagarel.gomlum døgumi gamle dage;tað var so gamalt við tídet var indlysende;eftir gomlum siðiefter gammel skik;tað er bæði gamalt og forntdet er ældgammelt3forhenværende,í gamla Jugoslaviai forhenværende Jugoslavien4(eufem.)gamlikammerat, gamle ven;gamli mín!;hygga gamli!5(mar.)(hin) gamliskipperen
gamaldags	gammeldags
gamalmálsligur	gammelsproglig, klassisksproglig,gamalmálsligt studentsprógvklassisksproglig studentereksamen
gamalmenni	olding
gamalsaldur	i ordforb.á gamalsaldripå ens gamle dage
gamalseyðabógvur	bov fra et gammelt får
gamalseyðakjaftur	i ordforb. somfullur gamalseyðakjafturfår som har alle tænderne i behold
gamalseyðakjøt	kød fra gammelt får
gamalseyðakrov	fårekrop af et fedt gammelt får
gamalseyður	fedt gammelt får
gamalskapur	alderdom, alderdomsskrøbeligheder,gamalskapur og gikt er tað, ið mær bagiralderdom og gigt er mit problem
gamalsligur	gammel af udseendeel.væsen,hann er so gamalsligurhan er så gammel af udseende;gamalsligt húsgammeldags hus;-liga
gamalur	gammel
gaman	fornøjelse, spøg, skæmt,við gleði og gamnimed glæde og fornøjelse;halda sær atel.á gaman, at gamnimore sig;tá gránaði gamanda blev spøg til alvor;(tað er) gaman í(det gør jeg) med fornøjelse;tað er gaman í at hjálpa tærjeg hjælper dig med glæde;tað er gaman í hjá honumhan kan sagtens!;gaman í er hann gamal, men enn rør hann útgodt nok er han gammel, men stadig tager han på fiskeri
gamansleikur	spøg, leg,tað er ikki gamansleikurdet er ikke til at spøge med, det er en alvorlig sag
gamansligur	skæmtsom,við gamansligum orðummed skæmtsomme bemærkninger;-liga
gamanslyndi	humor
gamanstáttur	skæmtevise
gamassjubuksur	gamachebukser, gamacher
gambi	gambier
Gambia	Gambia
gambiari	gambier
gambiskur	gambisk
gamlaárskvøld	nytårsaften,siður er at brenna nýggjársbál gamlaárskvølddet er skik at brænde nytårsbål nytårsaften
gamlaketa	dansespil(flettet ring hvor kvinder og mænd danser ind imod hinanden, tager under hinandens højre og venstre arm hver anden gang, mændene med solen og kvinderne mod solens retning)
gamlamannadansur	dans med ældre rolige melodier,gamlamannadansur við harmoniku
gamlamannamøsn	gammelmandssnak
gamlaseyðadeyði	(stor) dødelighed blandt de gamle får
gamlaseyðakrov	fårekrop af et fedt gammelt får
gamlaseyður	fedt gammelt får
gammageislar	(kem.)gammastråler fra radioaktivt stof
gammur	1(kvad)fabelfuglen gamel.grib,gammin síggja teir norðan flúgva2rivende, arbejdsomt menneske,arbeiða sum ein gammurvære meget arbejdsom;hon skrivaði og roknaði sum ein gammurhun var meget dygtig til at skrive og læse
gampur	(kvad)hest,kelling saðlar sær gampin grákællingen sadler sin grå hest
Gana	Ghana
ganabúgvi	ghaneser
ganda	hekse, forhekse, fortrylle, øve trolddom,tú verður ikki gandaður í dagdu bliver ikke forhekset i dag(sagt til en med vrangvendte klæder),gandaðurtryllebunden, forhekset;hann var gandaðurhan var forhekset
gandabók	trolddomsbog
gandabragd	trolddomskunst,hann gjørdi gandabragd við høgru hondhan udøvede trolddomskunst med højre hånd
gandafluga	(zoo.)lille flue af grøn farve med metalglinsende vinger
gandagerð	udøvelse af trolddom, trolddomsgerning
gandahít	troldkælling, heks
gandakallur	troldmand, heksemester
gandakelling	troldkælling, heks
gandakraft	trolddomskraft,á henda hátt fekk hon gandakraftinasådan fik hun sin trolddomskraft
gandakunstur	trolddomskunst,royna gandakunstirforsøge sig med trolddomskunster
gandakynstur	trolddomskunst,av mínum rama gandakynstrifra min stærke trolddomskunst
gandamáttur	1trolddomskraft,tá ið onkur brigslaði fólki gand, mistu tey gandamáttinnår nogen bebrejdede andre trolderier, mistede de trolddomskraften2kraftel.indflydelse fra trolddom
gandaorð	trolddomsord, trylleformular,hann dugdi gandaorðiðhan kendte trylleformularen
gandaráð	(folketr.)trolddom, hekseri,grøða við gandaráðumhelbrede med trolddom
gandasteinur	tryllesten, amulet
gandaørindi	(folketr.)vers med trolddomskraft
gandbinda	tryllebinde
gandkvæði	trolddomskvad,gandkvæði Tróndar
gandleikari	tryllekunstner, gøgler
gandur	1trolddom, hekseri,vera sterkur í gandivære stærk i trolddom2indflydelse fra en trolddomshandling,hatta er tann rami gandur1dette er den rene trolddom2(overf.)dette er helt forheksetel.besat,sjónin gekk frá honum, og tað var av gandihan mistede sit syn, og det var pga. trolddom
ganga	1gå, spadsere,læra at gangalære at gå;skulu vit ganga ella koyra?skal vi gå eller køre?;ganga fjøllinidrive fårene i fårefolden;ganga á bitigræsse;ganga e-m ein skarpan gangikke stå meget tilbage for en, være en farlig konkurrent til en;ganga aðrar gøturforsøge noget nyt;tú gongur so berurdu har så lidt tøj på;ganga og malagå frem og tilbage, strejfe omkring;ganga í dansgå i dans;ganga burtur í hagarøgte får i udmarken;ganga í kirkju, skúlagå i kirke, skole2være i bevægelse,báturin gongur skjóttbåden sejler hurtigt;motorurin gongurmotoren er i gang;hurðin gongurdøren går op;klokkan gongurtiden går;søgur gingu um hannder verserede historier om ham;talvan gongurkollekt i kirken;ganga kykurryste, dirre(fx af spænding);ganga vesturel.vesturum(om vind)dreje i vestlig vindretning;dansurin gekk í stovunidansen gik i stuen;hann fær dansin at gangahan er en god forsanger (i færøsk kædedans);ein góður filmur gongur í biografinumder går en god film i biografen;alt gongur sína vanligu gongdalt går som det plejer;hvussu gongur?hvordan går det?;tað gongur væl / illadet går godt / dårligt3hærge, plage,meslingarnir ganga;stormar ganga(raser);toran gongurdet tordner;ælini gangadet er bygevejr;giktin gongur í liðum og limumgigten plager i hele kroppen4(om tiden)gå,tíðin gongur;so gingu meir enn fjøruti árder gik mere end fyrre år5gå, løbe,markið gongur oman við ánnigrænsen går langs åen6stikke,skipið gekk djúpt í sjónumskibet stak dybt i søen7være gravid,kona gongur níggju mánaðirkvinden er gravid i ni måneder8(om ubagt brød)hæve,breyðini gangabrødene hæver sig9men gakk!ak!  / /ganga aftur1(om en død)gå igen, spøge,hann gongur aftur2komme igen, gentage(s),tað eru somu spurningar, ið ganga afturdet er de samme spørgsmål, som går igen3ganga e-n afturindhente en (til fods),tú gongur okkum skjótt afturdu indhenter os hurtigt4ganga aftur á hondina (við e-m)blive værre,tað gongur aftur á hondina við honumdet går tilbage med ham;ganga atgå hen til, imod etc.,ganga hart at e-mangribe (en) hårdt;salt (søtt, snykuro.lign.) gongur atdet smager af salt (sukker, tran etc.);ganga av1forløbe, slutte,alt gekk friðarliga avalt forløb fredeligt2tages fra(som del af noget),ein stórur partur av veiðini gongur aven stor del af fangsten bliver taget fra3(om skud)løsnes,skotið gekk av4få udløsning5(om byge)drive over6(i forskellige ordforbindelser)sum tíðindi ganga avsom rygtet fortæller;ikki ganga av áriel.árinumikke leve året ud;ganga av við e-tblive af med noget;ganga e-n avovervinde en i gang;ganga á1sjógvur gongur ávandet sprøjter ind i båden2ganga á e-nel.ganga á kroppin á e-mplage en om noget3ofta gekk hart ádet var ofte svært, det holdt ofte hårdt;tað gekk javnt ádet var en jævnbyrdig kamp,hvat gongur á?hvad er der galt?4(i forskellige ordforbindelser)hann gongur á sjeynda árihan er seks år gammel;ganga burturomkomme på havet,ganga burtur við barnidø i barselseng;ganga eftir1blive tilbage, blive hjemme2følge, holde sig til,vit mega fáa reglur at ganga eftirvi må få nogle regler at holde os til;ganga fram / framá1tað gongur fram á hondinadet går den rigtige vej, det går fremad;tað gongur framá við arbeiðinum2blive gennemført, gå i opfyldelse;ganga framvið(om lille barn)tage de første skridt ved at støtte sig til borde, vægge o.lign.;ganga frá1forlade, gå fra,ganga væl / illa frá (e-m)udføre (et arbejde, en opgave) godt / dårligt;(overf.)teir ganga ikki frá sínumde holder fast ved sin overbevisning2slippe op,kolið gekk frá;mótið gekk frá honummodet svigtede ham;sjónin gekk frá honumsynet svigtede ham;tað gongur ikki frá mærjeg glemmer det aldrig;ganga fyri1gå foran, være i spidsen,ofta gekk bóndin fyri í arbeiði2ødelægges, gå i stykker,motorurin gekk fyri3ganga fyri borðumopvarte, servere;ganga íkunne anbringes i, kunne få plads i,tað gongur ikki meira í lastinader er ikke plads til mere i lasten;nógv gekk innan í teimumde var meget ophidset;ganga ímillummægle;ganga inn:ganga inn við e-n (um e-t)indgå en aftale med en (om noget);ganga niður1(om mad)glide ned,tær ótu, men lítið gekk niðurde spiste, men uden appetit2ganga e-n niðurindhente en (til fods)3(om byld)fortage sig,svullurin er niðurginginbylden har fortaget sig;ganga nær:ganga e-m nærvære nærgående,hann gekk sera nær við sínum spurningumhan var meget nærgående med sine spørgsmål;ganga saman1ganga tvey samanfå to sammenkoblet;royna at ganga tvey saman2ganga saman í felagorganisere sig;ganga sundur1ganga tvey sundursøge at skille to ad2gå i stykker, ødelægges,(kvad)sundur gekk hans góða svørð;ganga til1gå til præst2gå til, gå for sig,tað gongur soleiðis til3gå til, krepere,hon er um at ganga til av pínuhun er ved at krepere af pine;ganga um1ganga væl / illa um e-tomgåsel.behandle på en forsvarlig (uforsvarlig) måde;ganga loyniliga um e-tbehandle som en hemmelighed2lata um seg gangafinde sig i,hann vildi ikki lata alt um seg ganga;ganga undan1gå i forvejen,hann gekk undan mær2stå i spidsen for3slippe op,maturin fer at ganga undan;ganga undir1acceptere, finde sig i,hann gekk undir dóminhan accepterede dommen2gå underel.til grunde3gå af syne,sólin gongur aftur undir fjalliðsolen forsvinder bag fjeldet4tað gongur mær undir eygunidet er mig en torn i øjet, det irriterer mig;ganga upp1barometrið gongur upp / niðurbarometret stiger / falder2(kvad)ganga upp á gólvbegynde at danse3(i forskellige ordforbindelser)nú gongur upp hjá tærnu har du rigtig fået tungen på gled;tað gongur upp hjá honum (at gera tað)det er mere end han kan magte, det overgår hans kræfter;roknistykkið gongur uppregnestykket går op;ganga e-n uppindhente en (til fods);ganga úrforsvinde,ganga e-m úr hond (el.hendi)gå skævt, mislykkes for en;ganga út1gå i opfyldelse2ende, være omme,áðrenn árið gekk útinden årets udgang3mjólkin er útginginmælken er for gammel(i forhold til datomærkningen);ganga við1vedgå, tilstå,ganga við e-t2ganga viðel.ganga við barnivære gravid  / /ganga seg:ganga seg í e-nmøde en tilfældigt;gangast1lykkes,heimferðin gekst vælhjemrejsen gik godt;e-m gongst væl / illadet går en godt / dårligt;hvussu gongst?hvordan går det?;gangist tær vælel.væl gangist tær!held og lykke!2tað gongst niðan í gjónnadet lader sig gøre at gå op til bjergkløften;gangast við:alt gangist tær við!må alting lykkes for dig!;gangandi:har er ikki gangandidet lader sig ikke gøre at gå der, det er ikke muligt at gå der (til fods)
gangarahestur	(kvad)ganger, ridehest
gangari	1(kvad)ganger, ridehest2gænge,vøggan vaggar á gangarunumvuggen vugger på gængerne
gangevni	hævemiddel
gangstari	(talesp.)gangster, bandit
gangur	støj, larm, spektakel,halda gangholde kommers, støje;við levind og gangmed frygteligt spektakel
gangvirði	(økon.)kurs
ganir	(zoo.)1(hos køer)hudtakkerel.knopper i munden(hindrer dem i at tygge drøv),skera ganir2(på hest),usædvanlig længde på ganens forreste fold bag ved fortænderne3i ordforb. someg fái ganir av hasum1jeg får knopper af det(sagt om en der altid ævler om det samme)2(sagt fx når noget fungerer dårligt)
ganiskur	ghanesisk
gantast	1vove en dyst (med), udfordre,gantast við deyðanudfordre døden;hann aftraði seg fyri at gantast við dýriðhan holdt sig tilbage for at udfordre dyret2spøge, pjatte, fjase, fjolle,gantast við hugsaninalege med tanken
gap	1gab, mund, kæft2(neds.)person der aldrig kan tie stille
gapa	1gabe,gapa langtgabe højt2væreel.stå vidt åben3måbe,hann sat bara og gapaðihan sad aldeles forbløffet
gapisjúka	sygdom når en fugleunge bare gaber uden at ville spise
gapistokkur	gabestok
gaputur	kådmundet, rapkæftet, åbenmundet
gardina	gardin
gardinustong	gardinstang
garða	i ordforb.hannel.tað garðarvinden falder i kast ned på søen(og danner strøg med krusninger)
garðabak	(den ujævne) bagside af et stengærde
garðaboð	besked om at reparere gærdet omkring den dyrkede indmark
garðagenta	pige der er arvtagerel.født til at overtage en gård
garðagerð	vedligeholdelse af hegn
garðagrót	materiale til stengærde,hann tók veggirnar av gróthúsinum til garðagróthan tog væggene fra stenhuset til stengærde
garðagrund	fundament til et gærde
garðagul	ujævne vindstød ned over havet
garðahald	vedligeholdelse af gærder og hegn
garðahola	hule i stengærdet
garðalið	port, led i et gærde
garðalisa	(bot.)sibirisk vinterportulak(Claytonia sibirica)
garðamold	jord fra et jorddige(fx til potteplanter)
Garðaríki	(stedn.,kvad,hist.)gammelt russisk rige
garðaskoðari	hegnsynsmand
garðatorva	digetørv, græstørv til at bygge dige af
garðbúgvi	kollegianer
garðlag	lavt dige, levninger af et gammelt jorddige
garðlið	port, led i et gærde
garðmaðkur	(zoo.)lille lyserød regnorm(Dendrobaena rubida)
garðmold	jord fra et jorddige
garðsarbeiði	arbejde på bondegård
garðsbak	(den ujævne) bagside af et stengærde
garðsblóma	haveblomst
garðsendi	ende af et gærde
garðsgrind	portel.led i et gærde
garðshola	hule i stengærdet
garðskoðari	hegnsynsmand
garðslag	lavt dige, levninger af et gammelt jorddige
garðslið	port, led i et gærde
garðsstubbi	lille stykke gærde
garður	1støbtel.opstablet gærde(omkring hus, grundstykke o.lign.),gera garð uttan um húsinibygge gærde omkring huset2stengærdeel.hegn(mellem ind- og udmark),innan fyri garðarnari indmarken;uttan fyri garðarnari udmarken;gera garðarreparere gærder;hesturin kom til garðarnarhesten kom hen til gærdet;kasta (tveita) upp um garðarlade i stikken, svigte (en)3gårdsplads, gård,børnini spæla í garðinumbørnene leger ude på gårdspladsen4gård, bondegård,nógv tænastufólk vóru á garðinumder var mange tjenestefolk på gården;ríða í garð;koma til garðskomme til huse, komme hjem;komu ríðandi í garð;reka av garðidrive bort;hann er ikki her á garðihan er ikke hjemme;vera gamal í garði(om en som har været længe i samme arbejde, sted osv.);vera úr garðivære slut,nú er dagurin úr garði;áðrenn árið var úr garðiinden året var omme;tað kemur at ríða teimum aftur í garðdet kommer dem dyrt at stå;(ordsp.)vís mær at garði, og eg skal siga tær, hvør inni býr5á GarðiRegensen (i København)6flokel.række flyvende fugle,lomvigin fleyg í garði7krusning på havoverfladen af vindstød,hann kastar garðar niður á sjógvin
garðutur	kantet, randet(uden at det var tiltænkt)
garðyrki	gartneridrift, havebrug
garðyrkismaður	gartner
garðær	1høstgilde(oprindeligt for dem der hjalp til med at grave grøfter i udmarken og efterse fårefoldene),teir sendu meg at biðja tykkum koma til garðærina og hava gestirnar viðde sendte mig for at invitere jer til høstgildet og for at medbringe gæsterne2får som blev solgt(for at skaffe penge til høstgildet)
garmur	hund
garn	1(koll.)garn, tråd (til vævning)2rendegarn3fiskegarn, fiskenet,seta gørnsætte fiskegarn
garnabátur	båd der fanger torskel.sild med garn
garnað	(håndarb.)lítið garnað(om vadmel)lidtel.løst vævet, luvslidt
garnafiskiskapur	garnfiskeri
garnafiskur	fisk fanget med garn
garnaleið	fiskeplads hvor der bruges fiskegarn,tá sildin kemur upp á garnaleiðnår sildene kommer der hvor de kan fiskes med fiskegarn
garnapína	(med.)smerte i tarmeneel.maven
garnar	segørn 1
garnarendi	anus, endetarmsåbning
garnarúgva	dynge fiskeindvolde,fuglurin fær sær føði í garnarúgvumfuglene spiser af dyngerne med fiskeindvolde
garnasild	sild fanget med garn
garnaskip	(skib.)skib der fanger torskel.sild med garn
garnaskjálvti	indvortes kuldegysninger(fx af at drikke noget koldt)
garnaskrambul	rumlen i maven
garnasótt	(zoo.)smittende tarmsygdom hos hovdyr(beslægtet med tuberkulose)(paratuberculosis)
garnatálg	hengemt tarmfedt (fåretælle) der hakkes og æltes
garnatálgardrýlur	aflangt stykke af hengemt tarmfedt
garnaveiða	fiskeri med garn
garnbummur	garnbom, kædebom
garnering	1garnering2(skib.)beklædning til skibets inderside
garnmørur	(på får)fedt som omgiver indvoldene af et (slagtet) dyr
garnsnælda	håndten til at spinde garn på
garnstrangi	streng ved enden på sildegarn
garnvindari	garnvinde
garpalið	(kvad)hær af kæmperel.helte,hann hevði samlað eitt garpalið
garpi	(kvad)kæmpe, helt,so vænur ein garpi at sjá
garpur	stærk og kæk fyr, kæmpe, helt
gart	støj, larm,halt ikki sovorðið gartlav ikke så megen larm
garta	være uregerlig, støje, larme,børnini garta útibørnene larmer ude;gæsa og gartavære urolig
gartan	støj, larm,nú er gartan í (el.á) henninu larmer hun
gartera	(talesp.)være uregerlig, støje, larme
garterilsi	(talesp.)støj, larm
garva	garve,eitt garvað skinnet garvet skind
garvari	garver
garvarungi	uregerligt og larmende barn
garvillur	meget vild, balstyrig, ustyrlig,gentan er garvillpigen er helt ustyrlig
gasella	(zoo.)gazelle
gass	(kem.)1gas,nýta gassbruge gas2giftgas, gas,nýta gass í kríggianvende gas i krigsførelsen
gassa	gasse, forgasse,bilurin gassar so illabilen oser meget
gassbrennari	gasbrænder
gassfeingi	gasressourcer
gassfløska	gasflaske
gassi	trækølle, knippel
gasskamar	gaskammer
gasslogi	gasflamme
gasslykt	gaslygte
gassmaska	gasmaske
gassolja	gasolie
gassovnur	gasovn
gassskortur	gasmaske
gasstangaskip	gastanker
gasstól	gasapparat
gassvinna	gasindustri
gastutur	forhærdet, bandsat, uartig,teir eru so gastutirde er meget uartige
gat1	1hul2(biol.)endetarmsåbning, anus
gat2	segita 2
gata1	(talesp.)gade
gata2	slå huller i, gennemhulle,(overf.)gata ein ígjøgnum (við eygunum)gennembore en (med øjnene);gataðurgennemhullet
gating	(på papir)perforering
gav	segeva
gá	(kvad)gå
gáa	lægge mærke til, blive opmærksom (på),eg gáaði tað ikkijeg var ikke opmærksom på det;hann gáar einkihan er ganske ligeglad, han lægger ikke mærke til noget;gáa eftir e-mlægge mærke til noget;gáa um e-tlægge mærke til noget;tíðin gekk skjótari, enn hann gáaði eftir;ikki gáa særvære så optaget af noget at man ikke mener at have tid til noget andet;hann gáar sær ikki frá tíhan kan ikke få sig til at forlade det han er beskæftiget med
gáaleysur	skødesløs, uagtsom,tey eru so gáaleysde er så skødesløse
gáaloysi	skødesløshed, tankeløshed, vanvare
gágga1	(zoo.)konk, trompetsnegl(Buccinum undatum)
gágga2	(barn.)lus
gágga3	(barn.)høne, and
gággagn	madding af konk, konk brugt som madding
gágghøvd	1torskehoved som madding til at fange konk med2(neds.)tosse,tú ert eitt gágghøvddu er en tosse
gágguagn	madding af konk, konk brugt som madding
gággubátur	båd der fisker konk
gágguglúpur	konkketsjer
gággugrús	knuste skal af konk
gágguhøvd	1torskehoved som madding til at fange konk med2(neds.)tosse
gággukassi	hyttefad til konker, konkkasse
gággukelv	konkyngel
gággukrabbi	(zoo.)eremitkrebs(Eupagurus bernhardus, Pagurus pubecens)
gágguleið	havstrøg hvor man fanger konk,góð gágguleið
gággulína	line hvormed man fanger konk, konkline,seta gággulínusætte konkline
gággumeis	konkketsjer
gággurósin	(med.)en slags rosen(erysipeloid)
gágguskel	skal af konk
gággusogin	(om fisk)suget af konk
gággutrog	konktrug
gáin	påpasselig, forsigtig,vera gáin um segvære påpasselig
gák	skræp, skræppen, rap,gákini frá villdunnunumrap fra vildænderne
gáka	1(fx om høns og gæs)skræppe, rappe2(om personer)snakke, skræppe op;alt upp at flenna og gákaalle begyndte at le og skræppe op
gákan	1det at skræppeel.rappe,gákan frá høsnunumrappende lyde fra hønsene2vrøvl, snak,nú er gákan á teimum um okkumnu snakker de løs om os
gákur	1gab, kæft(fx på fugl)2(neds.)flabmund, gavflab,halt gák;halt gákin til á tær!hold mund, hold kæft!
gákutur	(om folk)som altid skræpper op
gáleysur	skødesløs, uagtsom
gálgagrein	(kvad)tværtræ på galge,í hægstu gálgagrein
gálgi	1galge,dømdur til gálgandømt til hængning2(skib.)udstyr som noget hænger i(især trawlskovle)
gáloysi	skødesløshed, tankeløshed, vanvare
gáloysin	skødesløs, uagtsom
gáloysingur	skødesløs, uagtsom person,hann var eingin gáloysingurhan var ikke nogen skødesløs person
gáloysiskroppur	(neds.)skødesløs person
gáloysisliga	skødesløst, tankeløst
gáloysisligur	ganske skødesløs,medferðin var gáloysisligværemåden var skødesløs
gáloysni	skødesløshed, tankeløshed, vanvare,tað var gáloysni av tykkum at tveita lykilin burturdet var skødesløst af jer at smide nøglen væk
gálv	grimasse,hann tók um gálvið á honumhan tog om hans mund- og næseparti
gálva	1skære ansigt, lave grimasser, grimassere, vrisse, vrænge,hon gálvaði móti ljósinumhun missede med øjnene mod lyset;sita og gálva umborðsidde og kede sig ombord2række tunge(af hånel.væmmelse),gálva eftir e-mrække tunge ad nogen3være vindskæv, være skæv,hurðin gálvardøren er vindskæv
gán	glanende person
gána	1strække halsen;gána upp í loft2stirre opad, måbe, glo, gabe,statt ikki har og gánastå ikke der og glo;hvørjum gánar tú eftir?hvad står du og glor på?
gás	(ornitol.)gås(Anser),ein gáset par gæs(han og hun),(talem.)sum at sletta vatn á gássom at slå vand på en gås;sum at stjala gás(om noget, som ikke kan skjules)
gásabøli	gåsefamilie(par med unger)
gásadalsmaður	person iel.fra bygden Gásadalur
Gásadalur	(stedn.)bygd på øen Vágar,í / úr Gásadali,til Gásadals
gásadrongur	gåsedreng
gásaflokkur	flok gæs
gásafúti	en der jager gæs
gásagarður	gærde til at holde gæssene væk fra indmarken
gásahald	det at holde gæs
gásahold	gåsehud
gásakorn	(hjemmeavlet) korn af dårlig kvalitet
gásamatur	mad til gæs
gásamura	1(bot.)gåsepotentil(Potentilla anserina)2(spøg.)brudepar uden brudefølge
gásapar	et par gæs(gås og gase)
gásaravroð	gåsekråser
gásarbarki	luftrør af gås,tey gomlu vórðu ill, um tú blásti í gásarbarka, tí so kom regnde gamle blev vrede, hvis du blæste i gåseluftrør, for det bragte regn
gásarblóð	gåseblod,pannukøka av gásarblóðipandekage af gåseblod
gásarbyrsa	bøsse af fuglefjer(legetøj)
gásarbøga	gås(af hunkøn)
gásaregg	gåseæg
gásarepli	små kartofler, ærter(for små til at blive spist)
gásareyga	anførselstegn, gåseøjne, citationstegn,seta í gásareygusætte i anførselstegn;í gásareygumi anførselstegn;fremmandaorð verða ofta sett í gásareygufremmedord markeres ofte med citationstegn
gásarfjøður	gåsefjer
gásarfótur	1gåsefod2(spøg.)person som går indad på fødderne3(bot.)gåsefod(Chenopodium),hvítur gásarfóturhvidmelet gåsefod(C. album)
gásarfrælsi	ret til at holde et gåsepar (med unger) i udmarken
gásarfuglur	(en enkelt) gås
gásarhold	gåsehud,fáa gásarholdfå gåsehud
gásarhús	gåsehus
gásarístur	gåsefedt
gásarkjøt	kød af gås,fyrsta jóladag var gásarkjøt á borðinumjuledag var gås på bordet
gásarknokkur	tosse, dumrian
gásarkrov	gåsekrop,hendurnar vóru sum gásarkrovhænderne var meget store
gásarleggur	underben af gås
gásarlitur	broget, småprikket farve
gásarnev	næb på gås
gásarreiður	gåserede,sum eitt gásarreiður(om en lille samling hø)
gásarskrokkur	gåseskrog
gásarsmoltur	gåsefedt
gásarsteggi	gase,hásur sum ein gásarsteggihæs som en ravn
gásarsteggjareðr	gases avlelem
gásarsteik	gåsesteg
gásarungi	1gæsling2(overf.)gásarungarbørns tæer
gásarvongur	gåsevinge;isæri ordforb.sum ein gásarvongur(om en spinkel person)
gásaskipan	regler for at holde gæs
gásatættur	(om gærdet omkring den dyrkede indmark)så tæt at gæs ikke kan komme igennem,garðarnir skulu vera gásatættir
gáta	gåde, mysterium,bera upp gátu(r)give en en gåde (at gætte);gita gáturløse (gætte) gåder;nú er gitin gátanu er problemet løst;tað er ein gáta, hvussu tað kundi bera tildet er et mysterium, hvordan det kunne ske
gátt	1(husbyg.)dørtærskel, dørtrin,eg skal ikki gera teimum gáttina skitnael.dálka teimum gáttinajeg skal ikke aflægge dem besøg igen;hann hevur (eigur) nógvar gáttir at goymahan har så mange bekendteel.så stor familie at besøge;koma á gátt hjá e-mkomme ind i ens hus;reka á gáttjage på døren;á ytstu gáttyderst i (ved) døren;standa á gáttinistå i døren;(ordsp.)betri er ill hurð fyri gátt enn einginen ringe dør er bedre end slet ingen dør;koma inn fyriel.um gáttinakomme lige inden for døren;standa fyri gáttinistå lige uden for døren,genturnar vóru ikki innan gáttarpigerne var aldrig hjemme;fara út um gáttinagå uden for døren;ikki (út) um eina gáttikke uden for døren2(i vandmølle)tværtræ som den nederste ende af mølleakselen er fastgjort til ved en jernpind3(geol.)tærskel
gáttarfjørður	tærskelfjord
gáttartrom	i ordforb. somikki inn umel.út um gáttartromikke ind (i huset)el.uden for en dør
gátuføri	gådefuldhed, mystik
gátuførur	gådefuld, mystisk,tað er gátuførtdet er en gåde;hann doyði undir gátuførum umstøðumhan døde under mystiske omstændigheder
gáva	1gave, foræring,fáa gávufå en gave;geva gávugive en gave;í gávui gave;fáa til gávisfå som gave2gávurevne, gave, talent;hava góðar / ringar gávurhave gode / dårlige evner;skaldagávurdigtertalent3(kortspil)hava gávunaskulle give kort;tú eigur gávunadet er din tur at give kort
gávaður	begavet,hesin gávaði og søgukøni blaðmaðurdenne begavede og historiekyndige journalist
gávi	segeva
gávis	i ordforb.til gávissom gave,segáva
gávubók	gavebog
gávubræv	gavebrev
gávufiskur	den bedste hval der tilfalder den der opdagede grindeflokken
gávufúsur	gavmild,náttúran var blíð og gávufúsnaturen var venlig og gavmild
gávugóðs	noget man forærer væk,snapsurin er ikki gávugóðssnaps er ikke noget man forærer væk
gávugrunnur	1gavefond2fond oprettet af en pengegave(fx gennem et arvebrev)
gávukort	gavekort
gávulítil	svagtbegavet, ubegavet
gávumenni	talentfuldel.begavet person
gávumikil	gavmild
gávumildi	gavmildhed
gávumildur	gavmild, rundhåndet, generøs, large,ikki gávumildurikke gavmild, nærig, påholdende
gávupakki	gavepakke
gávuríkur	1begavet, talentfuld,av gávuríkastu skaldumblandt de mest talentfulde digtere2ydedygtig, givtig,havið tað gávuríkadet givtige hav
gávuseyður	får som gives som gave(især (det bedste får) til et bryllup)
ge	navn på bogstavetg
gedda	(fisk.)gedde(Esox lucius)
geggja	hurtig og energisk kvinde
gegl1	mund, kæft,koyra í gegliðguffe i sig
gegl2	(talesp.)fængsel,hann er settur í gegliðhan er fængslet
gegna	nytte, være til gavn,hvat skal slíkum gegna ?hvad skal det være godt for?;(kvad)tað man góðum gegnakomme til stort gavn;gegnastbekomme vel;væl gegnaðurvel behandlet
gegni	(jur.)habilitet
gegnigur	1brugelig, egnet,gegnig amboð;gegnigur maður;teir steinar, ið gegnigir vóru, vórðu settir saman til grúgvu2(jur.)habil
gegniligur	brugelig, egnet,gegniligt tilfaregnet materiale(fx om træ)
gegnisligur	brugelig, egnet
gegnistræ	stykke træ egnet til forarbejdning
gegnturrur	gennemtør
geil	1vej ad hvilken kvæg drives ud i udmarken2geilargade,i ordforb. somtað hoyrist út á geilarel.út um allar geilardet høres ud på gadenel.ud over alt;koma inn av geilum skitin og tvitinkomme ind fra gaden snavset fra top til tå;opið út á geilaråbent ud til gaden;úti á geilumude3afgrænset område(fx mellem to lande),zone,uttanveltaða geilin millum londiniden neutrale zone mellem landene4(på havet)snævert stræde5anderledes farvet stribe,eftir búkinum gongur ein hvít geillangs maven går en anderledes hvid stribe6(idr.)(i svømmebassin, på løbebane)bane,svimja á fyrstu, aðru, triðju geilsvømme på første, anden, tredje bane
geilarhorn	gadehjørne
geilastrok	person der går for meget ude, rendemaske
geilatík	1geilatíkar(på kvæg)parti fra næsebenet til øjnene2overkæbeparti af kvæg-el.fårehoved(parteret til spisning),geilatík til døgurða3en der sladrerel.råber op om alt og intet,sita og mýkja geilatíkinasnakke, bruge mund;brúka geilatíkinabruge mund;nú heldur tú geilatíkina saman á tærnu holder du mund;gongur sum ein geilatíkløber med sladder4(neds.)tøjte, mær,hatta er tann geilatíkin, ið erden mær!
geingi	føre,gott / ringt geingigodt / dårligt føre
geip	skryden, pral, praleri
geipa	prale, skryde,geipa av e-mprale af noget
geipari	pralhals, blærerøv
geiputur	pralende
geiraskrift	(hist.)kileskrift
geirfuglur	(ornitol.)gejrfugl
geiri	1kile(til indsætning i tøj),kileformetel.aflangt lille stykke skindel.tøj2strimmel jord3kileformetel.aflangt stykke træ4(ny bet.)sektor,almenni geirinden offentlige sektor
geisa	flamme højt,eldurin geisaði á grúgvuniilden flammede højt fra ildstedet
geisla	1(fx om solen)stråle,vágurin stendur og geislastvigen er spejlblank2(fys.)(om radioaktive stoffer)stråle
geislabogi	(biol.)hvirvelbue
geislafara	(med.)bestråle
geislafrøðingur	radiograf
geislaknúta	(biol.)den tykke del af ryghvirvlen, hvirvellegeme
geislamegnaður	(fys.)radioaktiv,geislamegnað evniradioaktive stoffer
geislamua	(barn.)ryghvirvel af grindehval som legetøj
geislan	(fys.)stråling
geislaprentari	(datal.)laserprinter
geislasoppur	(med.)sygdomel.en slags sygdomsfremkaldende svamp(Actinomyces)
geislaviðgerð	(med.)strålebehandling
geislavirkin	(fys.)(om stoffer)radioaktiv,geislavirkin evniradioaktive stoffer
geislavirkni	(fys.)radioaktivitet
geisli	1(biol.)ryghvirvel2stråle,sólin sendir geislarsolen sender stråler3(fys.)stråle,røntgengeislarrøntgenstråler
geisling	1stråling, udstråling2(fys.)stråling,vandamiklar geislingar(sundheds)skadelige strålinger
geislingarførur	(fys.)radioaktiv
geisp	gaben, gab
geispa	gabe(af søvnighed, kedsomhed el.lign.)
geispan	gaben, gab
geispi	gaben, gab
geit1	(zoo.)ged(Capra hircus),geitir og geitarbukkargeder og gedebukke;(ordsp.)mong er geitin aðrari líkder er flere brogede køer end præstens
geit2	1blågrå striber i tømmer, vanddrukkent træ2geitir1skurv(sygdom i hårbunden)2sår i hovedbunden fremkaldt af lus
geitafylgi	gedehjord
geitahirði	gedehyrde
geitarblað	(bot.)navn på forskellige planter af slægtenCaprifoliaceae)
geitarbukkur	(zoo.)gedebuk, buk
geitarkál	(bot.)slægt i skærmblomstfamilien(Aegopodium),tásárs geitarkálskvalderkål(A. podagraria)
geitarlamb	gedekid
geitarmjólk	gedemælk
geitarostur	gedeost
geitarskinn	gedeskind
geitasveinur	(kvad)gedehyrde
geithavur	gedebuk, buk
geitir	sår i hovedbunden fremkaldt af lus,segeit 2 (2)
geitreki	(skældsord om)støjende person
geitureki	1gedehyrde2(neds.)støjende person,snjallur sum ein geitureki(om en skingrende person)
geituskøltur	støjende person,njella sum ein geituskøltur
geituviður	vanddrukkent træ
gekk	seganga
gekkagríma	maske(for ansigtet)
gekkaskortur	maske(for ansigtet)
gekkur	1nar, tåbe, dumrian2klovn, spilopmager3(på bue)hakel.indsnit at spænde buen i,spenna bogan á hægsta gekk;(overf.)liggja í hálvum gekki(sagt om et halvfærdigt arbejde),liggja á gekkivære ved at falde4lyde, fejl, skavank,sært tú ongan gekk á hasum?ser du ikke nogen fejl der?;seta gekk á (e-t)kritisere (noget);hatta er ein gekkurdet arbejde er dårligt udført
gel	gelé
gelda	1kastrere,gelda til hornakastrere (vædderlam) sådan at det mister fertiliteten men ikke lysten;(overf.)gelda húkflette fiskesnøret om hagen på fiskekrogen2gelda greytkomme salt i grød3skære et stykke af struben og fjerne gællerne og hjertet på sild der skal saltes4geldast(om ko)blive gold, ikke give mælk
geldabásur	i ordforb.(kúgvin) stendur á geldabási(koen) er gold, (koen) malker ikke
geldblóma	(bot.)gold blomst
geldfuglur	(ornitol.,koll.)fugle der ikke yngler
geldgás	et år gammel gås
geldgimbur	gimmerlam der ikke får lam det første år
geldgjólingur	gimmerlam som ikke har læmmet
geldimuddur	nedslidt kniv
gelding	kastrering
geldingslamb	vædderlam kastreret som lille lam
geldingsær	hunfår uden lam
geldingur	1kastreret vædder, kastreret vædderlam2eunuk, kastrat
geldkokkur	(om mennesker og dyr)levende væsen (af begge køn) som ikke har afkom
geldkúgv	1gold ko2ko der ikke kælver et år men dog giver mælk
geldneyt	1gold ko2kvie der ikke kan blive drægtig
geldseyðakjøt	kød fra bede
geldseyðaroð	ruskind fra bede
geldseyður	bede
geldskrápur	skråpe der ikke har unger
geldskúgvur	storkjove uden unger
geldsteggi	1gase som ingen gås har2(spøg.)pebersvend
geldur1	1(om ko / hunfår)gold2(om ko)som ikke malker,kúgvin er geldkoen malker ikke3afgelda,geldur seyðurbede
geldur2	segalda,gjalda
geldær	hunfår uden lam
geldærarkrov	fårekrop af hunfår uden lam
geldærarlamb	lam fra hunfår som har været goldt året før
gella1	1viltert pigebarn2(neds.)upålidelig kvinde,hatta er ein gella
gella2	gjalde, klinge, knalde, genlyde,tað gelti eftirídet gav en syngende el. klingende genlyd;gellandi frostklingende frost
gellan	klingende lyd
gellifrost	klingende frost
gelligler	meget hårdt islag
gellutur	stilløs, ufiks(i påklædning)
gelur	segala
gelvingur	gimmerlam, hunlam
gemeinur	almindelig, venlig, usnobbet
gemlingur	gimmerlam, hunlam
gemsa	(zoo.)gemse(Rupicapra rupicapra)
gena	stirre, måbe, glo, gabe,standa og genastå og måbe
generálur	(militær)general
genevur	genever
genta	1pige, pigebarn2ung ugift kvinde,genta hansarahans kæreste;gomul gentaugift kvinde3husassistent, pige
gentubarn	pige, pigebarn
gentubátur	(idr.)kaproningsbåd med piger
gentubók	(litt.)ungpigebog
gentukór	(musik)pigekor
gentuligur	ungpigeagtig(fx i udseende og adfærd);-liga
gentunavn	1pigenavn, kvindenavn,vakurt gentunavnsmukt pigenavn2kvindes slægtsnavn(inden evt. skift ved giftermål)
gentuóviti	pigebarn
genturippa	dreng der er forgabt i piger
genturóður	(idr.)kaproning mellem piger
gentuskóti	pigespejder
gentuskúli	(skole)pigeskole
gentusnøkil	skørtejæger
gentuspæl	pigeleg
Georgia	Georgien
georgiari	georgier
georgiskur	georgisk
gepardur	gepard(Acinonyx jubatus)
ger	(biol.)gær
gera1	1lave, fremstille, frembringe, producere, foretage,hvat gert tú í løtuni?hvad laver du for tiden?;eg havi einki at gerajeg har ikke noget at lave;gera brúdleyp(forberede og) holde bryllup;gera bønbede(til Gud);gera døgurðalave middag;gera eið (upp á)sværge;gera enda á (e-mel.sær)gøre ende på (nogenel.sig selv);gera fastfæstne(fx bånd, line);gera ferðrejse;gera forboðnedlægge forbud, forbyde;gera grein (á e-m)gøre rede for (noget);gera lop á seggøre et spring, springe,gera lítgøre arbejde fuldt ud;gera matlave mad;gera mótstøðugøre modstand;gera mungøre forskel;gera óljóðgøre støj, larme;gera ónáðirforstyrre;gera sær renningarloptage tilløb (til spring);gera eina syndbegå en synd;gera uppskotudarbejde (og fremsætte) forslag;gera veganlægge en vej;gera hansara viljagøre efter hans vilje;tú gert, sum tú viltdu bestemmer selv2volde, frembringe,alt gjørdi túdet var din skyld det hele;gera iltvolde skade;tað ger ilt verridet gør ondt værre;sama gerel.tað ger tað samadet gør det samme, det er lige meget;gera e-n glaðan, illan o.s.fr.gøre en glad, vred etc.3udgøre, give (i udbytte),gávurnar skuldu gera útreiðslurnargaverne skulle dække udgifterne4(om vind og strøm)tage til i styrke,nú ger norður við landistrømmen begynder at løbe nordpå inde ved landet;hann gjørdi óveður (vind, kavarok)det blev uvejr (vind, snestorm)5(brugt i stedet for andet verbum)situr tú væl? Ja, tað geri egsidder du godt? Ja, det gør jeg;tað skuldi tú gjørtdet burde du gøre6lade som om,hon ger, sum hon ikki hoyrirhun lader som om hun ikke hører7tað var alt at gera, at teir ikki gingu burturde var lige ved at forlise (med mand og mus)  / /gera afturreparere, istandsætte;gera afturatbygge til, udvide;gera afturundirdanne modstrøm;nú fer at gera afturundir;gera atså småt begynde på et arbejde,eg geri at tí, tá ið ein løta er;gera av1beslutte, bestemme,teir gjørdu av at fara avstaðde besluttede at tage af sted;tað skal eg gera avdet er jeg sikker på2overdrive, prale,nú gert tú avnu overdriver du, nu tager du munden for fuld;hann gjørdi nógv avhan overdrevel.pralede meget3gera nógv / lítið avgøre meget / lidt ud af;tey gjørdu fittligt av brúdleypinumde gjorde meget ud af brylluppet;gera lítið av e-mvære tilbageholdendeel.mådeholden med noget;hann gjørdi nógv av brennivínihan drak ofte spiritus4gøre det af med (en), dræbe,gera av við (e-n)5aftale,gera (e-t) av við e-n (um e-t)aftale noget med en6gera langt avvære langtrukken, være omstændelig;gera skjótt avblive hurtig færdig;gera stutt av1fatte sig i korthed2være hurtig i vendingen;gera ábinde tov iel.omkring,gera á (seg, e-n, e-t);gera burtur av sær1gera e-t burtur av særse at få noget fra hånden;vit mugu gera hetta burtur av okkum, áðrenn vit faravi må få dette fra hånden, inden vi går2forrette sin nødtørft;gera burturúr1forberede godt og grundigt,tey gjørdu nógv burturúr til jóla2få en god historie ud af noget,hann dugdi so væl at gera burturúrhan var god til at fortælle historier3udnytte, få gavn af,hon dugdi so væl at gera burturúr;gera eftir1gera eftir (e-m)forarbejde (efter model)2gera e-m e-t eftirhandle efter ens eksempel, ens befaling etc.;eingin ger honum bragdið eftiringen er i stand til at udføre den samme bedrift som han3trylle(noget forsvundetel.stjålet tilbage),hann kundi at gera eftir4gera eftir seg(om døde)gå igen;gera fráfå det daglige (hus)arbejde fra hånden,gera e-t frá særlave noget færdigt;gera ígøre til, bearbejde,gera ull í troyggjur;gera niður:gera segl niðursænke sejlene;gera niðurfyrigøre i forvejen(før det behøves);gera saman:gera saman (hoyggj)få høet sat i stakke;gera tiltilberede, forberede,skjótt var hann tilgjørdurhan var hurtigt (rejse)klar;gera til brúdleypsforberede bryllup;gera tað til einkishæve forlovelse, gøre det forbi;gera umændre;gera lítið (einki) um segvære beskeden og stille;gera nógv um seggøre sig bemærket(ved sine bedrifterel.ved støjende og larmende opførsel);gera upp1(om tov o.lign.)lægge i ringe,gera ein enda upplægge en stump garn i ringe;gera upp (fiski)snørihaspe en fiskesnøre op;gera upp songrede seng2gera upp (til brund)udtage til springvædder;gera úr:hava úr at gerahave nok at tage fat på;gera út1gera skip útudrede skib(e)2forslå, gøre fyldest,hoyggið gjørdi nógv úthøet varede længere end forventet;gera út av særarbejde voldsomt(uden noget resultat);gera út á:gera út á súpanel.sósjævne en suppeel.sovs;gera viðbehandle,tað er ilt at gera viðdet er en vanskelig sag;hava við at gerahave med at gøre;hann er ringur at hava við at gerahan er vanskelig at have med at gøre;tað er einki við at geradet kan der ikke være delte meninger om;gera væl / illa við e-ngøre en noget godt / ondt;eg kundi ikki gera við taðjeg kunne ikke gøre for det  / /gera seg inn á:gera seg inn á e-nel.e-tantaste, forulempe, trænge ind på;gera seg til1forberede, gøre sig klar,vit gjørdu okkum til at fara at ferðast2gera seg til fyri e-mgøre sig bemærket, blæse sig op (for nogen),hon stendur og ger seg til fyri honum;gera seg uppblæse sig op, gøre sig bemærket;gera seg út1gera seg útudruste sig;gera seg út til langferð2gera seg illa út við e-nlægge sig ud med en;gera sær1lade som om,hann gjørdi sær at vera sjúkurhan lod som om han var syg2gera sær fyri skommumdumme sig;gerast1gøres, blive til, ske, lykkes,einki gerstdet er umuligt at gøre noget;hvat gerst?hvad laver du?;hvat gjørdist á sjónum í gjár?hvordan gik fiskeriet i går?2blive,hon gjørdist frísk, gomul, óðo.lign.hun blev rask, gammel, vred etc.;gerast atindtræffe, ske,hann hevði ein knív við sær, um nakað gjørdist athan havde en kniv i tilfælde af, at noget skulle ske;gerast á:tá ið e-t gerst ánår der er fare på færde;gerast úrkomme ud af (noget),einki prát gjørdist úr;gerast við:tað gerst ikki viðdet er der ikke noget at gøre ved;gerandisom kan gøres,tað er ikki gerandidet kan ikke gøres;gjørdur:illa gjørdursjusket
gera2	(kem.)gære, fermentere
gerandi	i ordforb.gerandi og heilagtbåde hverdage og helligdage
gerandidagur	hverdag, dagligdag
gerandisbrúk	til gerandisbrúktil dagligbrug(fx tøj)
gerandisdagur	hverdag, dagligdag
gerandiskendur	hverdagsagtig,tað er nakað gerandiskent við myndinider er noget hverdagsagtigt over billedet
gerandisklæddur	i hverdagstøj
gerandisklæði(r)	hverdagstøj
gerandiskostur	hverdagskost,tað er ikki gerandiskosturdet er ikke hverdagskost, det sker sjældent
gerandiskvøld	hverdagsaften
gerandisligur	hverdagsagtig;-liga
gerandislív	hverdagsliv
gerandisplagg	klædningsstykke til hverdagsbrug
gerandissjagg	daglig trummerum
gerandisskógvar	hverdagssko
gerandisstarv	hverdagsarbejde
gerandisvøra	dagligvare
gerbreyð	gærbrød
gerð	1gerning, handling,húsini standa í gerðhuset er under opførelse;hava í gerðarbejde på, have under arbejde;í gerðunder udførelse, i praksis2strøm, strømdrift,suðurgerðstrøm når den har sydlig retning
gerða	indgærde, indhegne
gerðabók	protokol
gerðabýti	i ordforb.gera gerðabýtigøre gensidig tjeneste(i stedet for løn),vit gera gerðabýti, eg arbeiði hjá tær í dag og tú hjá mær í morgin
gerðardómari	(jur.)voldgiftsdommer
gerðardómur	(jur.)voldgiftskendelse
gerðarleysur	1arbejdsløs2uvirksom, inaktiv, initiativløs
gerðarlítil	uvirksom, inaktiv, initiativløs
gerðarljóst	så lyst at man kan se at arbejde
gerðarloysi	uvirksomhed
gerðarnavn	(lingv.)nomen agentis
gerðarrættur	(jur.)voldgiftsret
gerðavald	(jur.)udøvende magt
gerði	indhegnet (og opdyrket) stykke jord(tidligere som regel føjet til den gamle indmark)
gerðisgarður	gærde (el.hegn) omkring et indhegnet stykke jord
gerðisjørð	jord tilel.i et indhegnet stykke jord
gerðismaður	mand som ejer et stykke (indhegnet) jord og delvis lever af det
gerðisstykki	(lille) indhegnet (og opdyrket) stykke jord
gerðsøgn	(lingv.)aktiv
gerikt	(håndv.)gerigt
geril	(datal.)processor
gering	(kem.)(om dej, øl o.lign.),gæring, fermentation
germani	germaner
germanskur	1germansk2germanskt málgermansk sprog
gerning	gerning
gerningsmaður	gerningsmand
gerningur	gerning
gerpulvur	bagepulver
gersoppur	(kem.)gærsvamp
gervi	(tekn.)gear,skifta gerviskifte gear
gerviskassi	(tekn.)gearkasse
gervisstong	(tekn.)gearstang
gessigur	1fyrig, ivrig,gessigur eftir e-mivrig efter noget2(om handyr)gejlhed3(om personer)begærlig
gessin	1fyrig, ivrig2(om handyr)gejl3(om personer)begærlig
gessur	1fyrighed, ophidselse, spænding,hvaðan hevur tú fingið handan gessin?hvorfra har du fået denne energi?2(om handyr)gejlhed3begær,tað er gessur komin í veðragjólinginvædderlammet er i brunst
gestablídni	gæstfrihed
gestablíðskapur	gæstfrihed
gestablíður	gæstfri
gestaboð	gæstebud, fest
gestabók	gæstebog
gestakamar	gæsteværelse
gestaleysur	(kvad)fri for gæster,her verður ikki gestaleystder kommer mange gæster
gestalærari	(skole)gæstelærer
gestamatur	god mad til gæster
gestarúm	gæsteværelse,trý gestarúm eru í húsinumder er tre gæsteværelser i huset
gestarøðari	gæstetaler,gestarøðari er navnframur rithøvundurgæstetaleren er en berømt forfatter
gestasong	gæsteseng
gestastova	gæstestue
gestfiskur	(fisk.)snyltefisk(Echiodon drummondi)
gestlærari	(skole)gæstelærer
gestur	1gæst,tú ert rárur gesturdu er en sjælden gæst2(noaord)strandskade3(bot.)blomsten af planten sværdlilje
geva	1give, skænke, tildele,geva e-m e-tgive en noget;geva gávurgive gaver;(talem.)ikki geva hundi beinvære nærig;Gud gæviel.gávi (satt)!Gud give!,gævi, tað var so vælgid det var så vel2give kreaturer (fødeel.vand),geva neytum3(kortspil)give kort,hvør gav?hvem gav?4(om moderfår)give mælk,ærin hevur lítið at gevamoderfåret har kun lidt mælk at give5i ordforb.tað gevur at bítadet har man et godt eksempel på;geva e-m ansvære opmærksom på noget;geva (e-m) banadræbe;geva e-m banasárgive en banesår;geva bróstamme, give die;geva e-m durafjórðinginvise en døren;geva e-m eftirlætiføje en;geva sær far umgive agt på, lægge mærke til;geva (e-m) fótin (í reyvina)1give (en) et spark bagi2(overf.)afskedige på gråt papir;geva e-m friðlade en i fred;gev ikki dreymum geymbryd dig ikke om drømme(ne);geva e-m griðgive en fred (nåde);geva e-m gæturgive agt på, lægge mærke til;geva e-m heilsubóthelbrede en;geva e-m høggtilføje en hug (af sværd el.lign.);geva e-m tvey (ójøvn) korsætte en to (ulige) vilkår;geva fangar leysarfrigive, løslade fanger;geva e-m lív1give liv til2lade en beholde sit liv,geva ljóðvære stille (og opmærksom);geva e-m málel.geva mál fyri e-mgive udtryk for noget;geva e-m navngive navn;geva sær stundir (til e-t)tage sig tid (til noget);geva greitt svargive ren besked;geva tolhave tålmodighed;geva av tonnumskælde ud;geva e-m ein undir vangangive en en lussing  / /geva afturgive et moderfår et andet lam i stedet for et dødt;geva av særgive udbytte,handa vinnan gevur einki av sær;geva á1anstrenge sig, presse på,frálíkur skal hann vera at geva áhan er flink til sit arbejde2á e-nprygle en, give en bank3regne,bara hann ikki fer at geva á;geva burturbortskænke,hann gav alt burtur, sum hann átti;geva eftir1give efter, eftergive,alla skuldina gav eg tær eftir2være eftergivende, være føjelig,hann var hóvligur maður og vanur at geva eftir;geva frá særopgive, overlade til andre,hann grøddi ein mann, sum læknin hevði givið frá særhan helbredte en mand, som var opgivet af lægen;hann gav festið frá særhan overlod gården til en anden;geva fyribetale for,hvat gavst tú fyri bilin?hvad betalte du for bilen?;geva inn(om bølge ved strandbredden)skylle op,mods.geva út;geva niður:ikki geva niður(om ko)ikke ville give mælken fra sig;geva samangifte;geva upp1opgive2opgive, meddele,øll inntøka skal gevast upp til skattamyndugleikarnar3(om søens bevægelse ved stranden)hæve sig, stige,tá ið sjógvurin gav upp4geva e-n uppangive en (for øvrigheden)5(kvad)geva upp sín andaudånde, dø6(idr.)begynde boldspil,teir stóðu til reiðar at geva bóltin upp;geva uppatholde op,teir góvu uppat við tíde holdt op med det;gev uppat við hasum!hold op med det!;geva uppí:geva e-m uppígive en et stop(fx i piben);geva út1udgive(fx bog, CD)2udstede3give mere tov,hann gav út av snørinum;(overf.)tað (el.har) er einki út at gevader er intet at give af4(om bølge ved strandbredden)skylle ned igen,tá ið út aftur gevur;mods.geva inn5sidestille,bygdin var útgivin ímóti nærum øllum Føroyalandi til fugl í teirri tíðini;geva yvirgevast, kasta frá sær,geva skarvin yviropgive det hele;tey geva so yvir at leita  / /geva seggive sig, give efter,samráðingarmenninir vóru treiskir og vildu ikki geva seg;geva seg illavære misfornøjet, klynke;geva seg vælvære fornøjet, slå sig til tåls;geva seg burtur1rejse væk, begive sig,geva seg burtur úr landinumrejse ud af landet2(om kvinde)indgå ægteskab;geva seg frágå til siden,teir góvu seg hvør frá øðrum;geva seg frá embætio.lign.gå af;geva seg inn á:geva seg inn á e-ngøre en fortræd;geva seg í:geva seg í Harrans hondbede Herren velsigne sig;geva seg í holt við,seholt;geva seg í kleysturgå i kloster;geva seg í part við e-ntilslutte sig nogenel.noget;geva seg í tos viðgive sig i snak med;geva seg ímóti:geva seg ímóti e-mgå imod nogen(fx at slås);geva seg saman1slutte sig sammen2giftes;geva seg sundurløsnes, løsne sig, blive løs,skeljarnar geva seg sundur;geva seg til:geva seg til tols (við e-t)slå sig til tåls (med noget);geva seg undanvige forel.gå til siden;geva seg undir1slå sig til tåls (med noget),teir góvu seg undir dómin2begynde på noget, give sig i kast med noget,geva seg undir e-t;teir góvu seg undir ferðina;geva seg upp1overgive sig, kapitulere,í fyrstu døgum í mai 1945 noyddist Týskland at geva seg upp2skipið gav seg upp og niðurskibet vippede op og ned;geva seg uppítilslutte sig,hann fór hagar, bardagin stóð, og gav seg uppí hjá prinsinum;geva seg út:geva seg út fyri (at vera)lade som om;geva seg yvirovergive sig;gevast1findes, eksistere,tað gevst ikki2holde op (med noget), slutte,teir góvust at arbeiða fyri veður;gevst nú við hasum!;gevast á hendur, hendiel.hondumholde op, opgive;hann gavst ikki, fyrr enn hann hevði fingið fatur á ærini;gevast áanstrenge sig, presse på,hon gavst á at gráta og græt hvaðna harðari;vit góvust á, og vit díktu á við sama lag;givin1afkræftet, træt og udaset, dødtræt, udmattet2slem, frygtelig, forskrækkelig,innan fyri skivuna var hann givin til at arga
gevari	giver
geviligur	(om jord)givtig,moldin verður geviligari
geykur	(ornitol.)gøg(Cuculus canorus)
geyl	skrig, skrål, brøl,róp og geylråb og skrig
geyla	skrige, skråle, brøle
geylan	skrigen, skrålen, brølen,har var sovorðin geylan, at ikki hoyrdist mannamálder var så meget skrig og skrål at man ikke kunne høre hvad folk sagde
geymi	1opmærksomhed,leggja (sær e-t) í geymalægge (sig noget) på sinde2(datal.)memory key, memory bird, USB disk
geymur	opmærksomhed,geva geymvise opmærksomhed
geypa	(zoo.)los(Felis lynx)
geyrhøvd	rod på tangstilk
geyri	tangstilk(med blade på)
geyrur	(bot.)tangstilk(med blade på)
geys	segjósa
geytari	stort søm
gidda	bæve, ryste, dirre, rokke,hann giddar altíð eitt sindur við høvdinumhan dirrer altid lidt med hovedet;tonnin giddaðitanden var løs,naglin giddar í holinumnaglen er ikke helt fast;knívsblaðið giddar í skaftinumknivsbladet er lidt løst i skaftet
gift	gift
gifta1	(kvad)lykke,Gud biði eg míni giftu stýrajeg beder Gud om at styre min lykke
gifta2	ægteskab,í seinnu giftui andet ægteskab
gifta3	gifte,gifta segel.giftastgifte sig, giftes;hann gifti seg við hennihan giftede sig med hende;giftast uppafturgifte sig igen
giftarmál	ægteskab
gifting	ægteskabs indgåelse, giftermål
giftingaraldur	giftealder
giftingarfúsur	giftelysten
giftingarførur	giftefærdig, gammel nokel.parat til at giftes
giftingarringur	giftering, vielsesring
giftur	gift, som lever i ægteskab
giggutur	(talesp.)(om personer og tøj)ufiks, umoderne
gigla	kigge efter noget(med sammenknebne øjne),gigla eftir e-m
gignast	gå godt / dårligt, lykkes,gignast væl / illa;illa gignaðist hjá honum í endanum
gignisligur	passende, egnet, brugbar,gignisligar árarbrugbare årer
gignisverk	gavnværk, gavnlig handling
gikt	gigt,hava / fáa gikthave / få gigt
giktarfelag	gigtforening
giktarflog	gigtanfald,fáa giktarflogfå et gigtanfald
giktarringur	ring (af jernel.stål) om håndleddet mod gigt
giktarrunnur	knude forårsaget af gigt,hann var ein stórur giktarrunnurhan var helt ødelagt af gigt
giktarveður	koldtel.råt vejr dårligt for gigtramte,í dag er giktarveður
giktfepur	(med.)gigtfeber(febris rheumatica)
giktpíndur	gigtramt
giktsjúka	(med.)gigtsygdom
giktsjúkur	gigtsvag
giktslitin	plaget af gigt
giktvølur	gigtknude
gil	bjergkløft, regnkløft
gilbakki	skrænt af en bjergkløft
gilbotnur	bunden af en bjergkløft
gilda	i ordforb.gilda seg uppbeløbe sig til;tað kemur at gilda seg nógv uppdet kommer til at koste meget
gildi	1gilde, selskab, fest,halda gildiholde fest2(jur.)(om love o.lign.)gyldighed, kraft,koma í gilditræde i kraft;fáa gilditræde i kraft;seta í gildisætte i kraft;standa í gildistå ved magt;fara úr gilditræde ud af kraft;seta úr gildisætte ud af kraft3værdi,kúgildien kos værdi(6 slagtefår)4í gildi sumpå størrelse med
gildigur1	(jur.)gyldig
gildigur2	(talesp.)meget stor, stor og kraftig,ein gildigur maðkuren meget stor orm
gildisdagur	festdag, højtidsdag,slíkir dagar vóru sannir gildisdagarsådanne dage var rigtige festdage
gildishald	fest
gildishús	hus hvor fest afholdes
gildiskoma	(jur.)ikrafttrædelse, ikrafttræden(fx om lovel.bekendtgørelse)
gildiskvøld	festaften
gildisleysur	1ligegyldig, skødesløs2(forsikr.)dækningsløs
gildismatur	festmad
gildisskáli	gildesal, festsal
gildisstova	gildestue, festlokale
gildistíð	tid da lovel.reglement er i kraft
gildugur	gyldig
gildur	1gyldig,meirilutin av gildum atkvøðumflertallet af gyldige stemmer2gæstfri, rundhåndet,gildur maðuren gæstfri mand3giltrigelig(t), i stor mængde;gilt av fiski (fugli, peningiosv.)rigelig(t) af fisk (fugle, penge osv.)
gilja	(kvad)1bejle, fri,kongsins dóttur at giljabejle til kongens datter2(forsøge at) lokke, forføre,gilja gentuforføre en pige
giljutur	(om terræn)ujævn,hagin er giljutur og heyggjuturudmarken er ujævn og bakket
gilla1	1lille torsk2stykke madding skåret af halsen på en fisk
gilla2	(vulg.)have samleje, bolle, kneppe, knalde,gilla einari
gillumurtur	(mar.)lille torsk
gilsbakki	skrænt af en bjergkløft
gilstrom	randen langs en bjergkløft
gilsur	(mar.)wire til at hive noget ombord på et fiskeskib med(fx en trawlpose)
gilt	rigtig meget, i stor mængde,fiska giltfiske rigtig meget
gima	1(om kød af vædderlam i brunsttiden)have stram lugt og afsmag2(om vædderlam)blive parringslysten
gimakjøt	kød (af vædder) med stram lugt og afsmag,gimakjøt er ikki berandi í munnkød med stram lugt og afsmag er ikke til at spise
gimalamb	vædderlam i brunst
gimaroykur	1stram lugt ved vædderlam i brunsttiden, brunstlugt2stram lugt ved kød af vædder
gimasmakkur	afsmag ved kød af vædder
gimbrarlamb	lam født af gimmerlam
gimbrarlambsmessa	8. september,á gimbrarlambsmessu tóku teir smáttden 8. september tog de de små får
gimbrarlambsneisti	lille lam født af gimmerlam
gimbrarseyður	årsgammel vædder(gildetel.ugildet)
gimbri	årsgammelt (hun)får, gimmerlam
gimbur	årsgammelt (hun)får, gimmerlam
gimburlamb	gimmerlam, hunlam
gimburlambskrov	gimmerlamskrop
gimburlambskøttur	lille gimmerlam
gimburlambsneisti	lille, svagt gimmerlam
gimi	brunstlugt,tað gongur gimi atkødet lugter stramt
gimmutur	(talesp.)ufiks, umoderne,ein gimmutur frakkien umoderne frakke
gimsteinur	juvel, ædelsten
gimtevur	brunstlugt,tað gongur gimtevur at honumden oser af brunst
gin	skræv, skridt
gina	skræve, gå skrævende, gå med lange skridt,hon kom ginandi omaneftirhun kom gående med lange skridt ned ad vejen
gingin	seganga
ginn	gin
ginna	(bibl.)lokke, forføre
ginsamur	foretagsom, energisk,hon var so røsk og ginsomhun var så arbejdsom og energisk
ginsemi	foretagsomhed, energi
gintur	livlig, ivrig, fyrig,hann var so gintur at sleppa viðhan kunne godt tænke sig at komme med
gippa	sparke udel.op i luften
gips	gips,hann gongur við gipsihan går med gips
gipsa	lægge i gips, gipse
gir	(tekn.)gear(på bil, cykel, maskine osv.),skifta girskifte gear
giraffur	(zoo.)giraf(Giraffa camelopardalis)
girari	(talesp.)let rus,hann mundi hava ein girarahan havde vist en lille fjer på
girða	indgærde, indhegne,girða e-t inniindhegne noget
girði	hegn, indhegning
girðing	hegn, indhegning,seta girðing um stykkið
girðlast	girðlast við e-t1gøre sig klar til at gå i gang med noget, smøle,hann gekk og girðlaðisthan gik og smølede2laveel.udføre noget uden omhu
girkassi	(tekn.)gearkasse(spec. i bil)
girnast	gerne ville få, attrå, eftertragte, begære,tú mást ikki girnast konu næsta tínsdu må ikke begære din næstes kone
girnd	(erotisk) begær, lyst, drift
girndarfullur	stærkt erotisk anlagt
girndarhugur	(erotisk) begær, lyst, drift,fáa girndarhugbegære
girndarmikil	stærkt erotisk anlagt
girndaróður	meget stærkt erotisk anlagt
giro	giro,flyta pengar á giroflytte penge på giro
girokonto	girokonto
girokort	girokort
girstong	(tekn.)gearstang
gisa	give sig, knage(fx om huse i storm),húsið gisar illa í óveðrihuset giver sig meget i stormvejr;tað gisar í húsunumdet knager i huset
gisin	1utæt(pga. tørhed),gået ud af fugerne,gisin dyllautæt mælkebøtte2(om får)tynd, mager(fx vædderlam når de begynder at vise tegn på parringslyst)
gisna	blive utæt pga. tørhed(om fx ting lavet af træ),hurðin er gisnaðdøren er blevet utæt
gissa	(talesp.)gætte,ein, ið altíð gissar, sigur onkuntíð til vissarden, der altid gætter, taler sommetider sandt
gissil	i ordforb.seta ein til gissil(s),hava ein sitandi sum gissillade en vente (på sig);standa / sita sum ein gissilstå / sidde som en tåbe;seta seg sum gissil (el.til gissils) inni hjá fólkiblive siddende, slå sig ned hjemme hos folk;hatta er ein verri gissilhan er en værre bandit
gista	1overnatte, være gæst(mindst én nat),gista hjá e-movernatte hos nogen2gæste, besøge,gista e-nbesøge nogen;hann hevur eina ferð gist Føroyarhan har engang besøgt Færøerne;(ordsp.)eingin veit á morgni at siga, hvar hann á kvøldi gistiringen kender sin egen skæbne
gistihús	hotel, pensionat
gisting	nattelogi, overnatning
gistingarhús	hotel, pensionat
gita1	1gætte,gita gáturløse (gætte) gåder;gita rættgætte rigtig;(talem.)nú er gitin gátanu er problemet løst2antage, formode, mene(efter al sandsynlighed),eg giti mær taðjeg formoder det;nú gitti eg ráðininu fandt jeg på råd;(talem.)hann, ið ilt gitir, hann ilt gerden, der ondt gætter, ondt gør
gita2	1avle, få barn,(kvad)hann gat svein við jalsdóttur;tey gótu svein2verða gitinblive undfanget;gitin av heilagum anda3kunne, være i stand til,(kvad)gitur ikki gingiðkan ikke gå;hann gat ikki lurtað eftir hesum tvætlinumhan gad ikke lytte til det nonsens4omtale,eg havi hoyrt tað (kvadogsåtess) gitiðjeg har hørt det omtalt;eg havi hoyrt hann gitnanjeg har hørt ham omtalt;gita á máliomtale, berømme;meira skal ikki gitast um hettamere skal der ikke siges om dette;gitinomtalt, berømt;illa gitinberygtet;víða gitinkendt vidt omkring
gitan	gætning, gisning
giti	1rygte, ry2fangst, bytte,i ordforb. somtit hava gjørt gitiI har gjort fangst3i ordforb.til gitistil gavn, til nytte;hann gjørdi arbeiðið til gitishan gjorde arbejdet omhyggeligt
gitikapping	gættekonkurrence, quiz
gitin	berømt, navnkundig, kendt
giting	gætning, gisning, gætteri,gitingar um e-tgisninger om noget
gitnaðardagur	undfangelsesdag
gitnaðarforðandi	(med.)præventiv, forebyggende
gitnaðarstund	undfangelsesøjeblik
gitnaðarverja	forebyggende middel, præservativ(fx kondom, spiral, p-pille)
gitnaður	(biol.)undfangelse, befrugtning
gittar	(fys.)optisk gitter
gittaraleikari	guitarspiller, guitarist
gittari	(musik)guitar
givin	meget træt, udmattet, udaset
gíggj	ry, berømmelse, stærk (beundring og) ros,nógv gongur gíggið av hansara klókskapider bliver talt meget om hans klogskab
gíggja	(beundre og) rose højlig, omtale med agtelse,gíggja e-n / e-t
gírigur	nærig, påholdende, gnieragtig, fornæret
gírin	nærig, påholdende, gnieragtig, fornæret
gírni	gerrighed, nærighed
gírugur	nærig, påholdende, gnieragtig, fornæret
gíslarænari	gidseltager
gíslatøka	gidseltagning
gísli	gidsel,taka gíslartage gidsler
gívur1	1jættekvinde, troldkvinde2(neds.)heks, arrigt kvindfolk,hon er ein verri gívurhun er en værre heks
gívur2	i ordforb. somtað er sovorðin (el.slíkur) gívur í honumhan har sådan arbejdsiver, energi
gjald	1betaling, afgift, gebyr,skattur og onnur gjøldskat og andre afgifter;gjøld fyri snarbrøvafgifter for ekspresbreve2(bibl.)straf, hævn,syndarinnar gjaldsyndernes straf3præstegæld
gjalda	1betale, erlægge,gjalda afturbetale tilbage;gjalda í hondbetale kontant2bøde(som straf for noget),gjalda seg leysanbetale bøde
gjaldari	betaler,góður gjaldarigod betaler
gjalddagur	forfaldsdag
gjaldfall	(jur.)henstand i tilbagebetaling
gjaldfreist	(økon.)betalingsfrist
gjaldføri	(økon.)1betalingsevne2likviditet,gott / ringt gjaldførigod / dårlig likviditet;gjaldførið hjá bankanum er gottbankens likviditet er god
gjaldførur	betalingsdygtig
gjalding	betaling
gjaldjavni	(økon.)betalingsbalance
gjaldkomin	forfalden(til betaling)
gjaldkort	(økon.)betalingskort
gjaldleysur	afgiftsfri
gjaldmiðlan	(økon.)betalingsformidling
gjaldmiðlari	(økon.)betalingsformidler
gjaldoyra	(økon.)valuta,fremmant gjaldoyrafremmed valuta
gjaldsjavni	(økon.)betalingsbalance
gjaldskái	(økon.)lille henstand i tilbagebetaling,fáa / veita gjaldskáa
gjaldskyldugur	afgiftspligtig,søla av gjaldskyldugum vørumsalg af afgiftspligtige varer
gjaldsteðgur	(økon.)betalingsstandsning,fara í gjaldsteðggå i betalingsstandsning
gjaldstova	oppebørselskontor,Føroya gjaldstova
gjaldstreyt	betalingsvilkår,lagaligar gjaldstreytirlempelige betalingsvilkår
gjaldtrot	konkurs,vera fyri gjaldtrotigå konkurs
gjaldtænasta	(økon.)betalingsservice
gjalla	gjalde, klinge, knalde, genlyde,(kvad)lúðrar, bjøllur, brandar gjalla
gjar	1(zoo.)rur(især ved strandbredden)(Balanus)2rur og knuste skal som lokkemad for fisk3(spøg.)valgflæsk, lokkemiddel, stemmefiskeri
gjara	i ordforb.gjara út1kaste rur o.a. på søen som lokkemad2(overf.)bruge som valgflæsk o.lign.,politikararnir gjara út við føgrum lyftumpolitikerne fisker stemmer med smukke løfter
gjarðarpetti	stykke af et tøndebånd
gjarðarrokkur	rok med bred, flad hjulfælg
gjarðir	segjørð
gjarhella	strandklippe med rur
gjarna	1gerne, med glæde,eg vil gjarna hitta tegjeg vil gerne træffe dig2som oftest, almindeligvis, som regel,tá sæst gjarna eingin útida kan man som regel ikke se nogen udendørs
gjarsker	skær besat med rur
gjarsteinur	(strand)sten besat med rur
gjarvaksin	besat med rur,gjarvaksin steinursten besat med rur
gjá	(poet.)kløft (klippe-, bjerg-, strand-)
gjáararmur	armel.side på en kløft
gjáarbakki	kløftekant,hann fór út á gjáarbakkan og rópaði niðurhan gik hen til kløftekanten og råbte ned
gjáarberg	klippevæg i kløft
gjáarbotnur	1bunden af en kløft,ein á rann niðri í gjáarbotninumen å løb nede i bunden af kløften2det inderste af en kløft
gjáarkelkur	strandkløft hvis inderste ende er spids
gjáarkjaftur	mundingen af en kløft
gjáarkjálki	stejl væg i kløft
gjáarlag	lille kløft
gjáarmaður	person iel.fra bygden Gjógv
gjáarmunni	mundingen af en kløft,nú var nósin komin út ímóti gjáarmunnanumnu var sælungen kommet ud mod kløftemundingen
gjáartrom	randen af en kløft, kløftekant
gjáarveggur	stejl side af en kløft,gjáarveggurin er snipst í haviðden stejle side af kløften går lodret ned i havet
gjáir	segjógv
gjálv	bølgegang, (mindre) søgang, toppet sø,gjálv í sjónumbølgegang i havet
gjálva	(om søen)være lidt urolig,tað gjálvarsøen er lidt urolig
gjálvasjógvur	urolig sø (med bølgegang)
gjálvur	bølgegang, (mindre) søgang, toppet sø
gjálvutur	(om søen)lidt urolig,rákið er hart, og ójavnt dýpi, og meldur í streyminum ger har ofta er gjálvutstrømmen er stærk og dybden ujævn, og malstrøm gør, at der ofte er toppet sø
gjánkaligur	usikker, tvivlende,tað var so gjánkaligt, tað hann gjørdidet han gjorde var så dårligt;-liga,hon lovaði tað so gjánkaligahun lovede det kun halvt
gjánkasligur	usikker, tvivlende;-liga
gjár	i ordforb.í gjári går
gjáramorgun	i ordforb.í gjáramorgunini går morges
gjáranátt	i ordforb.í gjáranáttinaforrige nat
gjárdagur	dagen i går,hon hevur ikki gloymt gjárdaginhun har ikke glemt dagen i går
gjárkvøld	i ordforb.í gjárkvøldiði går aftes
gjeikari	bøsse, homoseksuel mand
gjó	(kvad)kløft
gjódýpi	afgrund, kløft, svælg
gjógv	kløft (klippe-, bjerg-, strand-), vig med klipper på begge sider,komin um áir og gjáirkommet langvejs fra
Gjógv	(stedn.)bygd i Eysturoy,við / frá Gjógv,til Gjáar
gjólingslamb	gimmerlam
gjólingur	gimmerlam, hunlam
gjósa	(om vind)trænge igennem, blæse, trække,tað gýsur væl í hjallinumder er en tørrende blæst i forrådshuset;tað gýsur so illadet trækker så meget
gjóstur	træk, trækvind, gennemtræk,øgiligur gjóstur er í stovunitrækken i stuen er voldsom
gjóta	langagtig fordybning, mindre klippekløft, slugt,koyrivegurin lá gjøgnum eina tronga gjótukørevejen lå gennem en trang klippekløft
gjótrom	randen af en kløft, kløftekant,stutt frá gjótrominikort fra kløftekanten
gjótulag	lille klippekløft
gjums	bump,teir settu seg við einum gjumside satte sig med et bump
gjumsa	bumpe
gjøðin	1ivrig, flittig, meget arbejdsom,hon lurtaði ikki so gjøðin , sum hon var vonhun lyttede ikke så ivrigt, som hun plejede2forvoven, dumdristig
gjøgn	í gjøgn,seígjøgn
gjøgnturrur	gennemtør,træið má vera gjøgnturttræet må være gennemtørt
gjøgnum	gennem, igennem,oman gjøgnum eina brekkuned ad en bakke;gjøgnum bøingennem indmarken;steinurin fór gjøgnum rútinstenen gik gennem ruden;gjøgnum tíðinagennem tiden
gjøgnumdálkaður	gennemtilsølet
gjøgnumferð	gennemrejse, transit
gjøgnumgataður	gennemhullet,klæðini vóru gjøgnumgatað
gjøgnumgongd	gennemgang
gjøgnumgosin	gennemblæst,at ganga úti í storminum og verða gjøgnumgosinat gå ude i stormen og blive gennemblæst
gjøgnumheilur	massiv
gjøgnumhitaður	gennemvarmet,hann føldi seg gjøgnumhitaðanhan følte sig gennemvarmet
gjøgnumhugsa	gennemtænke
gjøgnumkoyring	(om trafik)gennemkørsel,eingin gjøgnumkoyringgennemkørsel forbudt
gjøgnumlestur	gennemlæsning
gjøgnumlýsa	(med.)gennemlyse
gjøgnumlýsing	(med.)gennemlysning
gjøgnummynstraður	gennemmønstret,gott gjøgnummynstrað linoleumgodt gennemmønstret linoleum
gjøgnumskakaður	aldeles forskrækket, rystet, forfærdet
gjøgnumskygdur	gennemsigtig, klar, transparent,hon er gjøgnumskygd sum glarhun er gennemsigtig som glas
gjøgnumskygni	gennemskuelighed, gennemsigtighed
gjøgnumslag	gennemslag
gjøgnumstungin	i ordforb. somgjøgnumstungin av kuldavoldsomt angrebet af kulde;gjøgnumstungin av krímivoldsomt angrebet af forkølelse
gjøgnvátur	dyngvåd, drivvåd, gennemblødt,klæðini eru gjøgnváttøjet er gennemblødt;hann var gjøgnváturhan var drivvåd
gjøgnveður	øsregn, bløde, bløder
gjøgnvæta	øsregn, bløder
gjøgnvæti	øsregn, bløder
gjøld	segjald
gjøldkúgv	1gold ko2ko der ikke kælver et år men dog giver mælk
gjøldneyt	1gold ko2kvie der ikke kan blive drægtig
gjøldum	i ordforb.hava fyri gjøldumhave en til bedste, holde for nar
gjøldur	i ordforb. somhavael.halda e-n fyri gjøldurgøre nar af en, håne en;gera gjøldur burtur úr e-m;halda gjøldur at e-m;gera gjøldur við (at) e-mhave en for nar
gjølla	klart, tydeligt, nøje,síggja (kenna, kanna eftirosv.) gjøllase (kende, undersøge) nøje
gjøllhugsa	ræsonnere,gjøllhugsa um e-træsonnere over
gjøllhugsan	ræsonnering, ræsonnement
gjølliga	klart, tydeligt, nøje,greiða gjølliga fráforklare nøje;(kvad)gjølliga kenni eg henda knørr
gjølligur	klar, tydelig, dybtgående, gennemgribende,ein gjøllig metingen dybtgående vurdering;ein gjøllig kanningen dyberegående undersøgelse;ein gjøllig lýsingen gennemgribende beskrivelse;-liga
gjøllkanna	undersøge grundigt
gjør	(ornitol.)hornet lappedykker(Podiceps auritus)
gjørdi	segera
gjørdur	segera
gjørð	1tøndebånd2fælg
gjørligur	1gørlig, mulig,hann hjálpti teimum so langt sum gjørligthan hjalp dem så langt som muligt;so skjótt sumel.skjótast gjørligtså hurtigt som muligt2arbejdsom og dygtig, flittig, ivrig,hon var ógvuliga gjørlighun var meget arbejdsom og dygtig
gjøt	i ordforb.upp á gjøtpå slump, på lykke og fromme, på må og få, på bedste beskub;ganga upp á gjøtgå på må og få
gjøtla	gjøtla umvurdere;gjøtla um hvat rætt man veravurdere hvad der mon er rigtigt
gladliga	gladelig, med glæde,tað gekk hann gladliga undirdet accepterede han med glæde
glaða1	røgskylignende vandmasser der især på fjorde og sunde hvirvles op af pludselige stærke vindstød eller hvirvelvinde,fjørðurin stendur í einari glaðu
glaða2	1varsle om noget(især grind),glaða av grind2hannel.tað glaðarder er storm med hvirvelvinde på søen,tað glaðar av hvørjari báru
glaðbeintur	1skrævende2stolt og glad, frejdig
glaðiliga	gladelig, med glæde
glaðing	det at varsle om noget(især grind)
glaðingarpláss	plads hvor der blev varslet om grind
glaðingarstaður	plads hvor der blev varslet om grind
glaðlyndi	muntert sind, jovialitet
glaðlyndur	munter af sind, jovial, gemytlig
glaðlyntur	munter af sind, jovial, gemytlig
glaðoygdur	med et muntert blik
glaðsintur	munter af sind, jovial, gemytlig
glaður	glad, fornøjet,glaður um e-tglad for noget;glaður uppi yvir e-mglad for noget;glaður við e-tglad ved noget
glaðurok	forrygende storm med hvirvelvinde på sunde og fjorde,brátt stóð sjógvurin í berum glaðurokipludselig stod søen i en sand storm af hvirvelvinde
glaðustrok	forrygende storm med hvirvelvinde på sunde og fjorde
glammur	larm, støj, spektakel,ongan glamm!ingen larm!
glamp	skær, skin, glans
glampa	(om lys)glimte, skinne, kaste glans,mánin skínur og glampar niður á aldurnarmånen skinner og kaster glans ned på bølgerne
glampi	skær, skin, glans
glamra	(bibl.)klirre
glana	glane, glo, stirre,standa og glanastå og stirre;sita og glana í sjónvarpsidde og glo i fjernsyn
glansa	glinse, skinne, stråle
glansbílæti	glansbillede
glansmynd	glansbillede
glanspappír	glanspapir
glanssólja	(bot.)bidende ranunkel(Ranunculus acris)
glansur	skær, skin, glans
glansutur	glinsende, skinnende, strålende
glantarí	skæmt, spøg
glantrarí	skæmt, spøg,eg segði hatta bara í glantraríjeg sagde det kun for sjov
glantrast	sige noget for spøg,eg glantraðist barajeg sagde det kun for sjov
glantrileikur	farce
glanus	person som står og glor
glapp	segleppa
glappakast	1fejlkast2uheld
glara	glasere
glaraður	glaseret
glareyga	(hos hest)glasøje, øje hvis regnbuehinde mangler pigment
glareygutur	glasøjet
glarflot	(biol.)øjets glaslegeme(corpus vitreum)
glargluggi	glasvindue
glaring	glasering, glasur
glaroygdur	(om hest)glasøjet,ross er glaroygt
glas	1glas(materiale og til at drikke af),fáa upp í glasiðfå en dram;eitt glas av vatniet glas vand2glasfuld,drekka tvey gløsdrikke to glas(fx brændevin)3lille flaske, medicinflaske4(zoo.)hoppes (ydre) kønsorgan5(vulg.)mødom, jomfrudom,bróta glasiðmiste sin mødom
glasa	i ordforb. somglasa avblive overiset,tað glasaði av, so tað var ógongtdet blev isdækket, så det var ufarbart
glasaður	overdækket med is,rútarnir vóru glasaðir av tjúkkum ísivinduerne var overdækkede af tyk is
glasbjørg	(i eventyr)isfjeld
glasbrot	glasskår
glaseyga	glasøje
glasing	glasering, glasur,kaka við glasingkage med glasur
glaskendur	glasagtig
glaskupul	(husbyg.)kuppel, glaskuppel
glaskúla	glaskugle
glaskvoysa	(fisk.)glashvarre(Lepidorhombus whiffiagonis)
glaspetti	glasskår,glaspetti av brotnum fløskum
glasrútur	glasrude
glasskál	glasskål
glasstova	(i ældre færøske huse)stue med glasvinduer på siden og loft
glastrevja	glasfiber
glastrevjubátur	(båd.)glasfiberbåd
glasull	(husbyg.)glasuld
glasvirki	glasfabrik
glata	give ud, give fra sig,glatast1gå til spilde, ødelægges2(bibl.)fortabes,hann, sum trýr á meg, skal ikki glatast, men hava ævigt lív
glatan	(rel.)fortabelse,bjarga frá glatanfrelse fra fortabelse
glatanarsonur	(bibl.)fortabelsens søn,eingin glataðist uttan glantanarsonurin
glatanarvegur	(bibl.)fortabelsens vej,ganga glatanarvegin
glatt	seglaður
glámlýsi	blændende sammenstød af lysstråler fra modsatte sider, alt for stærkt lys som blænder øjnene,glámlýsi av gøtuljósunumblændende lys af gadebelysningen
Glámur	i ordforb.eygu sum í Glámigloende, onde øjne
gleða	1glæde, gøre glad,gleða e-n (við e-m)glæde en (med noget);tað gleðir meg at hoyradet er jeg glad for at høre2gleða segglæde sig;gleða seg til jólaglæde sig til jul;gleða seg um e-tvære glad for noget
gleði	glæde, fornøjelse
gleðiár	(bibl.)jubelår
gleðiboð	glædesbud
gleðiboðskapur	(bibl.)glædesbudskab, evangelium
gleðibros	glædessmil,gleðibros á andlitinum
gleðidagur	glædesdag
gleðievni	noget der giver glæde, årsag til glæde
gleðifullur	fuld af glæde
gleðigenta	glædespige, skøge, hore
gleðihátíð	glædesfest
gleðileysur	glædesløs, glædeløs, trist,gleðileyst lívet trist liv
gleðiligur	glædelig,ein gleðilig hendingen glædelig hændelse;gleðilig jólglædelig jul;-liga
gleðiljóð	frydesang,(kvad)kvøðum gleðiljóð honum til æru
gleðimikil	glædelig
gleðirómur	glæde og højt humør, jubelrus
gleðiróp	fryderåb,skera í gleðiróp
gleðirúsur	glædesrus
gleðistund	glædens stund
gleðitár	glædeståre
gleðitíðindi(r)	glædelig nyhed, glædesbud
gleðitungur	vemodig
glefs	1snappen efter noget, haps2arrig bemærkning
glefsa	1(om hund)snappe2(overf.)tiltale en med en (pludselig) arrig bemærkning
glefsutur	arrig, aggressiv,hann er so glefsuturhan er så aggressiv
gleið	seglíða
gleiðbeintur	1skrævende2stolt og glad, frejdig,hann fór so gleiðbeintur avstaðhan gik så frejdig af sted
gleimur	(kvad,poet.)lystighed, munterhed,halda sær á gleim(i)være lystig, være i lystigt humør;halda gleim at e-mmore sig over noget, gøre sig lystig over;hann slær tað í ein gleimhan slår det hen i spøg
gleiv	1stort skræv, langt skridt2person der skræver megetel.tager lange skridt
gleiva	1skræve, ståel.sidde med skrævende ben2gå med lange skridt,hann fór gleivandi gjøgnum bygdinahan gik med lange skridt gennem bygden
gleivarspenni	i ordforb. somhann var sum eitt gleivarspennihan gik skrævende
gleivbeintur	1skrævende2stolt og glad, frejdig
gleivhyrntur	(om vædder)med stort mellemrum mellem hornene
gleivin	med stort skræv, skrævende, med skrævende ben
gleivstøða	det at stå med adskilte ben(især i gymnastik)
gleivur	med stort skræv, skrævende, med skrævende ben,hann var so gleivur, hann kom gangandihan kom gående med skrævende ben
glens	i ordforb.sláa e-t upp í glensslå noget hen i spøg
glentan	spøg, lystighed, fjas
glentast	spøge, fjase
glentran	spøg, lystighed, fjas,fullur av látri og glentranfuld af latter og spas
glentrarí	spøg, lystighed, fjas
gleppa	1glide pludselig ud af sin stilling, smutte;gleppa av:hondin glapp avmistede taget med hånden;gleppa (e-m) av hondumel.hendislippe ud af hænderne på en;vit mega ansa eftir ikki at lata alt gleppa okkum av hondumvi må passe på ikke at tabe alt på gulvet;gleppa e-m av munni(sige, udbryde);svørðið glapp mær úr hondini;gleppa útav:fóturin glapp útavfoden gled ud;gleppa út úr:tað glapp út úr honumhan kom med en pludselig bemærkning;gleppa aftureftirblive svag, svækkes, blive afkræftet og slap2mislykkes,fiskiskapurin má ikki gleppafiskeriet må ikke mislykkes;gleppa niðurfyri:tað glapp niðurfyri hjá honumdet mislykkedes for ham
gleppakast	uheld, ulave, uorden,gleppakøstunoder, uvane;eg veit ikki, nær ið hann hevur fingið hesi gleppakøstinijeg ved ikke, hvornår han har fået disse unoder
gleps	snappen efter noget, haps,hundurin gjørdi eitt glepshunden gjorde et haps;(overf.)hon gjørdi eitt glepshun kom med en pludselig arrig bemærkning
glepsa	1(om hund)snappe,hundurin glepsaði eftir hondum teirra2(overf.)tiltale en med en (pludselig) arrig bemærkning,hon glepsaði í hann
gler	(blank, spejlklar) is, tynd is(fx på vandpytter)
glera	beklæde med emalje, emaljere
glerfrystur	1stivfrossen,áir og tjarnir vóru glerfrystar2gennemkold,eg eri glerfrysturjeg er gennemkold
glering	1emalje2(biol.)(tand)emalje
glerkaldur	iskold
glerkuldi	bidende kulde
glerlagdur	islagt, overiset,gøtan var glerløgdgaden var overiset
glerlokaður	overiset, dækket med spejlklar is,allir smáhyljar glerlokaðiralle de små vandpytter er overiset
glerpípa	istap
glerseting	(geol.)glaciation
glersettur	overiset, dækket med spejlklar is
glerstoyta	dække med is,veturin glerstoytir hamrarnar
glerstoyttur	(fx om en vej)isdækket
gletta1	letsindigt pigebarn,tann glettan!tøjte!
gletta2	1grine, le,hon situr og glettir og neggjarhun sidder og griner og hviner;gletta (upp) á tonnsmile hånligt, le hånligt2skratte,hann fór at gletta á ljóðføri sínumhan begyndte at skratte med sit instrument
glið	gled,fara á gliðbegynde at glide;glið var komið ánu var det begyndt at gå fremad;fá á gliðfå på gled, få i gang;(overf.)fáa glið á samráðingarnarfå gang i forhandlingerne
glimma	lyse svagt, vise sig som svagt lysskær
glimman	svagt lys, skær, skin
glimra	lyse svagt, vise sig som svagt lysskær,nú glimrar eitt sindurnu klarer det lidt op
glinsa	glinse
glinssólja	(bot.)bidende ranunkel(Ranunculus acris)
glinsutur	glinsende, skinnende, strålende
glint	klingendeel.klirrende lyd
glinta	klinge, klirre,tenninar glintatænderne klaprer
glintan	klingen, klirren
glintormur	(zoo.)klapperslange(Crotalus sp.)
glintra	klinge, klirre
glisa	(håndv.)ikke slutte tæt, gabe lidt i sammenføjningen,tað glisar ímillumdet slutter ikke tæt
glisutur	fedtet, trannet,glisut hárfedtet hår;glisutur fuglurlomvie som mallemuk har oversprøjtet med tran
glitklæði	stadstøj, stiveste puds, søndagstøj
glitra	glitre, glimre, funkle,(ordsp.)ikki er alt gull, ið glitrardet er ikke alt guld, som glimrer
glitran	stråleglans, glansfuldhed
glitri	skin, glans,hon fekk glitra í eyguni
glitur	skin, glans,sólin legði glitur yvir kavansolen lagde en glans over sneen
gliturpappír	glanspapir
glitvevnaður	tøj med indvævet glitter
glitøgn	paillet
glíða	glide,glíða í hálkuglide i glat føre;bilurin gleiðbilen gled på den glatte vej;maturin glíður væl niðurmaden smager godt;hvalur glíður væl gjøgnum sjógvinhvalen glider smidigt gennem havet
glígginieyga	i ordforb.ryssan er glígginieygahoppen er glasøjet
glíggja	(begynde) at skinne,glíggja avel.fyri degi(begynde at) dages
glíggjhávur	(fisk.)portugisisk pighaj(Centroscymnus coelolepis)
glíma1	(idr.)brydning, brydekamp,ikki eiti á glímur og syftursikken en brydekamp
glíma2	brydes, tage brydetag,teir glímdust leingide tog brydetag længe
glíma3	glimte, blinke,torusláttur var, og ljósini glímduder var torden i luften og lynene glimtede
glíming	brydning, brydekamp
glírast	småfnise,standa og glíraststå og småfnise
glísa	glísurstore stirrende øjne,tá vóru glísur í honumhan gjorde store øjne;glísurnar í tær!(om stirrende øjne)
globus	globus
gloparegn	heftigt regnskyl, skylregn
glopp	1åbning, gab, mellemrum,glopp millum tveir steinaråbning, hule mellem to sten;standa á gloppiikke slutte tæt til;seta hurðina upp á gloppsætte døren på klem2lakune, tomrum, hul, mangel,eitt glopp í tekstinumen lakune i teksten
gloppa	1åbne lidtel.på klem,gloppa hurðinaåbne døren på klem;gloppa eskjunaåbne æsken2ikke slutte tæt, stå lidt åben,hurðin gloppaðidøren sluttede ikke tæt
gloppagrót	store sten med mellemrum imellem
glopparegn	heftigt regnskyl, skylregn
gloppin	segleppa
gloppknappur	(datal.)(på tastatur)mellemrumstast
gloppregn	heftigt regnskyl, skylregn
gloppskrift	(typogr.)skrift med store mellemrum mellem bogstaverne
glopputur	hullet
glopra	åbne lidtel.på klem
glopragrót	store sten med mellemrum imellem,sum at ganga á glopragróti(om at gå på meget ujævnt terræn),gongur sum kópur á glopragrótigår som en sæl på meget ujævnt terræn
glopraregn	heftig regn
gloprutur	1med huller og huler(imellem store sten)2med lakuner, mangelfuld, ufuldstændig,teksturin er heldur gloprutur, við tað at bløðini eru so illa farinder er mange lakuner i teksten, fordi bladene er i så dårlig forfatning3(om personer)åbenmundet,tað nyttar ikki at siga nakað fyri honum, hann er so glopruturdet nytter ikke at fortælle ham noget, han er så åbenmundet
glopur	åbningel.hule imellem store sten
glorva	rave,ganga fullur og glorvagå fuld og rave
glosa	glosa (upp)strikke hurtigt og løst
glosutur	lasket, kvabset, laskefed
glotta	1klare lidt op, lette(så himlen kan ses mellem skyerne),nú glottirel.glottar ídet klarer lidt op(om vejret),sólin glotti framsolen kiggede frem mellem skyerne2(kvad)glotta á tonnsmile hånligt, le hånligt
glotti	1åbning mellem skyerne,ein lítil glotti er;ein glotti birtist í eygunum á henniet håb tændtes i hendes øjne;ein slík ferð var sum ein glotti í gerandisdegnumen sådan rejse var et lyspunkt i dagligdagen2lille ophold i strengt vejr
glottur	1åbning mellem skyerne2lille ophold i strengt vejr
gloyma	1glemme,gloyma e-tglemme noget;tað gloyma vit aldridet glemmer vi aldrig;gloyma e-t avstað afturglemme noget siden;gloyma e-t burturglemme noget;nú gloymdi eg tað burtur aftur, sum eg skuldi siganu glemte jeg, hvad jeg skulle sige2glemme, efterlade,hann hevði gloymt knívinhan havde efterladt kniven;gloyma eftirefterlade;tey vóru gloymd eftirde blev efterladt3ikke tænke over,lær meg at gloyma meg og míttlær mig ikke at tænke over mig selv og mit4gloyma seg burturglemme sig bort
gloymiskítur	glemsom person
gloymmegei	(bot.)forglemmigej
gloymska	1glemsel,fara í gloymsku(na)gå i glemslen;søkka í gloymskunedsænke i glemsel;tað er farið í gloymskunnar havdet er glemt for altid, gået i glemmebogen2glemsomhed
gloymskur	glemsom
gloypa	sluge, opsluge,gloypa e-msluge noget;gloypa við høvdi og gørnumsluge med hud og hår;gloypa e-m ráumsluge noget råt;(overf.)gloypa ov stórum bitapåtage sig for meget(mere end man kan klare)
gloypingur	fisk der findes i uopløst tilstand i en stor fisks mave
gloypubiti	lækkerbisken, namnam
gloypur	mundfuld
gló	(om lyd hos sildemåge),gló, gló sigur likkan
glóð	glød, glødende stykke tørv, kul el.lign.,hon rakaði í glóðunum í komfýrinumhun rodede op i gløderne i komfuret;(talem.)sita sum á glóðumsidde som på nåle
glóðabak	glødild,geva kúgv glóðabakvarme koens yver med gløder i en gryde el.lign.
glóðarker	(bibl.)varmebækken
glóðbak	glødild
glóðheitur	glohed, glødende varm,glóðheitur kaffimunnurglohed kop kaffe
glóðhiti	glødhede
glóðker	varmebækken
glóðreyður	glorød, rødglødende
glóeyga	i ordforb.hava glóeygafå øje på ting som ellers ikke er så nemme at se
glógva	1tindre, lyse, skinne stærkt,glógva sum gullskinne som guld2(overf.)glógva í,har glógvar íder er noget godt at øjne der (værdifuldt, talentfuldt el.lign.);onkrum glógvaði ínogle var gode til sit arbejde;har glógvar ikki íder er intet lyspunkt at se;har glógvar ikki í nøkrumder var ingen hæderlig undtagelse
glógvheitur	glohed, gloende
glógvi	(kvad)handske,tak tú mínar glógvar á tínar sáru lógvar
glókattur	i ordforb. someyguni sum í glókattimed øjne der gnistrer (af vrede)
glóma	stort stirrende øje,nú eru glómur í honumnu gør han store øjne
glór	snak, vrøvl,svara aftur í glórisvare spøgende igen
glóra	1prale, skryde2glórastfjase, opføre sig naragtigt;hann sat og glóraðist við eitt konufólkhan sad og blærede sig over for en kvinde
glósa1	spotteglose, stikpille, spydighed
glósa2	give stikpiller, drille, håne,glósa ein (við e-m)drille en (med noget);teir kundu væl at glósastde var gode til at drille hinanden
glósutur	slem til at give stikpiller, drillende,teir eru glósutirde er slemme til at drille
glugga	(begynde) at skinne,nú gluggar fyri sólininu kommer solen frem
gluggabjálvi	(post.)rudekonvolut
gluggaglas	vinduesglas
gluggakarmur	(husbyg.)vindueskarm
gluggaklæði	gardin
gluggaluft	overskyet luft med skyfri partier ind imellem
gluggarim	gluggarimargitter (for vinduer)
gluggatjald	gardin
gluggi	1vindue,hyggja út gjøgnum glugganse ud af vinduet2(datal.)vindue3næsebor,fáa sær upp í gluggansnuse4åbning mellem skyerne5i ordforb. somtað vóru gluggar í honumhan gjorde store øjne
gluggur	segluggi
glukosa	(kem.)glukose, druesukker
glumdi	seglymja
glunti	ung (rask) fyr, knag,ungir gluntar
gluntur	ung (rask) fyr, knag
gluppu	segleppa
glups	mudderpøl
glupsi	mudderpøl
glúpa	tageel.fange med net(mallemukunger, småfisk, fiskeyngel o.l.)
glúpskliga	1ivrigt2aggressivt
glúpskur	1(om hund)glubsk,glúpskir hundar2(om blik)vred,seta glúpsk eygu(r) at e-mstirre med vrede øjne på nogen;glúpskthurtigt,vatnið rennur so glúpsktvandet løber så hurtigt
glúpur	1fangstnet2ketsjer(fx til fuglefangst og ørredfangst)
glymja	buldre, genlyde, runge, larme,glymur dansur í høll;tað glymur ádet regner voldsomt, regnen pisker ned
glymmardansur	i ordforb. somtað verður ein glymmardansurder bliver ballade
glymskál	(musik,bibl.)pauke
glymur	højtlydende brag, buldren, larm
glymurdansur	i ordforb. somtað verður ein glymurdansurder bliver ballade
glypsi	lille kløft
glyvramaður	person iel.fra bygden Glyvrar
Glyvrar	(stedn.)bygd i Eysturoy,á / av Glyvrum,(inn / út) á Glyvrar
glyvur	kløft ud mod søen der som regel fortsætter som en vegetationsklædt sænkning ind i landet
glýrast	småfnise
glýsa1	(fisk.)glyse
glýsa2	store stirrende øjne
glýsufiskur	(fisk.)glyse(Trisopterus minutus)
glývur	kløft ud mod søen der som regel fortsætter som en vegetationsklædt sænkning ind i landet
glæ	i ordforb.standa á glæ;(fx om fiskesnøre)stå på skrå ud i søen;snørið stendur á glæ;stigin stendur á glæstigen står meget på skrå
glæma1	lysning, stråle, dagskær
glæma2	give et svagt lysskær fra sig,eldurin liggur og glæmarilden giver et svagt lysskær fra sig
glær	i ordforb.standa á glæri(fx om fiskesnøre)stå på skrå ud i søen
glæra1	transparent
glæra2	gøre gennemsigtig,tað glærar fyri tonnman kan se en (fremvoksende) tand
glærfitaður	med kød der har den rette fedme,avdeyðaærnar eru líka glærfitaðar
glærfiti	(især om fårekød)klar fedme
glærgrønur	grønligt gennemsigtig
glærmynd	diapositiv
glærur	gennemsigtig
glærutur	glasagtig
glæsa	glimre, skinne, stråle
glæsiligur	prægtig, strålende
glæstri-	(kvad)strålende, prægtig
glæstriborg	smukt, prægtigt hus,(kvad)Hermundur snúðist av salinum út av glæstriborg
glæstrimynd	meget flot billede
glæstriskapur	storslåethed
glæstriskeið	(kvad)prægtigt skib,Høgni letur av lunni ganga sína glæstriskeið
glæstur	(kvad)strålende
gløa	glo, stirre, måbe,hann gløddi viðhan blev overvældet;gløa í rakivære meget mager
gløða	gøre glødende, gløde,ovnurin er gløðandi heiturovnen er glødende varm;gløðandi reyðurblodrød
gløðilampa	(fys.,elektr.)glødelampe
gløðitráður	(fys.)glødetråd
gløður	seglóð
gløgg	gløgg
gløggleiki	skarpsind, skarpsindighed, klarsyn
gløggliga	tydeligt, klart
gløggskapur	skarpsind, skarpsindighed
gløggskygdur	skarpsynet, klarsynet
gløggskygni	skarpsyn, klarsyn
gløggsýni	skarpsyn, klarsyn
gløggur	1fornuftig, klog, kløgtig, intelligent,(ordsp.)gløgt er gestsins eygafremmed øje er en god iagttager2nøjagtig
gløs	seglas
gløtta	1grine, le,gløtta á tonnle hånligt, smile hånligt2gløtta í(om tåge)lysne, lette lidt;eina ferð gløtti so mikið í, at teir sóu, hvar teir vóru staddir
gnadd	gnaven, gnubben
gnadda	gnave, gnide, skure, gnubbe,báturin gnaddar móti bryggjunibåden gnider imod kajen
gnaga	1gnave2flytte sig langsomt,teir gnagaðu upp undir landde var ved at komme ind til lands;enn gnagar suðurden sydgående strøm er ikke helt ophørt endnu
gnagari	gnaver
gnagdjór	(zoo.)gnaver(Rodentia)
gnagdýr	(zoo.)gnaver(Rodentia)
gnagmerki	mærke efter noget der er gnavet,gnagmerki av rottu
gnalla	gnaske
gnasti	lille knort el. fremspring i en fjeldvæg
gneggj	vrinsk, vrinsken
gneggja	1(om heste)vrinske2(om mennesker)hvine, skrige
gneggjus	(ornitol.)stormmåge(Larus canus)
gneis	(geol.)gnejs
gneisti	gnist
gnella	give høj og gennemtrængende lyd fra sig, knirkeel.skratte stærkt,rópið gnelti í fjøllunumråbet gav genlyd i fjeldene
gnis	fnis,gnisini hoyrdust til genturnar
gnisa	fnise
gníggilóg	(fys.)friktionslov
gnígging	1gnidning2(fys.)friktion
gníggital	(fys.)gnidningstal
gníggja	gnide,gníggja eygunignide sig i øjnene
gnísla	(kvad)give en ubehagelig skarp, skrigende lyd,gníslaðust svørð og ringabrynjur
gníst	hvin, (gennemtrængende) skrig
gnísta	pibe, hvine, udstøde hvinende gennemtrængende skrig,genturnar gnístu av ræðslupigerne peb af skræk
gnístipípa	pibe (fløjte) af halmstrå
gný	(kvad)larm, støj
gnýggjur	(kvad)larm, støj,gnýggjurin hoyrdist átjan míllarmen kunne høres atten mil
gnýur	(kvad)larm, støj
goff	(overflødig) snak, sludder, vrøvl
goffari	skvadronør, pralhals
goffur	skvadronør, pralhals
goffutur	snakkesalig, snaksom, snakkelysten
gogga1	(zoo.)konk, trompetsnegl(Buccinum undatum)
gogga2	(barn.)høne
gogga3	1tage fisk med krog(af line og ind i båden)2tage voldsomt i nogen
gogga4	1(neds.)bavle, vrøvle, kagle2(barn.)(om høns)kagle
goggur	krog til at hale store fisk indenbords med
goldin	segjalda
golf	(idr.)golf
golfbóltur	(idr.)golfkugle
golfbreyt	(idr.)golfbane
golfleikari	(idr.)golfspiller
Golfstreymur	(geogr.)Golfstrøm
golfvøllur	(idr.)golfbane
gollið	segjalla
gomlujól	jul efter den gamle kalender(1. juledag var 6. januar)
gomul	segamal
gong	1gang, korridor2snæver gennemgang, smøge, gyde,vatnið verður veitt gjøgnum eina gong í fjallinum(tunnel);viðarmaðkurin grevur sær gongir í viðin;(stedn.)í Gongini
gonga	1gåen, gang,fara til gongubegynde at gå, tage af sted til fods;móður av gongutræt af at gå;koma av gongukomme hjem (el. i hus) efter fodrejse2fåredrivning,meðan gingið varð aðru gongumens den anden fåredrivning var i gang3fårehjord (i en græsgang) der drives i fold på én gang,fjallmenninir komu við gonguni4folk som går i samlet flok,kravgongademonstration;kyndlagongafakkeltog;skrúðgongaprocession
gongd	1det at gå, gang (til fods),gongd hoyrist í túninumnogen kunne høres gå udenfor2bevægelse,tá kom gongd áda kom der gang i3forløb, udvikling,við hesari gongdsom det går nu;siga frá gongdinifortælle om forløbet;alt gongur sína vanligu gongdalt går sin vante gang;gongdin í málinumsagsforløbet4gang, korridor, passage,gongd, køkur og kovigang, køkken og spisekammer5gang,motorurin er í gongdmotoren er i gang;seta motorin í gongdsætte motoren i gang6skridt på bukser, skræv,hann er so skoppin í gongdinibukserne er snævre i skridtet7(om dej)gæring, hævelse,seta breyð til gongdsætte brød til hævelse8bevægelse af tarmluft,gongd í búkinum
gongdseting	igangsættelse, igangsætning
gongdur	1som man kan gå adel.bevæge sig over,har er gongtder kan man gå;har er væl / illa gongtder er det godt / vanskeligt at gå2(om folk)til bens,vera væl / illa gongdurgå godt / dårligt på sine ben
gongsgenta	rengøringsassistent på et hospital
gongubátur	båd der skyder god fart(pga. sin konstruktion)
gongubiti	bid mad til at gå på(fx under fåredrivning)
gongubreyt	gangsti, fortov
gongubrillur	briller til daglig brug
gongubrúk	i ordforb.til gongubrúks(om tøj)til hverdagsbrug,hosur til gongubrúks
gongubærur	ikki gongubærtikke gangbart(vanskeligt terræn)
gongudeild	(med.)ambulatorium
gonguferð	gåtur, vandring
gongufjalir	båd der skyder god fart
gongufólk	vandrer, fodgænger
gongufriður	det at kunne gå i fred(uden at blive forstyrret),ikki gongufriður fyri bilumdet er ikke muligt at gå i fred for bilerne
gonguførur	i stand til at gå,ikki vera gonguførurvære så beruset at man knap nok kan stå på benene
gongugøta	gågade
gonguherfólk	(militær)fodfolk
gonguherlið	(militær)fodfolk
gonguhermaður	(militær)infanterist
gongukallur	(kvad)omflakkende person
gonguklæddur	rejseklædt
gonguklæði(r)	hverdagstøj
gongulag	1(ret) måde at gå på, gang,hava gott / ringt / eyðkent gongulaghave en god / dårlig / karakteristisk måde at gå på;vinglutur í gongulagmed usikker gang2(om båd)måde at sejle på,báturin hevur vakurt gongulagbåden har en smuk måde at sejle på3rytme,gongulagið í yrkinginirytmen i digtet4(musik)march
gongulamb	lam som løn til fårehyrde
gongulið	stente
gonguliður	(biol.)knæled
gonguligur	farbar (til fods), fremkommelig,tað hevur ikki verið gonguligt(pga. glat føre)
gongulimur	ben
gongulína	line til at støtte sig til når man går i bjerge og brat terræn
gonguljóst	så lyst at man kan se at gå
gongulurt	walkman
gongulýsi	så meget (dags)lys at man kan se at gå
gonguløn	det man får for at løbe et ærinde,hetta skalt tú eiga í gonguløn
gongumaður	mand som er dygtig til at gå
gongur	seganga
gongurás	sti at gå efter
gonguskógvur	hverdagssko
gongusnapsur	en snaps at "gå på"
gongusokkur	hverdagssok
gongustjørna	(astronomi)planet
gonguteigur	fodgængerfelt
gongutúrur	gåtur, spadseretur
gonguveður	vejr til at gå i,gott / ringt gonguveður
gonguvegur	gangsti
gonguverk	gangværk (i ur), maskine
gonguvit	svageste grad af intelligens,hann hevur ikki gonguvithan er ganske dum;hann hevur gonguvithan er meget svagt begavet
gonnur	penis på grindehval
gor	tarmindhold hos dyr (især drøvtyggere),á seyði er alt etandi uttan gor og gallpå får kan alt spises uden kymus og galde;hann goysti bæði gor og gall oman yvir meghan skældte mig huden fuld
gora	1(om tarmindhold)løbe fra tarmene på dræbt dyr2(om tyr)brøle højlydt3bralre, prale,situr og gorar og gorar
goragangur	larm, spektakel
goran	rumlende lyd fra tarmene(af sult),goran í gørnunum
gorfuglur	(ornitol.)gejrfugl(Pinguinus impennis)
gorfullur	(om kreaturer)fuld af tarmindhold
gorhungraður	skrupsulten, hundesulten
gorilla	(zoo.)gorilla(Gorilla gorilla)
gorlakki	(neds.)uduelig person
gorlakkur	(neds.)uduelig person,ein sovorðin gorlakkur
gorlop	diarré
gorp	1voldsom hoste2lyd der ledsager stærk opkastning
gorpa	1hoste stærkt og ubehersket,hann bæði hostaði og gorpaði2kaste voldsomt op,gorpa upp
gorpur	1(ornitol.,poet.)ravn2i ordforb. somhann leggur ein gorp upp í dag (av sjóverki)han kaster meget op (pga. søsyge)
gorr	1ravneskrig2bralren, praleri,hann er eitt gorrhan er en værre pralhals
gorra	1(fx om ravn)skrige (hæst)2(neds.)(om folk)bralre, prale3brovte, blære sig, skvadronere
gorran	bralren,gorran av likkum
gorrari	person der bralrer, pralhals
gorrutur	(neds.)(om folk)højrøstet, skvaldrende
gorsvangur	skrupsulten, hundesulten
gorutur	1(om farve på uld)liggende midt imellem hvidt og sort2(neds.)(om folk)højrøstet, skvaldrende
gorvatn	i ordforb. somhatta er sum gorvatn(siges om meget vandet suppe)
gos	1(i forskellige faste ordforbindelser)vera (uppi) á gosivære ophidset;hann lýgur meg út á goshan fylder mig med løgn;hurðin stendur á gosidøren står vidt åben;seta opið út á goslade yderdøren stå åben (på vid gab);grava á gos (bøkkel.torvu)(om lunder)grave huller, så der bliver træk i redehulen2vulkanudbrud3(ny bet.)springvand4(talesp.)boblebad,er gosið opið?er boblebadet åbent?
gosbað	boblebad
gosbrunnur	springvand
gosfjall	(geol.)vulkan
gosfløska	sifon
gosgrýti	(geol.)vulkansk bjergart
goshálsur	(geol.)kraterrør
gosilska	(geol.)vulkansk slagger
gosin	gennemblæst,tað er so gosið í dagdet blæser meget i dag
goskelda	(geol.)gejser,heit goskelda
goskluft	(geol.)vulkanspalte
goslegugrýti	(geol.)vulkansk sediment
gosleitt	(om vejr)med vedvarende tør vind fra samme retning(gerne sydøst)
gosmyrja	(geol.)agglomerat
gosop	(geol.)vulkankrater
gosoyggj	(geol.)vulkanø
gosrøð	(geol.)række vulkankrater i samme vulkanspalte
gosvaksin	temmelig tør og tynd og ret høj,gosvaksin maður
gosvirkni	(geol.)vulkanisme
gosøska	(geol.)vulkansk aske
got	1udgydt rogn, fiskeyngel2kønsåbning på fisk
gotan	sludfuldt vejr (ved pålandsvind),ein gotan av landsynningi
gotaskrift	gotisk skrift
gotfjøður	(fisk.)gatfinne
gothol	kønsåbning på fisk
goti	goter
gotiskur	1gotisk,gotisktgotisk sprog2gotiskur stílurgotisk stil;gotisk skriftgotisk skrift
gotlendskur	gotlandsk
gott	segóður
gotur	kanon
goturstykki	(bot.)nederste del af en kvan
goya	(barn.)narresut, sut
goyggj	gøende lyd, gøen
goyggja	1(om hund)gø2(om folk)skælde ud, skråle op
goyggjan	gøende lyd, (megen) gøen
goyma	1gemme, opbevare,maturin goymist so vælmanden holder sig længe2huske, mindes, erindre,ikki nyttar mær at lesa, eg goymi tað ikkidet nytter ikke for mig at læse, jeg husker det alligevel ikke3passe, røgte,goyma at neytumel.goyma atrøgte køer;goymdi mær at seyðijeg røgtede får;goyma at seyðafylgjum sínum;goyma akurel.akri;(ordsp.)eingin kann allar dyr at goymaingen er specialist i alting;(talem.)hava nógvar gáttir at goymahave megen familieel.venner at besøge4(talesp.)skjule
goymd	bevarelse, opbevaring,i ordforb. somtað er eingin goymd í hasumdet er ikke værd at bevare
goymdur	gemt,tá man eg vera goymdurtil den tid er jeg nok død og begravet
goymi	i ordforb.leggja sær í goyma (ogsågoym)lægge (sig noget) på sinde
goymin	1dygtig til at gemme og spare på sine ting2sen til at glemme en fornærmelse
goyming	opbevaring,goyming av fiskiopbevaring af fisk
goymsla	1forvaring, varetægt2lager,hava vøru á goymsluhave vare på lager3varelager,goymslan hevur einki virði longurvarelagret har intet værdi længere
goymslubing	kornsilo
goymslubúr	(bibl.)forrådskammer
goymslubygningur	lagerbygning
goymslugrýti	(geol.)reservoirformation
goymsluháttur	opbevaringsmåde
goymsluhús	pakhus, lagerbygning
goymslumaður	lagerarbejder
goymslupláss	opbevaringssted,stórt / lítið goymslupláss
goymslurúm	lagerrum
goymslusandur	(geol.)reservoirsand
goymsluskip	(skib.)lagerskib(bruges i olieindustrien)
goymslustaður	lagerplads
goymsluvørður	lagerforvalter
goymur	i ordforb.leggja sær í goymlægge (sig noget) på sinde
goyr	segoyggja
goysa	1sprude, udspy,tað er farið at goysa úr gosopinumvulkanen er begyndt at spy lava;regnið goysti niðurdet styrtregnede2fare i flyvende fart, skynde sig af sted,hann fór goysandi avstaðhan skyndte sig af sted;báturin rann við goysandi ferðbåden sejlede med flyvende fart3kaste (voldsomt) op,hon goysti alt upp aftur, sum hon hevði etiðhun kastede alt op igen, som hun havde spist
goysan	1det at udspy2opkastning
goyst	(kvad)voldsomt,skrímslið loypur goyst um grund
gódlív	godmodigt menneske,maðurin er sagdur at vera eitt gódlívmanden siges at være et godmodigt menneske
gódmenni	godmodigt menneske
góð	segóður
góðalag	opstemthed, munterhed, lystighed, glæde,tá var góðalagda var stemningen munter
góðalív	herreliv, slaraffenliv,i ordforb. somhetta er góðalívdette er et slaraffenliv
góðaráð	goderåd(et bagværk)
góðastova	dagligstue, opholdsstue
góðbøn	bøn om det gode
góðdýr	1godmodigt skikkeligt menneske, godt skind,hann er eitt sovorðið góðdýr2fredsommeligt menneske
góðfjøldum	i ordforb.við góðfjøldummed det gode, venligt
góðga	i ordforb.góðga særnyde noget lækkert,hann fór inn í spískamarið at góðga sær
góðgerð	god gerning, filantropi, godgørenhed, velgørenhed
góðgerðarmaður	filantrop
góðgerin	godgørende, godhjertet, veldædig, velgørende,bæði blíður og góðgerinbåde venlig og velgørende
góðgjørdur	godgørende, godhjertet, veldædig, velgørende
góðgongdur	(om vej, sti el.lign.)vel farbar (til fods),góðgongdur vegur
góðgripur	værdifuld ting, klenodie,(ordsp.)tað er vamm áel.í hvørjum góðgripienhver, selv den bedste, har sine fejl
góðgutur	som gerne vil have noget at spise, lækkersulten
góðgæti	lækkeri, lækkerbisken, namnam
góðgætisbjølgur	lækkermund
góðgætisbúkur	lækkermund
góðgætisvomb	lækkermund
góðheit	godhed
góðhjartaður	godhjertet
góðhugur	velvilje, forekommenhed, godhed
góðhýrur	godt humør
góði	1kvalitet;i ordforb. somtað er eingin góði í hasumdet er værdiløst2lækkerier, lækkerbisken,aftur við kaffinum varð borðreitt við frálíkum góðumder blev serveret udsøgte lækkerier til kaffen3fordel, gavn
góðkenna	godkende, blåstemple, anerkende, acceptere,góðkenna sáttmálangodkende kontrakten;góðkendur roknskapurgodkendt regnskab
góðkenning	godkendelse, autorisering, anerkendelse,roknskapur til góðkenningarregnskab til godkendelse
góðkensla	ædel følelse
góðkynjaður	(med.)(om sygdom)godartet
góðleiki	godhed
góðlíðandi	godlidende, venlig,maðurin er so dámligur og góðlíðandimanden er så sympatisk og venlig
góðlíðin	godlidende, venlig
góðlyndi	godmodighed
góðlyndur	godmodig, venlig
góðlyntur	godmodig, venlig
góðlæti	godmodighed
góðmálmur	ædelt metal
góðmenni	godmodigt menneske
góðnevni	(lingv.)noaord
góðorð	rosende ord
góðorðaður	venlig, mild (i tale)
góðoygdur	med gode og venlige øjne
góðpjátur	venlig pludren, venlig snak
góðráð	(kvad)gode råd
góðs	1gods, ejendel,bæði góðs og gullbåde gods og guld2gods, store jordejendomme3gods,góðsið skal flytast til støðina í morginárigodset skal transporteres til stationen i morgen tidlig4(på skib)rigning
góðseigari	godsejer
góðsemi	enighed, god forståelse
góðsinnaður	godmodig
góðsinni	godmodighed
góðsintur	godmodig
góðska1	1kvalitet,góð / vánalig góðskagod / dårlig kvalitet;góðskan á vørunivarens kvalitet2godhed, velvilje, yndest
góðska2	forædle, rendyrke,góðskaðar vørurforædlede varer
góðsking	forædling
góðskriva	kreditere, godskrive
góðskriving	godskrivning, kreditering
góðskueftirlit	kvalitetskontrol
góðskufullur	godmodig, venlig
góðskumeta	kvalitetsvurdere
góðskumetari	kvalitetskontrollør
góðskumunur	kvalitetsforskel
góðskuríkur	(bibl.)godmodig, venlig,miskunnsamur og góðskuríkurbarmhjertig og godmodig
góðskutilvit	kvalitetsbevidsthed
góðskutilvitan	kvalitetsbevidsthed
góðsligur	(om folk og dyr)fredsommelig, godmodig, godhjertet;-liga
góðsstjórn	godsbestyrelse, godsforvaltning
góðtaka	godtage, acceptere, tage for gyldig,góðtaka treytirnaracceptere betingelserne
góðtokki	(bibl.)velbehag
góðtrúgvin	godtroende, troskyldig, naiv
góðtrúni	godtroenhed, naivitet, tossegodhed
góðtøka	anerkendelse, godkendelse
góður	1god, mild, kær,góða barnið!kære barn!;góður vinurgod ven;hann hevur ongan góðan(uden familie og venner);góðiel.góðin!kære!;hasi bæði eru góð(er forelsket i hinanden);vera e-m góðurvære trofast imod en;góður av særfredsommelig, godmodig;góður í særfredelig;barnið er gott í sær;vera góður við (e-n)elske, holde af (en);hann er altíð við tí góða orðinum(har altid noget godt at sige om nogen);gott í teg, kom og hygg mær at hesum!gør mig den tjeneste at kigge lidt på det her!;við góðumvenligt;í góðum lagi godt humør;í øllum góðumhelskindet, uskadt, i god behold;teir komu aftur í øllum góðumde kom hjem igen i god behold2fremragende, enestående(af kvalitet, karakter etc.),í góðum árumi sin bedste alder;góður dugurgod kvalitet;góður friður;fáa góðan frið;eg havi gjørt tær ein góðan munn(en god kop te / kaffe);ein góðan mun frægarien hel del bedre;hava góð ráðvære velbemidlet, være velstående;góður streymurgunstige strømforhold;tað góða erheldigvis;av góðum hugaivrigt;góður at heita áhjælpsom;góður í ávikumtjenstvillig, hjælpsom;tað skal eg vera góður fyridet skal jeg garantere for;eg havi fingið gott í beinini(fået sund mad i opvæksten);tað er fyri góðum(nyttigt);hvat ger hann fyri gott?hvad laver han?;alt gekk av í góðum(endte godt);teir komu til góðsde blev enige;síggja e-m til góða(r)tage sig af en, sørge for en;alt gott um hannikke et ondt ord om ham;(ordsp.)góður er gamalur í ráðumden gamle giver gode råd;tað er gott í hesum(af slidstærkt materiale);apríl byrjaði og endaði við góðum(godt vejr);bera e-m alt gottgive en et godt skudsmål;gera sær gottel.til góðar av e-mtage for sig af noget(fx god mad);gott er í sjónumsøen er rolig;teir fóru eftir hesum góða oksade gik for at hente den førnævnte okse;av góðum fólkiaf god herkomst3(hilsen)góðan morgun;góðan dagel.dagin!;gott kvøld!;góða nátt!4rigelig, god,við góðari kenninghalvfuld;eina góða løtuet godt stykke tid;geva sær góða tíðgive sig god tid;ein góðan tímagodt en time5nem,góður at kennalet genkendelig;góður at síggjanem at se, få øje på6gott og vælgodt og vel;gott og væl eitt árgodt og vel et år;gott íel.á tegvær så venlig7haldið mær til góða(r)!undskyld mig!;gott erdet er godt nok, blæse være med det!
góðvani	god vane
góðvarasnið	(lingv.)kæleform
góðvarin	godtroende, naiv,hon var altíð so góðvarinhun var altid så godtroende;(ordsp.)góðvarin maður kemur seinastur í himmiríkiden godtroende får ofte den ringeste del, bliver ofte den forurettede
góðvarni	godtroenhed, naivitet, tossegodhed
góðveður	godt vejr,bæði í óveðri og góðveðribåde i dårligt vejr og godt vejr
góðveðursdagur	dag med smukt vejr
góðveðursløta	(kort) stund med smukt vejr
góðverk	(bibl.)god gerning
góðviðrað	med vedvarende godt vejr
góðviðri	godt vejr
góðvild	god vilje, godhed
góðviljaður	med god vilje,vera e-m góðviljaðurvise god vilje imod nogenel.noget
góðvilji	god vilje, godhed,við góðviljamed god vilje
góðvinur	god ven
Góðvónarhøvdi	(stedn.)Kap det Gode Håb
góðvættur	god ånd, god vætte
góðynski	gode ønsker
gól1	larm, skrig, skrål
gól2	segala
góla	1(om fugle)skrige,likkurnar gólaðusildemågerne skreg2(om folk)larme, skrige, skråle,sita og gólasidde og skråle
gólan	larm, skrig, skrål
gólv	1(husbyg.)gulv,á gólvinumpå gulvet;fram á gólvud af sengen;ganga upp um gólviðgå frem og tilbage (på gulvet);ganga (fara, støkka) inn á gólviðel.gólv hjá e-mkomme på (kort) besøg;eg var inni á gólvinumel.gólvi hjá honum;(talem.)síggja niður í svart gólvikke have noget at slagte;turt gólv;(om filetfabrik)ingen fisk til bearbejdning,tað er turt gólv á flakavirkinum;sjógvurin er (slættur) sum gólviðsøen er spejlglat;tað er sum á gólvinumhavet er (helt) roligt;fáa úr gólvi(num)opdrage,tað er ikki lítið arbeiði at fáa tíggju børn úr gólvi(num)2dansegulv,fara upp á gólvforme en rundkreds til (færøsk) dans;tátturin er ofta kvøðin á gólvi3barselseng,farael.falla í gólvsnart skulle føde, komme i barsel(s)seng;liggja í gólvi;hon doyði í gólvi(i barsel(s)seng)
gólvborð	gulvbræt
gólvbust	gulvskrubbe
gólvbúni	gulvbelægning
gólvfjøl	gulvbræt
gólvflís	gulvflise
gólvklædningur	gulvbeklædning
gólvleingja	løber, gulvløber
gólvleypari	løber, gulvløber
gólvlisti	(husbyg.)fejeliste
gólvmál	gulvareal
gólvskarn	gulvsnavs
gólvskitin	møgbeskidt,hundarnir komu inn so gólvskitnirhundene kom ind så møgbeskidte
gólvskrubba	gulvskrubbe
gólvslættur	jævn som et gulv
gólvsóp	fejeskarn,gólvsópið lá tjúkt í krókunum
gólvsópskøstur	fejeskarnsdynge, affaldsdynge
gólvteppi	gulvtæppe
gólvtorv	i ordforb.standa sum gólvtorvstå som sild i en tønde
gólvtvøga	gulvklud
gólvuppboðssøla	fiskeauktion(i stor hal)
gólvvídd	gulvareal
gómaljóð	(lingv.)ganelyd, palatal
gómapípa	(biol.)ganebue(Tuba auditiva)
gómaturrur	tørstig
gómi	(biol.)gane
gómur	gane
góri	mørk tværstribe (på himlen),hann setur górar á luftinader danner sig mørke striber på himlen(varsel om regn)
górutur	1(om farve på uld)liggende midt imellem hvidt og sort2(om himmelen)med mørke tværstriber,górut luft
góta	se nøje efter, følge enel.noget (nøje) med øjnene, stirre,góta eftir e-mstirre på en;góta ein ígjøgnumgennemstirre en
gótu	segita 2
góvu	segeva
grabba	1grave op med grab,sandbáturin grabbar sand upp av botninumsandsugeren graver sand op fra bunden2(spøg.)grabse(til sig med begge hænder)
grabbari	grab
grabbi	grab
gradligur	(vulg.)ret begærlig;-liga
graðhestur	hingst
graðpirra	graðpirrur(spøg.)filipenser
graður	1(om handyr)ikke kastreret,graður hesturhingst2(om handyr)brunstig3(vulg.)(om folk)begærlig
grafikari	grafiker
grafikkur	grafik
grafiskur	grafisk,grafiskur verkstaðurgrafisk værksted
grafitt	(kem.)grafit
gramdi	segremja
graml	1forlydende, rygte, opspind, sladder,hoyra graml um e-thøre rygter om noget2anelse, formodning, mistanke,hava graml um (e-t)have en anelse om (noget), have noget på fornemmelsen;hann hevði ikki graml um at bera seg athan anede ikke hvordan han skulle opføre sig;vera á gramlinumantyde noget
gramla	antyde, ymte,gramla (um e-t)antyde (noget);tað gramlaðist um, at ...det forlød, at ...
gramm	(vægt)gram(fork.g)
grammast	grammast eftir e-mvære ivrig efter noget
grammleiki	grådighed
grammligur	1vredladen, bøs, vred2temmelig begærlig, grådig;-liga
grammofon	grammofon
grammofonpláta	grammofonplade
grammur	ivrig, begærlig, opsat på,grammur eftir e-mivrig efter noget;grammur í hugaaggressiv;grammur eftir at fáahavesyg, grisk;grammur at stjalaslem til at stjæle
grams	(koll.)noget der er (for) småt og værdiløst(fx om fisk),gramsið varð tveitt fyri borð afturde små fisk blev smidt i havet igen
gramsa	1rage til sig2tage "grams"
granar	segron
granarbein	næseben (på pattedyr og fisk)
granarhár	knurhår, børste
granarslupur	slubretel.slimet masse(spec. geléagtigt kød i torskehoveder)
granarstykki	stykke af et kohoved
granat	(militær)granat
grand	1skade, men,vera e-m at grandivolde én skade2(bot.)nederste del af en kvan
granda	skade,einki skal henni grandaintet skal skade hende;eg havi ikki grandað lund í mín dagjeg har aldrig stjålet det mindste
grandi	lav landtange
granitt	(geol.)granit
grann1	1(bot.)grantræ, tømmer af gran2bundt af grene fra grantræ(som pynt),eldur kom í grannið
grann2	(kortspil)grand
granna1	granna tilvære naboer til
granna2	(kortspil)melde grand
grannabygd	nabobygd
grannafólk	naboer
grannafriður	fredeligt naboskab
grannahagi	nabogræsgang
grannahandil	nærbutik
grannahús	nabohus
grannaklandur	nabostrid
grannakona	naboerske, nabokone
grannalag	nabolag
grannaland	naboland
grannamál	nabosprog
grannaoyggj	naboø
grannaseyður	får fra nabogræsgang
grannaskikkur	i ordforb. somfara til grannaskikkrejse om for at holde grandestævne(om sysselmanden og hans "kalsmenn"),halda grannaskikkholde grandestævne
grannasókn	nabosogn
grannastevna	grandestævne, grandemøde(hvor en bygds jordbesiddere, under sysselmandens ledelse, afgør lokale uoverensstemmelserel.opretter vedtægter)
grannastríð	nabostrid
grannatjóð	nabofolk, nabonation
granngrein	grangren
grannhavandi	i ordforb. somikki grannhavandiikke til at have med at gøre
granni	nabo,vit eru næstu grannarvi er nærmeste naboer;hann var eingin grannihan er en dårlig nabo;teir vóru eingir grannarde havde et dårligt naboskab
grannkona	naboerske, nabokone
grannkongul	(bot.)grankogle
grannlýsi	(astronomi)grannlýsiðmælkevejen
grannnál	nål fra grantræ
grannsíggin	som ser nøje efter, som lægger nøje mærke til noget
grannskoða	(økon.)revidere,grannskoðaður roknskapurrevideret regnskab
grannskoðan	(økon.)revision(af regnskab)
grannskoðari	(økon.)revisor
grannskógur	(bot.)granskov
grannskygdur	skarpsynet
granntræ	grantræ
grannur	(om garnel.tråd)tynd, fin
grannvaksin	granvoksen(høj og slank)
grannvandin	pirrelig, kort for hovedet
grannviður	gran
granska	forske, granske, undersøge
granskan	forskning
granskari	forsker, gransker
gransking	forskning
granskingarráð	forskningsråd
granskingarstovnur	forskningsinstitut
granskingarstyrkur	stipendium
gras	græs,velta undir grasbehandle jorden til græs;tað, sum grasið bítur(omskrivning for får i modsætning til fisk);(talem.)vera býttari enn tað, ið grasið bítur(om en enfoldig person);koma aftur á grønt gras1have fast grund (el. jord) under fødderne2genvinde sit helbred,hann man ikki fara at koma aftur á grønt grashan kommer næppe til kræfter igen;leggjastel.falla á grøsini1(om kreatur)finde sig anden græsgang2(overf.)(om folk)blive boende på et (fremmed) sted;brimið stendur (upp) í grasiðbrændingen går helt op til græsset i kystkanten
grasaður	græsgroet,oyggin er so væl grasaðøen er så smukt groet med græs
grasagarður	(kvad)have,í miðjum grasagarði akslar hann sítt skinn
grasár	år mht. græsvækst,gott / ringt grasár
grasbakki	græsbevokset grøftekant
grasbeittur	(om kalvel.lam)som er begyndt at spise græs
grasbitin	(om lam, kalv og gæsling)som er begyndt at spise græs,tá ið lambið er 14 dagar gamalt, søgdu teir, at tað var grasbitiðnår lammet er 14 dage gammelt, blev det sagt, at det var i stand til at spise græs
grasbýti	ret til græshøst (på et stykke indmark) gående på omgang
grasbøkkur	lille græsbevokset plet i stejlfjeld
grasbøur	græsmark,góður grasbøurgod græsmark
grasdjór	græsædende dyr,i ordforb.etur sum eitt grasdjór(om grovæder)
grasdýr	græsædende dyr(får, kvæg, heste),at vera sum tað, ið grasið bíturat være enfoldig, at være uvidende
grasendi	(mar.)tovende af græs
grasfeingi	græsvækst, forekomst af græs
grasfløta	1græsbevokset slette2græsplæne, plæne
grasfløttur	1græsbevokset plet i (stejle) fjelde2græsplæne, plæne
grasfríður	smukt græsbevokset
grasfræ	græsfrø
grasgarður	have
grasgóður	græsrig, med frodig græsvækst,grasgóður bøurindmark med frodig græsvækst
grasgrógva	blive græsgroet
grasgrógvin	græsgroet
grasgrøði	græsvækst
grasgrønur	græsgrøn
grashani	(spøg.)landkrabbe
grashjalli	græsbevokset (bred) afsats i en bjergside
grashoppa	(zoo.)græshoppe(Orthoptera)
grasing	strandbrinkens (nederste) græsgrænse
grasjørð	areal hvor græs gror
graskar	(bot.)græskar
grasker	(bot.)græskar
graskyka	græsspire, græsstrå
graslendi	græsmark, græsland
grasleykur	(bot.)purløg
graslíki	kunstgræs
graslíkisvøllur	(idr.)kunstgræsbane
grasloppur	tot græs
grasloysi	mangel på græs, ualmindelig dårlig græsvækst
grasmikil	græsrig, med frodig græsvækst,har er so grasmikið
grasnál	græsspire
grasnám	strandbrinkens (nederste) græsgrænse
grasormur	(zoo.)larve af stankelben(Tipulidae)
grasrók	græsbevokset klippeafsats
grasrót	græsrod
grassina	fiber af græs
grassíður	med højt græs
grasslag	græsart
grassoppur	håndfuldel.smule græs
grasspell	græstab
grasstrá	græsstrå
grassvørður	grønsvær
grastari	(bot.)bændeltang(Zostera marina)
grastekja	græstørvtag
grastorva	græsbevokset afsats i klippevæg
grastúgva	græsbevokset tue
grastøð	(landbr.)græsgødning
grasvaksin	græsbevokset,grasvaksin túgvagræsbevokset tue
grasvallaður	græsbevokset
grasvelta1	agerstykke behandlet om vinteren til græs(grønsværen løsnes og vendes med gødning under)
grasvelta2	behandle jorden til græs
grasvøkstur	góður / ringur grasvøksturgod / dårlig græsvækst
grasvøllur	1græsplæne, plæne2(idr.)græsplæne, plæne
grasætt	(bot.)græsfamilien(Poaceae)
gratt	segretta,graður
grava	1grave(med spade o.lign.),grava flaggrave græstørvstrimler løse;grava gjargrave (med spade) rur løs(til lokkemad);grava kavaskovle sne bort;grava eftir e-mgrave efter noget;grava eftir gulli;standa sum grivinstå aldeles forbløffet2skrabe,grava rust av ringunum3klø sig,hann grevur sær millum herðarnar4begrave,hann liggur grivin harhan ligger begravet der5(fx om båd og skib)sejle med stærk fart så at skummet står fra boven,báturin gróv seg inneftir;grava (oman) avgrave grønsværen af;grava niðurnedgrave,grava seg niður í hoyggiðgrave sig ned i høet;grava uppgrave op,grava upp hagaskera upp haga;grava útgrave ud,hann er farin at grava út
gravan	voldsom blæst,ein gravan í vindistiv kuling, streng vind
gravarbakki	randen af en grav(til døde),vera komin á gravarbakka(n)være døden nær, være hendøende
gravardagur	begravelsesdag
gravarferð	begravelse
gravarfriður	gravfred,bróta gravarfriðinkrænke gravfreden
gravarfylgi	ligfølge
gravarførur	i ordforb.ikki gravarførur1(om får om foråret)så udmagret at det ikke kan springe over en grøft2(overf.)(om mennesker)afkræftet(pga. alderel.sygdom)
gravari	graver
gravarlov	eftermæle, rosende omtale som man bliver genstand for efter sin død,tað var eitt gravarlov, hann fekk
gravarmunni	gravåbning,settu stóran stein fyri gravarmunnande satte en stor sten for gravhøjens åbning
gravarsálmur	begravelsessalme
gravarskari	ligfølge
gravartøgn	dødstilhed
gravdýpi	(bibl.)gravens dyb
gravgangur	rift,gravgangur eftir (e-m)rift om noget
gravhús	mausoleum
gravimaskina	gravemaskine, gravko
gravir	segrøv
gravkrossur	gravkors
gravkúgv	gravemaskine, gravko
gravkvirrur	bomstille, musestille, dødstille,hann situr gravkvirrur og hyggur beint fram fyri seghan sidder musestille og stirrer lige ud
gravkyrrur	bomstille, musestille, dødstille
gravlaksur	gravlaks
gravlegging	(bibl.)begravelse,gravlegging Jesusar
gravleggja	begrave
gravleiði	grav
gravrustaður	med gravrust, næsten fortæret af rust
gravsálmur	begravelsessalme
gravseta	begrave
gravseting	begravelse
gravskitin	møgbeskidt
gravsongur	begravelsessalme
gravsteinur	gravsten
gravstillur	bomstille, musestille, dødstille
gravtala	ligtale
grábeintur	i ordforb.hin grábeintifanden
grábláur	gråblå
grábleikur	gråbleg,ein grábleikur summarmorgunen gråbleg sommermorgen
grábrúnur	gråbrun
grábøka	(ornitol.)bjergand(Aythya marila)
grábøkutur	(om gås)med grålig farve på ryggen,grábøkut ontbjergand
grádeplutur	gråplettet
grádæmdur	grå i ansigtet,grádæmt andlit;grádæmdur sjógvurgrålig sø
gráða	(om vind)kruse havets overflade,nú gráðar út frá landi
gráði	svag vind som kruser havets overflade, parti af søen med krusninger,tað var ein gráði á sjónumder var en svag vind som krusede havets overflade
grágás	(ornitol.)grågås(Anser anser)
grágrýti	(geol.)kampesten
grágrælingur	(ornitol.)sortgrå ryle(Calidris maritima)
grágrønur	grågrøn
grágulur	grågul
gráhara	(zoo.)den europæiske hare(Lepus europaeus)
gráhávur	(fisk.)gråhaj(Galeorhinus galeus)
gráheili	(biol.)grå dele af hjernen
gráhvítur	råhvid, grålighvid
gráhærdur	gråhåret,ein gráhærdur maðuren gråhåret mand
grái	1grå plet på ellers snedækket jord2den første anelse af land i tåge,eg síggi gráan av landi3grå farve,dagar og nætur renna saman í ein einlittan gráadage og nætter løber sammen i en eneste grå farve
gráin	i ordforb.við gráin takkel.við sítt gráin skinnmed uforrettet sag;koma aftur við gráin takkkomme tilbage med uforrettet sag
grákaldur	(om vejr)kold og med mange lave mørke skyer,ein grákaldan morgunen grå og kold morgen
gráklæddur	i gråt tøj,ein gráklæddur maðuren mand i gråt tøj
gráleiki	det at noget er gråt
gráleittur	grålig,gráleitt luftgrålig luft
gráligur	grålig,kalt og gráligt veðurkoldt og gråligt vejr
grálittur	grålig
grálýsi	dagning, daggry
grámaðkur	(zoo.)regnorm(Allobophora caliginosa)
grámilti	i ordforb. somhatta er sum eitt grámilti (í andlitinum)han / hun er forfrossen (af udseende), gusten
grámulta	(fisk.)tyklæbet multe
grámurtur	(neds.)ganske lille fisk,vit fingu bara nakrar grámurtar
grána	1gråne, blive grå,hann er farin at gránahan er begyndt at blive gråhåret2(om vejr)blive skyet,nú gránar3i ordforb. somnú fer at grána gamanel.nú gránar gamannu bliver spøgen alvor
gráoygdur	med grå øjne
grápílur	(bot.)blågrå pil(Salix glauca)
grárognkelsi	(fisk.)kvabso, kulso
gráryggjutur	(om kvæg)med grå sider og hvid ryg
grásalva	lusesalve(ungventum hydrargyri)
grásálva	lusesalve
grásíl	lille bækørred
gráskalli	1(noaord)sæl2(spøg.)gammel gråhåret mand
gráskeggjutur	gråskægget,gráskeggjutur maðurgråskægget mand
gráskinn	(kvad)gråskind, gråværk(især egernskind)
gráskýggjað	(om vejr)med grå skyer
grásprongdur	(om hår el. skæg)gråsprængt
grásprøklutur	gråbroget,skurapisan er grásprøklutden lille mågeunge er gråbroget
gráspurvur	(ornitol.)gråspurv(Passer domesticus)
gráspølutur	gråstribet,pisan er gráspølutfugleungen er gråstribet
grástar	(med.)grå stær(cataracta)
grásteinur	(geol.)kampesten
grásúla	(ornitol.)havsule i sit første år efter at den har fældet dundragten,grásúlu taka teir um heystið
gráta	1græde, udgyde tårer,gráta av sorg, gleðio.lign.græde af sorg, glæde o.lign.;skera útúr at grátabriste i gråd;gráta og illa látajamre og klage;gráta í kíkiel.klumsigræde så man er ved at kvæles;gráta einel.um einbegræde, sørge over2småregne, støvregne,útsynningur græturder er småregn i vinden fra sydvest
grátinna	(geol.)fyrsten, flint(kalcedon)
grátítlingur	(ornitol.)skærpiber(Anthus petrosus)
grátkendur	grædefærdig,við grátkendari røddmed grædefærdig stemme
grátkomin	grædefærdig
grátkøvdur	grådkvalt, tårekvalt
grátoygdur	med forgrædte øjne
grátrødd	grædende, klynkende stemme
grátsrødd	grædende, klynkende stemme
grátsøtur	sentimental,grátsøtar søgursentimentale historier
grátukona	(om udenlandske forhold)grædekone
grátuligur	i ordforb. somtað er bæði láturligt og grátuligtdet er til at le og græde over, det er tragikomisk;-liga
grátur	gråd,skera í grátbriste i gråd;skera í sjóðheitan grát(begynde at) tudbrøle;flúgva í grátbriste i gråd;(ordsp.)eftir látur kemur gráturefter den søde kløe kommer den sure svie
gráturødd	grædende, klynkende stemme,siga e-t við gráturødd
grátusperðil	(neds.)barn der græder meget
grátusurra	barn der græder meget
grátutur	som ser grædefærdig ud,við grátutum eygummed grædefærdige øjne
gráur	1grå2gråhåret,hann er vorðin so gráurhan er blevet så gråhåret3(zoo.)grátt undir steinibænkebidere(Oniscoidea)4hin grái1fanden, djævelen2(noaord)sæl5(noaord)tær gráumus6hin gráaverden;(talem.)hin gráa temur(sagt om uartig ungdom som fx laver noget i kådhed)
gráverk	gråskind, gråværk(især egernskind)
greði	1(om dyr)brunst2(vulg.)fysisk begær
greðingur	(zoo.)hingst
greðungur	(zoo.)tyr,(talem.)(illur) sum greðungur á gori(vred) som en olm tyr, aldeles rasende;ganga sum greðungur á gorivære stærkt forhippet i noget
grefligur	grov, plump, (alt for) storel.iøjnefaldende,stór og greflig var honhun var stor og havde grove ansigtstræk;grefligur í ásjónmed store, grove ansigtstræk;stórur og grefligur;-liga
gregorianskur	gregorianska tíðarrokningingregoriansk kalender
greidleiki	klarhed, tydelighed, orden
greidligur	klar, tydelig,greidligt svartydeligt svar;-liga
greiða1	1i ordforb. somfáa (hava) greiðu á (e-m)få (have) rede på (noget);gera greiðu fyri (e-m)forklare2greiðurgrejer, redskaber, udstyr3(talesp.)i ordforb. somfínar greiðurmægtigt, dejligt,tað eru fínar greiðurdet er fint
greiða2	1udrede, ordne,greiða fløkjunaudrede forviklingen;greiða línuordne en line;greiða snøri2rede, kæmme,greiða særel.greiða háriðrede sit hår;greiða sær reikrede skilning3være i stand til, klare, løse,greiða spurninginløse problemet;greiða ætt sínaudrede sin slægt4levere, udlevere,greiða til prentingargøre trykklar5udrede, betale,greiða gjaldbetale;greiða e-m bøturbetale bøder (til nogen);greiða atkvøðu (fyri / ímóti)stemme for / imod (noget);greiða afturlevere tilbage;greiða av hondumudlevere;greiða væl / illa úr hondumudføre (et arbejde) godt / dårligt6sige, gøre rede for (noget),so er greitt fyri mær;greiða fráfortælle, forklare,hon dugir væl at greiða fráhun er god til at fortælle
greiði1	fáa (hava) greiði á e-mfå (have) rede på noget
greiði2	(kvad)god modtagelse, gæstfrihed
greiðikambur	redekam, kam
greiðiliga	tydeligt, klart
greiðing	frisering
greiðkambur	redekam, kam
greiðsamligur	med klarhed, med tydelighed,tað verður ikki greiðsamligtdet bliver ikke så let at udrede;jf.ó-
greiðsla	1udredning, løsning(fx af et problem)2betaling
greiðsluevni	problem, problemstilling
greiðslumyndil	forklaringsmodel
greiðsluorðing	problemformulering
greiðslurokning	(skole)problemregning
greiðtóni	klartone,bíða eftir greiðtónavente på klartone
greiður	1klar, utvetydig, rede,greitt svarklart svar;tað er ikki greitt, hvør gjørdi taðdet er ikke klart, hvem gjorde det;tað er greittdet er klart;mær er greitt, at...el.(talesp.)eg eri greiður um taðjeg er klar over det;stutt og greittkort og godt2mild, føjelig, medgørlig,hann er ikki greiður at hava við at gerahan var umedgørlig;tá var ikki so greitt at ferðast sum núda var det ikke så nemt at rejse som nu;greiðasta leiðin var ...den hurtigste vej var ...
grein1	1gren, kvist,høgga greinar av trænumhugge grene af træet2slægtsgren,vit eru av somu greinvi er af samme slægt3fag, videnskabsgren4art,músin hevur broytt seg bæði í vøkstri og lívi, at hon nú kann eitast at vera ein serstøk grein5artikel(fx i avis)6paragraf, lovparagraf,fyrsta grein, onnur grein;sambært grein 5 er hetta ólógligt7ordbogsartikel8profil,fjøllini standa við skørðutum greinum9omrids, linje,greinin um sólina sást gjøllari10fornuft, rigtighed,hava grein í sínum málihave (nogen) ret i det man siger;gera grein ímillumskelne imellem;gera grein fyri e-mredegøre for noget, forklare noget;gera sær grein fyri (e-m)gøre sig klart
grein2	segrína
greina	1skelne (imellem),greina ímillumgøre rede for, forklare2analysere, behandle, udrede,greina e-m e-tudrede noget for nogen;greina stuttsøgur og yrkingaranalysere noveller og digte;(kvad)so er greint fyri mærsådan er mig fortalt;greina fráforklare;greinael.greina sunduranalysere;greina útforklare, belyse3greina seg sundurel.greinastforgrene sig
greinarendi	(bot.)spidsen på en gren
greinargerð	redegørelse, betænkning
greinargóður	fornuftig og klar,greinargóð frágreiðingfornuftig og klar redegørelse
greinarmunur	forskel
greinarskil	i ordforb. somhava greinarskil ákunne skelne imellem, have rede på;hava greinarskil á e-m
greinarstubbi	1stump af en gren2kort artikel
greinarøð	artikelserie
greinasavn	artikelsamling
greinaval	(skole)valg af fag
greindur	segreina
greiniligur	tydelig, klar, indgående, udførlig,merkini eru greiniligmærkerne er tydelige;-liga,frætta greiniligarihøre nærmere
greining	1redegørelse2analyse
greiningarháttur	(litt.)(litterær) analysemetode
greiningarmyndil	(skole)analysemodel(fx til litteratur)
greinlærari	(skole)faglærer
greinskrivari	artikelforfatter
greinutur	grenet,greinutur vøksturgrenet vækst
greip	segrípa
greipa1	1sammenbundet par(spec. to fisk til tørring),(overf.,spøg.)tað er ein greipa!det er et nydeligt par!2(idr.)vinna greipunavinde "the double"
greipa2	binde sammen parvis(spec. to fisk),tit áttu at verið greipað bæðiI er lige gode om det;reka greipaðan seyðdrive to sammenbundne får;eg verði greipaðurjeg har kun fanget en fisk
greiping	det at binde (fisk) sammen parvis
greipingartráður	tråd til parvis sammenbinding af fisk
greipt	(poet.)omfavnelse,læsa saman í harðari greipt
greipufiskur	fisk ophængt parvis til tørring
greiputráður	tråd til parvis sammenbinding af fisk
greivabiti	fedt stykke på boven af (tørret) fårekrop
greivadømi	1grevskab2administrativt område(fx i England)
greivafrú	grevinde
greivafrúgv	grevinde
greivansbiti	fedt stykke på boven af (tørret) fårekrop
greivi	greve
grell	1ganske små fisk(torskel.kuller),teir fingu einans fimm grellde fik kun fem små fisk2(overf.,neds.)småbørn
gremi	vrede, harme
gremja1	bekymring, græmmelse,til mikla sorg og gremjutil stor sorg og bekymring
gremja2	gremja seggræmme sig, beklage;gremja seg um e-tbeklage sig over noget;gremja seg fyri e-mbeklage sig over for nogen
gremjan	bekymring, græmmelse,sorg og gremjansorg og bekymring
gremjing	bekymring, græmmelse
gremjukendur	bedrøvet, modløs
gremjumikil	fuld af bekymring,ein long gremjumikil prædikaen lang prædiken fuld af bekymring
Grenada	Grenada
grenadabúgvi	grenadier
grenadiskur	grenadisk
grenj	1knurren, knurrendeel.knirkende lyd,grenjið í tollunumknirkende lyde fra åretoldene2kværulanteri3utilfreds person,hon er eitt gamalt grenjhun er en rigtig utilfreds person
grenja	1knirke2(om personer)være utilfreds, give ondt af sig,ganga og grenja um e-tgå og være utilfreds med noget3(om dyr fx hund)knurre, gø
grenjan	kværulanteri
grenjisurra	gnaven person(især om børn)
grenjutur	gnaven, klynkende, knarvorn
greppur	(kvad)kæmpe, jætte,vær grípum tann greppin inni
gresiligur	(talesp.)forfærdelig, frygtelig, grufuld;-liga
gresj	knasende lyd
gresja	1knase,gresja bommini millum tenninarknase bolcherne mellem tænderne2give en ubehagelig skarp, skrigende lyd
gresjaður	græsgroet,vegurin er gresjaðurvejen er græsgroet
gressiligur	(talesp.)forfærdelig, frygtelig, grufuld,gressiligt regnforfærdelig regn;-liga
grett	eitt grett størrien lille smule større
gretta	el.1i ordforb. somikki grettaikke sige et ord,hann gretti ikki um hettahan sagde ikke et ord om dette;hon gretti tað ikki fyri nøkrumhun sagde det ikke til nogen;ikki varð orð grett teirra millumde sagde ikke et ord til hinanden;eg havi ikki hoyrt tað grettjeg har ikke hørt et muk om det2tað gretturel.grettir ikkidet slår ikke fejl;honum gratt ikki blakhan ramte ved hvert kast;tað grettir ikki fyri honumhan rammer hver gang;honum grettir ikki á at komadet er helt sikkert at han kommer3hejse,gretta mannin niður í lastinahejse manden ned i lasten4(om søm)glide ud
grettur	i ordforb.ein grett lægri, størri, meiriosv.en lille smule lavere, større, mere osv.
grev	1spadejern2(om mennesker)et jern til arbejde, slider, arbejdsnarkoman,hon er eitt grevhun er en slider
grevjass	(kortspil)kortspil hvor knægten er højeste kort
grevlingur	(zoo.)grævling(Meles meles)
grevstrarhundur	gravhund
grevstur	el.1gravning2grav, gravsted, begravelsesplads3stærk storm med høj søgang
grevur	segrava
greypfrukt	(bot.)grape
greytarbak	grødomslag
greytardagur	dag hvor der var grød til middag(især ombord på skib)
greytarfat	grødfad
greytarheili	grødhoved
greytarkendur	grødagtig, grødlignende
greytarmoli	i ordforb.í greytarmolari stumper og stykker
greytarpottur	grødgryde
greytarskón	skover
greytarsleiv	ske at øse grød op med
greytarsneis	redskab til at røre i grødgryden med(træpind forsynet med takker i den ene ende),(talem.)(nipin) sum slokt greytarsneismeget flov
greytarspónur	1ske til grød2skefuld grød
greytarsvartur	(om tåge)overmåde tyk,greytarsvart í mjørka
greytartjúkkur	(om tåge)overmåde tyk, meget tyk,greytartjúkt í mjørkael.greytartjúkkur mjørkioverordentlig tæt tåge
greytheili	(neds.)grødhoved
greytsvartur	(om tåge)overmåde tyk, meget tyk
greyttjúkkur	(om tåge)overmåde tyk, meget tyk
greytur	grød, grødet masse,(talem.)seta spónin í greytinbegynde på noget;tað er ikki greytur at grína atdet er ikke noget at le ad;gelda greytkomme salt i grød;(talem.)sita við tunnan greythave lidt at spise
grið	i ordforb. somfara av grið (at leita)søge til man finder;leypa á griðskynde sig af sted
griðleysur	fredløs, uden fred og sikkerhed,friðleysur og griðleysur skalt tú fjakka um á jørðini
griðloysi	fredløshed
griðstaður	(bibl.)tilflugtssted,finna í oyðimørk ein griðstaðfinde tilflugtssted i ørkenen
griður	fred, sikkerhed, tryghed, amnesti,biðja um griðbede om amnesti;geva grið og friðgive pardon
griffil	griffel
grift	1grøft,(kvad)grav tú griftir tríggjar2kølvand
Grikkaland	Grækenland
grikki	græker
Grikkland	Grækenland
grikskkatólskur	(rel.)grikskkatólska kirkjanden græskkatolske kirke
grikskur	græsk
grill	1grillrist2grill3grillbar
grilla	grille, grillstege,grilla pylsurgrille pølser
grillbarr	grillbar
grillmatur	grillmad
grima	blive tyndereel.lysere,i ordforb. somtað grimir í ælinumbygen er blevet tyndere;tað grimir ikki í ælinumbygen er så tæt at man ingenting kan se;nú grimir í kavanumnu begynder jorden at blive bar;tað grimir ikki í kavanumsneen ligger så tyk at der ikke er en mørk plet at se
grimast	i ordforb.grimast áblive ivrigere (med noget);tey grimast á at dansa
grimd	1av grimdmed stor kraft;rógva, syftaosv.av grimdro, kaste osv. med voldsomhedel.kraft;tað regnar av grimddet styrtregner2(kvad)vrede, hidsighed, arrigskab,av grimd og reiði
grimdarfok	voldsomt snefog
grimdarfrost	klingende frost
grimdargangur	støjende adfærd
grimdarhugur	vrede, barbari, grusomhed
grimdarmikil	grusom,grimdarmikil valdsharrigrusom hersker
grimdarregn	slagregn, øsregn
grimdarskúrur	voldsom regnbyge
grimdarstríð	rasende kamp
grimdarvørrur	(om hval)voldsom bevægelse (med halen),hvalurin gjørdi ein grimdarvørr
grimdaræl	voldsom regnbyge
grimilsi	i ordforb.ríða grimilsivippe(en leg)
grimmliga	(kvad)voldsomt,Sjúrður høgg so grimmliga
grimmur	1grum, forbitret2af frygtindgydende udseende,hesin grimmi risidenne frygtindgydende jætte
grimur	1grum, forbitret2af frygtindgydende udseende
grin	grin, grinen
grind1	1flok grindehvaler,(talem.)her er roykur og eingin grinddet er blind alarm2kød og spæk af grindehval,etael.fáa grind til døgurðaspise el. få hvalkød og spæk til middag3grindefangst,fara í grindtage af sted til grindefangst;rógva sum í grindro med stor hastighed;eg hitti hann í eini grindjeg mødte ham under en grindefangst4(overf.)uventet kødspise(af får el. okse),hetta var vorðið sum grind at fáa(om slagtning uden for slagtetid af okse el. fedt får)
grind2	1(husbyg.)ramme, især (i huse) anlægget af fodstykker og bjælker2portel.led i digeel.hegn, låge3gitter
grinda1	(om en flok grindehvaler)ligge stille med hovederne i vandskorpen for at hvileel.sove,bólkurin stendur og grindar
grinda2	(husbyg.)lægge fundamentet til et hus(dvs. fodstykker og bjælker),grinda eini hús
grindaár	år (godtel.dårligt) mht. grindefangst,gott / ringt grindaár
grindabátur	båd tilel.med grindefangst
grindabein	ben af grindehval
grindabiti	stykke (grinde)hvalkød
grindablástur	vandsøjle frembragt ved grindehvals (el.-hvalers) udånding
grindablóð	blod fra dræbt(e) grindehval(er)
grindablóstur	vandsøjle frembragt ved grindehvals (el.-hvalers) udånding
grindaboð	råbel.tegn (især ved røgsignal) for at meddele opdagelse af en grindeflok,rópa grindaboð:tað fór sum grindaboð um alt landiðdet gik som løbeild
grindabolli	det øverste af hovedet (der ses stikkende op af vandet) af grindehval
grindabólkur	mindre flok grindehvaler (løsrevet fra en større)
grindabýti	fordeling af (et parti af) grindefangsten
grindadansur	dans efter endt grindefangst,sum í grindadansi(om sammenkomst hvor der kun var mænd til stede)
grindadráp	grindefangst(aflivning af grindehvaler)
grindafarmur	(båd)ladning med grindekød og -spæk
grindaferð	bådrejse til og fra grindefangst
grindafiskur	grindehval
grindaflógv	stak saltet grindekød
grindaformaður	(lovformelig udpeget) leder af grindefangst
grindaførningur	(båd)ladning med grindekød og -spæk
grindageisli	ryghvirvel af grindehval
grindahugur	lyst til at deltage i grindefangst
grindahvalur	(zoo.)grindehval(Globicephala melas)
grindahvølja	hud (skind) af grindehval
grindahvølpur	grindehvalens unge
grindakast	sten man kaster i søen ved inddrivning af en flok hvaler
grindakempa	kæbeben af grindehval(anvendt som øseske o.lign.)
grindakeyp	køb af grindekød og grindespæk
grindakíkur	mavesæk af grindehval
grindaknívur	(stor) kniv der bruges ved grindefangst
grindakúla	hoved af (især aflivet) grindehval
grindalaki	lage til kød og spæk af grindehval
grindaleysur	uden grindefangst,tey grindaleysu áriniårene hvor der ingen grindefangst var
grindalisti	fortegnelse over de personer der er berettiget til at få andel i udbyttet af grindefangst
grindalokkur	(zoo.)stankelben, langbenet myg(Tipulidae)
grindaloysi	periode uden fangst af grindehvaler
grindalóg	lov vedr. grindefangst(ang. fangst, drab, fordeling o.a.)
grindalykkja	(langt og smalt) stykke (af det magre) kød af grindehval ophængt (til tørring)
grindalýsi	tran (olie) af grindehval
grindamaður	deltager i grindefangst
grindamerking	det at mærke grindehvaler
grindamjørki	tæt tåge under hvilken grindeflokke kan forvilde sig ind mellem øerne
grindapartur	andel i grindefangst
grindapottur	gryde med grindekød og grindespæk
grindaprestur	i ordforb.góður grindapresturpræst i hvis embedstid der kommer mange grindeflokke
grindar-	grinda-
grindarakstur	drivning af grindeflok (ind i en bugt)
grindareglugerð	reglement angående grindefangst
grindaregn	voldsom regn(der menes at stå i forbindelse med grindeflokkes ankomst)
grindareiðskapur	samling redskaber til brug ved grindefangst
grindarlag	(husbyg.)(i et hus under opførelse)det sværere træværk
grindarokning	1regning for købt grindekød2(overf.)stor regning
grindaróður	1stærk roning for at komme tidsnok til en grindeflok2roning med robåd til grindefangst
grindarut	levninger af et måltid grindekød (og grindespæk)
grindarverk	stel, skelet,isæroverf.grindarverkið til sjónleikirnar tók hann oftast frá øðrum
grindaseðil	seddelel.skriftligt bevis for ens andel i grindefangsten(udstedes på fangststedet til bådformændene)
grindaskaði	1skade (på båd el.lign.) under grindefangst,stórur grindaskaði2erstatning til de skadelidte i grindefangst
grindaskifti	den retmæssige fordeling af grindefangst(under ledelse af sysselmanden)
grindaskøltur	kranium af grindehval
grindasnykur	trannet lugtel.smag af grindekød og grindespæk
grindasoð	vand hvori grindekød og grindespæk er kogt
grindaspik	spæk af grindehval, grindespæk
grindast	(om en flok grindehvaler)ligge stille med hovederne i vandskorpen for at hvileel.sove,grindin liggur úti fyri bygdini og grindast;(overf.)menninir standa og grindastmændene står tæt sammen
grindastovnur	grindebestand
grindatonn	tand fra grindehval
grindatrog	(træ)fad med (el.til) grindekød (og grindespæk)
grindatunna	tønde med saltet kød af grindehval
grindatvøst	(det magre) kød af grindehval
grindaumdømi	begrænset område hvori grindefangsten fordeles
grindavás	strabadser i forbindelse med grindefangst
grindaverður	portion grindekød og grindespæk
grindavísa	Grindavísanvise på dansk om grindedrab
grindaøki	begrænset område hvori grindefangsten fordeles
grindil	(datal.)stregkode
grip	pladsen mellem tommelfingeren og den øvrige hånd,gripið á hondini
gripabúr	skatkammer
gripagoymsla	museum
gripasavn	museum
griphólkur	gribetut
gripil	gribetut
gripsborð	i ordforb.laðin í gripsborð(om båd)så tungt lastet at der kun er en afstand af en hånds længde fra rælingen ned til vandoverfladen;hava gripsborðhave fisket så meget at båden er "laðin í gripsborð"
gripur1	1værdifuld genstand, klenodie,góður gripurkostbar genstand;dýrur gripurklenodie, skat2pladsen mellem tommelfingeren og den øvrige hånd3lyske
gripur2	(ornitol.)grib
grisin	(om tøj)utæt, åbent
grisla	utilfreds person
grislast	begynde at danne skorpe,steikin er ikki grislað ennstegen er ikke begyndt at danne skorpe endnu;eplini eru ikki grislaðkartoflerne er ikke kogt
grivin	segrava
grivjass	kortspil hvor knægten er højeste kort
gríma1	1ansigtsmaske, maske2hvid ko med sorte striberel.pletter på hovedet(mest brugt som egennavnGríma),grímurnar uppi á bø3grime, hovedtøj til heste (el.kvæg)
gríma2	1forsyne med grime,oksarnir vórðu nú grímaðir og leiddir oman2i ordforb. somgríma seggrise sig til i ansigtet
gríma3	blive lysere,tað grímir í eystriel.fyri degidet begynder at lysne(om det første svage dagslys, grålys);gríma ílette, lysne
grímusveima	(zoo.)lang græssvirreflue(Melanostoma scalare)
grímutur	1(om mennesker)grimet, snavset, med sort(e) stribe(r)el.pletter i ansigtet2(om dyr, mest køer)mørkstribetel.mørkplettet på forhovedet
grína	1grine, le,grína í kíkiskoggerle, skrupgrine;hann er herviligur at grína at øðrumhan er slem til at grine ad andre;grína burtur øðrumegingrine (le) for sig selv2tað grínur ikki í(når man vaskerel.pudser noget)der ses ingen hvide pletter3grínandi(om vind)som kommer pludselig med regnel.sne
grínibítur	grinebider
grípa	gribe, tage fat på med hænderne,hann greip bóltinhan greb bolden;grípa tvørtur um e-tel.tvørturumgribe om (noget)
grískligur	brysk,hann sá grískligur út;-liga
grískur	bøs, vred, vredladen,hann var grískur á at lítahan så vred ud
grísl	1skarpe småsten i jordsmonnet som spaden skurer imod,har er bert grót og grísl2skarp, hvinende lyd
grísla	give en ubehagelig skarp, skrigende lyd,grísla tennskære tænder;hatta gríslar í oyrunumdet skurrer i ørerne
grísur	(zoo.)gris,hann hvein sum stungin grísurhan hvinede som en stukket gris;at eiga hvørki grísel.gásvære fattig
groddi	stump, takel.pind afstumpet ved slid,groddarnir stóðu eftirstumperne stod tilbage
grolla	1kønsorgan på hunhval2(vulg.)kvindens kønsorgan
grolluskógvur	dårlig syet sko
grolluspik	spæk fra hunhvalens kønsorgan(spises ikke)
grollutvøst	kød fra hunhvalens kønsorgan
gron	1(på dyr)næse, snude, mule, fjæs2(vulg.)(på mennesker)snude, fjæs,hava gronel.ganga við gronsurmule, være gnaven, være i dårligt humørel.misfornøjet3(på fartøj)forstævn, forende, snude, næse,sita frammi í gronsidde i bådens forende
grona	1(om fartøjer i oprørt sø)stikke næsen dybt i søen,skipini gronast í ringum sjógv2gronastsurmule (om), være utilfreds (med),liggja her umborð og gronast
groning	det at et skib under sejlads stikker næsen dybt i søen
gronsora	smadre ansigtet på en
gronutur	1gnaven, surmulende, sur og gnaven2stormønstret
grottið	segretta
grovbolli	grovbolle
grovfíl	grovfil,(talesp.)geva e-m av grovfílinigive en af grovfilen
grovhyrntur	(om får)med kraftige, store horn
grovka	blive mere grov,ælingurin grovkaðibygevejret blev voldsommere;sjógvurin grovkarsøen bliver uroligere
grovkambur	kam med utætte tænder
grovkarðar	grovkarter
grovkøkur	bryggers, grovkøkken
grovleiki	grovhed
grovligur	1temmelig grov2med store og grove ansigtstræk,hon er heldur grovlig;-liga,taka grovliga tilbande, sværge
grovlimaður	med store og stærke lemmer, grovlemmet,grovlimaður maðurgrovlemmet mand
grovmalin	grofthakket, groftmalet,grovmalið fars
grovmæltur	med dyb stemme
grovregn	voldsom regn
grovskeldast	skændes voldsomt
grovskýggjað	med mørke skyer
grovtentur	med grove takker;grovtent sagsav med grove takker
grovullaður	med grov uld,grovullaður feldurpels med grov uld
grovur	1grov, stor, frygtelig, forfærdelig,grovt grótstore sten;grov aldahøj bølgegang;grovt saltgroft salt;grovt mjølgroft mel;tað grovasta av einum sjógvidet meste (værste) af en brodsø;grovur hesturhest med stærkt udviklede testikler;grovt hundraðet hundrede og tyve2tyk,grovt tógvgroft garn;grovur tráðurgrov tråd3(om regnbyge, regn o.lign.)voldsom, kraftig,grovur ælingurvoldsom regnbyge4(om skriftel.tryk)fed,grovur stílur;grov skrift5grov, sjofel, uterlig,grovar myndirsjofle billeder;mala grovtbruge (for) hårde ord (om noget);hava grovt á munnibruge hårde ord6(om stemme)grov, dyb,grov rødddyb stemme7(talesp.)meget god,grovur fiskiskapurmeget godt fiskeri;hann er grovur at spæla fótbólt, klaverosv.han er meget god til at spille fodbold, klaver o.s.v.
groyggj	1(neds.)rappenskralde2rask og dygtig kvinde
groyggja	rappenskralde,hon er ein verri groyggjahun er en værre rappenskralde
groyggjalig	(om kvinde)hidsig,hon er so groyggjalig
groyggjut	hidsig
groypa	(især om tømmerarbejde)sammenfælde, indfalse,bjálkin er groyptur niður í syllinabjælken er sammenføjet med fals;groypa sperrursammenføje tagspær
groyping	1(om tømmerarbejde)fals, falsning2(bibl.)indfatning,skera út steinar til groypingar
groyti	(geol.)magma
groytisgrýti	(geol.)vulkansk bjergart
gró	(bot.)spore
gróa	(kvad)gro, spire op, vokse
gróblað	(bot.)sporeblad, sporofyl
gróði	segrógva
gróðrarblað	(bot.)kimblad
gróðrarblettur	oase
gróðrarbotnur	1jordsmon2grobund
gróðrarbrigdi	(bot.)vegetationstype
gróðrarbúgvin	(poet.)moden til vækst,sólin fløvar gróðrarbúnan svørð
gróðrargóður	frugtbar
gróðrarhold	hava gott / ringt gróðrarholdhave god / dårlig sårheling
gróðrarhús	drivhus
gróðrarlendi	gott / ringt gróðrarlendigod / dårlig jord mht. frugtbarhed
gróðrarleysur	uden græsvækst,allan aprílmánað var gróðrarleysthele april måned var der ingen græsvækst
gróðrarligur	med det rette grødevejr
gróðrarlíkindi(r)	udsigterel.betingelser for grøden, vækstforhold, vækstbetingelser,góð / vánalig gróðrarlíkindi(r)gode / dårlige vækstforhold
gróðrarlítil	ufrugtbar, uden frugt
gróðrarmagn	grokraft
gróðrarmáttur	grokraft
gróðrarmegi	grokraft
gróðrarmikil	frodig, frugtbar, vækstrig, som bærer god afgrøde
gróðrarmykja	gødning fra kvæg der græsser på nyudvokset græs om foråret
gróðrarnál	(bot.)spire
gróðrarringur	ufrugtbar, uden frugt,sumrini vóru stutt og gróðrarringsomrene var korte og ufrugtbare
gróðrarríkur	frugtbar, som bærer god afgrøde
gróðrarrót	(bot.)kimblads rod
gróðrarsjógvur	hav med meget plankton
gróðrarskriði	kløe i sår der er ved at heles
gróðrarskrubb	udslæt om foråret(specielt hos børn)
gróðrarsmakkur	afsmag ved mælk når køerne kommer på græs om foråret
gróðrarstøð	planteskole
gróðrartíð	1væksttid2(overf.)tid med stor (politisk, kulturel) aktivitet,gróðrartíð við bjørtum hugsjónum og høgum málumtid med lyse ideer og høje mål
gróðrartungur	frodig
gróðrarvatn	(biol.)lymfe
gróðrarvágur	lymfe blandet med materie
gróðrarvánir	udsigterel.betingelser for grøden, vækstforhold, vækstbetingelser
gróðrarveður	grødevejr
gróðrarvónir	udsigterel.betingelser for grøden, vækstforhold, vækstbetingelser
gróður	1(planters) vækst,gróður í sjónumstor forekomst af plankton, der gør vandet uklart2plantevækst, vegetation,lítil gróðursparsom plantevækst
gróðurangi	(bibl.)(ny) kvist (på et træ)
gróðurbærur	frugtbar, som bærer god afgrøde,grønt og gróðurbærtgrønt og frugtbart
gróðurkvistur	(bibl.)stikling
gróðurleysur	uden græsvækst
gróðurlítil	ufrugtbar, uden frugt
gróðurmikil	frodig, frugtbar, vækstrig, som bærer god afgrøde
gróðurnál	spire
gróðurríkur	frugtbar, som bærer god afgrøde
gróðursamur	frugtbar, som bærer god afgrøde
gróðursemi	fertilitet, frodighed, frugtbarhed
gróðurseta	plante
gróðurseting	plantning
gróðursproti	(bibl.)spire
gróðurstøð	planteskole
gróðurteinur	(bibl.)stikling
gróðurtungur	frodig
grógoymsla	(bot.)sporehus
grógv1	mellemrummet mellem balderne
grógva	1gro, spire op, vokse,(ordsp.)grør um gangandi fót, heima situr svøltandi krákadet lykkes godt for den som forsøger ihærdigt;húsini grógva undirel.eru undirgrógvin í grasihuset er tilgroet (i græs)2(om sår, benbrud osv.)gro sammen, heles, læges,beinbrotið gróði væl saman aftur
grógvin	1groet2(stærkt) kalveknæet3(om kød af fisk især i store torskehoveder)fasthængende, klumpet
gróhópur	(bot.)sporehus
grókorn	(bot.)spore
gróleysur	(bot.)uden spore
gróma	1stribeel.plet af snavsel.smuds(fx i ansigtet),andlitið er tær beru grómur2gråel.mørke (uvejrssvangre) striberel.skyer,hann setur grómur upp á luftinader er uvejrsstriber på luften
grómutur	1med snavsede striberel.pletter,eitt grómut andlitsnavset ansigt2med mørke skyer(før uvejr)grimet,grómut luftuvejrssvanger luft
grón	planteføde, korn-el.melspise
grónnoða	bolle sammenæltet af mel og lever af mindre helleflynder(derpå kogt)
grónoffur	(bibl.)afgrødeoffer
grónska	nylig (ovn)tørret korn
grónskudrýlur	usyret brød bagt af mel af nyt korn
grónskusmakkur	speciel (af)smag ved mel af nyt korn
gróp	dybt spor i jorden (efter hæle el.lign.), oprodetel.afskrabet stribe
grópa1	dybt spor i jorden (efter hæle el.lign.), oprodetel.afskrabet stribe,isærgrópurnar stóðu eftir rossunum
grópa2	1rode, oprode jorden især med fødderne,tarvurin fór at ýla og grópatyren begyndte at brøle og oprode jorden med fødderne;gravimaskinurnar hava grópað alt lendið uppgravemaskinerne har oprodet hele jordstykket;koma grópandikomme med megen fart og sætte (dybe) spor i jorden;tarvurin kom grópandi gjøgnum bøin;skipini koma grópandi við troli inn á minusettan sjógv2gennemrode(for at finde noget),grópa í lummunumgennemrode lommerne
gróplanta	(bot.)sporeplante, kryptogam
grót	1(koll.)sten, stene,blaka grótkaste med sten;arbeiða upp á grótforarbejde sten(især til husbygning);bróta upp grót1grave store stene frem af jorden2(overf.)udføre et meget besværligt arbejde;tað kostar gull og ikki grót(om noget som koster mange penge)2stenet område3hårde knuder i fårs lunger
grótarbeiði	stenarbejde
grótborur	stenbor
grótbrot	stenbrud
grótbrúgv	1stenbro2(vandret) stenlag i stejl bjergside
grótbræðing	(geol.)(flydende) lava
grótfeingi	stenmateriale(til opførelse af huse el.lign.),gott / ringt grótfeingi
grótflógv	1(geol.)stenlag,kolalindin liggur ímillum grótfláirnarkullaget ligger mellem stenlagene2lag sten i dobbelt stenvæg,innara / ytra grótflógvin
grótfríur	stenfri
grótfrystur	stivfrossen,tað var so grótfrystder var hård frost
grótføroyskur	(spøg.)ægte færøsk, rent færøsk,hatta er grótføroysktdet er ægte færøsk
grótgarður	stengærde, stendige
grótgeil	stenet jordstrækning(især i udmarken)
grótgráur	grå som sten
gróthamari	stenhammer
grótharður	stenhård
grótheiðin	(vulg.)aldeles blottet,eg eri grótheiðin í hasumjeg er aldeles blottet til dette
grótherða	stenet højdedrag
grótheyggjur	stenhøj
gróthús	udhus med stenvægge(helt op til taget, uden panel indvendig)
grótídnaður	stenindustri
grótkast	læmole
grótkíli	kile til stenarbejde
grótklípi	mindre sten el. skår af sten(brugt til afstivning, til udfyldning af mellemrum mellem større sten)
grótlaðaður	opført af sten,grótlaðaður garðurgærde opført af sten
grótlaðari	stenhugger
grótlaðing	stenkonstruktion
grótlendi	stenet terræn
grótleypur	bærelad (til sten)
grótlind	(geol.)stenlag
grótljóð	larm fra nedstyrtende sten
grótlop	stenskred
grótmaður	mand der arbejder med at opføre stenvægge, stengærder o.lign., stenhugger, stenmester,hann er góður grótmaðurhan er en dygtig stenmester
grótmeitil	mejsel til stenarbejde
grótrenna	stensat (underjordisk) rendeel.gang
grótrók	stenet afsats i stejl bjergside
grótrúgva	stendynge
grótrætt	fårefold opført af sten
grótskot	1stensprængning2lyden fra stensprængning
grótskursl	løse småsten iblandet jordsmonnetel.bedækkende et (ofte brat) sted hvor man går
grótslag	(geol.)stenart
grótsleða	slæde til stentransport
grótsleggja	stenhammer
grótsmiður	stenhugger
grótu	segráta
grótvarði	varde opført af sten
grótvánir	mulighed for at skaffe stenmateriale,har eru góðar / ringar grótvánirder er gode / dårlige muligheder for at skaffe stenmateriale
grótveggur	stenvæg, stenmur
grótvirki	stenhuggeri, stenhuggervirksomhed
grótvøttur	grótvøttirstrikkede grove vanter til stenarbejde
gróv1	mellemrummet mellem balderne
gróv2	segrava
grubba	arbejde foroverbøjet,liggja og grubba
grubban	det at arbejde foroverbøjet
gruddi	segryðja 2
gruður	grund, (hav)bund
grugg	1grums, bundfald, bærme,tá ið løgurin verður køldur, legst grugg á botninved afkøling af væsken udskilles et bundfald2uro i søen3vrede,grugg kom í hannhan blev vred4nag, fjendskab,gruggið liggur eftir á botninum(de er tilsyneladende venner, men gemt er ikke glemt)
grugga	1grumse, mudre op,(overf.)alt tað, ið lá og gruggaði teirra millumalt det, som de var uenige om;gruggastsurmule,maðurin sat og gruggaðist niður í borðiðmanden sad og surmulede2komme i oprør, blive urolig,hann gruggar sjógvinsøen bliver (mere) urolig
gruggketil	kedel med kaffegrums
gruggutur	1grumset2(noget) oprørt,gruggutur sjógvuroprørt sø3vred, oprørt,hann gongur gruggutur og talar ikki orð til nakranhan er vred og siger ikke et ord til nogen
gruggvatn	grumset vand,hetta er tað bera gruggvatn(om dårlig kaffe)
grulva	kravle, krybe på alle fire,børn grulvabørn kravler
grulvigarður	kravlegård
grummheit	slagregn, øsregn, voldsom regn
grummliga	grumt, vredt,hon hugdi grummliga upp á hannhun kiggede vredt på ham
grummur	grum, vred,eitt grumt ælen voldsom snebyge
grun	segrunur
gruna	ane, have anelseel.mistanke om, formode,hetta mundi meg grunajeg havde en lumsk mistanke om det;eg grunaði taðjeg havde en anelse om det;eingin grunaði nakaðingen anede noget
grunan	anelse, mistanke
grund	1(kvad)jord,tá skalv bæði grót og grund2(geol.)jordbund3(husbyg.)byggegrund, grund,grava sær grundbortgrave jord for at bygge hus;fara av grund(om hus o.lign.)ødelægges af vind;brenna í grundbrænde ned til grunden;húsini brunnu í grundhuset brændte ned til grunden4det nederste af en byld5hovedfarve, bundfarve,við ljósari grundmed lys bundfarve6(overf.)fundament,grundin undir skriftmálinumfundamentet under skriftsproget7grundkarakter, karakter, personlighed, sindelag,góð / ring grund er í honumhan har en god / dårlig karakter;góður av grund8årsag, grund,tað er eingin grund til taðder er ingen grund til det9farael.ganga til grundargå til grunde, ødelægges
grunda	1lægge grunden til noget, grundlægge,grundael.grunda fyri;hann grundar fyri einum ælidet trækker op til regnbyger2(overf.)have som grundlag under noget,henda giting er grundaðel.kann grundast á ymisktdenne gisning bygger på forskellige indicier3grunde(med maling)4spekulere, grunde overel.på noget,hann stóð og grundaði djúpthan stod i dybe tanker
grundan	grublen, grubleri, spekulation
grundarfastur	grundfæstet, solid
grundargóður	1af god karakter,drongurin er so grundargóðurdrengen har en god karakter2solid,grundargóður lærdómursolid lærdom
grundargrót	sten under stor høstak
grundarlag	1grundlag, fundament, basis,norðri á Bø eru menn komnir niður á grundarlag2(overf.)grundlag,grundarlagið undir samfelagnumsamfundets grundlag
grundarleysur	ubegrundet, uberettiget, ugrundet, umotiveret,tað var ikki grundarleyst, at hann gramdi segdet var ikke uden grund, at han beklagede sig
grundarringur	af dårlig karakter, ondskabsfuld,gíslarænarin er so grundarringurgidseltageren er så ondskabsfuld
grundarstaður	ruin (af hus)
grundarsteinur	grundsten(første sten ved påbegyndelse af offentlige bygninger)
grundarstig	(lingv.)grundform, positiv
grundbók	(skole)grundbog,grundbók í føroyskumgrundbog i færøsk
grundbroyta	ændre grundlæggende, revolutionere, omvælte,at motorar komu í skipini grundbroytti allan fiskiskapindet at motorer kom i skibene ændrede fuldstændig hele fiskeriet
grundbroyting	omvæltning, revolution
grundevni	(kem.)grundstof
grundfastur	grundfæstet, solid
grundfesta	grundfæste
grundgeva	begrunde, motivere,grundgeva fyri e-mbegrunde noget;tú mást grundgeva fyri tínum pástandumdu må bevise dine påstande
grundgeving	begrundelse, motivering
grundgóður	1af god karakter2solid
grundgransking	grundforskning, basisforskning
grundhugsan	grundsynspunkt, hovedsynspunkt
grunding	grunding
grundleggjandi	grundlæggende, fundamental, basal
grundlendi	fundament,grundlendið, skúlin hevur at byggja ádet fundament, som skolen bygger på
grundleysur	ubegrundet, uberettiget, umotiveret, ugrundet
grundliður	(lingv.)grundled, subjekt
grundlitur	1grundfarve, primærfarve2bundfarve, hovedfarve
grundlóg	(pol.)grundlov
grundlógaravhoyring	(jur.)grundlovsforhør
grundlógardagur	grundlovsdag(5. juni)
grundløn	grundløn
grundmáling	grundmaling
grundmongd	(mat.)grundmængde
grundpeningur	grundbeløb, anlægskapital, startkapital,grundpeningur bankansbankens startkapital
grundregla	grundsætning, hovedregel, princip, ide
grundringur	af dårlig karakter, ondskabsfuld
grundsetningur	grundsætning, hovedregel
grundskeið	(skole)grundkursus
grundskúli	(skole)grundskole, folkeskole
grundstig	(lingv.)positiv
grundstovnur	hovedelement, hovedindhold
grundstuðul	hovedstøtte, fundament,(overf.)heimini eru veruligu grundstuðlar samfelagsinshjemmene er samfundets virkelige fundament
grundstykki	byggegrund, grund
grundstøði	grundlag,(overf.)kristna grundstøði okkaravores kristne grundlag
grundtal	kardinaltal, grundtal
grundtilfar	(geol.)grundmateriale
grundtóni	1(musik)grundtone2essens, hovedtræk
grundútbúgving	(univ.)grunduddannelse, basisuddannelse
grundvalla	(bibl.)grundfæste
grundvatn	grundvand
grundvøllur	(bibl.)grundlag
grundøki	byggegrund, grund
gruni	anelse, mistanke,eg havi ein gruna á mær, at okkurt fer at hendajeg har en mistanke om, at noget vil ske
grunnafiskur	meget stor torsk
grunnát	føde (for fisk) nede på havbunden
grunnbrot	voldsomt bølgebrud,vit sigla inn millum grunnbrot í bæði borðvi sejler ind mellem voldsomme bølgebrud til begge sider;(overf.)lívsins grunnbrot
grunnbróta	(om bølgebrydning)bryde voldsomt
grunnfiskur	meget stor torsk
grunnhav	(geol.)epikontinentalhav
grunningshøvd	torskehoved begyndt at gå i gæring,sum maðkur í grunningshøvdii overordentlig mængde, myldrende
grunnklór	små og mindre gode fisk(bliver tilbage efter at størstedelen har forladt fiskebanken),á miðinum er einki eftir uttan grunnklór
grunnlína	(på fiskenet)den nederste line
grunnlús	(zoo.)fiskesnylter(Aega)
grunnmús	(zoo.)guldmus, børsteorm(Aphrodite aculeata)
grunnskygdur	kortsynet, snæversynet, overfladisk
grunnskygni	overfladiskhed, kortsynethed, snæversynethed
grunnslóð	den spædeste yngel på en fiskeplads
grunnsóp	små og mindre gode fisk(bliver tilbage efter at størstedelen har forladt fiskebanken)
grunnsópa	bundskrabe,trolararnir hava grunnsópað fiskileiðirnartrawlerne har bundskrabet fiskebankerne
grunnur1	1grund, (hav)bund,taka grunnstrande;(talem.)sum drigin frá grunnidrivvåd, gennemblødt2fiskebanke3(på fiskenet)den nederste line4fond(fx til godtgørendeel.kulturelt formål)5ressource, reservefond,seta / leggja í grunnhenlægge / overføre til fond
grunnur2	1grund, lav, lavvandet,báturin kom inn á grunt vatnbåden kom ind på grundt vand2(overf.)overfladisk, snæversynet,hann er ógvuliga grunnurhan er meget overfladisk
grunnæti	føde (for fisk) nede på havbunden
grunsil	anelse, mistanke
grunsul	i ordforb.hava grunsul áhave anelseel.mistanke (om noget)
grunur	anelse, mistanke,e-m rennur e-t í grunman får en anelse (om noget), det kommer til en i tankerne;hava grun um e-thave mistanke om noget;eg havi ein grun um taðjeg har en mistanke om det
grupur	rødplettet hud (især på benene) af at sidde for tæt på ilden
gruttu	segretta
grúgva1	1ildsted i gamle huse opført af sten2(i smedje)esse
grúgva2	1i ordforb. somá grúgvu, fram eftir grúgvunæsegrus,dettael.falla fram eftir grúgvuel.á grúgvufalde på næsen;leggja seg á grúgvukaste sig næsegrus2(overf.)i ordforb. somkomin á grúgvukommet på knæerne
grúgvubonkur	bænk ved ildstedet
grúgvubrík	bænk ved ildstedet
grúgvudrekk	i ordforb.leggja seg fram á grúgvudrekklægge sig på maven for at drikke af en bæk el.lign.
grúgvueldur	arneild
grúiligur	(talesp.)gruelig;-liga
grúkur	1hoved på sælhund2(neds.)hoved,teir vóru ógvuliga tómir í grúkinumde var dumme
grúpanslær	(ordsp.)tað hanga ikki allir lyklar við eitt grúpanslæren person rummer ikke alle kvaliteter
grúpur	rødplettet hud (især på benene) af at sidde for tæt på ilden
grús	(koll.)1grus(småsten el.lign.)2ganske små fisk31klar luft(mange ellers ikke synlige stjerner øjnes),tað er grús á luftini2hvidagtigt skær på himlen(af begyndende skydannelse)
grúsa	knuse (sten o.lign.) småt
grúsutur	i ordforb.grúsut luftklar luft med mange synlige stjerner(i Mælkevejen)
grúsvøllur	grusbane
grúva	áel.fram eftir grúvunæsegrus
grúvudrekka	ligge næsegrus og drikke,hann legst at grúvudrekkahan lægger sig næsegrus for at drikke
grúvudrykkur	i ordforb.leggja seg á grúvudrykklægge sig på maven for at drikke vand af en bæk
gryðja1	tyndslidt sted på tøj(fx på knæene)
gryðja2	1(om tøj)være tyndslidt til hul, begynde at gå fra hinanden,troyggjan gryður á albogunumtrøjen er tyndslidt på albuerne2(overf.)blive dag, dages,tað gryður fyri degidet dages
grynka	1grundt sted i elvel.indsø2lille "grynna"
grynna1	grundt sted, banke, forhøjning af havbunden,hon var sum ein grynnahun var meget vred
grynna2	1kunne bunde,tey svumu longri út enn tey kundu grynnade svømmede længere ud end de kunne bunde2(om vand)blive lavere,grynnastblive lavere;fjørðurin treingist og grynnist sum inn kemurfjorden indsnævres og bliver mere lavvandet længere ind man kommer
grynnubakki	kant af en banke ("grynna")
grynnufiskur	meget stor torsk
grynnutrom	kant af en banke ("grynna")
gryvja	grav, grøft, grube
gryvjutræ	gangbræt over en grøft
gryvjutur	med grøfter og grave,har er gryvjut og ringt at gangader er grøfter og grave og svært at gå
grýla	1person (udklædt som troldel.lign.) med maske for ansigtet der i (begyndelsen af) fasten går fra hus til hus,ganga grýla (el.langaføsta)2maskeret person, deltager i karneval
grýlubúni	forklædning, maskeradedragt
grýlugildi	karneval, maskerade
grýluklæði(r)	forklædning, maskeradedragt
grýlukvøld	den første tirsdag i fasten, hvide tirsdag
grýluskortur	1maske(for ansigtet)2grimt fjæs
grýluveitsla	karneval, maskerade
grýn	gryn, grynkorn
grýnamjøl	bygmel
grýta1	gryde
grýta2	1belægge med sten,grýta tekjulægge sten på tagets grønsvær2kaste med sten, kaste sten på, stene,grýta (grót) eftir e-mkaste med sten efter nogen;grýta leysakøstkaste stene i søen(ved inddrivning af hvalflok)3kaste, smide, slænge,grýta ein undiroverdænge en;tú hevur grýtt meg undir í øllumdu har overdænget mig med alt muligt;grýta (sand) upp í stórar rúgvuropdynge sand i store bunker
grýting	stenkast
grýtingargrót	sten der lægges på græstørvedækket på en "krógv"
grýtingur	(geol.)rene sten
grýtissmyril	(ornitol.)tårnfalk(Falco tinnunculus)
grýtugur	stenet, klippefuld,grýtug brúgvstenbro
grýtulappi	grydelap
grýtulok	grydelåg
grýturættur	gryderet
grýtutur	stenet, klippefuld,tey grýtutu reyninide stenede højdedrag
grýtuvatnsarvi	(bot.)stor vandarve(Montia fontana)
grækarismessa	gregoriusdag, 12. marts,tjaldrið kemur á grækarismessustrandskaden kommer 12. marts
græla	1(om person)give svag indeklemt lyd fra sig, ralle,tað grælar ikki í honumhan rører sig ikke, han ligger ganske stille (som død)2begynde at koge, boble,nú grælar í pottinumdet begynder at boble i gryden
grælingafjaðrar	i ordforb. somhann er ikki vaksin upp av grælingafjaðrumman kan se at han har fået god og kraftig kost i opvæksten
grælingsungi	(ornitol.)unge hos sortgrå ryle
grælingur	(ornitol.)sortgrå ryle
grætur	segráta
grøða	helbrede, læge, hele,læknin grøddi hanalægen helbredte hende
grøði	1afgrøde, høst,fáa grøðina til høldarfå afgrøden i hus;nú er grøði í honumnu vokser det godt2plantevækst, vegetation,hóvdýrini liva mest av grasi, viðargreinum og aðrari grøðihovdyrene lever mest af græs, grene af træ og anden plantevækst
grøðiátin	planteædende,bævurin er grøðiátinbæveren er planteædende
grøðibærur	frugtbar, som bærer god afgrøde,landið er grøðibærtlandet bærer god afgrøde
grøðievni	lægemiddel
grøðifingur	ringfinger
grøðiligur	frodig, frugtbar,oyggin er stór og grøðiligøen er stor og frodig
grøðimikil	frodig, frugtbar,jørðin er grøðimikiljorden er frugtbar
grøðing	helbredelse
grøðiplanta	plante anvendt til at helbrede sygdom med,eirisgras er grøðiplanta
grøðipláss	rekreationssted
grøðisálva	(med.)helbredende salve
grøðiskel	(zoo.)skal af blæksprutte((tidligere) brugt som lægemiddel)(Sepia officinalis)
grøðiurt	lægende urt
grøðuligur	frodig, frugtbar,trý grøðulig ártre frugtbare år
grøðuskel	skal af blæksprutte((tidligere) brugt som lægemiddel)(Sepia officinalis)
grøna1	oase(i ørken)
grøna2	farve grøn
grønakorn	(bot.)grønkorn
grønatorva	undir grønutorvudød og begravet
grønbláur	blågrøn
grønbrúnur	brungrøn
grønertur	(bot.)grønært(Pisum sativum)
grønfóður	grønfoder
grøngulur	grøngul
grønhavri	grøn havre
Grønhøvdaoyggjar	Kap Verde
grønhøvdoyingur	kapverder
grønhøvdoyskur	kapverdisk
grøni	oase,ein vakur grønien smuk oase
grøning	handlingen at farve grøn
grønjørð	(geol.)grønjord
grønka1	oase
grønka2	1gøre grøn, få til at blive grøn,(poet.)sólin grønkar dalsolen gør dalen grøn2grønka(st)blive grøn, grønnes,nú er farið at grønka(st)nu er det begyndt at blive grønt
grønkál	(bot.)grønkål(Brassica oleracea var. acephala laciniata)
grønkorn	(bot.)grønkorn
Grønland	Grønland
grønlandsbjalla	(bot.)grønlandsk skjaller(Rhinanthus groenlandicus)
grønlandsfiskiskapur	fiskeri ved Grønland
grønlandskópur	(zoo.)grønlandssæl(Phoca groenlandica)
grønlandsmaður	mand der fisker ved Grønland
grønlandsselur	(zoo.)grønlandssæl(Phoca groenlandica)
grønlandsslættibøka	(zoo.)grønlandshval(Balaena mysticetus)
grønleiki	det at være grøn,tann skæri grønleiki um alla leiðgrøn indmark
grønlendingur	grønlænder
grønlendskur	grønlandsk,grønlendsktdet grønlandske sprog
grønleykur	(bot.)purløg(Allium schoenofrasum)
grønligur	grønlig;-liga
grønlittur	grønfarvet
grønmálaður	grønmalet
grønmeti	grøntsager
grønoygdur	grønøjet
grønsápa	grøn sæbe, brun sæbe
grønska1	nylig (ovn)tørret korn
grønska2	gøre grøn, få til at blive grøn,sólin brátt grønskar dalar og líðir
grønskast	i ordforb. somtað grønskast ikkidet er udrøjt, det varer ikke længe
grønstar	(med.)grøn stær(glaucoma)
grønsteinur	(geol.)grønjord
grøntari	(bot.)grønalge(Chlorophyta)
grønur	1grøn,hann man ikki fara at koma aftur á grønt grashan kommer næppe til kræfter igen;undir grønu torvudød og begravet2ung, umoden, uerfaren,tú ert ungur og grønurdu er ung og uerfaren
grør	segrógva
grøs	segras
grøta	få til at græde, bringe til tårer, bedrøve, såre
grøtiligur	til at græde over, sørgelig, bedrøvelig, frygtelig, gruelig,ein grøtiligur larmuren frygtelig larm;-liga
grøtimikil	1let til tårer2tilbøjelig til at græde,hann var grøtimikil á at líta
grøtin	tilbøjelig til at græde, let til tårer,summi børn eru so grøtinnogle børn har let til tårer
grøtutur	tilbøjelig til at græde, let til tårer
grøv	1grøft2grav, gravsted,bera e-n til gravarbære nogen til graven;hann legði blómur á grøvinahan lagde blomster på graven;fara til gravarblive begravet;fáa kalda grøvomkomme på søen;hava e-t í grøvina við sær(om hemmelighed man ikke vil fortælle om);(talem.)tað var sum í grøvinider var dødstille3kølvand, stribe som et skib skærer gennem vandet(især når det skyder god fart),grøvin stóð frá bógnumskummet stod fra stævnen4ildstribe(fx fra meteor)
grøva	sejle med stærk fart så at skummet står fra boven,báturin fór grøvandi;(overf.)mamma kom grøvandi at vitamoren kom forpustet for at høre
Guatemala	Guatemala
guatemalari	guatemalaner
guatemali	guatemalaner
guatemalskur	guatemalansk
gubbakona	gudfars kone
gubbi	gudfar, (mandlig) fadder,gubbi mínmin gudfar
Gud	(rel.)Gud, Vorherre,Guds friður í húsiGuds fred;Guds húskirken;hvar í Guds garði hevur tú verið?hvor i alverden har du været?;Gud gævi (satt)!Gud give! gid!,Gud signi teg!Gud velsigne dig!;Gud eigi teg!for Guds skyld!(siges når man beder en indtrængende om noget);Gud signi teg!Gud velsigne dig!;hvørt Guds skapta kvøldhver eneste aften
guda	sværge ved Gud,hann gudaði upp á, at tað var satthan svor ved Gud, at det var sandt
gudaborin	gudbenådet
gudadrykkur	1(mytol.)gudedrik2(poet.)god (stærk) drik
gudadýrkan	(rel.)gudedyrkelse
gudafrøði	(mytol.)gudelære, mytologi
gudafrøðiligur	(mytol.)mytologisk;-liga
gudakvæði	(litt.)gudedigt
gudalæra	gudelære, mytologi,griksk gudalæragræsk mytologi
gudasøga	(mytol.)gudesagn, mytologi
gudasøgn	(mytol.)gudesagn
gudborin	gudbenådet
guddómligur	(rel.)guddommelig,guddómligur kærleiki;-liga
guddómsligur	(rel.)guddommelig
guddómur	(rel.)guddom
guddóttir	guddatter,hon er guddóttir mínhun er min guddatter
gudfaðir	gudfar, gudfader
gudfrøði	teologi,lesa gudfrøðistudere teologi;fáa prógv í gudfrøðifå eksamen i teologi
gudfrøðideild	(univ.)teologisk fakultet
gudfrøðiligur	teologisk;-liga
gudfrøðingur	teolog
gudfrøðiprógv	teologisk embedseksamen
gudiligur	(rel.)1kristen, gudelig, religiøs2from, gudfrygtig,mamman var ein gudilig konamoren var en gudfrygtig kvinde;-liga
gudinna	(rel.)gudinde
gudleysur	gudløs, ugudelig,liva eitt gudleyst lívleve et gudløst liv
gudloysi	ugudelighed, gudløshed, ateisme
gudloysingur	ateist
gudlýðin	gudfrygtig, troende
gudmamma	gudmoder
gudmóðir	gudmoder
gudmóður	(bibl.)henrykkelse
gudóttandi	gudfrygtig
gudpápi	gudfar, gudfader, mandlig fadder
gudræddur	gudfrygtig
gudrøkin	gudfrygtig, from, troende,tey eru gudrøkin fólkde er fromme mennesker
gudrøkni	fromhed, religiøsitet
gudsavnoktari	gudsfornægter, ateist
gudsbarn	et Guds barn
gudsbermiligur	sørgmodig, trist, fortvivlet
gudsbørmiligur	sørgmodig, trist, fortvivlet
gudsdoyð	gudsdød,gudsdoyð ikki!(sagt når man bliver overrasketel.vred)
gudsdyrkan	gudsdyrkelse
gudsdyrkari	gudsdyrker
gudsdýrkan	gudsdyrkelse
gudsfriður	fred som Gud giver menneskene
gudsgáva	(en) Guds gave
gudshugaður	gudfrygtig, from
gudshugi	gudsfrygt
gudslán	(en) Guds gave
gudsleið	i ordforb.farin av allari gudsleiðkommet på afveje
gudslív	trosliv
gudsmaður	Guds mand,hvør gudsmaður er hetta?hvem (i Guds navn) er denne fremmede?;ein sovorðin gudsmans mongden uhyre mængde
gudsnáð	Guds velsignelse,ikki gudsnáð at fáa (á útróðri)ikke den mindste smule at få (af fisk på fiskeri)
gudsnoktan	gudsfornægtelse, ateisme
gudsnoktari	gudsfornægter, ateist
gudsonur	gudsøn
gudsoyðin	helt øde for alting(som kan glæde osv.)
gudsóttandi	gydfrygtig, from
gudsótti	gudsfrygt
gudsskaptur	som Gud har skabt,hvønn gudsskapta daghver eneste dag
gudsspottan	gudsbespottelse
gudsspottandi	gudsbespottende,gudsspottandi hugsanirgudsbespottende tanker
gudsspottari	gudsbespotter
gudssvikari	(kvad,bibl.)gudsfornægter, ateist
gudstrúgv	tro på Gud, gudsfrygt
gudstænasta	gudstjeneste,fara til gudstænastugå til gudstjeneste, gå i kirke
gudsøkin	gudfrygtig, from
gudur	(rel.)(hedensk) gud,tú mást ikki hava aðrar gudardu må ikke have andre guder(et af de ti bud);í norrønu gudalæruni eru nógvir gudar: Óðin, Tórur, Froyur o.a.i den nordiske mytologi findes der mange guder: Odin, Thor, Frej m.fl.
gudvígdur	viet til Gud
Guð	Gud
guðiliga	gudelig, kristelig,býta guðiligadele retfærdigt
guðiligur	1kristen, gudelig, religiøs2from, gudfrygtig;-liga
Guinea	Guinea
Guinea Bissau	Guinea-Bissau
guineabúgvi	guineaner
guineiskur	guineansk
Gujana	Guyana
gujanabúgvi	guyaner
gujanskur	guyansk
gul	1let brise,hann trilkar guliðvinden vokser2(meteorol.)let brise, 3,4 - 5,4 m / sek.
gula1	(om vind)blæse svagt, lufte,hann fer at guladet begynder at blæse svagt
gula2	farve gult
gularót	(bot.)gulerod(Daucus carota)
gulasmæra	(bot.)hvidkløver
gulasótt	(med.)gulsot
gulbeit	(bot.)padderokke
gulbeita	(bot.)padderokke
gulbeitarbjølluvísa	(bot.)kær-padderok(Equisetum palustre)
gulborð	luvart, et fartøjs vindside,í gulborðtil luvart
gulbrondutur	(om ager)begyndt at gulne
gulbrúnur	gulbrun
guldu	segalda,gjalda
guldæmdur	1gullig2gusten(om teint)
gulgrønur	gulgrøn
gulhærdur	gulhåret, gullokket
guling	handlingen at farve gult
gull	1(kem.)guld(grundstof, tegnAu, dvs.aurum),tað er sum at fáa hendur á gull at fáa hendur á fisk núnu til dags er fisk næsten ikke til at opdrive;hava tað sum perlan í gullinumhave det som blommen i et æg2rigdom, penge,gull og fæguld og fæ;tað kostar gull og ikki grót(om noget som koster mange penge);(ordsp.)ikki er alt gull, ið glitrardet er ikke alt guld, som glimrer3medalje af guld,vinnael.fáa gull í ítróttakappingfå guldmedalje i sportskonkurrence
gullaldarskald	(litt.)guldalderdigter
gullasj	gullasch
gullband	guldbånd
gullbikar	guldbæger
gullbjølla	guldbjælde
gullborin	(kvad)prydetel.dækket med guld
gullbrandur	slags vandmand
gullbrillur	guldbriller
gullbrúdleyp	guldbryllup
gulldrigin	guldprydet,í gulldrignum frakka
gulleittur	1gullig2gusten(om teint)
gullepli	guldæble(fx i eventyr)
gullfiskur	(fisk.)guldfisk(Carassius auratus)
gullgerð	(hist.)alkymi
gullgerðarmaður	(hist.)alkymist
gullglitur	guldglans
gullglæma	(poet.)gyldent skær(fra solen),drangar í gullglæmu standa
gullglæstur	gylden,gullglæst hár og læandi blá eygugyldent hår og smilende blå øjne
gullgravari	guldgraver
gullgrevstur	guldgraveri
gullgripur	værdifuld genstand af guld
gullgulur	guldgul
gullhorn	guldhorn
gulligur	gullig,gulligur liturgullig farve;-liga
gullittur	gul, gulfarvet
gullkambur	kam af guld
gullkálvur	(bibl.)guldkalv,dansa um gullkálvindanse om guldkalven
gullkendur	guldholdig
gullker	guldbæger
gullketa	guldkæde
gullkista	guldkiste
gullknappur	guldknap
gulllaksur	(fisk.)guldlaks(Argentina silus)
gullmerki	guldmedalje
gullmura	(bot.)guld-potentil(Potentilla Crantzii)
gullnám	guldmine
gullpeningur	guldpenge
gullpennur	guldpen
gullrandaður	med gylden kant,høvur hennara var gullrandað í sólinihendes hoved havde en gylden kant i solen
gullregn	(bot.)guldregn
gullreinur	1ren som guld, skinnende ren, fuldstændig ren,í gullreinum klæðumi skinnende rent tøj2(kvad)af ren guld,gullrein hjálm á høvdi barmed en hjelm af ren guld på hovedet
gullrendur	(kvad)med gylden kant
gullringur	guldring
gullsandur	guldholdigt sand
gullsmiðja	guldsmedje
gullsmiður	(håndv.)guldsmed
gullsmíð	guldsmedearbejde
gullsólja	(bot.)nyrebladet ranunkel(Ranunculus auricomus)
gullsteyp	guldpokal, guldbæger
gullstong	guldbarre
gullstólur	1stol af guld,(kvad)keisarin situr í gullstóli2guldstol,bera e-n í gullstólibære én i guldstol
gullstykki	guldmønt
gullstøði	(økon.)guld som møntfod
gulltonn	(odont.)guldtand
gulltráður	guldtråd, guldspind,í vøkrum búna vovin í vøkrum litum og drigin við gulltræðrum
gullu	segjalla
gullur	guldur
gullvísa	(bot.)gyvel
gullvovin	vævet med guldtråd
gulløl	1guldøl(5,8 %)2flaske med guldøl,tvær gulløl
gulløld	guldalder
gulmálaður	gulmalet
gulmikil	med megen vind,nú er so gulmikiðnu er der megen vind
gulna	gulne, blive gul,akrarnir vóru farnir at gulnakornmarkerne var begyndt at blive gule
gulnan	det at gulne
guloygdur	med gule øjne
gulpílur	(bot.)slags piletræ(Salix vitellina aurea)
gulreyður	rød med en antydning af gult
gulsótt	gulsot
gulur	gul,(talem.)fáa sær ein gulanfå sig en stærk kop te med mælk i;banka e-n gulan og bláanbanke nogen gul og blå
gulusótt	(med.)gulsot
gumma	gudmoder
gummi	gummi
gummiballa	balle gummi
gummiband	elastik, gummibånd
gummibátur	(skib.)gummibåd,menninir vóru farnir í gummibátarnarmændene var gået i gummibådene
gummibóltur	gummibold
gummihandski	gummihandske
gummilím	gummilim
gummiskógvur	sko af gummi
gummislanga	gummislange
gummisóli	gummisål
gummistivli	gummistøvle, røjser
gummitræ	(bot.)gummitræ(Ficus elastica)
gumpa	1(husbyg.)lave valmtag2(om heste)slå bagud,rossið gumparhesten slår bagud
gumpabreiður	(om folk)bredgumpet
gumpahús	(husbyg.)hus med valmtag
gumpareising	(husbyg.)valmtag
gumpatak	(husbyg.)valmtag(skrå tagflade på gavlsiden af en bygning)
gumpur	1(spec. om dyr)gump, bagdel,sláa gumpslå bagud med bagbenene2valmtag,gumpur á húsi
gurka	(bot.)agurk
gurla	(med.)gurgle
gustmánaður	(talesp.)augustmåned
gusu	segjósa
guva1	1fygen af sne, vandmasser, støv o.lign.2røgel.røgskyer (fra tobak)3(noa-ord på søen for)røg fra huse4(fys.)vanddamp
guva2	1ryge, dampe, støve(om snefog, havgus osv.),tað guvar illa2ryge(cigaret, cigar)3guva burturfordampe,vatnið guvar burturvandet fordamper
guvan	fordampning,guvan av svørtum royki stóð upp úr skorsteininumfordampningen af sort røg steg op fra skorstenen
guvubað	dampbad, sauna
guvuketil	dampkedel
guvumaskina	dampmaskine
guvur	drag, sug(fra cigaret, cigar el.lign.),gev mær ein guvgiv mig en røgel.smøg
guvurok	meget snefog
guvuskip	(skib.)dampskib, damper
guvutrýst	(fys.)damptryk
gúpp	(idr.)spark(op i luften)
gúppa	1(idr.)sparke udel.op i luften2(vulg.)sparke,hann gúppaði hann í reyvinahan gav ham et spark í røven
gvagg1	rap!(lyd fra ænder)
gvagg2	(om ænders)rap,dunnan sigur gvagg
gvagga	(om ænder)rappe,dunnurnar gvaggaænderne rapper
gyðja	(mytol.)gudinde
gykl	gøgl, gøgleri, fantaseren, blændværk
gykla	1forestille sig, se for sig2vise sig i fantasien, foresvæve en (i vildelse),gyklast fram fyri ein3hekse, forhekse,gykla umomskabe ved hekseri, forvandle
gyklan	blændværk, illusion,hann livdi í síni gyklanhan levede i sin egen illusion
gyklari	tryllekunstner, gøgler
gyklaverk	gøgl, noget uvirkeligt, blændværk,hvat er hatta annað enn svik og gyklaverkhvad er det andet end svig og blændværk
gykling	hekseri
gylla	forgylde,ein gyltur ringuren forgyldt ring
gyllin	(mål)1(om værdi i jord)gylden, 1 / 16 "mørk"el.20 "skinn",ein gyllin í jørð2(om værdi angående grindehval)20 skinn (6.5);jf.gyllinsfiskur3(økon.)gylden(hollandsk møntenhed)
gyllinamaður	ejer af enel.et par gylden jord
gyllinatal	antal gylden,býtt eftir gyllinatalifordelt efter antal gylden
gylling	forgyldning
gyllingur	guldpirol, pirol(Oriolus oriolus)
gylliniár	år hvor 1. juledag falder på en søndag
gyllinistykki	stykke (silke)tøj vævet med guld-el.sølvtråd
gylliniæðr	(med.)hæmoride
gyllinsfiskur	dræbt grindehval vurderet efter størrelse til en gylden
gyllinshvalur	dræbt grindehval vurderet efter størrelse til en gylden
gyllinsmaður	ejer af enel.et par gylden jord
gyllinsvirði	samme værdi som en gylden jord
gyltur	forgyldt, gylden,gyltur roðiforgyldt rødme
gyrða	1gjorde, omgjorde, binde båndel.bælte om livet (på en),gyrða segomgjorde sig;gyrða seg við svørðbinde sværd ved sin side;gyrða sín hest við gylta reimlægge gjord på hest2binde sine bukser op om sig,gyrða upp um seg;illa gyrdur maðurmand med hængerøv3lægge båndel.gjord (om tønde, kar o.lign.),gyrða tunnu;gyrdur1gjordet, omgjordet2udstafferet, pyntet,gyrdur í brókumsom har fået bukser på;(talem.)vera gyrdur í brøkursat i knibeel.stor forlegenhed
gyrði	1forsyning med gjorde el. (tønde)bånd2(ny bet.)elasticitet,tað er gott gyrði í viðinumtræets elasticitet er godt
gyrðin	elastisk,húðin er gyrðinhuden er elastisk
gyrðisbind	(med.)elastisk bind
gyrðisdýr	(zoo.)bæltedyr(Dasypodidae)
gyrðislop	elastikspring, bungeejumping
gyrðistræ	træ hvoraf man laver gjordeel.(tønde)bånd
gyski	i ordforb.gera gyski (burtur) úr (e-m)1gøre nar af en, håne en,hon gjørdi gyski úr dreinginumhun gjorde nar af drengen2formøble,hann arvaði nógv, men gjørdi gyski úr tíhan arvede meget, men formøblede det3forfølges af uheld
gýðingadómur	(rel.)jødedom
gýðingahatur	jødehad
gýðingur	jøde
gýsur	segjósa
gýta	(om fisk)gyde, kaste rogn
gýting	gydning
gýtingarfiskur	(fisk.)gydefisk
gýtingarførur	(fisk.)gammel nokel.moden til at gyde,gýtingarførur svartkjaftur
gýtingargrunnur	(fisk.)gydeplads(for fisk)
gýtingarrogn	(fisk.)rogn i fisk modne til at gyde
gýtingarstovnur	(fisk.)del af fiskebestand som er moden nok til at gyde
gýtingartíð	(fisk.)gydetid,í gýtingartíðini
gýtt	1bronze2en slags messing
gýtusól	måned i den gamle færøske kalender som varede fra 24. april til 23. maj
gývil	(bot.)gyvel
gæliskur	gælisk
gæra	i ordforb. somtað gærir frá oyrunum(om får)ulden løsner sig fra ørerneel.kinderne
gærna	(om tøj)blive utæt, løst (af slid),gærna sundur
gæruskinn	meget tyndt stykke tøj
gærutur	(om klædningsstykke)usædvanlig løst og utæt vævetel.strikket,troyggjan er so gærut
gæs1	segás
gæs2	1stundesløshed,í gæsi ella óvitii stundesløshed eller bevidstløshed2ustyrlig person,hann er eitt gæs
gæsa1	ustyrlig kvinde,gentan hevur alla skyldina, tann gæsan hon er
gæsa2	fare (hovedkulds) omkring,hann fór gæsandi omaneftir;gæsa og gartavære urolig
gæsin	vild, ustyrlig, støjende
gæsni	stundesløshed,áðrenn tann nýggja tíðin kom við sínum skundi og gæsni
gæsutur	vild, ustyrlig, støjende,gæsut børnstøjende børn
gæta	iagttage, vogte, bevogte,hann gætaði væl hesum boðum;teir settu mann at gæta honumde satte en mand til at bevogte ham
gætiliga	forsigtigt, varsomt
gætur	i ordforb. somgeva (e-m) gæturagte, bemærke (nogenel.noget), lægge mærke til;geva gætur eftir (e-m);gevið gætur eftir liljunum á markini;her er at geva gætur, at ...her er det værd at bemærke, at ...
gæva	(kvad)lykke
gævhyrntur	(om får med horn)med lige horn
gævi	segeva
gævigur	gæv, ypperlig, brav, tapper
gæviligur	gæv, ypperlig, brav, tapper
gævudagur	lykkelig dag
gævudýr	i ordforb.hann er ikki gævudýr(sagt om en som ikke har lykken med sig)
gævuligur	gæv, ypperlig, brav, tapper,(kvad)Sjúrð bað hon nevna sær hin gævuliga svein
gævumikil	lykkebringende, lykkelig
gævur	(kvad)gæv, ypperlig, brav, tapper
gævustund	lykkelig stund,jallin eigur tógva synir  /  gitnir á gævustund
gø1	(med.)seneskede(hinde)betændelse(især ved håndleddene)(peritendinitis crepitans)
gø2	måned i den gamle færøske kalender(mellem "torri" og "einmáni"),ravnur verpur í gøravnen lægger sine æg i marts
gøða	fede, opfede, opføde,(ordsp.)maður eigur at verða føddur og ikki gøddur
gøðing	opfedning, mæskning
gøðingarkálvur	fedekalv
gøðska	1kvalitet2godhed, velvilje, yndest
gøfjøra	stor ebbe om foråret (i marts)
gøgast	i ordforb.gøgast upp á e-t1se på, betragte (noget)2være forgabet i, løbe efter,ein heygsmaður gøgist upp á ljósiðen vårflue løber efter lyset
gøgn	redskab, apparat
gøla	1storm, uvejr,ein gøla inn úr havinumen storm ind fra havet2skænderi, klammeri,tað verður gøla úrdet ender med klammeri3opsigt, opstandelse, skandale
gøll	segall 1
gøllhalda	holde en så fast som i en skruestik,gøllhalda e-m;tað er skeivt at gøllhalda um tað gamladet er forkert stædigt at holde fast på det gamle
gøllur	i ordforb. somhalda e-m í gølli (el.gøll)holde en fast som i en skruestik, hindre en i at undslippe;sita í gølli og seyma, skrivaosv.anstrenge sig med at sy, skrive osv.;drekka í gøllitylle i sig
gølublað	skandaleavis, sensationsavis
gølukendur	skandaløs
gølusøga	skandalehistorie
gølutíðindi(r)	skandalenyhed
gørðum	segarður
gørn1	1tarm,eg reinsaði hvørja gørnjeg kastede voldsomt op;hatta stendur væl / illa í gørnunum(om mad som man er mæt af i lang / kort tid);spyrja garnarnar (uppel.út) úr e-mspørge mere end det sømmer sig2garnarindvolde på fisk
gørn2	segarn
gørtil	lille garnrulle
gørtur	lille garnrulle,eg eigi ein gørt eftirjeg har en lille rulle garn tilbage
gøsól	måned i den gamle færøske kalender(mellem "torri" og "einmáni")
gøssum	segassi
gøta	stedn.1trådt vej, sti, marksti(fx mellem bygder)2gade i en by(til folk og trafik),lágur í gøtuniungel.lille;gamal í gøtunigammel i gårde;tú hevur ikki greitt nakrar góðar gøtur fyri mærdu har ikke banet vejen for mig;soleiðis fer gøtan at gangasåledes vil det gå med sagen
Gøta	(stedn.)bygd i Eysturoy(dvs. Norðragøta, Gøtugjógv og Syðrugøta),í / úr Gøtu,til Gøtu
gøtubarn	gadebarn
gøtubrá	(bot.)vejbred(Plantago),stórvaksin gøtubráglat vejbred(P. major)
gøtubráarætt	(bot.)vejbredfamilien(Plantaginaceae)
gøtudanskt	(lingv.)stærkt færøskpræget dansk (sprog),tosael.skriva gøtudanskt
gøtugjáarmaður	person iel.fra Gøtugjógv
Gøtugjógv	(stedn.)bygd i Eysturoy,við / frá Gøtugjógv,til Gøtugjáar
gøtugrái	vandblandet vælling
gøtuhorn	gadehjørne
gøtuhædd	stueetage, stuen
gøtukustur	gadekost
gøtuljós	gadebelysning
gøtulykt	gadelygte
gøtumaður	1mand iel.fra bygden Gøta2(spøg.)i ordforb.hava gøtumennhave menstruation
gøtunavn	gadenavn
gøtuseljari	gadesælger
gøtusjónleikari	gadeskuespiller
gøtusjónleikur	gadeteater
gøtuskuri	(spøg.)person iel.fra bygden Gøta
gøtusópari	gadefejer
gøvgaður	ophøjet, hædret,(kvad)av Gudi veri tú gøvgaður!
gøvigur	ædel, fornem
gøvugur	(kvad)ædel, fornem
