n	1(lingv.)konsonant2(lingv.)16. bogstav i det færøske alfabet (kaldes )
nabb	(ved fiskeri)kun lidt bid, begrænset fangst,eitt lítið nabb var á miðinumder var ikke megen fangst på fiskebanken
nabba	fange lidt nu og da,vit nabbaðu nakrar fiskarvi fangede lidt fisk nu og da
nabbi	(stedn.)klippefremspring(i en fjeldvæg)
naddamáttur	(tekn.)donkraft
naftalin	(kem.)naftalen el. naftalin
nagg	lidt smerter,eg havi sovorðið nagg í tonninijeg har lidt tandpine
nagga	gnide, gnubbe,nagga eygunignide øjnene;(overf.)nagga seg uppi á e-mgnubbe sig op ad en
naggatódn	uheldig (mislykket) valkning,naggatódn kom í1valkningen mislykkedes2(overf.)arbejdet gik i stå,naggatódn er komin í samráðingarnarforhandlingerne er kommet i et dødvande;fáa naggatódnina úr afturkomme ud af dødvandet
naglabonkur	(skib.)naglebænk
naglabust	neglebørste
naglafastur	nagelfast
naglahol	naglegab
naglahøvd	naglehoved
naglajarn	naglejern
naglaklippari	negleklipper
naglakuldi	neglebid(det at fryse om fingrene),hava naglakulda
naglalakk	neglelak
naglamerki	naglegab
naglareinsari	neglerenser
naglarót	neglerod
naglaskøta	(fisk.)sømrokke(Raja clavata)
naglasoppur	(med.)neglesvamp
naglavatn	vand som man ryster af våde (nyvaskede) fingre
nagli	1nagle, søm,(talem.)nú stendur á gomlum nøglumnu skal det briste eller bære, nu gælder det;vera (so trúgvur) sum naglin í trænumvære meget trofast2træsøm, trænagle
naglsband	(biol.)neglebånd(sinus unguis)
naglskongur	ydre fingerknogle
naglsrót	neglerod
naglur	1negl,hann gevur ikki tað svarta undan naglinumhan er meget nærig;hann etur seg ikki undan naglihan er temmelig nærig;vaska sær um neglinarvaske neglene2(bot.)negl
nailon	nylon
nailonsokkur	nylonstrømpe
nakar	1nogen, nogen som helst,er nakar inni?er der nogen hjemme?;kann nakar siga mær, hvat klokkan er?kan nogen sige mig, hvad klokken er?;er nøkur mjólk, nakað breyð?er der mælk, brød?;nakrir mennnogle mænd;nakrar konurnogle kvinder;tey sóu nakað, sum tey seint fóru at gloymade så noget, som de sent ville glemme;nakrir og tjúgu mansnogle og tyve mænd2nakaðen hel del(anvendt som adj.)nakað av fiski var at síggja;vit fingu nakað av fiskivi fangede en del fisk;breyð við nakað av smøri uppiábrød med lidt smør på;millum nakað og einkimeget lidt;tað kostar millum nakað og einkidet koster meget lidt3nakaðnoget;nakað nær landiret tæt ved land;nakað leingiret længe;eg gekk nakað undan honumjeg gik lidt foran ham;teir eru nakað javnirde er temmelig jævnbyrdige;hann er nakað so fittur!han er rigtig sød!4nakaðomtrent, cirka;hann er nakað sum eg til støddarhan er omtrent så stor som jeg;tað er nakað tað samadet er omtrent det samme;nakað soomtrent det
nakin	nøgen, bar, blottet,ein nakin kroppuren nøgen krop;eg dragi naknar húkarjeg fanger ingen fisk
nakinleiki	nøgenhed
nakinskapur	nøgenhed
nakka	1hæve en sten ved at lægge understøttelse under løftestangen2en over nakken, slag over nakken,eg skal nakka tegjeg skal give dig en over nakken
nakkaagn	madding af nakkekødet på fisk
nakkabein	(biol.)nakkeben(os occipitale)
nakkabrestur	nakkestød,fáa ein nakkabrestfå et nakkestød
nakkafattur	1knejsende, stolt,ganga so nakkafatturgå og knejse2trodsig,nakkafattur í talutrodsig i ord
nakkafiskur	nakkekød på fisk
nakkafjøður	1(ornitol.)nakkefjer2nakkafjaðrarnakkehår,lat meg fáa í nakkafjaðrarnar á tærlad mig få fat i nakken på dig
nakkahár	nakkehår,nakkahárini eru farin at gránanakkehårene er blevet grå
nakkakast	nakkekast, kast med nakken,eitt firtið nakkakastet fornærmet kast med nakken
nakkakrappur	(om mennesker og dyr)knejsende, med tilbagebøjet hoved
nakkakulla	(biol.)nakkegrube
nakkalangur	flov, skamfuld, slukøret, med uforrettet sag,hann fór so nakkalangur heim afturhan vendte skamfuld hjem igen
nakkalegd	(med.)nakkefold
nakkalegdarskanning	(med.)nakkefoldsskanning
nakkaskinn	nakkeskind
nakkaskot	nakkeskud
nakkaslag	en over nakken, slag over nakken,fáa nakkaslagfå en over nakken
nakkaspik	(især på får)nakkespæk
nakkastuðul	nakkestøtte
nakkhyrntur	1(om vædderlam)med hornene voksende tæt ind til hovedet2stolt, knejsende, hovmodig, med næsen i vejret / sky,hon gongur so nakkhyrnthun er så knejsende;jf.nærhyrntur
nakki	1nakke,klóra sær í nakkanumklø sig i nakken;detta aftur eftir nakkafalde bagover;fara eftir nakkanumfalde baglæns;kasta upp á nakkaslå med nakken;traðka upp í nakka(om fodtøj)træde aldeles op, slide ganske op;skógvarnir vóru traðkaðir upp í nakkaskoene var slidt op2understøttelsespunkt for en løftestang,legg ein nakka undir jarnbrotið3bane på hammer4den øverste ende(flade) af stenbor5(båd.)den øverste del af en åretold6rundingen på fangekrog,kleppurin hevði nakka7(spøg.)hava nakkahave en fjer på, være let beruset
nakkur	(stedn.)højt forbjerg med skarp kant
nakni	nøgenhed
nakrantíð	nogensinde el. nogen sinde,hevur tú nakrantíð verið har?har du nogensinde været dér?
nakrastaðni	nogetsteds,hevur tú verið nakrastaðni?har du været ude / hjemmefra?;tað er ikki nakrastaðni at finnadet er ikke at finde nogetsteds
nakrastaðnis	(talesp.)nogetsteds
nalvabind	navlebind
nalvagras	(bot.)slægt i syrefamilien(Koenigia),íslendskt nalvagrasdværgsyre(K. islandica)
nalvalop	(med.)navlebrok,nalvalop hjá pinkubørnumnavlebrok hos spædbørn
nalvaskoðan	navlebeskuelse, selvoptagethed
nalvaskoðari	navlebeskuer, narcissist
nalvasoppur	(bot.)navlehat(Omphalina),legghærdur nalvasoppur(O. velutipes)
nalvastrongur	(biol.)navlesnor, navlestreng
nalvi	(biol.)navle
nalvungi	1(ornitol.)fugleunge der er brudt gennem skallen uden at blommesækken er helt tom(og som derfor ikke er levedygtig)2svageligt (spæd)barn,hatta er tann nalvungin, ið erhan / hun er en rigtig svækling3(neds.)grønskolling, grønært, purk,slepp tær burtur tín nalvungi!pil af, grønært!
nam	senema
Namibia	Namibia
namibiari	namibier
namibiskur	namibisk
namm	(barn.)namnam,namm, tað smakkar væl!namnam, det smager godt!
namma	(barn.)spise
nana	sidde (og rokke) et barn(på skødet),mamman sat og nanaði barninummoderen sad og rokkede barnet
naning	det at sidde (og rokke) et barn(på skødet)
napoleonshattur	napoleonshat
nappa	plukke,nappa ullplukke uld
napping	handlingen at plukke uld
nardus	(bot.)narde(Nardostachys jatamansi)
narr	1spot, hån,gera narr (at e-m)gøre nar af (nogen)2nar, gæk, dåre,títt narrdin nar
narra1	1gøre det forbi,narra einel.einagøre det forbi (med en), ophæve forlovelsen2narre, bedrage, bondefange,(ordsp.)gamal ravnur er ikki góður at narra3narrastspøge, drive spøg, gækkes;tú narrastdet kan du ikke mene
narra2	1gnide,narra eygunignide sig i øjnene;narra hendurnargnide sig i hænderne2valke en smule,narra hosurnarvalke strømperne en smule
narrarí	spøg, skæmt,tað var ikki annað enn narrarídet var kun spøg;í narrarífor sjov;hetta er ikki narrarídette er ikke spøg
narribræv	brev hvormed man gør en forlovelse forbi
nart	senerta
nartl	1gran, smule,nartl av royðugrótien smule rødlig tuf2hudafskrabning,hvørjum nartli undir ilini máttu vit geva gætur3småttærende person4(bot.)arve(Anagallis);jf.neyðarnartl
nartla	1nippe til noget,kongafiskarnir nartlaðu agnið burturavrødfiskene tog småbidder af maddingen2pille ved, berøre svagt
nasa	dø,eg sá, tá ið ærin nasaðijeg så, da hunfåret døde
nasabein	(biol.)næseben(os nasale)
nasablóð	næseblod,bløða nasablóðhave næseblod
nasadirvi	frækhed
nasadjarvur	fræk,(ordsp.)neyð ger nasadjarvannød lærer nøgen kvinde at spinde
nasadropi	næsedryp
nasaflot	(med.)løbenæse, næseflåd
nasagluggi	næsebor
nasahár	næsehår
nasahjól	(flyvning)næsehjul
nasahola	(biol.)næsehule(cavitas nasi)
nasaklemmari	lorgnet
nasaklútur	lommetørklæde
nasalangur	flov, skamfuld, slukøret, med uforrettet sag,hann fór so nasalangur heim afturhan vendte skamfuld hjem igen
nasaljóð	(lingv.)nasal, næselyd,"m" og "n" eru nasaljóð"m" og "n" er nasaler
nasaljótur	med grim næse
nasaloft	(biol.)det øverste i næsehulen
nasanabbi	næsetip
nasanebbi	næsetip
nasar	senøs
nasareari	(bibl.)nazaræer
nasareingur	(bibl.)nazaræer
nasaringur	næsering,hava nasaringgå med næsering
nasarót	næserod
nasaryggur	næseryg
nasasnippur	næsetip
nasaspískur	spidsnæset
nasastórur	stornæset
nasasøtur	som dufter sødt el. godt,nasasøtur roykursød duft
nasavegin	(med.)nasal
nashyrningur	(zoo.)næsehorn(Rhinocerotidae)
nasi	klippefremspring(i en fjeldvæg),á einum nasa í fjallinum situr ein fuglurpå et klippefremspring i en fjeldvæg sidder der en fugl;jf.nøs (2)
nasisma	(pol.)nazisme
nasistiskur	nazistisk
nasistur	nazist
naskast	være nærgående,naskast uppi áel.uppi í e-mel.upp á e-ngnide sig op ad en
naskliga	næsvist, påtrængende
naskur	næsvis, nærgående, påtrængende,(talem.)naskur sum nykurvære nærgående;naskir spurningarnærgående spørgsmål;naskt at spyrja...undskyld jeg spørger...
nasmæltur	snøvlende
naspa	stjæle, rapse, hugge
-nasutur	reyst-
nasvísur	1flov, skamfuld,eg var so nasvísurjeg var så flov2næsvis,ein framligur og nasvísur dronguren ugenert og næsvis dreng
natigur	nærig, påholdende,hann var natigurhan var nærig
natin	nærig, påholdende
natinskapur	nærighed
natni	nærighed
NATO,Nato	NATO, Atlantpagten
natrium	(kem.)natrium
natron	(kem.)natron
naturalisma	naturalisme,naturalisman kyknaði í Fraklandi í 19. øldnaturalismen opstod i Frankrig i 1800-tallet;jf.realisma
naturtunnur	tynd som en nøddeskal
natúr	1natur,natúrin er vøkurnaturen er smuk;tað er ímóti natúrinidet er imod naturen2natur, væsen, naturel,hann var glaður av natúrhan var glad af natur;vera bangin av natúrvære ængstelig af natur3erotisk begær,hann hevur onga natúrhan har intet erotisk begær
natúrligur	1naturlig, naturgiven,doyggja ein natúrligan deyðadø en naturlig død2naturlig, selvfølgelig, normal,tað er natúrligt, at e-m leingist heimdet er naturligt at længes hjem3ligefrem, frejdig, uformel,hann er so natúrligur, tá ið hann tosarhan er så ligefrem, når han snakker
natúrsterkur	rask, sund, ved godt helbred,mods.natúrveikur
nauriskur	naurisk
Nauru	Nauru
naurubúgvi	nauruer
navar	1vridbor,fara á navarin1(om ko)blive slagtet2gå konkurs2for navarin!for pokker!
navargeisli	taphvirvel(Epistropheus)
navari	1vridbor2tap på taphvirvel
navarsgeisli	(biol.)taphvirvel(Epistropheus)
navir	senøv
navn	1navn, benævnelse,spyrja e-n at navnispørge en om ens navn;eg kenni ikki hansara kristna navnjeg ved ikke hvad han hedder;hon komst við navniðhun kendte navnet;(talem.)navnið spillir (el.skemmir) ongankald det hvad du vil, man kan kalde hvad man vil;tað hevur navnið hjá særdet ligger i selve navnet;í sama navnel.navniligesådan;dagin eftir gekk í sama navnnæste dag gik det ligesådan2titel
navna	navnesøster,vit eru navnur báðarhun er min navnesøster
navnabók	navnebog
navnabretti	(båd.)navnebræt
navnabroyting	navneforandring
navnabræv	navneattest;jf.dópsseðil
navnagáva	1navngivelse2dåbsgave, faddergave,fáa e-t í navnagávufå noget i dåbsgave
navnagransking	(lingv.)navneforskning
navnakall	(pol.)navneopråb,atkvøtt varð við navnakallider blev stemt ved navneopråb
navnaklútur	navneklud
navnakort	visitkort
navnalisti	navneliste, personregister,aftast í bókini er ein navnalistibagest i bogen er et personregister
navnalóg	personnavnelov, navnelov
navnamerki	navnetræk, monogram,navnamerki hennara er broderað á dúkinhendes navnetræk er broderet på dugen
navnaprógv	navnebevis,vísa navnaprógvvise navnebevis;jf.samleikaprógv
navnaseðil	navneattest
navnasiður	navneskik,navnasiðirnir eru nógv broyttir gjøgnum tíðirnarnavneskikkene er meget forandret gennem tiderne
navnaskelti	navneskilt,navnaskelti við gøtunavninavneskilt med gadenavn
navnaskifti	navneforandring
navnaskrá	personregister, stedregister
navnberi	(lingv.)navnbærer
navnblað	titelblad(på bog)
navnbót	titel,doktaranavnbótdoktorgrad
navnfestur	navngiven,maðurin er ikki navnfesturmanden er ikke navngiven
navnframi	navnkundighed
navnframur	navnkundig, berømt,ein navnframur málarien berømt maler
navnfremi	(bibl.)navnkundighed
navnfrægd	berømmelse
navnfrægur	berømt,hann er navnfrægur maðurhan er en berømt mand
navngáva	navngivelse
navngeva	1nævne2navngive, døbe, kalde,tey hava navngivið dóttur sínade har navngivet deres datter
navngitin	1berømt, navnkundig,ein navngitin sangarien berømt sanger2navngiven, nævnt ved navns nævnelse,ein ungur ikki navngitin dronguren ung ikke navngiven dreng
navngreina	(bot.)bestemme,navngreina eina plantubestemme en plante
navnháttarmerki	(lingv.)infinitivmærke
navnháttur	(lingv.)infinitiv, navnemåde,"gera", "selja", "taka" standa í navnhátti"gøre", "sælge", "tage" er infinitiv(infinitivus)
navnheild	(lingv.)navnehelhed
navni	navnebror, navnefælle,navni mínmin navnebror;vit eru navnarvi er navnefæller
navnkenna	præsentere,navnkenna e-n við e-npræsentere en for nogen
navnkristin	navnekristen,tey, sum av sonnum eru trúgvandi, og hin stóri hópurin av navnkristnum
navnkunnur	navnkundig, berømt
navnleysur	navnløs
navnliður	(lingv.)substantivisk led
navnloysi	navnløshed, anonymitet
navnnevndur	navngiven, nævnt med navns nævnelse,navnnevndur maðurnavngiven mand
navnorð	(lingv.)substantiv, navneord(nomen substantivum)
navnorðabending	(lingv.)nominalbøjning
navnseðil	etiket, etikette
navnskelti	navneskilt
navnvinur	ven af navn(og ikke af gavn),mangir vilja navnvinir veramange vil kaldes venner
navnvirði	(økon.)nominalværdi, pålydende værdi
náa	1nå, række hen til, få fat el. ram på,náa e-mnå noget;eg náddi honum ikkijeg fik ikke fat el. ram på ham;teir náddu ikki á lendinginade nåede ikke landingspladsen2få lov el. tilladelse til,tú skalt náa viðdu skal få lov at komme med3have tid til,eg nái ikki at komajeg har ikke tid til at komme;hvørki teirra náddi útingen af dem kunne komme, ingen af dem slap ud
nábalsklógv	gnier, fedthas
nábleikur	ligbleg
nábúgvi	nabo
náð	1fred, ro,í náðumi fred og ro;sita í frið og náðumsidde i ro og mag;geva sær góðar náðirgive sig god tid;eg fái ikki náðir fyri henni, sum hon plágar megjeg får ikke fred for hende, som hun plager mig;ikki hava náðir (til e-t)ikke have tid (til noget);(ordsp.)góðar eru fátækrael.fátækar náðirdet er godt at nyde fred og ro, hvis man er fattig2hjælp, støtte,snávaði ein har, so vóru ongar náðirhvis man snublede der, så var der ingen hjælp at hente3(rel.)nåde, miskundhed,Guds náðGuds nåde;at biðja til Gud um náðat bede til Gud om nåde
náða	1nåde, være en nådig,Gud náði teg!Gud nåde dig el. Gud nåde og trøste dig;Gud náði meg syndaraGud vær mig synder nådig;Jesus náði (tú) meg!Jesus se i nåde til mig! Gud være mig nådig2benåde,fangarnir vórðu náðaðirfangerne blev benådede
náði	1(rel.)nåde, barmhjertighed, gunst,fáa náði frá Guðifå nåde fra Gud2hjælp,teir kunnu ikki ana uttan annans náðide kan ikke overleve uden andres hjælp3tygara náðiDeres Nåde
náðibreyð	nådsensbrød
náðifullur	(rel.)nåderig
náðigáva	(rel.)nådegave
náðigerð	(rel.)nådesgerning
náðigur	(rel.)nådig,Harrin veri tær náðigurHerren være dig nådig
náðileysur	nådeløs, nådesløs
náðiligur	mild, nådig;-liga
náðing	benådning,bíða eftir náðingvente på benådning
náðir	senáð
náðiríkur	(rel.)nåderig
náðistólur	(bibl.)sonedække(2. Mós.25.17;3. Mós.16.2)
nágranni	nabo
nágreina	præcisere
nágreiniligur	dybtgående, tilbundsgående,ein nágreinilig kanningen dybtgående undersøgelse;-liga
nágreining	1præcisering2specifikation
náhond	(zoo.)dødningehånd(Alcyonium digitatum)
náhvalur	(zoo.)narhval(Monodon monoceros)
náhvítur	ligbleg,náhvítur í andlitiligbleg i ansigtet
náhøvur	(zoo.)dødningehoved(sommerfugl)(Acherontia atropos)
nákvæmi	nøjagtighed
nákvæmur	nøjagtig
nál	1nål,leita sum eftir nállede nøje efter noget;ikki duga at halda á nálikke være dygtig til at strikke o.lign.,sita sum á nálumsidde som på nåle2kompasnål,kumpassin er kvik á nálinikompasset er ustadigt, følsomt;(overf.)kvikur á nálinihidsig, opfarende;hon er so leys á nálinihun er så ustadig, hun er så flygtig;fara av nálinigå fra koncepterne;drekka seg út av nálinidrikke sig fra sans og samling3(bot.)spire,tá ið lambið er 14 dagar gamalt, fer tað at taka nálnår lammet er 14 dage gammelt, begynder det at græsse;taka nálirnar av eplunumfjerne spirerne af kartoflerne4(bot.)nål5(med.)kanyle
nálabræv	nålebrev
nálakoddi	nålepude
nálaprentari	(datal.)matrixprinter
nálapúta	nålepude
nálareyga	nåleøje
nálarhúgvusoppur	(bot.)nålehuesvamp(Mycena capillaripes)
nálarhús	nålehus
nálarhúsi	nålehus
nálarhøvd	nålehoved
nálaroddur	nålespids,hon stóð sum á nálaroddumhun stod som på nåle
nálaskógur	nåleskov
nálatorva	i ordforb. somfara (liggja, leypa) í nálatorvu(om kartofler)spire så meget at spirerne filtres sammen
nálatræ	(bot.)nåletræ
nálaviðgerð	(med.)akupunktur
nálg	1kælent barn,tú ert eitt nálgdu er et kælent barn2i ordforb.hava (fáa) nálg atel.á e-mføle stærkt erotisk begær
nálga	nálga segel.nálgast (uppi íel.uppi á e-m)1gnide / gnubbe / klistre sig op ad en, indynde sig hos en,hann nálgast altíð uppi í honumhan klistrer sig altid op ad ham2uafbrudt gentage den samme ting,gakk ikki og nálgast3gøre tilnærmelser til, lægge an på,hon nálgast uppi á honumhun lægger an på ham
nálgutur	liderlig, lysten
nálvaksin	(bot.)nálvaksið blaðnåleformet blad
nám	1mine, grube,kolanámkulmine2studium,námið endar við próvtøkustudiet afsluttes med eksamen3grænse,kavanámsnegrænse4anelse,hava sovorðið nám av e-mhave en anelse af noget5tegn på at et hundyr er brunstigt,eitt nám tyktist vera á kúnnidet så ud som om koen var i brunst
náma1	mine, grube
náma2	tage, røve,náma e-t frá e-mrøve noget fra en
námd	i nærheden,her í námdher i nærheden
námi	i nærheden,eingin kundi koma honum nær ella námiingen kunne komme i nærheden af ham
námind	nærhed,har var eingin í námindder var ingen i nærheden
náminda	nærhed,í náminduel.í námindumnær, i nærheden;her í náminduher i nærheden
námindis	i nærheden,ikki nær námindislangtfra;eg kom honum ikki nær námindisjeg kom ikke i nærheden af ham;ikki nær ella námindislangtfra;hann er ikki nær námindis so sterkur sum eghan var langt fra så stærk som jeg
námleiki	nøjagtighed
námmið	fiskeplads der er så lille at den er vanskelig at ramme
námmiðað	(om fiskeplads)så lille at den er vanskelig at ramme,miðið er so námmiðaðfiskepladsen er så lille at den er vanskelig at ramme
námsarbeiðsmaður	kulminearbejder
námsár	(skole)studieår
námsevni	(skole)lærestof
námsferð	studierejse,næmingarnir fóru námsferð til Rómeleverne tog på studierejse til Rom
námsfrøði	(skole)pædagogik
námsfrøðiligur	(skole)pædagogisk
námsfrøðingur	pædagog
námsgongd	mineskakt
námsgrein	studiefag
námskeið	kursus,lærarar eru á námskeiðilærerne er på kursus
námslán	studielån
námsráðgevi	(skole)pædagogisk konsulent,námsráðgevi í byrjanarundirvísingpædagogisk konsulent i begynderundervisning
námsstyrkur	stipendium
námsvinna	minedrift
námsætlan	(univ.)studieplan
námur	1nøjagtig, akkurat,teir tveittu bumbur tó uttan at raka, men vóru tó so námir, at skipið fekk skaðade smed bomber uden dog at ramme, men var dog så tæt på, at skibet blev beskadiget;námt miðfiskeplads som er vanskelig at træffe pga. lidenhed;hatta er ov námtsømmen er for smal2følsom, fintmærkende,hetta er nógv námaridette er langt mere følsomt(om tv-apparat)
nánd	i ordforb. somí nándel.í nándinii nærheden;har í nándder i nærheden;í nánd av (e-m)i nærheden af noget
nápa	rapse, stjæle, hugge,eg nápaði blýantin hjá honumjeg rapsede blyanten fra ham;nápa sær ein bitastjæle en bid mad
nápari	(spøg.)tyv
náptak	piratkopi
nápur	(ornitol.)náparfluesnapper(Muscicapidae)
nátaegg	mallemukæg
nátasjúka	papegøjesyge
nátaungi	ung mallemuk før den er (rigtig) flyvedygtig,fara eftir nátaungumsejle ud for at fange mallemukunger
nátt	nat,mods.dagur,tá ið leið út á náttinasenere på natten;nátt kom ádet blev nat;á náttved nat;eg blundaði ikki á náttinijeg kunne ikke sove i nat;á miðjari náttmidt om natten;náttin kom ánatten faldt på;liggja náttovernatte;í nátt1sidste nat, i går nat2i (denne) nat;sita uppi til langt út á náttinasidde oppe til langt ud på natten;inn í náttinaud på natten;um næturom nætterne;tey eru (so ólík) sum dagur og náttde er som dag og nat,góða náttgod nat!;koma undir náttikke nå frem før det bliver nat;um vit ikki kvika okkum, koma vit undir nátthvis vi ikke skynder os, når vi ikke frem før det bliver nat
-náttaður	setrí-
náttarblindur	(med.)natteblind
náttarbrandur	emmer, glødende aske
náttardimmi	nattemørke,náttardimmið undan ólavsøku er ikki langtnattemørket inden ólavsøka er ikke langt
náttardøgg	nattedug
náttarfriður	nattero
náttarfrost	nattefrost
náttarfuglur	natfugl
náttargali	(ornitol.)1nattergal(Luscinia luscinia)2(spøg.)hane
náttargestur	nattegæst,her verði eg ikki náttargesturel.náttargesturinher vil jeg ikke overnatte
náttargrátur	nattegråd
náttarhimin	nattehimmel, nathimmel
náttarhimmal	nattehimmel
náttarhvíld	nattehvile
náttarkuldi	nattekulde
náttarkvirra	nattestilhed
náttarlega	natteleje, natlogi,har á garðinum fingu teir náttarleguder på gården fik de natlogi
náttarlevnað	nattesvir, nattesværmen
náttarlív	natteliv,náttarlívið í Keypmannahavnnattelivet i København
náttarluft	natteluft
náttarmaður	nattegæst
náttarmyrkur	nattemørke,náttarmyrkur kom á teirnattemørke kom over dem
náttarravnur	natteravn, B-menneske
náttarrógv	nattero
náttarseta	det at en fiskeline står natten over,seta eina náttarsetusætte en fiskeline for natten
náttarskýli	nattely,veita e-n náttarskýligive nogen nattely
náttarsvøvnur	nattesøvn,fáa góðan náttarsvøvnfå en god nattesøvn
náttartíð	nattetid,á náttartíðved nattetid
náttartími	nattetime,teir myrku náttartímarde mørke nattetimer
náttartøgn	nattero
náttarvakt	1nattevagt,hava náttarvakthave nattevagt;vera á náttarvaktvære på nattevagt2natvægter, nattevagt,náttarvaktin kemur til arbeiðis á midnáttnatvægteren går på arbejde ved midnat
náttarvekur	nattevågen
náttarviðbót	nattetillæg
náttarvøka	nattevågen
náttarvørður	nattevagt, natvægter
náttborð	natbord, sengebord
náttból	natteleje,hjørtirnir høvdu náttból í eini lægdhjortene havde natteleje i en lavning
náttbrandur	emmer, glødende aske
náttbussur	natbus
náttdrakt	natdragt
náttfar	himlens udseende om natten, månen og stjernerne
náttfara	himlens udseende om natten, månen og stjernerne,hvat fram var, veit eg ikki, tí náttfaran sást ikkijeg ved ikke, hvad klokken var, for det var overskyet
náttfirvaldur	(zoo.)natsommerfugl, natsværmer
náttfuglur	natfugl,velhvíti er náttfuglurlille stormsvale er natfugl
nátthúgva	nathue
nátthús	wc, toilet
nátthúspappír	wc-papir, toiletpapir
náttkjóli	natkjole
náttklubbi	natklub
náttklæði(r)	nattøj, pyjamas
náttkrem	natcreme
náttkvirrur	nattestille
náttlampa	natlampe
náttljós	lampelys,lesa við náttljóslæse ved lampelys, læse ved kunstigt lys
náttlýsi	(bot.)natlys
náttmyrkur	nattemørke
náttpottur	natpotte
náttravnur	natteravn, B-menneske
náttserkur	natdragt, natkjole
náttsól	måne,tað verður ikki veiðisól hjá honum, ið nevnir mánan við røttum navni í staðin fyri náttsólden der nævner månen ved dens rette navn ("máni": tabu under fiskeri) i stedet for "náttsól", fanger ingen fisk
náttstaðin	1som har stået natten over,náttstaðin mjólkmælk som har stået natten over2(om får)der først bliver slagtet dagen efter at det (de) er indfanget,lambið var náttstaðið, annars hevði tað vigað meir
náttsvartur	nattesort
nátttroyggja	nattrøje
nátturðabein	tungeben(os hyoideum)
nátturðabiti	(lidt) aftensmad,fáa sær ein nátturðabitaspise (lidt) aftensmad
nátturðaboð	meddelelse om at aftensmaden er færdig
nátturðaborð	aftensbord,tey sita uttan um nátturðaborðiðde sidder ved aftensbordet
nátturðaførur	der har fanget så mange fisk at det bliver til aftensmad,ikki nátturðaføruruden at have fanget fisk nok til et måltid mad;jf.málaførur
nátturðaleysur	som ikke har spist aftensmad, uden (at have fået) aftensmad,fara nátturðaleysur í songgå i seng uden at have spist aftensmad
nátturðalinur	søvnig efter at have spist aftensmad
nátturðaløgur	vand hvori aftensmaden koges(er kogt)
nátturðamatur	aftensmad
nátturðamáli	tid da man spiser til aften,út móti nátturðamálahen imod aftensmaden
nátturðapottur	gryde med aftensmad
nátturðasvangur	sulten efter aftensmad,teir vóru nátturðasvangirde var sultne efter aftensmad
nátturðatíð	tid da man spiser til aften,eftir nátturðatíðefter aftensmaden
nátturðavatn	vand til kogning af aftensmaden
nátturði	aftensmåltid, aftensmad,etael.fáa sær nátturðaspise aftensmad
náttúra	1natur,úti í náttúruniude i den fri natur;Føroya náttúraFærøernes natur;frøast um náttúrunaglæde sig over naturens skønhed;náttúran hevur sína føstu gongdnaturen har sin vante gang;tað er ímóti náttúruni at skilja barnið frá mammunidet er ikke naturligt at skille barnet fra moderen2natur, naturel, karakter, væsen
náttúruborin	naturgiven, naturlig,hennara náttúruborna medferðhendes naturgivne væremåde
náttúrubundin	naturbestemt,náttúrubundin gongdnaturbestemt forløb
náttúrufriðing	naturfredning
náttúrufrøði	naturvidenskab;jf.náttúruvísindi
náttúrufrøðiligur	naturvidenskabelig,náttúrufrøðiligar rannsóknirnaturvidenskabelige undersøgelser
náttúrufrøðingur	naturforsker
náttúrufyribrigdi	naturfænomen
náttúrugripasavn	naturhistorisk museum,Føroya NáttúrugripasavnFærøernes Naturhistoriske Museum
náttúrugripur	naturgenstand
náttúruheilivágur	naturmedicin
náttúruhúshald	naturaløkonomi,broytingin frá náttúruhúshaldi til peningahúshaldovergangen fra naturaløkonomi til pengeøkonomi
náttúrukensla	naturfølelse
náttúrukreftir	naturkræfter
náttúrukvæði	naturmytisk vise
náttúruligur	naturlig
náttúrulóg	også(fys.)naturlov
náttúrulýsing	naturbeskrivelse
náttúrulækni	(med.)naturlæge
náttúrulæra	(skole)naturfag
náttúrumáttur	naturkraft
náttúrumynd	naturbillede, sceneri
náttúruríkidømi	naturrigdomme
náttúruskipan	naturens orden,tað er ímóti náttúruskipaninidet er imod naturens orden
náttúrusøga	(skole)naturhistorie
náttúrutilfeingi	naturressource, naturlig ressource
náttúruvakurleiki	naturskønhed,ansur fyri náttúruvakurleikainteresse for naturskønhed
náttúruvanlukka	naturkatastrofe
náttúruvernd	naturbeskyttelse
náttúruvísindaligur	naturvidenskabelig
náttúruvísindamaður	naturvidenskabsmand
náttúruvísindi	naturvidenskab;jf.náttúrufrøði
náttvørður	nattevagt, natvægter
nátungi	ung mallemuk før den er (rigtig) flyvedygtig
nebba	lille helleflynder
nebbafiskur	(zoo.)finhval(Balaenoptera physalus)
nebbasild	(fisk.)tobis(Ammodytes),fiska nebbasildfiske tobis
nebbaskoyti	1stykke hvormed en fiskestang er forlænget i den tynde ende2spidsen på en fiskestang
nebbaskøta	(fisk.)gøgerokke(Raja fullonica)
nebbatong	niptang
nebbi	1spidsen på en fiskestang2hver af en fugleketsjers to spidser3(neds.)mund;tað kom ikki orð av hansara nebbahan sagde ikke et muk
neðra	i ordforb.í neðraforneden, nedenunder;tað er klárt í neðra, men mjørki á fjallatindunumdet er klart forneden, men tåge ved fjeldtopperne;búgva í neðrabo i nederste etage;í neðraunder bæltestedet
neðrafylgi	flok får der græsser på lavtliggende græsgang(e),mods.ervafylgi
neðralamb	lam der græsser på lavtliggende græsgang(e)
neðraseyður	får der græsser på lavtliggende græsgang(e),mods.ervaseyður
nefs	reprimande, opsang, overhaling
nefsa	straffe, revse
negativur	negativ,negativt svarnegativt svar;(mat.)negativ tølnegative tal
neggj	vrinsk, vrinsken
neggja	1gnægge, vrinske,rossini neggjahestene vrinsker2hvine, skrige,hatta situr og neggjarhan / hun sidder og hviner
neggjan	vrinsk, vrinsken
negl1	negl
negl2	senaglur
negla	1nagle, fastnagle, fæste med nagler,negla plankar samannagle planker sammen;(overf.)øll stóðu sum negldalle stod som fastnaglet(fx af skræk)2give stikpiller, snerte, håne,negla e-n við e-mgive en en stikpiller el. skoser for noget3trykke, genere,eg kann ikki eta hatta, tí tað neglir meg so illajeg kan ikke spise dette, fordi jeg kan ikke tåle det;tað neglir so fyri bróstinumjeg har pine i brystet;tað neglir undir síðunijeg har sidesting
neglalaksloysari	neglelaksfjerner
negling	1nagling2trykkende fornemmelse(efter at man har spist noget tørt og hårdt),eg havi sovorðna negling fyri bringunijeg har en trykkende fornemmelse for brystet
nei1	nej,mods.ja 1,korta neiabsolut nej;á neiel.o neinej, vist ikke;kemur tú ikki? nei, eg fái ikkikommer du ikke? nej, jeg kan ikke;nei, sum kjólin er fínurnej, hvor kjolen er fin!
nei2	nej, afslag,mods.ja 2;hann fekk nei frá stjóranumhan fik et nej fra direktøren;spyr hann, tú fært ikki meira enn eitt neispørg ham, du får ikke mere end nej
neig	seníga
neiligur	negativ;ilt er at byrja nakað nýtt, tá ið øll eru so neiligdet er vanskeligt at begynde på noget nyt, når alle er negativt indstillet;arbeiðsloysið hevur neiliga ávirkan á ungfólkarbejdsløsheden har negativ påvirkning på ungdommen
neilon	nylon
neis	beskæmmelse, slem streg, slemt puds,vinna e-m neisirspille en et puds
neisa	beskæmmelse, slem streg, slemt puds,vinna e-m neisurspille en slemt på næsen, spille en et puds
neisagdur	negativ
neista	gnistre, slå gnister,tendriproppurin neistar ikkitændrøret giver ingen gnist;(overf.)eyguni neistaøjnene gnistrer af vrede
neistabressa	(zoo.)hvidplettet agersvirreflue(Scaeva pyrastri)
neistafok	flyvende gnist
neistaregn	flyvende gnist
neistarok	flyvende gnist,sum eitt neistaroksom en flyvende gnist
neisti	1gnist,(ordsp.)lítil neisti kann birta stóran eldaf liden gnist kommer ofte stor ild;styggur sum ein neisti(om får);sum ein neisti1rap, hurtig,hann var sum ein neisti avstaðhan fór af sted2hidsig,hon er sum ein neisti  so illsinthun er en rigtig hidsigprop2(meget) lille lam
neistra	gnistre
neit	seníta
neita	give ondt af sig, småskænde, være utilfreds,neita inn á e-nbebrejde en noget
-neiti	seill-
-neitin	seill-
-neitutur	seill-
nekari	neger
nekt	nøgenhed
nekta	gøre nøgen, blotte, afklæde,nekta e-n úr øllum klæðunumtage alt tøjet af nogen
neliksrót	(bot.)nellikerod(Geum)
neliksætt	(bot.)nellikefamilien(Caryophyllaceae)
nelikur	(bot.)nellike(Dianthus)
nell	spirrevip, mandsling,eitt pinkalítið nellen lille bitte spirrevip
nema	1røre ved,barnið nemur so illabarnet rører ved alting,nema við (e-t)1berøre, røre (let),nem ikki við!(du må) ikke røre!;(overf.)hann er gamal, nemur við 90han er gammel, næsten 90 år2behandle overfladisk,hann nam leysliga við evniðhan behandlede emnet flygtigt3have indflydelse på,hesi orðini numu við megdisse ord berørte mig (dybt)2lægge hånd på nogen,skal eg nema teg?skal du have tæsk?3stjæle, hugge,hann skal altíð nemahan nyder at stjæle4tage i besiddelse,nema landtage land i besiddelse;jf.landnám5nemme, tilegne sig (i hukommelsen), lære,nema sær kunnleikatilegne sig kundskab;(ordsp.)(tað, ið) ungur nemur, (hann) gamal fremurhvad man i ungdommen nemmer, man ej i alderdommen glemmer6lægge mærke til, opdage,hann kom inn í kamarið og nam ljóðið av mongum málumhan kom ind på værelset og hørte lyden af mange sprog7i ordforb.tú nemur ikki at broyta eitt viðursvetdu vover ikke at forandre noget som helst
nemus	(spøg.)pilfinger
nenna	i ordforb.nenna sær1nænne, kunne bekvemme sig til,eg nenti mær ikki at vekja barniðjeg nænnede ikke at vække barnet2unde sig,hann nennir sær einkihan er meget nærig
neon	(kem.)neon(tegnNe)
neonrør	(kem.)neonrør
Nepal	Nepal
nepalbúgvi	nepaleser
nepalskur	nepalesisk
neppa	(talesp.)næppe
-neppingur	selív-
neps	reprimande, opsang, overhaling,hann fekk eitt nepshan fik en opsang
nepsa	dadle, bebrejde
Neptun	(astronomi,mytol.)Neptun
nerta	1røre (let), berøre,nerta við e-trøre ved noget;hasir báðir leidningarnir mugu ikki nerta samanel.nerta hvør við annandisse to ledninger må ikke røre hinanden2berøre, omtale, nævne, tale om,nortið verður eisini eitt sindur við skúlaviðurskiftiniskoleforholdene bliver også omtalt;her skal bert nertast við tann týdning, hann hevði fyri felagiðher skal kun nævnes den betydning, som han havde for foreningen;tað nerturel.nertir ikki afturatdet er så langtfra
nertil	(mat.,musik)tangent
nerting	berøring
nerv	(biol.)nerve(nervus),hava nervarvære nervøs,hann er fullur í nervumhan er meget nervøs;eg havi ikki nervar til at síggja hattajeg har ikke nerver til at se det;hava góðar nervarhave stærke nerver, have nerver af stål;hava ringar nervar1have dårlige nerver2være bange
nerva	trykke, genere, gøre (ubehageligt) indtryk på,tað nervar meg ikkidet generer mig ikke;henda veiða nervar ikki stovnindenne fangst gør ikke indhug i bestanden
nervabrek	(med.,psyk.)nervøs lidelse
nervagass	nervegas
nervaheilivágur	(med.)nervemedicin
nervakríggj	nervekrig
nervakykna	(biol.)nervecelle(neuron)
nervalag	(biol.)nervesystem
nervalækni	(med.)nervelæge
nervasjúka	(med.)1nervesygdom2(psyk.)nervelidelse
nervasjúkur	(med.)1nervesyg2(psyk.)neurotisk, nervesvækket
nervatablett	(med.)nervepille
nervaveikur	(med.,psyk.)neurotisk, nervesvækket
nes	næs,millum nesjaimellem næssene
Nes	1bygd i Eysturoy,á / av Nesi,(inn / út) á Nes2bygd i Suðuroy,á / av Nesi,(út) á Nes3bydel i bygden Hvalba,í / úr Nesi,(út) í Nes
nesmaður	1person iel.fra bygden Nes i Eysturoy2person iel.fra Nes i Suðuroy
net	net, garn,(idr.)bólturin fór í netiðbolden gik i mål, bolden gik i nettet
netamaður	(mar.)fisker som er ansvarlig for nettene(på trawler)
netanál	nål til knytning af net(til fuglestang)
netarulla	(skib.)netrulle
nethinna	(biol.)nethinde(retina)
netja	bughulens net(omentum majus)
nett	1netop, lige, akkurat,nett sum hinilige som de andre;nett herlige her;skógvurin passar so nett til fót tínskoen passer nøjagtigt til din fod;tað var nett so sum eg segðidet var akkurat sådan som jeg sagde2nøjagtigt,fiskurin stóð nett á Grynnuni;longumið má leggjast so nett
nettleiki	nøjagtighed
nettligur	spinkel, finlemmet,nettligt arbeiði, t.d. træskurðurpillearbejde, fx træskæring;-liga
netto1	(økon.)netto
netto2	netto,mods.brutto 2,pakkin vigaði 2 kg nettopakken vejede 2 kg netto
nettupp	netop, lige, akkurat, præcis, nøjagtig,tað er nettupp taðdet er netop det,tað var nettupp tað, tú ikki skuldi geradet var præcis det, du ikke skulle gøre;nettupp núlige nu
nettur	1net, fin,hon hevur so nettar hendurhun har så fine hænder2omhyggelig, påpasselig,loyvt var monnum, ið nettir vóru við hoyggj, at sláa hagagras;teir gomlu vóru nettir við seyðatali í haganum3nøjagtig, akkurat, præcis,nett miðfiskeplads der er så lille at den er vanskelig at ramme4nøjagtig, præcis, eksakt,nett vekten nøjagtig vægt5træfsikker,hann var so nettur at steinahan var så træfsikker at kaste med sten6nærig,hann er so nettur í at lata afturhan er så nærig med at give tilbage
netverk	netværk
nev	1næb,bresta fyri nevel.nevislå hul(om ægget med unge i),bróta fyri nevel.nevi(om fugleunge)bryde æggeskallen med næbbet;sum lundi sligin á neviðyderst skamfuld, flov;vera í nevifå næb;nevið reyðastrandskade;høga neviðlunde i vinterdragt;(spøg.)fáa sær upp í neviðtage en snaps;(talem.)vera millum nevs og nebbavære i en kritisk situation2(båd.)fremspring på åretold,oman fyri gripið ella skakkið er nøsin ella nevið3(bot.)næb (på frugt)4(flyvning)næse5spids på fiskekrog6(stedn.)mindre klippefremspring nede ved søen, lille spids pynt
neva	1slå med næven,hann nevaði í borðiðhan slog i bordet2true med næven,neva eftir e-mtrue en med næven3nevastslås
nevaduk	næveslag
nevaleikari	bokser
nevaleikur	(idr.)boksning
nevaslag	næveslag
nevasláttur	næveslag
nevastingur	i ordforb.draga nevastingsy med tråden løbende inde i hånden
nevastórur	nævestor
nevdregil	(fisk.)stor næbsnog(Nerophis ophidion)
nevdýr	(zoo.)næbdyr(Ornithorhynchus anatinus)
nevhávur	(fisk.)næbhaj(Deania calceus)
nevhjól	(flyvning)næsehjul
nevhvalur	(zoo.)næbhval(Mesoplodon bidens)
nevi	1næve, knyttet hånd,geva e-m nevanslå nogen med den knyttede hånd;fáa nevanfå et næveslag;hann legði nevan til hansarahan slog ham med knyttet næve;taka upp í nevarnar av e-mtage en håndfuld af noget;síggja seg í nevantage sig i agt, vogte sig, være yderst forsigtig el. varsom;hann sær seg ikki í nevan fyri at gevahan er gavmild2håndfuld,ein nevi av saltien håndfuld salt
nevna	1nævne, benævne, kalde,tey nevndu hann Sjúrðde kaldte ham Sigurd;sjáldan verður eydnismaður, ið nevndur er burtur úr ættdet bliver ikke nogen dygtig mand, som ikke er opkaldt efter sin egen slægt2nævne, sige navnet på,nevna á (at) navninævne ved navn;nevna segel.nevnasthedde, kaldes,hann nevndi seg Hanushan kaldte sig Hans;nevna segpræsentere sig;hann nevndi seghan præsenterede sig;eingin nevndur, eingin gloymduringen nævnt, ingen glemt3nævne, omtale, berøre,eg skal nevna tað fyri honumjeg skal nævne det for ham;hann nevndi einki um nakaðhan nævnte intet om det4udnævne, beskikke,kongur nevndi hann til umboðsmann sínkongen udnævnte ham til sin repræsentant
nevnari	(mat.)nævner
nevnd	1udvalg2bestyrelse, ledelse, styrelse
nevndarálit	udvalgsbetænkning
nevndarformaður	bestyrelsesformand
nevndarfundur	bestyrelsesmøde
nevndarlimur	bestyrelsesmedlem
nevndarmaður	bestyrelsesmedlem
nevndarsessur	udvalgspost,hann segði nevndarsessin frá særhan forlod udvalget
nevndarviðgerð	udvalgsbehandling,málið hevði fingið nevndarviðgerðsagen var behandlet i udvalget
nevni	betegnelse, benævnelse,hatta nevnið hóskar ikki henniden benævnelse passer ikke på hende
nevniliga	nemlig,tað er nevniliga so, at hann hevur sagt uppdet er nemlig sådan, at han har sagt op;tað er nevniliga ikki bara sum at siga taðdet er altså ikke nogen let sag
nevning	1nævnelse2udnævnelse
nevningamál	(jur.)nævningesag
nevningarverdur	nævneværdig
nevningating	(jur.)nævningedomstol, jury
nevningur	(jur.)nævning, jurymedlem
nevrót	næbrod, næbgrund
nevsa	dadle, bebrejde
nevsligin	yderst skamfuld, flov,sum nevsligin lundiyderst skamfuld, flov
nevsoddur	spidsen af et næb
nevsrót	næbrod, næbgrund
nevstiði	ambolt med spids, spærhorn
nevstør	(bot.)næb-star(Carex rostrata)
nevtron	(fys.)neutron
neyð	1nød,vera í dýrastu neyðvære i yderste nød;staddur í neyði nød;neyð gekk á hanahun var i nød og trang;við neyð og deyðel.við neyðmed nød og næppe;kæra sína neyðklage sin nød;tá ið neyðin er størst, er hjálpin næstnår nøden er størst, er hjælpen nærmest;(ordsp.)neyð ger nasadjarvannød lærer nøgen kvinde at spinde;(talem.)neyð ger so mangan tjóvder er mange som stjæler af nød;(ordsp.)mangur dansar og dansar av neyðel.neyðum,sedansa;(ordsp.)mangt er í neyðini nýtt (el.tøkt) (sum ikki er í armóðini gitið)i trang hjælper man sig, som man kan2fattigdom, armod, nødstilstand,hann hevur onga neyðhan lider ingen nød;hava e-t fyri neyðiniel.fyri neyðumtrænge til noget;hava hjálp fyri neyðinitrænge til hjælp;vera fyri neyðinitiltrænges;tað var fyri neyðinidet var fornødent, det kom højlig tilpas;vit hava alt, sum er fyri neyðinivi har alt, som behøves;nú er neyð á honumhan er ivrig efter at ...;tá var neyð á honum (eftir) at sleppa við;tað er eingin neyð fyri tídet fikser sig nok3mangel, trang,neyð upp á grýturmangel på gryder4lille smule,hann drakk so illa og oyðilegði ta neyðina av ogn, sum var í húsinum fyri brennivín
neyðakker	(mar.)nødanker
neyðar	stakkels,tann neyðar drongurden stakkels dreng
neyðara	stakkel,at sleppa sær burtur úr hesum neyðara landinumat slippe bort fra dette arme land
neyðaradýr	stakkels person, stakkel
neyðarár	år hvor folk lider nød
neyðarbeist	stakkels person, stakkel
neyðardalur	jammerdal,í hesum neyðardalii denne jammerdal
neyðardýr	stakkels person, stakkel,hann er eitt satt neyðardýrhan er en rigtig stakkel;nú, neyðardýrið!nå, lille ven!
neyðaregg	usædvanlig lille æg
neyðarhús	et fattigt hus
neyðarkall	nødsignal,skipið sendi út neyðarkallskibet udsendte nødsignal
neyðarkor	usle kår, kummerlige forhold,hann livdi í neyðarkorumhan levede under kummerlige forhold
neyðarlív	elendigt usselt liv, skyggetilværelse, skyggeliv,liva eitt neyðarlívleve en skyggetilværelse
neyðarmaður	stakkels mand
neyðarnartl	(bot.)spæd arve(Anagallis tenella)
neyðarróp	nødråb,rópa neyðarrópråbe om hjælp;neyðarrópini hoyrdustnødråbene kunne høres
neyðars	stakkels,neyðars maðurstakkels mand
neyðarseil	(på fisk)det yderste tynde kæbekød
neyðarsligur	ynkelig, kummerlig, elendig, ussel,eitt neyðarsligt lívet elendigt liv;hon var so rak og neyðarslighun var så mager og spinkel;-liga
neyðarstandur	elendighed,á, tann neyðarstanduråh, hvilken elendighed!
neyðarstund	(bibl.)nødens stund,á neyðarstundi nødens stund
neyðarstøða	elendighed
neyðartíð	trang tid
neyðbluss	nødblus
neyðbrá	i ordforb. somgera e-t í neyðbrái en snæver vending
neyðbremsa	nødbremse(også fx i fodbold)
neyðbróta	slå i stykker ved for hårdhændet behandling,árin er neyðbrotinåren er knækket(pga. for hårdhændet behandling)
neyðdoypa	(rel.)nøddøbe
neyðdópur	(rel.)nøddåb
neyðdyr	nødudgang
neyðflagg	(mar.)nødflag,flagga við neyðflaggiflage med nødflag
neyðfullur	kvalfuld, pinefuld
neyðhalda	klamre sig til,neyðhalda sær í (e-t)klamre sig til noget(også overført)
neyðhavn	nødhavn,í illveðrinum tók skipið neyðhavnunder stormen søgte skibet nødhavn
neyðhjálp	nødhjælp,slíkur studningspolitikkur er bert ein neyðhjálpen sådan støttepolitik er kun nødhjælp;Neyðhjálp fólkakirkjunnarFolkekirkens Nødhjælp
neyðkomin	kommet i nød
neyðlenda	1(om et fly)nødlande,flogfarið mátti neyðlenda, av tí at ólag var á motorinumflyvemaskinen måtte nødlande, fordi motoren var i uorden2(om en båd)lægge til land og trække båden op på et fremmed sted pga. uvejr
neyðlending	nødlanding
neyðloysn	nødløsning
neyðlygn	nødløgn, hvid løgn
neyðmikil	kvalfuld, pinefuld
neyðpíndur	kvalfuld, pinefuld
neyðrakett	nødraket
neyðroyta	1(på får)klippe uld for tæt,nú neyðroytti tú seyðinnu klippede du ulden for tæt2klippe hår for tæt,hann er neyðroytturhans hår er klippet for tæt
neyðróður	(skib.)nødror
neyðsegl	nødsejl
neyðsemja	kompromis
neyðsend	livsvigtigt ærinde,fara í neyðsendudføre et livsvigtigt ærinde(fx hente læge, jordemoder o.lign.)
neyðsendarboð	bud for en som er i nød el. højst nødvendigt bud
neyðsendarferð	livsnødvendig (båd)rejse,fara neyðsendarferðudføre en livsnødvendig (båd)rejse
neyðsendarørindi	livsnødvendigt ærinde(fx at hente læge, jordemoder),gerael.fara neyðsendarørindiudføre et livsnødvendigt ærinde
neyðsigling	nødsejlads
neyðskot	nødsignal,neyðskot frá einum skipi, ið rak undir landnødsignal fra et skib, som drev hen imod land
neyðskræða	rive (i stykker) ved for hårdhændet behandling el. pga. snæverhed(fx tøj)
neyðspark	(idr.)det at sparke bolden væk
neyðstaddur	nødstedt,hjálpa neyðstøddum børnumhjælpe nødstedte børn
neyðstandur	nødsituation
neyðstøða	nødsituation
neyðsyn	nødvendighed,fyri neyðsynjar sakiraf nødvendighed, tvangsmæssigt
neyðsynd	livsvigtigt ærinde
neyðsynjargerð	nødvendig handling
neyðsynjarlutur	nødvendighedsartikel
neyðsynjarmál	vigtig sag
neyðsynjartørvur	meget stort behov
neyðsynjarvøra	nødvendighedsartikel
neyðsynjarørindi	1livsvigtigt ærinde,teir fara neyðsynjarørindi á nátt sum á degide udfører livsvigtige ærinder både nat og dag2nødtørft,hann fór eini neyðsynjarørindihan forrettede sin nødtørft
neyðsynligur	nødvendig,nú kundi hon keypa alt, sum neyðsynligt var til jólanu kunne hun købe alt det nødvendige til jul;-liga
neyðsynt	nødvendigt,einki var so neyðsynt sum kornintet var så nødvendigt som korn
neyðtaka	1voldtage2(overf.)ødelægge, skæmme,gravkýrnar hava neyðtikið bøingravemaskinerne har ødelagt marken
neyðtrongdur	1nødstedt, kommet i en farlig situation,vit vóru neyðtrongdir av einum hvali2nødvendig,tað er ikki neyðtrongtdet er ikke nødvendigt3stærkt trængende(til vandladning)
neyðturvandi	nødvendig
neyðturviligur	nødvendig,neyðturviligar vørurnødvendige varer;vit hava tann neyðturviliga kunnleikanvi har de nødvendige kundskaber;-liga
neyðtænasta	alarmcentral, nødtjeneste
neyðtøka	1voldtægt2ødelæggelse
neyðtørviligur	nødvendig
neyðugleiki	nødvendighed, fornødenhed, behov
neyðugur	nødvendig, fornøden, nødig
neyðuliga	i ordforb.neyðuliga staddurilde stedt(fx økonomisk)
neyðverja	1nødværge2slidt klædningsstykke som dog endnu er for godt til at kassere
neys	senjósa
neyst	bådehus, bådeskur(ved søen),har var bátur í hvørjum neystider var både i hvert bådehus
neystadyr	døråbning el. indgang til et bådehus
neystakjaftur	døråbning el. indgang til et bådehus
neystaloft	loft over et bådehus
neystatoft	ruin af et bådehus
neystaveggur	væg i bådehus
neyt1	1kvæg,ganga til neyta(r)gå i udmarken for at malke køerne;sópa undan neytumel.neytunummuge under køerne2dumrian, tosse,títt neytdin tosse
neyt2	senjóta
neytaband	bånd om halsen på kvæg
neytabásur	kobås
neytabit	græsgang for kvæg
neytabløðra	koblære
neytaeydna	held i arbejdet med køer,hann hevði góða seyða- og neytaeydnuhan havde held i arbejdet med får og køer
neytaflokkur	flok køer
neytafóður	kvægfoder
neytagarður	gærde der skal hindre køer i at græsse hvor de ikke må
neytagerði	indhegning for køer
neytahaft	(uld)bånd til at binde køers ben sammen med
neytahagi	græsgang for køer
neytahald	kvægavl, kvæghold,fólkið livdi mest av seyða- og neytahaldibefolkningen ernærede sig mest ved fåre- og kvægavl
neytahali	kohale
neytahorn	kohorn
neytahúð	oksehud
neytahælur	tøjrepæl for køer
neytahøvd	kohoved
neytahøvur	kohoved
neytakjøt	oksekød
neytakleyv	klov på (af) ko,har var ikki ein neytakleyv at síggjader var ingen ko at se
neytakroppur	kvægkrop
neytaland	ajle
neytaligur	tåbelig, dum
neytalortur	kokasse
neytamergur	komarv
neytamjólk	komælk
neytamykja	komøg
neytanetja	fedthinden omkring mavesækken på en ko
neytapokur	(med.)kokopper
neytarakstur	kvægdrivning
neytasíða	koside
neytaskarn	komøg
neytaskipan	besætning af køer
neytaslag	kvægrace
neytasteik	oksesteg
neytasýning	kvægskue
neytatal	antal køer,stórt / lítið neytatalstort / lille antal køer
neytatrygging	(forsikr.)kvægforsikring
neytatrøð	indhegning i udmarken til (kortere) ophold for køer
neytatuberklar	kvægtuberkulose
neytatunga	oksetunge
neytatøð	kogødning, komøg
neytaøði	(zoo.,med.)kogalskab
neythagi	græsgang for køer
neythali	kohale
-neyti	sefylgis-,kappingar-
neytsband	bånd om halsen på kvæg
neytshorn	kohorn
neytshúð	oksehud
neytshøvd	kohoved
neytsskarn	komøg
-neytur	sefylgis-
neyvan1	knapt, knebent, næppe,hann fer neyvan at hóra undanhan overlever næppe;hann var neyvan edrúurhan var ikke helt ædru
neyvan2	bidevind,teir máttu sigla so neyvan, sum til barde måtte sejle så bidevind som muligt
neyvasigling	(mar.)bidevindsejlads,seneyvur (5)
neyvhugsan	ræsonnement,hann hevði ongantíð havt evnir til neyvhugsanhan havde aldrig haft evner til at ræsonnere
neyvur	1nøjagtig, præcis,neyv hugsanpræcis tænkning;neyv mátingnøjagtig måling2nøjeregnende, påholdende, nærig, smålig,hann er altíð so neyvurhan er altid så nøjeregnende3knap, kneben,í neyvan hálvtímapå en knap halvtime4(om fisk)som står tæt sammen på lille område,fiskurin stendur neyvurfiskene står tæt sammen5(mar.)(om vind)skral,neyv sigling;neyvur vindur;sigla neyvtsejle bidevind6næsvis, nærgående, påtrængende,nú ert tú so neyvur við megnu er du så påtrængende
-ni	(adverbiumsuffiks, alm. i talesp.)illani = illa, niðaneftirni[-ɛt:ɪnɪ]= niðaneftir, norðaneftirni = norðaneftir, oftani = ofta, toluligani = toluliga
niða	1nymåne, mørke,blá niðabælgmørke2den tid da månen er usynlig,í hvørjari niðui hver måned3(overf.)trist tid
niðamyrkur	bælgmørke
niðan	1nedefra, op,mods.oman,hann fór niðanhan gik op;sólin skein bæði oman og niðander var solskin over det hele2(sammen med præp.)niðan at:teir gingu niðan at húsumde gik op til huset;niðan av:bilurin fór niðan av vegnumbilen kørte op fra vejen;niðan á:niðan á bakkan, oynnao.lign.op på bakken, øen o.lign.;niðan eftirnedefra og opefter,niðan eftir vegnumop ad vejen;niðan frá1nedefra og opefter,hann gekk niðan frá strondinihan gik op fra stranden2lidt op fra,hjallurin stóð niðan frá húsunumforrådshuset stod lidt oven for huset;niðan fyrilængere nede end,hjallurin stendur niðan fyri húsiniforrådshuset står længere nede end huset;niðan í:niðan í brekkunaop i skråningen;niðan ígjøgnum:niðan ígjøgnum Nólsoyarfjørðmod nord gennem Nólsoyfjorden;niðan umlængere op end,niðan um bøgarðarnar;niðan við:niðan við ánniop langs med åen  / /3op gennem, op ad,niðan brekkunaop ad skråningen;fara niðan trappurnargå op ad trapperne4neden for,niðan beltiunder bæltestedet;fyri niðannedenfor;fyri niðan knænedenfor knæ
niðanav	op fra noget,bilurin fór niðanavbilen kørte op fra vejen
niðaná	helt op, op på toppen
niðaneftir	op ad vejen,vit gingu spakuliga niðaneftirvi gik langsomt op ad vejen
niðanfok	(om) vandfald der i storm blæses opad
niðanfrá	længere op,teir bóru fiskin niðanfráde bar fiskene op fra båden;hann gekk eitt sindur niðanfráhan gik et stykke længere op
niðanfyri	nedenfor,har er ein dalur niðanfyrider er en dal nedenfor
niðanífrá	nedefra
niðankloyvdur	langbenet
niðantil	forneden,hon var farin at kólna upp niðantilhun var begyndt at blive kold om benene og opefter;niðantil umforneden, nedenunder;kjólin var bordutur niðantil umkjolen har borter forneden
niðanundir	op til foden af en højde
niðanúr	ud fra et sted el. ud af en flok i retningen opad
niðanvert	i ordforb.niðanvert við (e-t)lidt neden for (noget);niðanvert við Høvdan
niðari	1nedre, nederst af to,niðara gøtaden nederste gade;niðari munnurundermund;niðari vegurden nedre vej2længere ned,teir gingu niðari enn vitde gik længere nede end vi
niðarlaga	(temmelig) langt nede, lavt nede,mods.ovarlaga
niðast	nederst,mods.ovast,niðast í sjóvarmálanumnederst i strandkanten
niðastur	nederst,tey niðastu húsinide nederste husene
niðra	laste, nedsætte, fornedre,niðrandi orðnedsættende ord
niðran	fornedrelse
niðri	nede,her niðriher nede;niðri á sandinum, helluninede på sandet, klippen;niðri fyri landilige ud for kysten,skipið legði seg niðri fyri landiskibet lagde sig lige ud for landet;niðri í fjøruninede ved strandkanten;leita bæði uppi og niðrisøge overalt;niðri undir húsunumneden for husene;prísirnir vóru niðri ígjøgnumpriserne var i bund;hann býr niðrihan bor i Danmark
niðrifrá	1nedefra2fra Danmark(sjældnere: fra England)
niðriundir	1nedenfor,trongt var niðriundir í kirkjunidet var trangt nedenfor i kirken2til sengs, i sengen,eg lá tríggjar dagar niðriundirjeg lå tre dage i sengen syg
niður	1ned,mods.upp,rópa niður til e-nråbe ned til nogen;prátið kom niður á hannder blev talt om ham;far (ríð, renn) tú niður og norð(ur)gå ad helvede til;tað var upp og niðurdet var op og ned;standa upp og niðurstå lodret;alt stendur væl upp og niðuralt står godt til økonomisk;fáa e-t flótt niður fyri hjartaðfå noget varmt at drikke,sehjarta;fara niður1rejse til Danmark el. England,teir sigldu niður við fiskide sejlede med fisk til England2gå til sengs, gå i seng2gå med strømmen,báturin rekur niður á miðiðbåden driver med strømmen til fiskepladsen  / /3ned gennem,hann setti ferð á niður brattanhan satte fart på ned ad bakken4(hj saman við sagnorði)fxbeyka niður;binda niður;detta niður;falla niður;fáa niður;ganga niður;geva niður;hyggja niður;koyra niður;leggja niður;seta niður;skera niður;stoyta niður;taka niður(sí sagnorð)
niðurarvaður	nedarvet,tað, ið niðurarvað var frá forfedrunumdet, som var nedarvet fra forfædrene
niðurat	ned imod noget,kloykja seg niðuratsætte sig lidt, hvile;set teg niðurat eina løtusæt dig et øjeblik
niðurav	ned af noget(et tag, en stak etc.),fara niðuravgå ned af noget
niðurá	ned på noget,náttin seig niðurádet blev nat
niðurboygdur	1nedadbøjet2nedbøjet, bedrøvet
niðurbreiður	bred over hofterne
niðurbrot	ombukning(på støvleskaft)
niðurbundin	1(om får)med bundne lemmer,niðurbundin seyðurfår med bundne lemmer2(overf.)i lænker;niðurbundið kætiglæde holdt i lænker;lívið var niðurbundið og óliviligtlivet blev holdt i lænker og var ikke til at leve
niðurdeilur	(talesp.)nederdel
niðurdottin	nedfalden, nedfaldet,niðurdottin garðuret nedfaldet gærde;húsini eru niðurdottinhuset er nedfaldet
niðureftir	1nedad, nedefter2slægt efter slægt,hinir synir Árons og teirra synir niðureftir skuldu vera prestarde andre af Arons sønner og deres sønner slægt efter slægt skulle være præster
niðurfall	fald,norskt mál kom til niðurfalsdet norske sprog stod for fald
niðurfallin	1(om kage)faldet sammen, mislykket,køkan er niðurfallinkagen er mislykket2flóðin var næstan heilt niðurfallinhøjvandet var næsten helt forbi, det var blevet ebbe igen3(om får)som man ikke kan drive til de højereliggende græsgange
niðurfalssjúkur	(med.)epileptisk
niðurfalssótt	(med.)epilepsi
niðurfarin	1nedfaren2gået i seng
niðurfaringartíð	sengetid
niðurfelling	(fys.)projektion
niðurferð	1nedstigning,hann datt oman á niðurferðhan faldt ned under nedstigningen2(under sidste verdenskrig)sejlads med fisk til britiske havne3rejse (med skib el. fly) til Danmark
niðurflaknaður	sammenfalden, sammensunken,ein niðurflaknaður báturen sammenfalden båd;tekjan er niðurflaknaðtaget er sunket sammen
niðurflyting	nedrykning,(idr.)niðurflyting úr fyrstu niður í aðru deildnedrykning fra 1. division til 2. division
niðurfrá	1ned,hurðin var dottin niðurfrádøren hang på sit ene hængsel;skræða niðurfránedrive2bagud, bagefter,detta niðurfrásakke bagud;hann orkaði ikki at fylgjast við hinum og datt so við og við niðurfráhan orkede ikke at følge med de andre og sakkede efterhånden bagud
niðurfyri	ned for en brink el. lign.,farael.detta niðurfyrifalde i vandet;vera væl niðurfyri viðfxklæðumvære godt udrustet med fx tøj;detta niðurfyriikke blive til noget(om et foretagende, en plan),eta niðurfyrispise så meget, at man kan klare sig et godt stykke tid;hava niðurfyrihave i reserve
niðurfyrikomin	forkommen,troyttur og niðurfyrikomintræt og forkommen
niðurgangur	nedstigning
niðurgingin	(om hævelse)fortaget sig, lagt sig igen,svullurin er niðurginginbylden har fortaget sig;jf.ganga niður
niðurgonga	nedstigning
niðurgongd	1nedstigning2nedsættelse,niðurgongd í prísunumprisnedsættelse;niðurgongdin í fiskiskapinumtilbagegangen i fiskeriet
niðurgongutíð	nedgangstid
niðurgrógvin	blevet fast i jorden,niðurgrógvin hoygarðsstøði(r);(med.)niðurgrógvin nagluren nedgroet negl
niðurífelling	(på strømpe)strikningen ved ankelen
niðurímillum	ned mellem fx skib og kaj,maðurin datt niðurímillum, tá ið hann skuldi leypa á landmanden faldt i vandet (mellem skibet og kajen), da han skulle springe i land
niðurkomin	kommet ned,nýliga niðurkomin urðnyligt stenskred
niðurlag	1omkvæd,tvíflættað niðurlag2parole, slagord,niðurlagið hjá teimum var: stavsetingin er torfør og ring at nýtaderes slagord var: retskrivningen er svær at lære og anvende3ende, slutning,tað var uppistøða og niðurlag: drekking, drekking, drekkingdet var alfa og omega: drikkeri, drikkeri, drikkeri
niðurlagdur	ophørt, stillet i bero,skúlin er niðurlagdurskolen er nedlagt;handilin varð niðurlagdurforretningen ophørte;hetta verður ikki niðurlagtdette bliver ikke glemt
niðurlagstur	(om får)vanrøgtet
niðurlegsaður	nedtrådt
niðurlendingur	nederlænder
niðurlendskur	nederlandsk
Niðurlond	Nederland;jf.Háland
niðurlop	(med.)brok
niðurlopin	nedstyrtet(ved skred),røkurnar vóru fyltar við niðurlopnum grótiklippeafsatserne var fyldt med nedstyrtede stene
niðurløga	1ende, slutning,i ordforb. somuppstøða og niðurløgabegyndelse og ende, alfa og omega;tað er uppstøða og niðurløga hjá honumdet er hans alfa og omega, det er hans et og alt2ydmygelse, tab, nederlag,hetta kom honum til niðurløgudette blev hans nederlag
niðurmark	nedre grænse
niðurmolnaður	bortsmuldret
niðurmókandi	trættende, besværlig, anstrengende,tú ert niðurmókandidu er så anstrengende
niðurmøddur	(om får)udmattet
niðurnívdur	nedtrykt,móðirin var niðurnívd av sorgmoderen var nedtrykt af sorg
niðurpartur	1den nederste del af noget2underkrop,mods.yvirpartur (2)
niðurrapaður	sammenstyrtet,niðurrapaður garðuret sammenstyrtet gærde
niðurrassaður	nedtrådt,akurin var niðurrassaður hvønn morgunmarken var nedtrådt hver morgen
niðurrendur	(bot.)niðurrent blaðet nedløbende blad
niðurrenning	afløb
niðurringaður	nedringet,niðurringaður kjólinedringet kjole
niðurrivin	nedrevet
niðurríving	nedrivning,niðurríving av einum húsumnedrivning af et hus
niðurseting	1kartoffellægning2bosættelse (i ubeboet land), kolonisering
niðursetingartíð	kartoffellægningstid
niðursettur	1plantet,niðursett trøplantede træer2nedsat,niðursettar vørurnedsatte varer;niðursett lønnedsat løn
niðursetubygd	udflytterbygd, nybygd, koloni;jf.landnámsbygd
niðursetufólk	kolonist, nybygger
niðursetuland	koloni
niðursetumaður	1nybygger, kolonist2forpagter, forvalter
niðursetur	bosættelse, nybyggersted,niðursetrið vaks og blómaðinybyggerstedet voksede og blomstrede
niðurseyring	nedsivning
niðursjóða	konservere, henkoge
niðursjóðing	konservering, henkogning
niðursjóðingarvirki	konservesfabrik
niðurskriving	(økon.)nedskrivning, devaluering,mods.uppskriving;jf.avskriving,virðislækkan
niðurskurður	nedskæring
niðurslættaður	jævnet med jorden,heyggjurin er niðurslættaðurhøjen er jævnet med jorden
niðursmokkaður	1sunket med fødderne i jorden(morads el. lign.)2skredet ned,øll skorin er niðursmokkaðhele fjeldsiden er skredet ned3flov, slukøret,tit eru mær so niðursmokkaðir á at lítaI ser så flove ud;hann fór nipin og niðursmokkaður á dyrhan gik skuffet og flov til dørs
niðursoðin	henkogt,niðursodnar fiskavørurhenkogte fiskeprodukter;niðursoðin rognhenkogt rogn
niðurstanding	(mar.)den måde hvorpå fiskesnøre(r) hænger ned,góð / ring niðurstanding
niðurstandur	(mar.)den måde hvorpå fiskesnøre(r) hænger ned,tá ið góður niðurstandur er, koma snørismenninir ikki so lætt í trol
niðurstrika	(skole)nedstreg,mods.uppstrika;"m" hevur tríggjar niðurstrikur"m" har tre nedstreger
niðurstøða	konklusion, afslutning,vit mega koma fram til eina niðurstøðuvi må komme til en konklusion;niðurstøðan í kanningini er, at ...undersøgelsens konklusion er, at ...
niðursøktur	nedsænket
niðurteljing	nedtælling
niðurtikin	nedrevet,húsini vórðu niðurtikinhuset blev revet ned
niðurtil	den nederste del, underkroppen,hann var vátur niðurtilhan var våd om underkroppen
niðurtjúkkur	med tyk underkrop,ein niðurtjúkkur maðuren mand med tyk underkrop
niðurtraðkaður	nedtrådt,í niðurtraðkaðum skómmed nedtrådte sko
niðurum	ned,fáa sær ein bita niðurumfå noget i skrutten
niðurundir	1nedenfor, ned2(ned) under dæk,teir fóru niðurundir at skaffa3til sengs,hann fór niðurundirhan gik til sengs4før maden,fá tær breyð niðurundirtag et stykke brød før maden5koma niðurundirkomme i klemme, komme i knibe(fx psykisk el. økonomisk);koma fíggjarliga niðurundirkomme i pengenød
niðurundirkomin	1kommet i klemme, kommet i knibe,fíggjarliga niðurundirkomin;niðurundirkomin fátækafólkforhutlede personer;niðurundirkomin í svøvniforvåget2forfaldet,niðurundirkomin garðurforfaldet gård
niðurúr	ned(fra noget),hatta hongur niðurúrdet hænger ned fra (noget)
niðurvallaður	(fx om sten)(delvis) dækket af grønsvær,ein niðurvallað urð
niðurvisin	med spinkle ben(i forhold til overkroppen)
niðuryvir	ned over (noget), ned,mjørkin hongur niðuryvirtågen ligger langt ned;dimmið setur niðuryvirmørket falder på
Niger	Niger
nigerbúgvi	nigerer
nigeri	nigerianer
Nigeria	Nigeria
nigeriabúgvi	nigerianer
nigeriskur	nigeriansk
nigerskur	nigersk
nigil	(zoo.)stankelbenslarve(Tipulidae)
Nikaragua	Nicaragua
nikaraguabúgvi	nicaraguaner
nikaraguari	nicaraguaner
nikaraguiskur	nicaraguansk
nikk1	nik(med hovedet),hann heilsaði við einum nikkihan hilste med et nik
nikk2	i ordforb.hvørt nikk og pikkhver smule, alt
nikka	nikke
nikkla	fornikle
nikkul	(kem.)nikkel
nikkur	1kræsen, småttærende,hann var so nikkur, hann vildi ikki hava drekkahan var så småttærende, at han ville ikke have noget at drikke2smålig, nøjeregnende, nærig,teir eru so nikkir at krevja pengarde er så nøjeregnende med at kræve penge3som nemt bliver fornærmet,tú ert so nikkur, tað talast ikki við tegdu bliver så let fornærmet, at man kan ikke snakke med dig
niklasarmessa	6. december
nikotin	nikotin
nilk	1svækling,eitt nilken svækling2en smule,lat meg fáa eitt lítið nilk av kakunilad mig få et lille stykke af kagen
nilta	1tage små mellemmåltider2tirre, drille
nina	1sidde (og rokke) med barn på skødet,nina barni;nina og nana2(barn.)sidde
nipil	lille sammenløben klump(fx i uld),niplar eru í ullinider er klumper i ulden
nipin	skuffet, slukøret, flov
nipisligur	som gør en slukøret,hatta var nipisligtdet var flovt, det var en skuffelse;-liga
nipla	(om tøj)være nopret,troyggjan niplar so illatrøjen er meget nopret
niplutur	(fx om tøj)nopret,troyggjan er so nipluttrøjen er så nopret
nippa	rykke let i noget,fiskurin nippaði ífisken rykkede let i maddingen;onkur nipti í skjúrtið aftanífránogen rykkede let i nederdelen bagfra
nippari	pincet
nippil	nippel
nisp	ganske lille klump uld, uldtot
nispa	ganske lille klump uld, uldtot
nissa1	(folketr.)nisse
nissa2	have afsmag,spikið (tvøstið) nissar eitt sindurspækket har en afsmag
nissur	1afsmag,nissur gongur at kjøtinumkødet har afsmag2stram lugt
nitra	luseæg,nitrur í høvdinumluseæg i håret
nitrat	(kem.)nitrat
níð	hån, spot
níðingsgerð	niddingsværk, niddingsdåd
níðingsligur	skændig
níðingsskapur	nederdrægtighed, lavhed
níðingsverk	niddingsværk, niddingsdåd
níðingur	nidding
níðskur	nidsk, gerrig, gnieragtig,níðskur og natinnidsk og gerrig
níga	1neje, knikse,níga fyri e-mneje for nogen;teir nigu djúpt fyri honumde nejede dybt for ham2bøje sig, segne, synke
nígginieyga	(fisk.)negenøje
níggju	ni
níggjufaldur	nifoldig,níggjufalt hurráet nifoldigt hurra
níggjundi	niende
níggju(r)	(kortspil)nier(i kortspil),eini níggju(r)en nier;níggjuninieren
níggjutal	nital
níggjuti	halvfems
nípa	1lude, bøje sig forover (ned)el.være foroverbøjet,hesturin stendur og nípirhesten står og luder2(overf.)stå / sidde og surmule,hann stóð bara og níptihan stod bare og surmulede
nísa	(zoo.)marsvin, tumler(Phocaena phocaena)
níst	hvin, skrig,hann skar í eitt nísthan udstødte et skrig
nísta	hvine, skrige,barnið nístir og græturbarnet skriger og græder
nístan	skrigen, hvinen
nístipípa	pibe (fløjte) af halmstrå
níta	stikke, svie, smerte,tað neit honum fastdet var hårdt for ham;illa neit at hjartanumdet gjorde ondt helt ind i hjertet
níti	halvfems
níting	stik, smerte
nítiundi	halvfemsindstyvende
nítjan	nitten
nítjandi	nittende
níva	1trykke (ned), knuge,níva niður átrykke ned på;níva e-nel.e-t niðurtrykke nogen el. noget ned;(overf.)níva e-m e-t afturgengælde en noget ondt2(om fisk)trække stærkt i linen,longan nívdi á;hann hevði ikki meir enn heintað, tá nívdi á sum stórur kalvi3(om skib)sætte, hugge,skipið nívdi so nógv niður frammiskibet stævn huggede hårdt i søen4gentage i det uendelige,situr og nívir og nívirsidder og gentager og gentager5knuge, tynge,tað er okkurt, ið nívir hannder er noget, der tynger ham;nívandi sorg, óttio.lign.tyngende sorg, angst o.lign.
njarðarvøttur	(zoo.)havsvamp(Porifera)
njella	1være højrøstet og vred, skælde ud, skingre,hon njellir og smellur um taðhun skælder ud over det2banke, dunke, klapre,tuflurnar njella á steinintræskoene klaprer imod stenen
njóða	klinke søm,njóða fyriklinke søm for(fx dør)
njóra	(på en bestemt monoton måde)synge, nynne,hann njóraði lagið fyri hennihan nynnede melodien for hende
njósa	nyse
njósarið	vedvarende nysen
njósi	nysen,pipar elvir njósapeber medfører nysen
njóskaturrur	knastør,hoyggið er so njóskaturthøet er så knastørt
njóskur	trøske,turt sum njóskur(in)(om hø)knastørt
njósn	nys, underretning,fáa njósn um e-tfå nys om noget
njósnan	udspejdning
njósnari	spejder, spion
njósnarsveinur	spejder, spion
njósnast	1snuse, være nysgerrig efter,njósnast um e-tsnuse efter noget2spionere,njósnast fyri fremmant landspionere for et fremmed land
njóta	1nyde, finde behag i,njóta blíðskapnyde gæstfrihed;njóta líviðnyde livet;njóta góðveðriðnyde det gode vejr2nyde, spiseel.drikke,hann beyð teimum at njóta eitt sindurhan bød dem lidt mad og drikke;njóta rúsdrekkanyde spiritus3lide noget ondt,njóta iltlide ondt;njóta mein av e-mlide skade af noget;(ordsp.)ilt nýtst av illumondt avler ondt;(ordsp.)ilt nýtst av bráðræsiel.bræðihastværk er lastværk
njótari	nyder
njótilsi	(talesp.)nydelse
njóting	nydelse
njótingarevni	nydelsesmiddel
njótra	1nynne,hon situr og njótrar eina gamla vísuhun sidder og nynner en gammel vise2tærske langhalm på noget
noð	1den klinkede ende af et søm, den ende der stikker uden for klinkeringen2den nedhamrede ende af et stenbor3(med.)knogleudvækst(osteofyt)
noða1	garnnøgle, nøgle
noða2	klinke søm,noða fyri (endan)
noðin	i ordforb.noðin og snoðinpudset og glat, uden plet el. rynke
noðseymur	(båd.)klinkesøm(til bådebygning);jf.rekseymur
nokk	1(talesp.)nok,nú er nokknu kan det være nok;hava nokk av e-mhave nok af noget;nokk um taðnok om det2utvivlsomt, uden tvivl,tað er nokk ikki mangur, ið ger honum tað eftirder er nok ikke mange, som kan gøre ham det efter3nokk sotemmelig;tað er nokk so langt síðanidet er temmelig længe siden
nokta	nægte, sige nej, afslå,nokta einum e-tnægte en noget;nokta fyri e-mforbyde noget;atgongd noktað ørindaleysumadgang forbudt for uvedkommende;nokta e-m bøngive afslag
noktan	afslag
nom	senæmur
nomin	senema
nomisligt	kedeligt, ærgerligt, flovt,tað er so nomisligt at skula út at lænadet er så flovt at skulle ud for at låne;tað er nomisligt einki at eiga inni, tá ið fólk kemur
norð	nordpå,hon skuldi norð um fjørðhun skulle nordpå over fjorden;ríð tú bæði niður og norðgå ad helvede til,seniður
norðan1	1nordenvind,norðan er góð ætt hjá okkumnordenvinden er en god vindretning hos os2í ein norðani nordlig retning
norðan2	1nordfra(især om vind),vindurin er norðanvinden kommer nordfra;hann er norðan (í ættini)vinden er nordlig;landnyrðingur norðannordnordøst;útnyrðingur norðannordnordvest2norðarumegin, í norðara parti,norðan fyriel.fyri norðan (e-t)nord(en) for;norðan fyriel.fyri norðan Føroyarnord for Færøerne;hon er norðan av landihun er slægtet fra de nordlige øer
norðanbrim	brænding ved nordlig vindretning
norðandagur	dag med nordenvind,illfýsnir norðandagar
norðaneftir	nordfra, fra det nordlige,teir komu norðaneftirde kom nordfra;hann er norðaneftirel.hann stendur norðaneftirvinden er nordlig
norðanfjørðs	nord for Skopunarfjørður
norðanfólk	folk fra de nordlige øer
norðanfyri	i det nordlige,skipini royna norðanfyriskibene fisker nord for Færøerne
norðanífrá	nordfra
Norðanland	nordisk land
norðanlendis	i den nordlige del af landet, nordpå
norðanlot	svag brise fra nord
norðanmaður	mand fra de nordlige øer (på Færøerne)
norðanmál	1nordfærøsk dialekt,hann tosar norðanmálhan taler nordfærøsk dialekt2nordisk sprog
norðanódn	orkan fra nord
norðanregn	regn fra nord
norðanstormur	storm fra nord
norðantil	norðantil á oynnipå øens nordlige del
norðanvert	lidt nord for,norðanvert við (e-t / e-n)lidt nord for (noget el. nogen)
norðanvindur	nordenvind
norðanæl	regnbyge fra nord
norðari	nordligere, nordligst(af to)
norðarlaga	(på et sted el. egn)nordpå, nordligt,vit vóru nakað norðarlaga ávi var ret langt nordpå
norðast	nordligst
norðastur	nordligst(af flere)
norðbúgvi	nordbo
Norðdepil	(stedn.)bygd i Borðoy,í / úr Norðdepli,til Norðdepils
norðdepilsmaður	person iel.fra bygden Norðdepil
norðeftir	(i retningen)nordpå
Norðhavið	(stedn.)havområdet nord for Færøerne
Norðkollur	(stedn.)Nordkalotten
norðleiki	nordlig beliggenhed
norðlýsi	(astronomi)nordlys
norðmaður	1nordmand2norsk skib,nógvir norðmenn lógu inni á Fuglafirðider lå mange norske skibe inde på Fuglafjørður
norðoyingur	person iel.fra Norðuroyggjar
norðoyrarmaður	person iel.fra bygden Norðoy
Norðoyri	(stedn.)bygd i Borðoy,á / av Norðoyri,til Norðoyrar
norðpólur	nordpol;tann landafrøðiligi norðpólurinjordens geografiske nordpol;tann magnetiski norðpólurinjordens magnetiske nordpol
norðradalsmaður	person iel.fra bygden Norðradalur
Norðradalur	(stedn.)bygd i Suðurstreymoy,í / úr Norðradali,til Norðradals
Norðragøta	(stedn.)bygd i Eysturoy,í / úr Norðragøtu,til Norðragøtu
norðragøtumaður	person iel.fra Norðragøta
norðri	(om væren på et sted)som ligger nordpå,norðri í Fugloypå Fuglø
Norðsjógvurin	(stedn.)Nordsøen
norðskálamaður	person iel.fra bygden Norðskáli
Norðskáli	(stedn.)bygd i Eysturoy,við / frá Norðskála;til Norðskála
Norðstjørnan	(astronomi)Nordstjernen, Polarstjernen(Stella polaris)
Norðstreymoy	(stedn.)nordlige del af Streymoy,í / úr Norðstreymoy
norðstreymoyingur	person iel.fra Norðstreymoy
norðsveima	(zoo.)lang bredfodsflue(Platycheirus podagratus)
norðtoftamaður	person iel.fra bygden Norðtoftir
Norðtoftir	(stedn.)bygd i Borðoy,í / úr Norðtoftum,til Norðtofta
norður1	el.nord,í norðrimod nord;frískur vindur av norðrifrisk vind nordfra;móti norðriimod nord;hann rekur avel.á norðrivinden er gået om i nord;á norðrii nordenvind;tað gular av norðridet er en let brise fra nord;í norðurnordpå;úr norðrinordfra
norður2	1(om retningen)nordpå, mod nord,teir fóru norður eftir oyggjde rejste mod nord over øen;norður á leiðinanordpå;húsini standa øll suður og norðuralle husene vender i nordlig-sydlig retning;norður við landi(num)mod nord langs kysten;far tú niður og norðurgå du ad helvede til2(om væren på et sted)i nord, nordpå,norður við Gjógvi (bygden) Gjógv
norðurá	mod nord,skipið vendi norðuráskibet drejede mod nord
norðurbreidd	(geogr.)nordlig bredde
norðureftir	nordpå
norðurendi	nordende, nordspids
norðurferð	rejse mod nord
norðurhallur	(om terræn)nordvendt,norðurhallur haginordvendt udmark
norðurhav	Nordhavet,í norðurhøvumi de nordlige have
norðurhálva	(geogr.)den nordlige halvkugle
norðurheimur	norden
norðurhjálmsoppur	(bot.)nordisk hjelmhat(Galerina pseudomycenopsis)
norðuri	i nord, nordpå,har norðurider nordpå
norðuríri	nordirer
Norðurírland	Nordirland
norðurírskur	nordirsk
norðurjarðtunga	(bot.)slags jordtunge(Geoglossum starbaeckii)
Norðurkorea	Nordkorea
norðurkoreani	nordkoreaner
norðurkoreanskur	nordkoreansk
norðurkoreari	nordkoreaner
norðurkorei	nordkoreaner
norðurkoreiskur	nordkoreansk
Norðurland	NorðurlondDe nordiske lande, Norden,í Norðurlondumi Norden;Norðurlandahúsið í FøroyumNordens Hus på Færøerne
norðurlandamál	nordisk sprog,føroyskt er eitt av norðurlandamálunumfærøsk er et nordisk sprog
Norðurlandaráðið	(pol.)Nordisk Råd
norðurleiki	nordlig beliggenhed,lond um sama norðurleika sum Føroyarlande med samme nordlige beliggenhed som Færøerne
norðurlendingur	skandinav, nordbo
norðurlendskur	nordisk, skandinavisk,tey norðurlendsku málinide nordiske sprog
Norðurlond	seNorðurland (2)
norðurmark	nordgrænse
Norðuroyggjar	(stedn.)Norderøerne
norðuroyingur	person iel.fra Norðuroyggjar
norðurpartur	nordlig del
norðurpólur	nordpol
norðurrák	nordgående strøm,mods.suðurrák
norðurum	nord for,hann var noyddur at flyta norðurum til at krógva seghan var nødt til at flytte nordover for at gemme sig
norðurvent	tað er norðurventstrømmen er begyndt at drive nordover
norðurætt	nordenvind
Noreg	Norge
Noregsland	Norge
norna	norne, skæbnegudinde,(poet.)nornan spinnur lagnutráðskæbnegudinden spinder skæbnetråden
nornaspor	hvid plet på negl
Norra	(talesp.)Norge
norrønur	1norrøn, vestnordisk, oldnordisk,norrønt málnorrønt sprog2nordisk, skandinavisk,Norrøna felagiðForeningen Norden
norska	fornorske
norskur	norsk,norsktnorsk sprog
nos	1nys,eitt hart noset kraftigt nys2styrt, sprøjt, overhaling,báturin fekk eitt nosbåden fik en overhaling3kortvarig febersygdom4vredesudbrud,hann gjørdi eitt nosder kom et vredesudbrud fra ham
nosið	senjósa
nosrið	vedvarende nysen
nossa	testikel
nossasúpan	suppe kogt på fåretestikler
nossligur	ren og pæn, hyggelig og lun,áin var rein og nossligåen var ren og pæn;-liga
-not	av-
nota1	(bot.)nælde(Urtica)
nota2	(økon.)nota, regning
notið	senjóta
notufirvaldur	(zoo.)nældesommerfugl(Vanessa urticae)
notusótt	(med.)nældefeber(urticaria)
notutráður	nældetråd
notuætt	(bot.)nældefamilien(Urticaceae)
november	november
novembermánaður	november måned
novembur	november
noyða	tvinge, nøde,noyða e-n til at gera e-ttvinge nogen til at gøre noget;noyða niður í e-ntvinge en til at spiseel.drikke,hann noyddi matin niður í seghan tvang maden i sig;noyða e-t upp á e-npåtvinge nogen noget;hann noyðir seg at drekkahan tvinger sig til at drikke;noyðastvære nødt til, nødes,hann noyddist at farahan var nødt til at gå;noyðast uppi á e-mligge (nogen) til byrde;noyddurtvungen,hann var noyddur at gevasthan var nødt til at holde op
noyðsla	tvang, nødvendighed,hann lurtaði ikki av noyðslu, men av hugahan lyttede ikke af tvang, men af lyst
nóðra	lammesky,nóðrur á luftinilammeskyer på himlen
nóðrutur	letskyet,nóðrut luftletskyet himmel
nóg	1nok, tilstrækkelig,nóg stórur, ungurstor, ung nok;nóg nógvurtilstrækkelig;nóg illanæppe nok2nóg solige lovlig,nú var vorðið nóg so seintnu var det blevet lige lovlig sent;hann hevði fingið nóg so væl upp í høvdiðhan var godt lakket til;jf.nógvur (2)
nógvastaðni	mangesteds
nógvur	1megen,nógvur vindurmegen vind;tað man ikki vera tað nógva, teir hava fingiðde har ikke fået så meget;tað nógva av seyðinum doyðistørstedelen af fårene døde;tað nógva av degnumdet meste af dagen;hann var fyri tað nógva heima hjá teimumhan var for det meste hjemme hos dem;tað er nógv fyri at hugsa særdet er frygteligt at tænke sig;tað er nógv ímillumder er stor forskel på;hatta hevur ikki nógv upp á seg at geradet er enkelt at lave;hann var ikki nógv til bókinahan var ikke meget for at læse;gera nógv um segholde kommers, støje;hann gjørdi ikki nógv um seghan gik stille med dørene2nógvmeget;nógv betrimeget bedre;hvalurin verður nógv veiddurder fanges mange hvaler;hann var nógv hugtikin av hennihan var stærkt betaget af hende
nólsoyingur	person iel.fra Nólsoy
nómu	senema
nón	klokken 3 om eftermiddagen
nónbil	(bibl.)ved den niende time(dvs. ved tretiden om eftermiddagen)
nópur	1alkenæb2(spøg.)næse
nóra	(bot.)norel(Minuartia)
nósi	(nyfødt) sælunge;jf.svidningur
-nósin	sekapp-
-nósutur	sekapp-
nót	vod,kasta nóttrække vod;skip royna við nótskibene anvender vod
nótabendil	(musik)nodesystem
nótablað	(musik)nodeblad
nótabók	(musik)nodebog
nótafastur	(musik)tonefast, tonesikker
nótahálsur	(musik)nodehals
nótahøvd	(musik)nodehoved
nótaleysur	tonedøv
nótaprikkur	(spøg.)tonedøv person,hann er nótaprikkurhan har ikke en tone i livet
nótarbátur	1vodbåd2vodskib,nótarbátarnir fáa nógva sild norðanfyri
nótaregla	(musik)nodelinje
nótarfiskur	fisk fanget med vod
nótargarn	vodgarn,fittir í hondunum til at riða nótargarn og at bøta nót;at nótargarn varð spunnið á hampasnældu, haldi eg meg hava hoyrt
nótarkast	voddrag, voddræt
nótarkálvi	vodkalv, vodpose, vodsæk
nótarkikari	kikkert der bruges ved fiskeri,nótaformaðurin liggur við nótarkikara og hyggur eftir seiði
nótarkyrra	rolig sø til voddragning
nótarleypur	trækurv der bruges til at udmåle fangstandelene ved vodfiskeri
nótarlína	vodline, vodreb, vodtov
nótarnál	nål til vodbinderi
nótarseiður	sej fanget med vod
nótarskip	(skib.)vodskib
nótaskipan	(musik)nodesystem
nótavirði	(musik)nodeværdi
nóti	(musik)1node, nodetegn2melodi,eg dugi ikki nótanjeg kan ikke melodien;syngja og spæla eftir nótumsynge og spille efter noder;halda nótansynge rent;ikki fara av nótanumsynge rent
nr.	nr.
nudla	nudel
nugga1	nougat
nugga2	(om spædbørn) die, (om lam) patte
null	(mat.)nul
nullingur	høballe, høknippe
nullmark	nulpunkt
nullpunkt	(mat.)nulpunkt
nulva	1vikle hø (udbredt til tørring) sammen i små knipper for at beskytte det imod regn2rulle, gnide, valke(på bræt, valkebræt el. mellem hænderne),nulva hosurvalke, rulle, gnide strømper
nulvingur	1lille knippe hø sammensvøbt for at beskyttes imod regn2nulvingarlammesky
nummar	1nummer,framhald í næsta nummari av blaðnumfortsættelse følger i næste nummer af bladet;vit búgva í nummar 10vi bor i nummer 10,gerast nummar trý í kappingblive nummer tre i en konkurrence;nummar 39 í skómskonummer 392(vulg.)samleje,fáa eitt nummarhave samleje
nummarkall	nummeroplysning
nummarpláta	nummerplade
nummarrað	nummerorden, numerisk rækkefølge
nummarrøð	nummerorden, numerisk rækkefølge,í nummarrøði nummerorden
nummarspjaldur	nummerplade
nunna	(rel.)nonne
nunnukleystur	(rel.)nonnekloster
nunnuregla	(rel.)nonneorden
nurra	(vulg.)have samleje, kneppe, knalde, bolle
nurtu	senerta
nussur	(barn.)kalv
nutu	senjóta
nú	1nu, på dette tidspunkt, i dette tilfælde,bussurin fer núbussen kører nu;nú á døgumnu til dags;nú er illa vorðiðdet er galt fat;kom nú avstaðkom nu af sted;nú (ið) teir koma fyri dyrnar, er stongtda de nu kommer til døren, er den lås,eitt núfor eksempel;nú fyrstaførst nu;nú, hvussu er vorðið?nå, hvordan går det?;nú, núnu kan det være nok2alligevel, dog(tryksvagt),eg haldi nú, at hann kundi sagt frájeg synes dog, at han kunne have sagt det;tað er nú ikki verri enn iltdet er nu ikke værre end slemt, det er nu ikke så slemt endda
núgaldandi	nugældende,núgaldandi sáttmálinnugældende overenskomst
núleiki	aktualitet
núliðin	(lingv.)núliðin tíðførnutid, perfektum;"havi skrivað" og "er farin" er núliðin tíð;jf.táliðin
núligur	aktuel, dagsaktuel;jf.núleiki
núlivandi	nulevende
núpur	1(stedn.)forbjerg2(båd.)(for)stævn
nústa	først lige nu
nústani	først lige nu,hví kemur tú nústani?hvorfor kommer du først nu?
nútíð	1nutid,í nútíðinii nutiden2(lingv.)nutid, præsens
nútíðarbærur	moderne
nútíðareyga	i ordforb. somsæð við nútíðareygumset med moderne øjne
nútíðargranskari	samtidsforsker
nútíðarhóskandi	moderne,nútíðarhóskandi amboðmoderne redskaber
nútíðarhugsan	nutidstankegang
nútíðarligur	aktuel,bókin hevur ein nútíðarligan og ein søguligan parti bogen er der en aktuel og en historisk del
nútíðarmál	nutidssprog,føroyskt nútíðarmálfærøsk nutidssprog
nútíðarmenniskja	nutidsmenneske, moderne menneske
nútíðarsamfelag	nutidssamfund, det moderne samfund,bókin snýr seg um danska nútíðarsamfelagiðbogen handler om det danske nutidssamfund
nútíðarsøga	1nutidshistorie, samtidshistorie2novelleel.roman med samtidsstof
nútíðaryrking	1nutidsdigtning2nutidsdigt,ein nútíðaryrkinget nutidsdigt
nútímans	moderne, nutidig,eitt nútímans frystihúset moderne frysehus;nútímans hentleikarmoderne faciliteter
núverandi	nuværende
n.v.	p.b.v.
nyðra	1den fineste, inderste uld,sker ikki í nyðruna, segði pápi mín javnan í várgongu2uldtot,hann fann nakrar nyðrur3uld der sidder tilbage i karten efter kartning4lammesky,hann setur nyðrur á luftina5(spøg.)mandsling, spirrevip,ein sovorðin nyðraen sådan spirrevip
nyðruskýggj	lammesky(altocumulus)
nyðrutur	letskyet,nyðrut luftletskyet himmel
nyðruull	den fineste, inderste uld
nyðruvongur	spirrevip
nykbrandur	meteor, ildkugle
nykk	ryk, træk
nykkja	1trække, rykke,nykkja ágøre hastigt træk på en line2ombøje, nitte,nykkja seymnitte et (gennemgået) søm3nykkja e-n við e-mbebrejde en noget;nykkja niður á e-nbagtale, rakke ned på nogen
nykkjutur	(om fisk der trækkes op)som gør (små) ryk i snøren,hasin toskurin hevur verið nykkjuturdenne torsk har gjort mange små ryk i snøren
nykkunagli	nittenagle, nittesøm
nykkur	1nyk, (lille) ryk2kurre,nykkur á stáltráðikurre på ståltråd
nykubrandur	meteor, ildkugle
nykur	(folketr.)nøkke(overnaturligt væsen i elv og sø)
nykurt	(bot.)nøkkerose(Nymphaea),hvít nykurthvid nøkkerose(N. alba)
nykurtarætt	(bot.)åkandefamilien(Nymphaeaceae)
-nyrðingur	seland-,út-
nytra	(fisk.)øresten(på fisk);jf.nytur
nytta1	nytte, gavn,gera e-t til nyttugøre gavn;hann ger einki til nyttuhan gør ikke gavn;fáa nyttu burtur úr e-mhave gavn af noget;til onga nyttutil ingen nytte
nytta2	nytte, hjælpe, gavne,tað nyttar ikki at noktadet nytter ikke at nægte;ikki nyttaði at hugsa um taðdet nyttede ikke at tænke over det;ikki nyttar at tosa hann frá tídet hjælper ikke at tale ham fra det;tað nyttar ikki at halda ádet nytter ikke at fortsætte;filmurin nyttar einkifilmen er dårlig;drongurin nyttar einki til arbeiðisdrengen er ikke til gavn;eg nytti einki longurjeg duer ikke til noget mere
nyttuleysur	nytteløs, unyttig,tað er nyttuleyst at tosa við hanndet er nytteløst at snakke med ham
nyttuligur	nyttig, dygtig, som gør nytte,nyttulig tiltøknyttige initiativer
nyttuloysi	meningsløshed,oyðsla lívið burtur í nyttuloysispilde livet væk i meningsløshed
nyttulutur	nyttegenstand,mods.prýðislutur
nyttuverk	nyttigt arbejde,gera nyttuverklave nyttigt arbejde
nyttuvøkstur	nytteplante,hvonnin var nyttuvøkstur her á landikvannen var en nytteplante her til lands
nýár	nytår
nýbakaður	nybagt, friskbagt,nýbakað breyðnybagt brød
nýborin	nyfødt,(poet.)sum nýborið vársom et nyfødt forår
nýbrot	gennembrud;nýbrotið í norðurlendskum bókmentumdet moderne gennembrud
nýbygd	udflytterbygd, nybygd, koloni,nýbygdirnar í Amerikanybyggerkolonierne i Amerika
nýbygdur	nybygget, nyopført
nýbygging	nybyggeri
nýbygningur	(skib.)nybygning
nýbýli	udflytterbygd, nybygd, koloni,reisa nýbýligrundlægge en koloni
nýbýlismaður	nybygger, kolonist
nýdyrking	nyopdyrkning
nýðingur	meget stor grindehval
nýfikin	nyfigen
nýfikinskapur	nyfigenhed
nýfikkin	nyfigen
nýfikni	nyfigenhed
nýfingin	nyfanget,nýfingin fiskurnyfanget fisk
nýfjeppin	nyfigen,kettan er nýfjeppinkatten er nyfigen
nýfrælsur	som lige er blevet selvstændige,tær nýfrælsu smátjóðirnarde små nationer som lige er blevet selvstændige
nýføddur	nyfødt,nýføtt barnnyfødt barn
nýføðingur	nyfødt barn
nýføroyskur	nyfærøsk,nýføroyskur skaldskapurnyfærøsk digtning
nýgerð	nydannelse, nyskabelse,nýgerð av vegumanlæggelse af nye veje;málslig nýgerðneologisme
nýggindi	nyskabelse, nydannelse, notation, innovation,eini nýggindien nyskabelse
nýggja	i ordforb.nýggja upp afturforny, genopfriske;nýggja upp aftur gomul minnigenopfriske gamle minder
nýggjár	nytår,á nýggjárinumtil nytår;halda nýggjárfejre nytår;gott nýggjárgodt nytår;millum jóla og nýggjársmellem jul og nytår
nýggjársaftan	nytårsaften;jf.gamlaárskvøld
nýggjársbál	bål der tændes nytårsaften
nýggjársdagur	nytårsdag,annar nýggjársdaguranden nytårsdag
nýggjárshald	nytårshøjtid,nýggjárshaldið byrjar á midnáttnytårshøjtiden begynder ved midnat
nýggjárskvøld	nytårsdags aften
nýggjársleiti	nytårstid,um nýggjársleitiðved nytårstid
nýggjárslyfti	nytårsforsæt,nýggjárslyftið var, at hann skuldi leggja av at roykjanytårsforsættet var, at han skulle holde op med at ryge
nýggjársmorgun	nytårsmorgen
nýggjársnátt	nytårsnat
nýggjárstíð	nytårstid
nýggjárstrøll	arbejde man ikke bliver færdig med til nytår
nýggjur	1ny;nýggj húset nyt hus;nýtt skipet nyt skib;tað nýggja landsstýriðdet nye landsstyre;hann var í nýggjum frá uttast til innasthan havde taget nyt tøj på;av nýggjumpå ny;byrja av nýggjumbegynde på ny;bróta, velta upp úr nýggjumnydyrke;nýggir siðir og skikkirnye sæder og skikke2senest, sidst,nýggjastu tíðindininyeste nyt;nýggjasta fløganden nyeste cd;nýggj eplinye kartofler
nýggjyrði	neologisme, sproglig nydannelse,"snyril" og "stinni" eru dømi um nýggjyrði
nýgiftur	nygift
nýgingið	i ordforb.har var nýgingiðder havde folk gået for nylig
nýgjørdur	nylavet
nýgróður	nyspiret græs,nú legst seyðurin á nýgróðurinnu begynder fårene at spise nyspiret græs
nýgýta	(fisk.)ganske lille (ung) ørred el. forel
nýhending	nylig begivenhed
nýhent	nylig, sket for nylig
nýhugsan	nytænkning,mods.vanahugsan;nýhugsan er neyðugnytænkning er nødvendig
nýkomin	1nyankommen, lige ankommen,ungarnir vóru nýkomnir úr reiðrinumungerne var lige kommet fra reden;tey nýkomnude nyankomne2(om strøm)som lige er begyndt,so at rógva norður við nýkomnum vestfalli
nýkomingur	1en nyankommen2opkomling, parvenu
nýkókaður	nykogt,nýkókaður laksurnykogt laks
nýlagdur	1(om pattedyrs unger)nyfødt,nýlagdur hvølpurnyfødt hvalp2(om sne)nyfalden,nýlagdur kavinyfalden sne
nýlagstur	1som lige har lagt sig(fx til at sove),hann er nýlagsturhan er lige gået i seng2nyfalden,nýlagstur kavinyfalden sne
nýland	koloni
nýlembt	nyfødt,lambið var nýlembtlammet var nyfødt;ein ær hevði mist nýlembtet hunfår havde mistet et nyfødt lam
nýlendi	nylig dyrket mark,hann sló eitt nýlendihan slog græsset på en nylig dyrket mark
nýlendisstykki	nylig dyrket stykke jord
nýliðin	(om tid)nylig overstået,í nýlidnari tíði nylig overstået tid
nýliga	nys, (for) nylig,tey eru nýliga giftde er nygifte
nýlingur	opkomling, parvenu
nýmalin	friskmalet,nýmalið kaffifriskmalet kaffe
nýmálaður	nymalet
nýmálsligur	(skole)nysproglig,nýmálsligt studentsprógvnysproglig studentereksamen;nýmálsligur studenturnysproglig student
nýmáni	(astronomi)nymåne;jf.tendra (4)
nýmenning	innovation, fornyelse, nyskabelse, novation
nýmeta	omvurdere, revurdere
nýmeting	omvurdering, revurdering
nýmjólk	nymalket mælk
nýmótans	moderne,nýmótans útgerðmoderne udstyr
nýnorskur	nynorsk,nýnorsktnynorsk sprog;nýnorskar bókmentirnynorsk litteratur;nýnorsk stavsetingnynorsk retskrivning,jf.bókmál (1),landsmál (2)
nýra	(biol.)nyre
nýrabørkur	(biol.)nyrebark
nýraflutningur	(med.)nyretransplantation
nýragrús	(med.)nyregrus
nýrakaður	nybarberet
nýrakoka	(biol.)nyrebækken(pelvis renis)
nýrakollur	(biol.)binyre
nýrasteinur	(med.)nyresten
nýrastrongur	(biol.)urinleder
nýravaksin	(bot.)nyreformet,nýravaksið blaðnyreformet blad
nýreising	fornyelse,við hesari yrking tekur við tann rætta nýreisingindette digt markerer den reelle fornyelse
nýrnabruni	(med.)nyrebetændelse
nýroynd	ny prøve,vit hava fingið ymsar nýroyndir uttanífrávi har fået forskellige nye prøver fra udlandet
nýrómi	nyfløde,nýrómi út í kaffinyfløde i kaffe
nýrumørur	nyrefedt, nyretælle,nýrumørurin varð roknaður at vera besta tálgnyrefedt blev anset for at være den bedste tælle
nýsilvur	nysølv
nýskapaður	nyskabt, nydannet, nyetableret, nyoprettet, nystiftet
nýskapan	nyskabelse, novation, innovation
nýskaptur	nyskabt, nydannet, nyetableret, nyoprettet, nystiftet
nýskipan	nyordning,nýskipan av skúlanumnyordning af skolen
nýskipanarhugaður	reformvenlig,nýggi forsetin er nýskipanarhugaðurden nye præsident ønsker at iværksætte reformer
nýsligin	nyslået,nýsligið grasnyslået græs;nýsligin mynturnyslået mønt
nýsloktur	i ordforb.sum nýsloktur kálvur(om personer)slikket, overdrevent pæn og pyntelig,sekálvur
nýsmíðaður	nysmedet
nýstovnaður	nydannet, nyoprettet, nyetableret, nystiftet,ein nýstovnaður flokkur stillar upp til valiðet nystiftet parti stiller op til valget
nýsur	senjósa
Nýsæland	New Zealand
nýsælendingur	newzealænder
nýsælendskur	newzealandsk
nýta	1bruge, anvende, benytte,(ordsp.)mangt er í neyðini nýttnød lærer nøgen kone at spinde;nýtir tú mjólk út í drekka?bruger du mælk i teen?;eg nýti ikki henda skógvinjeg kan ikke passe denne sko;nýta ábenytte sig af lejligheden, smede medens jernet er varmt2nýtastbehøves;e-m nýtistman har brug for,tær nýtist ikki at óttastdu behøver ikke at være bange;ikki nýtist mær at siga meirjeg behøver ikke at sige mere
nýtaramót	(datal.)brugergrænseflade
nýtari	bruger, forbruger
nýtendraður	(astronomi)nytændt(om månen),nýtendraður máninymåne
-nýti	sebú-,hús-
nýtiligur	brugelig, brugbar,teimum longdist eftir at fáa ein nýtiligan døgurðade længtes efter at få en ordentlig middag;ein nýtiligur biluren brugelig bil
nýting	udnyttelse
nýtíð	nutid,nýtíðinnutiden;knappliga møttust miðøld og nýtíðpludselig mødtes middelalderen og nutiden
nýtíðarbýur	moderne by
nýtíðarbærur	moderne
nýtíðarkendur	nutidspræget, med moderne præg
nýtsla	brug, anvendelse,prísir fyri nýtslu av ljósi og hitapriser for brug af lys og varme;skúlin er tikin í nýtsluskolen er taget i brug;nýtslan av rúsevnum er nógv vaksinbrugen af narko er steget kraftigt;hava til nýtsluhave til forbrug
nýtsluforrit	(datal.)applikationsprogram,nýtsluforrit til bókhaldapplikationsprogram til bogholderi
nýtslugjald	brugerbetaling
nýtslugransking	anvendt forskning
nýtsluleiðbeining	brugervejledning
nýtslulutur	brugsgenstand,mods.prýðislutur
nýtslumálfrøði	anvendt lingvistik
nýtslumálvísindi	anvendt lingvistik
nýtsluplanta	nytteplante;jf.skreytplanta
nýtslurættur	brugsret
nýtsluskattur	(økon.)forbrugsskat
nýtslustig	belægning
nýtslutal	belægning
nýtsluvirði	brugsværdi,hestavognurin hevur einki nýtsluvirði í daghestevognen har ingen brugsværdi i dag
nýtsluvísindi	anvendt videnskab
nýtsluvøra	forbrugsvare,mjólk er neyðug nýtsluvøramælk er en nødvendig forbrugsvare
nýtt	senýggjur
nýtulka	nyfortolke
nýtur1	1nyttig, tjenlig,nýt vápnnyttige våben2god, træffende,hann takkaði við nýtum og blíðum orðumhan takkede med gode og venlige ord
nýtur2	senjóta
nýturrur	nytørret,nýturt kjøtnytørret kød
nývaknaður	nyvågnet
nýval	nyvalg
nývaldur	nyvalgt,hann er nývaldur í nevndinahan er nyvalgt til bestyrelsen
nývaskaður	nyvasket,bilurin er nývaskaðurbilen er nyvasket
nývelting	opdyrkning
nývørrur	gennembrud,nývørrur í málaralistinigennembrud i malerkunsten
nýyrði	neologisme, sproglig nydannelse
nýøld	(geol.)nyere tid (i jordens historie), kænozoikum
næla	1(om vækst)spire, spire op,tað nældi skjótt, av tí at har var ikki so djúplentdet spirede hurtigt, fordi jorden var ikke så dyb;seteplini eru farin at nælalæggekartoflerne er begyndt at spire2(om sved)bryde frem,ómagasveittin nælir um kroppinkoldsveden bryder frem over hele kroppen;pínan fekk sveittan at næla framsmerterne fik sveden til at bryde frem3sy, stikke,næla buksursy bukser
næling	1spiring2(håndarb.)stikning (syning)3(håndarb.)randsyning (på knaphul)
nælingartráður	1fin sytråd2knaphulstråd
næmi	1nemme, lærenemhed,hann hevur eitt flúgvandi næmihan er usædvanlig lærenem2anelse,eg eri á næminumjeg har en anelse om
næmingaarbeiði	elevarbejde
næmingablað	elevblad
næmingabústaður	kollegium
næmingafelag	elevforening,næmingafelag læraraskúlansseminariets elevforening
næmingafundur	elevrådsmøde
næmingaheim	elevhjem
næmingaíbúð	kollegielejlighed
næmingaráð	(skole)elevråd
næmingatal	elevtal
næmingaumboð	elevrådsmedlem
næmingaveitsla	elevfest
næmingsverk	elevarbejde,hetta er eitt næmingsverkdette er et elevarbejde
næmingur	elev
næmur	lærenem,børnini eru so nombørnene er så lærenemme
nær1	1nær, i nærheden,nær viðnær ved;nær landiel.nær við landtæt ved land;nær bygdiniel.nær við bygdinatæt på bygden;fuglurin torgar ikki nær húsunumfuglene tør ikke nærme sig husene;eingin fiskur er at fáa hvørki nærri ella fjarriingen fisk fanges hverken nær eller fjern;standa e-m nærvære tæt knyttet til nogen;tey, ið standa e-m nærnære slægtninge;báturin var komin nær at okkumbåden var kommet tæt på os;vit komu nærri og nærrivi kom nærmere og nærmere;nær umnær ved, hen ved, næsten;leggja sær nærstræbe af al magt, anspænde sig;hesin tilburður gekk honum sera nærdenne hændelse gik ham meget på;taka sær e-t nærtage sig noget nær, blive ked af noget;tú veitst ikki, hvussu nær hann tekur sær hettadu ved ikke, hvor ked han bliver af det2nær sumnæsten,her er einki fleygað, nær sum einkiher er intet fanget, næsten intet
nær2	hvornår, når,nær fer bussurin?hvornår kører bussen?;nær kemur tú?hvornår kommer du?;hann spurdi, nær (ið) eg komhan spurgte hvornår jeg kom
nær3	senáa
nærband	tæt forbindelse,hansara nærbond at jørð, havi og veðurlaghans tætte forbindelse til jorden, havet og klimaet
nærbundin	i tæt forbindelse med,hann var so nærbundin at hennihan havde meget tæt forbindelse til hende
nærbýlt	i ordforb.har er so nærbýltder er der så kort afstand mellem husene;jf.tættbygdur
nærfrøði	(med.)obstetrik
nærgeingin	nærgående,hann er so nærgeingin við konufólkhan er så nærgående mod kvinder;tú heldur meg vera ov nærgongnandu synes, at jeg er for nærgående
nærgingin	nærgående
nærgongdur	nærgående
nærhendis	nær, i nærheden
nærhugaður	påpasselig, forsigtig
nærhyrntur	(om væddere)med hornene voksende tæt op ad kæben
-næriligur	seó-
nærindis	1nær, i nærheden,nærindis hoyrdist fuglaljóði nærheden hørtes lyd af fuglestemmer2i nærheden af, nær ved, tæt på,nærindis húsunumtæt på huset
nærindisbygd	nabobygd, nabolandsby
-nærisligur	seó-
nærka	nærme, bringe el. flytte nærmere,nærka segel.nærkastnærme sig;jólini nærkastjulen nærmer sig;nærka segel.nærkast e-mnærme sig noget;hann nærkaðist bygdinihan nærmede sig bygden;nærkast at e-mkomme nærmere på en el. noget;nú nærkast at tíni deyðastundnu nærmer din dødsstund sig
nærkan	tilnærmelse
nærkomin	tæt på,nærkomin deyðanumdøden nær;nærkomin at kálvanær ved at kælve
nærkvæmi	nøjagtighed
nærkvæmsliga	nøje, akkurat,hann reinskaði alt so nærkvæmsligahan rensede alt så nøje;skógvurin er so nærkvæmsliga slitinder er ikke noget tilbage af skoen
nærkvæmsligur	nøjagtig, eksakt,lýsa nærkvæmsligaangive nøjagtigt
nærkvæmur	nøjagtig, eksakt,nærkvæmar lýsingar av ástarlívinøjagtige skildringer af kærlighedsliv
nærlagdur	som gør sig umage, flittig, energisk,drongurin var nærlagdurdrengen var flittig;hann er nærlagdurhan gør sig umage
nærlagni	grundighed, omhyggelighed,lesa við nærlagnilæse grundigt, nærlæse
nærleiki	nærhed,hennara nærleiki uggaði meghendes nærhed gav mig trøst
nærlíkur	i ordforb. somá nærlíkan háttpå næsten samme måde
nærlív	det at leve tæt på enel.noget
nærljós	nærlys
nærlækni	(med.)fødselslæge, fødselshjælper
nærmentan	subkultur
nærmynd	nærbillede
nærnet	(datal.)lokalnet;nærnet á bókasavnilokalnet på et bibliotek
nærri	nærri frágreiðingnærmere beskrivelse;nærri upplýsingarnærmere oplysninger;nærri landitættere på land;teir komu nærri og nærride kom nærmere og nærmere,senær,næstur
nærrógvin	(om båd)som sejler for tæt på kysten
nærskygdur	(med.,biol.)nærsynet,mods.langskygdur
nærskygni	(med.,biol.)nærsynethed
nærskyldur	nær(t)beslægtet,vit eru nærskyldirvi er nær(t)beslægtede;eg eri nærskyldur við hannjeg er nær(t)beslægtet med ham
nærspurin	som stiller nærgående spørgsmål,vera ov nærspurinstille for nærgående spørgsmål
nærstaddur	som befinder sig i nærheden,teir fóru illa við honum, tá ið hann ikki var nærstaddurde bagtalte ham
nærsýntur	nærsynet
nærsøkin	1bjærgsom, bjergsom, som gerne vil have lidt mere end der tilkommer ham2nærgående,tjaldrið er meira nærsøkið móti ravninum enn móti nøkrum øðrum rovfugli
nærtøkin	nærtagende, ømfindtlig,gentan var ógvuliga nærtøkinpigen var meget nærtagende
nærum	næsten, omtrent,hann vá nærum pundhan vejede næsten et pund
nærvarp	(radio)lokalradio
nærvegis	i nærheden,teir bátar, ið vóru nærvegisde både, som var i nærheden
nærvera	nærværelse
nærvinur	nær ven
nærvorðin	1nærgående,hann er so nærvorðin í brennivínihan er så nærgående, når han er beruset2om båd der sejler for tæt på land
næst	afnær;næst eftir fiskiskapinum er jørðin tann vinnuvegur ...næst efter fiskeriet er jordbruget det erhverv ...
næsta1	i ordforb.í næstuniom kort tid
næsta2	i ordforb.nú í næstafor kort tid siden, i den allerseneste tid;jf.næstu,næstum 1
næstaftastur	næstsidst,næstaftasti fingurringfinger
næstakærleiki	næstekærlighed
næstan	næsten,næstan 100 kr.næsten 100 kr.;hann er næstan tíggju ára gamalhan er næsten ti år gammel;hon er næstan líka stór sum túhun er næsten lige så stor som dig;hann er næstan ongantíð til arbeiðishan er næsten aldrig på arbejde;eg haldi næstan, eg komi viðjeg tror næsten, jeg kommer med
næstbestur	1næstbedst,hann var næstbestur av næmingunumhan var næstbedst af eleverne2(talesp.)ikke god nok,tað er ikki meira enn næstbestdet er kun næstbedst,líkindini at lenda eru ikki meira enn næstbestlandingsforholdene er kun næstbedst
næstelstur	næstældst
næstformaður	næstformand
næsti	(bibl.)næste, medmenneske,tú skalt elska næsta tín sum sjálvan tegdu skal elske din næste som dig selv
næstimaður	stedfortræder, suppleant,hann leggur frá sær og letur næstamann sín sleppa framathan fratræder og lader sin suppleant komme til
næstingur	person af nærmeste slægt,skyldfólk og næstingarfamilie og nærmeste slægt
næstmestur	næstmest
næstrafólk	(ens) nærmeste
næstseinastur	næstsidst
næstsíðstur	næstsidst
næststørstur	næststørst
næstu	i ordforb. som(nú) í næstufor nylig;jf.næsta 2
næstum	i ordforb.í næstumom kort tid;teir fara avstað í næstumde tager af sted om kort tid
næstur	afnærrinærmest,hon sat næst vindeyganumhun sad nærmest vinduet;í næstu viku, í næsta mánaði, næsta ári næste uge, måned, år;næsta leygardagnæste lørdag;næstu ferðnæste gang;næsti maður stjóransdirektørens nærmeste medarbejder;tú skuldi verið næstur til at gjørt taðdu skulle være den nærmeste til at gøre det;í næstumom kort tid
næstyngstur	næstyngst
nætur	senátt
nævur	næver, birkebark
nøgast	nøjes,nøgast við (e-t)nøjes med noget
nøgd	tilstrækkeligt el. rigeligt forråd, mængde,stór / lítil nøgdstor / lille mængde;stórar nøgdir av fiski koma upp á landstore mængder fisk kommer op på land;nøgd av seyði, fiski, fuglio.lign.mængde får, fisk, fugl o.lign.
nøgdaravsláttur	(økon.)mængderabat, kvantumsrabat
nøgdsamur	nøjsom,foreldrini vóru nøgdsom og gudrøkin fólkforældrene var nøjsomme og gudfrygtige mennesker
nøgdsemi	nøjsomhed
nøgdur	tilfreds,væl / illa nøgdurgodt / dårligt tilfreds;vera nøgdur við úrslitiðvære tilfreds med resultatet;glaður og væl nøgdurglad og godt tilfreds
nøgga	slide af,nøgga burtur av e-m;brimið hevði nøggað kneysan burtur;ullin nøggast av æriniulden bliver slidt af hunfåret
nøgisemi	nøjsomhed
nøgla	(båd.)bundprop(i båd),lænseprop,(talem.)gera nøgluna, áðrenn tú gert bátinbegynde et arbejde forkert el. bagfra;(ordsp.)ikki eigur at smíða nøgluna fyrr enn bátin
nøgta	tilfredsstille, give en nok
nøkta	tilfredsstille, give en nok,hann er ikki til at nøktahan er umulig at tilfredsstille;ikki nøktastaldrig få nok;hann nøktast ikki við ríkidømihan får aldrig nok rigdom;hann nøktast ikki við mathan kan aldrig blive mæt;nøktast kynsligablive tilfredsstillet seksuelt
nøktan	tilfredsstillelse,kynslig nøktanseksuel tilfredsstillelse
nøkulunda	1nogenlunde, omtrent,veiðan varð býtt nøkulunda í helvtfangsten blev delt i to nogenlunde lige store dele;tað kann metast nøkulunda javntdet kan vurderes nogenlunde ens;teir eru nøkulunda javngamlirde er nogenlunde jævnaldrende;nøkulunda sonoget i den retning2rimeligt,ferðin gekk so nøkulundarejsen gik rimelig godt
nøkur	senakar
nøra	1(om unge kreaturer, især får)lade et overtalligt dyr leve,lítið fóður var, so lítið varð nørt2nøra børnavle børn  / /nøra afturatlægge brænde på, fyre;nøra at særforsyne sig rigeligt, tage vel til sig(af mad og drikke),vera raskur at nøra at sær sjálvumvære dygtig til at forsyne sig selv;nøra umforøge, formere,nøra um inntøkurnarforøge indtægterne;nøra upplade et overtalligt dyr leve  / /nøra segvokse i antal, formeres,teistin hevur nørt seg væl afturtejsten har formeret sig godt igen;nørastvokse, formeres,teir ynskja heldur at ritan minkar enn nøristde vil hellere at der bliver færre end flere rider;Gud segði: nørist á jørðini og leggið hana undir tykkumGud sagde: Bliv frugtbare og talrige, opfyld jorden, og underlæg jer den,kópurin er afturnørdursælerne er blevet talrigere;tey seinastu árini hava húsini nørst so nógvde seneste år er antallet af huse steget meget
nøring	1forplantning, formering2(skole)seksualundervisning
nøringarkorn	(bot.)diaspore
nøringarlag	(biol.)forplantningsorganer
Nørvasund	(stedn.)Gibraltarstrædet
nøs	1(biol.)næse,hava stóra nøshave stor næse;nasarnæse,blóðið dreiv um nasar og munnblodet flød om næse og mund;hava góða nøshave god lugtesans;tað er sum nøsin vendirhan snakker som vinden blæser,nøsin vendir skeivt á hennihun er i dårligt humør;hann gav honum á nasarnarhan slog ham i ansigtet;beint fyri nøsinilige for næsen;bróta nasar fyri e-nel.e-tvove skindet for nogenel.noget;snarurel.skjótur fyri nøsiniopfarende;tað er ilt í nøsini á honumhan er i meget dårligt humør;reka e-t aftur í nasarnar á e-mlade nogen få noget i hovedet igen;fáa e-t stungið í nasarnarel.upp í nøsinafå noget sagt lige ud til nogen;renna upp í nøsina á e-mbebrejde en noget;tað sást ikki fram um nøsinaman kunne ikke se en hånd for sig;hann var ikki sørur at duga fram um nøsinahan kunne mere end sit fadervor;rýða e-m um nasarbeskylde en for noget2klippefremspring,(stedn.)Úti á Nøsini3(båd.)fremspring på åretold,oman fyri skakkið er nøsin4(flyvning)næsen på et fly5en lille smule,hon bað hana læna sær eina nøs av tehun bad hende låne sig en lille smule te
nøt	(bot.)nød, skalfrugt
nøta	nød
nøtra	ryste, skælve, bæve, gyse,beinini nøtrabenene ryster;hon nøtraði av ræðsluhun skjalv af rædsel;nøtrandi ræðslagysende rædsel;nøtrandi av kulda og máttloysiskælvende af kulde og udmattelse;meg nøtrar í holdiðjeg gyser
nøtran	skælven, bæven, gysen,ein nøtran fór ígjøgnum hanaen skælven gik igennem hende
nøtrilsi	skælven, bæven, gysen,nøtrilsi fór ígjøgnum hanaen skælven gik igennem hende;nøtrilsi um allan kroppinskælven over hele kroppen
nøtubrótari	nøddeknækker
nøv	(især istedn.)klippefremspring, forbjerg,hann kom um eina nøv í haganumhan kom forbi et klippefremspring i udmarken
nøva	klippefremspring, forbjerg
nøvn	senavn
