o1	1(lingv.)vokal2(lingv.)17. bogstav i det færøske alfabet (kaldes )
o2	åh
o.a.	fork. forog annað
o.a.m.	fork. forog annað mangtel.meira
obeliskur	obelisk
oberstur	(militær)oberst
oblát	(kirk.)oblat, nadverbrød
odda	pege, sigte,odda knível.við knívipege med kniv;sit ikki og odda ímóti beiggja tínumsid ikke og peg imod din bror
oddablað	(bogb.)forsatsblad, smudsblad
oddadystur	(idr.)topkamp
oddafiskur	1den forreste hval i en flok grindehvaler2den forreste fisk i en stime,tá ið sildin er á gongd, síggjast oddafiskarnir leypa leysir úr sjónum3(overf.)leder, anfører, foregangsmand
oddafólk	fører, leder
oddafundur	(pol.)topmøde
oddagrein	leder, spidsartikel(i avis)
oddaleysur	(om kniv)uden spidsel.od
oddalið	(idr.)tophold,oddaliðini í 1. deild hittast sunnudagintopholdene i 1. division mødes på søndag
oddamaður	1leder, anfører,tey ungu fylktust um oddamann felagsinsde unge sluttede op om foreningens leder2(ved fåredrivning)en af de to forreste mænd i rækken
oddanevni	(lingv.)akronym, initialord(et ord som er dannet af forbogstaverne i et udtryk der består af flere ord fx NATO)
oddaskapur	styrelse, ledelse, administration
oddastarv	lederstilling, topstilling
oddbogastílur	(arkitektur)spidsbuestil, gotisk stil
oddbogi	(arkitektur)spidsbue
oddi	1den forreste del af flok (får, hvaler) der drives,vera á oddanumunder drivning af får opholde sig ved den forreste del af flokken;(overf.)være i spidsen (for noget);(om får)taka odda í segløbeel.gå foran de andre, der (så) følger;(overf.)standa á oddastå i spidsen;liggja á oddaføre, være forrest2næs, pynt
oddklombur	spids parentes, < >,í oddklombrum;jf.bugklombur,hornklombur,klovaklombur
oddur1	spids, od;oddurin á lítlafingrispidsen på lillefinger;út í odd og eggtil det yderste, til fingerspidserne;draga saman oddar(om skyer fra modsat retning)drive imod hinanden
oddur2	ørredfiskeredskab bestående af et stykke træ med liner og kroge
offiserur	(militær)officer
offur	offer,bera Gudi offurbære offer til Gud
offurdjór	offerdyr
offurdýr	offerdyr
offurfólk	brudefølge,offurfólkini skipa seg í pørbrudefølget ordner sig parvis
offurfúsur	hjælpsom, behjælpsom, imødekommende
offurgáva	offergave
offurgerð	ofring
offurlamb	offerlam
offurpengar	(kirk.)offerpenge
offursfólk	brudefølge
offurvilji	offervilje
o.fl.	fork. forog fleiri
ofra	ofre,ofra bæði tíð og peningofre både tid og penge;ofra seg fyri e-tofre sig for noget;ofra til gudarnarofre til guderne
ofring	ofring,meðan ofringin var fyrimens ofringen stod på
ofsin	ubetænksom og åbenmundet
ofta	ofte, tit,ofta og tíðumtit og ofte;ofta og stundtit og ofte;tað er ikki oftari enn sodet er ikke hver dag;fyri tað oftastafor det meste
oftani	ofte, tit
og	og,himmal og jørðhimmel og jord;svartur og hvítursort og hvid;aftur og framfrem og tilbage;av og ánu og da, undertiden, iblandt;væl og virðiligagodt og grundigt;so við og viðefterhånden;við bit og slitmed nød og næppe, med stort besvær, knap og nap;líkt og ólíktløst og fast;bæði ogbåde og;eins ogligesom, som
ogn	1ejendom, besiddelse,føst ognfast ejendom;fáa e-t til ognarfå noget som ejendom;føra til ognarbogføre som indtægt;tað er ikki hvørs mans ogndet er ikke hvermandseje;tað er ogn í tídet er værd at eje, det er værdifuldt;tykja(st) ogn í e-mvære lykkeligel.stolt ved at besidde noget,móður tykir ogn í unga sínummoderen føler sig stolt over at besidde en sådan søn2jordejendom, ejendom i odelsjord3ognir(økon.)aktiver(fx i regnskab)
ogna	tilegne, tilkende, tildele,ogna særel.ognast (e-t)tilegne sig, sætte sig (el.komme) i besiddelse af,summum ognaðist eitt lambnogle fik tildelt et lam;ogna e-m e-ttilegne en noget,bókin er ognað honumbogen er tilegnet ham
ognan	tilegnelse, dedikation
ognarbræv	(jur.)skøde
ognarbygd	bygd hvor jorden er mest i privat eje,mods.kongsbygd
ognarfornavn	(lingv.)ejestedord, possessivt pronomen,mín, tín og sín eru ognarfornøvnmin, din og sin er possessive pronomener
ognargenta	ung pige med jordejendom,trúlovaður við einari ognargentu
ognarhagi	udmark tilhørende odelsjord
ognarhús	hus i besiddelse af odelsjord,størsta ognarhúsið í bygdini
ognari	1ejer,hann var ognari til tríggjar merkur í óðalsjørð2kreditor,mods.skuldari
ognaríbúð	ejerlejlighed
ognarjørð	odelsjord,mods.kongs(jørð)
ognarleysur	ejendomsløs, ludfattig
ognarloysi	ejendomsløshed
ognarloysingur	ejendomsløs person, proletar
ognarlutur	ejendel, ejendom, besiddelse,hann kom heim at fáa skil á ognarlutum sínumhan kom hjem for at få styr på sine ejendele
ognarmaður	besidder af odelsjord
ognarrættur	ejendomsret
ognarsíða	(økon.)kreditside,mods.skuldasíða
ognarskattur	formueskat, ejendomsskat
ognarsteyp	(idr.)pokal som vindes til ejendom
ognartaka	ekspropriere,ognartaka jørð til vegagerðekspropriere jord til vejbyggeri
ognartøka	ekspropriation
ognaruppgerð	ejendomsopgørelse,ognaruppgerð skal latast inn saman við sjálvuppgávuejendomsopgørelse skal indleveres sammen med selvangivelsen
ognarviðurskifti	ejerforhold,ógreið ognarviðurskiftiuklare ejerforhold
ognskriva	(økon.)kreditere, bogføre som indtægt
ohm	(elektr.)ohm
ok	(ogsåoverf.)åg, tung byrde
oki	(husbyg.)tværtræ, (tvær)klampe
okkara1	sevit 2
okkara2	1vores,okkara húsvores hus;kvæðaskaldskapur okkaravores kvaddigtning;foreldur okkaravores forældre;børn okkaravores børn2(i stedet for substantiv)eg fari niðan til okkarajeg går hjem til os
okkum	sevit 2
okkur	(geol.)okker
okkurgulur	okkergul
okkurlittur	okkerfarvet,við okkurlittum faksimed okkerfarvet manke
okkurt	seonkur
okkut	seonkur
okn	(ornitol.)svane(Cygnus cygnus),hin fannhvíta okninden snehvide svane
okra	drive åger, ågre
okrari	ågerkarl
oksabásur	oksebås, studebås
oksafall	i ordforb.geva e-m oksafallkaste en til jorden
oksafjórðingur	fjerdedel af en okse,kokkurin hevði ein oksafjórðing við særkokken kom med en fjerdedel af en okse
oksafrælsi	græsningsret for kvæg
oksahald	kvægfarm
oksakjøt	oksekød, kød af stud(e)
oksalær	(kvad)oksekølle, bov,tey bóru honum fram oksalær
oksasíða	(kvad)side af en okse (stud),hon legði fram eina oksasíðuhun lagde frem en side af en okse
oksasteik	oksesteg,hava oksasteik til døgurðahave oksesteg til middag
oksatjógv	oksekølle, bov
oksavetringur	årsgammel stud
oksi	kastreret tyr, stud
oktan	(kem.)oktan
oktober	oktober
oktobermánaður	oktober
oktobur	oktober
okur	åger,bót fyri okurbøde for åger
okurkallur	ågerkarl
okurprísur	ågerpris, ublu pris,teir krevja ein okurprís fyri kistunade kræver ågerpris for kisten
okurrenta	ågerrente, ublu rente
OL	(idr.)fork. forolympiuleikir
oldingi	olding
oldurabbi	tipoldefar
olduromma	tipoldemor
olivinolja	olivenolie
olja1	olie,steikja í oljustege i olie;fáa seinastu oljunafå den sidste olie;bora eftir oljubore efter olie;(overf.)oysa olju á báliðel.eldingøre mere skade end gavn
olja2	oliere
oljuber	(bot.)oliven
oljubilur	tankvogn
oljublað	olieblad,dúgvan hevði oljublað í nevinumduen havde et olieblad i næbbet
oljublettur	olieplet
oljuboring	olieboring
oljuboripallur	olieplatform, boreplatform
oljubrá	oliefilm
oljubrøkur	oliebukser
oljubuksur	(mar.)oliebukser
oljubúskapur	olieøkonomi
oljudansur	sømandsoliefrakke(hel foran)
oljudálkaður	olieforurenet, olieagtig,oljudálkaður fuglurfugl indsmurt i olie
oljudálking	olieforurening
oljudunkur	oliedunk
oljuendurvinning	oliegenindvinding
oljufarmur	olielast
oljufeingi	olieressource
oljufelag	olieselskab
oljufella	(geol.)oliefælde
oljuframleiðsla	olieproduktion
oljufundur	oliefund
oljufyrisiting	olieadministration
oljufýr	oliefyr
oljufýrur	oliefyr
oljugoymsla	oliereservoir, oliebeholder,har standa nú saltbing og stórar oljugoymslurder står nu saltsiloer og store oliereservoirer
oljuídnaður	olieindustri
oljujarðfrøði	oliegeologi
oljujarðfrøðiligur	oliegeologisk
oljujarðfrøðingur	oliegeolog
oljukanna	oliekande
oljukelda	oliekilde
oljukendur	olieagtig
oljuklæddur	i olietøj,skiparin var oljuklæddurkaptajnen var i olietøj
oljuklæði(r)	olietøj,oljuklæði(r) av plastiolietøj af plastik
oljukynding	oliefyr
oljukyndur	oliefyret
oljukøka	oliekage
oljuleið	oliefelt
oljuleiðing	olieledning
oljuleiting	olieeftersøgning
oljuleki	olieudslip
oljulitur	oliefarve
oljulomvigi	lomvie der er indsmurt i olie
oljuloyvi	oliekoncession
oljulóggáva	petroleumslovgivning
oljulygna	olieplet
oljumarknaður	oliemarked
oljumáling	oliemaling
oljumálningur	oliemaleri
oljumóttøkustøð	ilandføringsanlæg, terminalanlæg for olie
oljuneyð	oliemangel
oljuovnur	petroleumsovn
oljupálmi	(bot.)oliepalme(Elaeis guineensis)
oljuprísur	oliepris,oljuprísurin er fallin í seinastuniolieprisen er faldet i den seneste tid
oljureinsiverk	olieraffinaderi
oljusamtak	oliekonsortium
oljutangaskip	(skib.)olietankskib
oljutangi	olietank
oljutilfeingi	olieressource
oljutrot	oliemangel
oljutrýst	olietryk
oljutræ	(bibl.,bot.)oliventræ(Olea europaea)
oljutunna	1olietønde2(rummål)158,76 l af raffineret olie(anvendt i olieindustrien)
oljutur	olieagtig
oljuútvinsla	olieudvinding
oljuvánir	muligheder for oliefund
oljuviður	(bibl.)oliventræ
oljuvinna	olieindustri
olmussa	1almisse,fáa (e-t) í olmussufå (noget) som almisse;lova burtur (í) olmussulove en gave(til en trængende, kirken etc.)i håb om derved at opnå redning2olmussuarm, stakkels,tær olmussu konurde stakkels koner
olmussudrongur	stakkels dreng
olmussudýr	1stakkel2olmussudýrið(i kærlig tiltale)lille ven, lille stakkel,far aftur og legg teg, olmussudýriðgå og læg dig igen, lille ven
olmussugenta	fattig pige,tá ið faðirin doyði, varð hann kongur og olmussugentan drotningda faderen døde, blev han konge og den fattige pige dronning
olmussulamb	et lam hvis ejer har lovet at give det som almisse
olmussuligur	ussel af udseende,vera olmussuligurvække medlidenhed
olmussumaður	stakkel
olympiskur	olympisk,olympisku leikirnirde olympiske lege
olympiuleikir	olympiske lege
Oman	Oman
oman	1(ovenfra) ned, nedad(hyppigt om en skrå, nedadgående bevægelse),mods.niðan,farael.ganga omangå ned;detta oman(omkomme ved at) falde ned fra et stejlt sted;kastael.stoyta omankaste (støde) ned i søen fra et højtliggende sted,kasta sær omantage sit eget liv ved at springe ud over klippekanten;oman og niðan1(i retning)vinkelret på en skråning,húsini standa oman og niðanhuset står vinkelret på en skråning2nedad og opad,nú fóru neytini at ganga oman og niðannu begyndte kreaturerne at gå op i udmarken om morgenen og tilbage til huset om aftenen3alle vegne, alle steder,sólin skeinel.sá bæði oman og niðander var solskin over det hele2(med præposition)oman at:oman at húsumned til husene;oman av:oman av landitil udlandet;taka móðu oman av pottiskumme (kød)suppe;oman á1ned på,oman á bakkanned på bakken2oven på,rómi legst oman á mjólkfløden lægger sig oven på mælken3oven på, efter,oman á døgurða fingu teir kaffiefter middagsmaden fik de kaffe;oman fyriel.fyri omanoven for, oppe over,oman fyri húsinioven for husene,mods.niðan fyri;flogfør surraðu oman fyri teirflyvemaskiner svævede oppe over dem,hevur aldri verið til uttan oman fyri hálsvøliner tomme ord, er uden bund i virkeligheden;oman í:oman í brýrhelt ned til øjenbrynene;oman ígjøgnum:teir gingu oman ígjøgnum hagan;oman til:oman til strandarned til stranden;oman úr:koma oman úr fjallined fra bjerget;oman við:oman við ánnined langs med åen;oman við Strond  / /med3nedad,sum eitt fok oman brekkunasom et lyn nedad bakken;hann rann oman trappurnarhan løb ned gennem trapperne4ovenover,svimur sum oftast við høvur sínum oman vatnið;førur oman belti;oman Hoydalar;oman Viðarlund5vera oman stokkvære vågen, være oppe,er hann so frægur, at hann er oman stokk?(se ogsåomanat,omanav,omanáosv.)
omanat	ned til landingspladsen,hann fór omanat móti manninumhan gik ned til landingspladsen imod manden
omanav	af, fra overfladen,taka omanavskumme fløden af mælken;grava omanavgrave fra overfladen
omanavlestur	skimning, skimming
omanavtikin	skummet,omanavtikin mjólkskummetmælk
omaná	1ovenpå,liggja omanáligge ovenpå(fx i slagsmål)2i live, levende,tað skal ikki henda so leingi hann er omanádet skal ikke ske så længe han er i live3i ordforb. sometael.hava e-t omanáspiseel.have noget til dessert
omanávatn	overfladevand,ofta er lítið salt í omanávatninumtit er der kun lidt salt i overfladevand
omanbúgvi	omaner
omandeks	(oppe) på (skibs)dækket,aftur at tí skaða, vit fingu omandeks, kom eisini hol á skipiðforuden den skade, vi fik oven på dækket, kom der også hul på skibet
omandøttur	nedstyrtning,av omandøttri og ringari hagreiðing var seyðatalið minkaðpga. nedstyrtning og dårlig behandling var antallet af får blevet mindre
omaneftir	ned ad vejen
omanfyri	1ovenfor,høg fjøll omanfyri og smalt sund niðanfyrihøje fjelde ovenfor og smalle sund nedenfor2længere oppe3(om fåreskind)spretta omanfyriskære et fåreskind op fra rumpen og frem under bugen(efter at det er løsnet fra kroppen)
omangongd	nedgang,tað er klettur norðanvert við omangongdinader er en stor klippesten på den nordlige side af nedgangen
omanífrá	ovenfra
omankast	nedstyrtning, nedskridning af sten,akvegurin liggur illa fyri omankastivejen ligger dårligt på grund af fare for nedfaldne sten;hann fór av omankastihan blev ramt af en nedfalden sten og døde
omankavað	i ordforb.nú er nógv omankavaðsneen når langt ned på fjeldsiderne;tað er ikki omankavað enn, so seyðurin gongur høgtfjeldsiderne er endnu ikke helt dækket af sne, så fårene kan græsse højt oppe
omankoyring	nedkørsel,tá ið vit komu til omankoyringina, brotnaði bremsanda vi kom til nedkørselen, gik bremsen i stykker
omanljós	ovenlys,í omanljósii ovenlys
omanlop	nedstyrtning, nedskridning af sten,menn vóru bangnir fyri omanlopi;(overf.)síggja út sum eitt omanlopsurmule, være utilfreds, se ud som et uvejr
omanlopin	nedstyrtet,omanlopið grótnedstyrtede sten
omannevndur	ovennævnt,omannevnda uppskot varð sett í gildiovennævnte forslag trådte i kraft
omanrakstur	neddrivning af får
omanrák	sydgående strøm i Nólsoyarfjørður
omanrok	heftigt snefald,var ættin ímóti, hevði eg ikki funnið, tí so nógv var jarðrokið og omanrokið
omanrudd	nedstyrtet grund, sten o.lign.,víkingagravirnar liggja undir omanruddivikingegravene ligger under nedtyrtet grund og sten
omanskrið	sneskred, jordskred, stenskred,eg minnist fleiri ferðir til omanskrið av bæði kava og gróti
omanskur	omansk
omansleipin	(om terræn)stærkt skrånende, stejlt,tú skalt ikki fara har, tí tað plássið er so omansleipið;(overf.)tú sært mær heldur omansleipin útdu ser ud til at være plaget af tømmermænd
omansnákutur	glatkæmmet,tú ert so omansnákutur í morgundu er så glatkæmmet her til morgen
omantil	foroven,opið omantil á tunnuniåbent foroven på tønden
omanturt	med ophold i vejret,tað var jarðrok, men omanturt;tað er omanturtder er opholdsvejr
omanum	1ned forbi,ein ójavni, har vatnið skolar moldklumpar omanum2på tværs for oven,flábygdur bátur, ið liggur so nógv út omanum
omanundir	nedefter og indunder
omanvegur	nedtur, tilbagetur, hjemtur,á omanvegnumpå tilbageturen
omanvert	i ordforb.omanvert við (e-t)lidt oven for (noget)
omanvæta	overfladevand,omanvætan er til miklan bágaoverfladevandet er til meget besvær
omma	1bedstemor, bedstemoder2gammel kone,ein gomul ommaen gammel kone
ommubarn	barn som man er bedstemoder til
ommubeiggi	broder til ens bedstemoder
ommudóttir	sønne-el.datterdatter,hon er ommudóttir hennara
ommuligur	bedstemoderagtig(fx om tøj),alt er nýmótans, sjálvt hitt ommuligastaalt er moderne, selv det mest bedstemoragtige
ommusonur	sønne-el.dattersøn,ommusonur mín
ommusystir	søster til ens bedstemoder
ommutur	bedstemoderagtig(fx om tøj),ein ommutur kjólien bedstemoragtig kjole
ompil	(ornitol.)havsuleunge i dens første år
ond	1ånde, åndedræt, åndedrag, vejrtrækning,draga ondinatrække vejret;missa ondinatabe vejret, tabe pusten, blive forpustet;vera tungur fyri ondinihave åndenød;ondin blakast í honumhan er ved at opgive ånden, at drage sit sidste åndedrag;við ongari ondforpustet, åndeløs(pga. anstrengelseel.travlhedel.latter)2ånd, sjæl, tanke,stórur í ondinistolt, hovmodig3luftning, brise, vind, vindpust,ondin er køldvinden er kold4(overf.)vera sum ein ondvære begejstret,hann var sum ein ond beinanveginhan var straks meget begejstret
ong	(kvad,poet.,stedn.)eng, græsmark,gras av eingjum
ongan	seeingin
ongantíð	aldrig,ongantíð beturså meget desto bedre;ongantíð nakrantíðaldrig nogensinde,hatta tólið hevur ongantíð verið gott nakrantíðdette apparat har aldrig nogensinde været godt
ongastaðni	ingensteds
ongiliubein	helleflynderens nøgleben(clavicula)
ongin	eingin
onglalag	redskab hvormed man retter en skæv fiskekrog op
Ongland	England
onglendingur	englænder
ongspretta	(zoo.)græshoppe(Saltatoria),ongsprettur eta tíðum alla grøðina av
ongul	angel, fiskekrog,ongul í reyvikke have fanget en eneste fisk;ikki loysa ongulinikke fange nogen fisk
ongulfastur	(om fisk)fast på (fiske)krogen
ongulfesta	(med et ryk) få (en fisk, der har bidt) fast på krogen
onka-	som man har forkærlighed for, yndlings-
onkabarn	udvalgt barn, særlig kærtel.højest elsket barn,hann var onkabarnið umborðhan var den mest elskede ombord
onkabróðir	(kvad)kær og elsket broder, yndlingsbroder
onkadóttir	særlig elsket datter, kæreste datter,(kvad)kongurin læt eina gullbreyt gera til onkadóttur sína
onkar-	onka-
onkasonur	udvalgt søn, kæreste søn,onkasonur GuðsGuds udvalgte søn
onkavinur	fortroligste ven, særlig nær ven
onkuntíð	1engang(i fortidenel.fremtiden),onkuntíð var eg fitt á fótumdet var den tid da jeg var let til bens2somme tider, en sjælden gang, en gang imellem,tað var ikki meira enn onkuntíð, at ...det var kun engang imellem, at ...
onkur	nogen, en eller anden,onkun daginen (eller anden) dag, en af de nærmeste dage;onkun dag uppímillumen enkelt dag nu og da;onkra frægari gentu mátti hann funniðman skulle tro, han kunne have fundet en bedre pige;onkur annaren anden en;væl er hon ikki so andlitsfríð sum onkur onnurgodt nok har hun ikke så smukt ansigt som andre;okkurt var at geranoget måtte der gøres;okkurt sigur túdu snakker!;okkurt sovorðiðnoget i den retning;okkurt um(forkorteto.u.)cirka, omtrent
onkursvegna	på en eller anden måde,tað man fara at laga seg onkursvegna
onkustaðni	etsteds, et eller andet sted,onkustaðni stendur skrivaðetsteds står skrevet
onnur	seannar
ont	(ornitol.)vildand;jf.dunna
op	åbning
opa	1rense en tilstoppet åbning2åbneel.opskære får som skindet er flået af,henda kundi, at menn fingu upp í glasið, tá ið opað varð og fitin komin til sjóndar3åbne,opa øðurnar
opalur	(geol.)opal
opera	(musik)opera,operan í Wienoperahuset i Wien
opilsi	åbning,øll opilsi í plantunum fyllast við luftalle åbninger i planterne fyldes med luft
opin	1åben, ikke lukket,opið stóð út í túnyderdøren stod åben;setael.blaka opið eftir særikke lukke døren efter sig;dyrnar standa opnar1døren står på vid gab2ikke låst,opin innanhul, tom;nøtin er opin innannødden er tom,opin ferðaseðilåben billet;hava opið høvdvære fornuftig, være god til at huske;(lingv.)opin ljóðåbne lyde;opið sjálvljóðåben vokal;opið brævåbent brev,(úti) á opnum havi(ude) på det åbne hav;i ordforb. somhar er opið innundirder er en hulning under(fx klippen, åbrinken etc.);i ordforb. somsigla opnan fjørðinsejle gennem fjorden, så man ser en åbning mod havet forude2åbentliggende, ubeskyttet, bar,liggja opinligge på ryggen;opið beinbrotåbent benbrud3som ikke forstår at tieel.skjule, åbenmundet4som giver mælk,kúgvin er opinkoen giver mælk;einans kúgv er opinkun en ko giver mælk
opinbera	åbenbare, afsløre, røbe
opinbering	åbenbaring,fáa eina opinbering frá Guðifå en åbenbaring fra Gud;Jóhannesar opinberingJohannes' Åbenbaring
opinberingarbók	(rel.)Johannes' Åbenbaring, apokalypsen
opinberligur	åbenbar, offentlig, tydelig, åbenlys,kenslan av einsemi og fremmandaleika er heilt opinberligfølelsen af ensomhed og fremmedhed er helt åbenlys;opinberligur sannleikioffentlig sandhed;-liga,gera e-n opinberliga til skammargøre nogen offentligt til skamme;atfinningarnar komu fram opinberligakritikken blev fremført offentligt
opinberur	åbenbar, tydelig, klar,danska stjórnin stóð í opinberari mótstøðu við tjóðskaparrørsluna í Føroyumden danske regering stod i åbenlys opposition til nationalbevægelsen på Færøerne
opinekruarvi	(bot.)almindelig fuglegræs(Stellaria media)
opinleiki	åbenhed, offentlighed, glasnost,størri opinleikistørre åbenhed
opinlyndi	åbenhed, offentlighed,yrki teirra - runnið av opinlyndi og víðfevnandi hugsjónumderes arbejde - udsprunget af åbenhed og radikale idéer
opinlýst	åbenlyst, frit,Jesus kundi ikki longur koma opinlýst inn í nakra bygdJesus kunne ikke længere frit komme ind i nogen landsby
opinlýsur	åbenlys, åbenbar, tydelig, klar
opinoygdur	med udstående øjne
opinskára	røbe, afsløre,teir fáa einki burtur úr tí uttan at opinskára seg sum falsararde får intet andet ud af det end at afsløre sig som bedragere;lærarin var ikki tann maður, at hann opinskáraði nakaðlæreren var ikke en mand som afslørede noget;tað verður skjótt opinskárað, at vit eru herdet bliver hurtigt afsløret, at vi er her
opinskáraður	1som taler lige ud, åbenhjertig,hon hevði altíð verið opinskárað og aldri dult nakað fyri honumhun havde altid været åbenhjertig og aldrig skjult noget for ham2åbenmundet,tað var honum so líkt at vera opinskáraður við slíkum, ið skuldi verið væl umhugsað og varisliga sagt
opinskáraføri	åbenmundethed,í opinskáraføriåbenlyst;eg tordi ikki at drekka í opinskáraførijeg turde ikke drikke brændevin åbenlyst;koma í opinskáraføri(om indestængte følelser)komme til udbrud
opisligur	hul, tom,tað ljóðaði opisligt at ganga eftir brúnnidet lød hult at gå efter broen
opium	(med.)opium
opna1	(zoo.)hunsæl;jf.brimil
opna2	1opslag, bogopslag(to modstående sider i en bog),úr hvørjari opnu vellir kærleikin til ættina2(den åbne) inderside af en lammekrop,opnan á krovinum skuldi altíð venda frá fólki
opna3	åbne,opna brøviniåbne brevene;opnaståbne sig, åbnes,best at koma sær tætt at landi, áðrenn bygdin opnast;himmalin opnaðist fyri honumhimmelen åbnede sig for ham
opnari	oplukker(fx flaske, dåse etc.)
opnatroyggja	trøje med lukke foran
opningur	(med.)1åbning(om afføring, modsat forstoppelse)2afføring(om dennes konsistens),harðurel.linur opningurhårdel.blød afføring;hava harðan opninghave hård afføring
opsin	ubetænksom og åbenmundet,hann var altíð opsinhan var altid ubetænksom og åbenmundet
opsni	åbenmundethed
optiskur	(fys.)optisk
orangutang	(zoo.)orangutang(Pongo pygmaeus)
ordan	(talesp.)i ordforb. somgera í ordangøre i stand, reparere;vera í ordanvære i orden
ordans	(talesp.)rigtig,hatta er ein ordans gloypubitidette er en rigtig lækkerbisken
ordans-	(talesp.)ordentlig, dygtig,ein ordanskona / ordansmaðuren dygtig kone / mand
ordiligur	(talesp.)ordentlig, rigtig,hann sær, at tað er ikki ordiligt fólkhan ser, at det er ikke ordentlige folk;ver ordiligur!opfør dig ordentligt!;-liga
ordri	(talesp.)1ordre, befaling, instruks,geva ordrargive ordrer2ordre, bestilling
orð	1(lingv.)ord2det som bliver sagt,(bibl.)í fyrstuni var orðiði begyndelsen var ordet;vita orð fyrikende ord for,teir høvdu á sær hesa undrandi kenslu, sum teir ikki vistu orð fyri;ikki leita eftir orðunumtale ligeud og præcist;hann átti eingi orð fyri gleði sínihan havde ingen ord for sin glæde;taka orð úr munninum á e-mtage ordet ud af munden på nogen;vera við tí góðael.ringa orðinumse det godeel.dårlige i noget, roseel.kritisere,hann er altíð við tí góða orðinumhan er altid positiv;tað var ikki orð á, sum hann varð rósturdet var ubeskriveligt som han blev rost;í orð og tal kundi hon mangan vera ov grefligi sin tale kunne hun ofte være for grov;gloym ikki títtel.tíni orð!husk hvad det var du ville sige(det kan man sige til en person der bryder ind i ens tale);øvut orð;taka orðið av (e-m)afbryde en der taler;havael.taka seg aftur í orðinitage sine ord i sig igen;(talem.)eitt var orðið, annað høggiðder var ikke langt fra ord til handling;skaðin var størri á orði enn á borðiskaden var overdrevet, skaden var ikke så stor i virkeligheden;(ordsp.)mangur er á orði, ið ikki er á borðiloven er ærlig, men holden besværlig(mange holder ikke hvad de lover),(ordsp.)tað er ikki hvørt orð, tú skalt svara til, og ikki hvørt gildi, tú skalt fara tilman skal ikke svare på alle tiltaler eller gå til alle fester3udsagn, ytring,orðum kønurveltalende;ikki fáa orðið uppel.framikke få sagt noget;taka til orða(nna)tage til orde4samtale, dialog,skifta orð (við e-n um e-t)tale med nogen;eiga orð samantale sammen;hava orðum samantale sammen, skændes;koma til orða við e-nkomme til at tale med nogen;vera til orðamødes og tale sammen;fáa / bera orð á (e-n)komme til at tale med nogen;bera orð av dreingi / gentuomtales i forbindelse med en fyr / pige;tey bæði høvdu borið orð av hvørjum øðrum nøkur kvøldde havde været set sammen nogle aftener;bóru tvey orð av hvørjum øðrum, so var altíð nógv at siga um teyhvis to blev set sammen, var der altid meget at sige om dem5omtale, rygte,hava á orðiomtale(især rosende),(ordsp.)fátt er betri enn á orði havtikke meget er bedre end sit rygte;hava (e-t) við orðiomtale, nævne;øll hava teir við orðialle taler rosende om dem;hava á orði við e-n (um e-t)tale med nogen (om noget), omtale noget (med nogen);hava orðið umnævne, omtale,har veksur hin reyði tarin, tygum høvdu orðið um6sladder, snak,komael.førast út í orðblive udsat for sladder;hann kemur út í orðsladderen går om ham;loypa út í orðløbe med sladder om;hesari ferð hansara gekk mikið orð avdenne rejse han havde gjort, gik der megen snak om;uttan orð og / ella boðuden varsel,hann gjørdi tað uttan orð og boðhan gjorde det uden varsel;hoyra hvørki orð ella eið (frá e-m)intet høre (fra nogen);áðrenn nakar visti orðið av tífør nogen havde hørt tale om det7rygte,hava gott / ringt orð á særhave et godt / dårligt rygte;orð gongur avdet siges / forlyder;hann ber orð fyri at vera sterkurhan har ord for at være stærk;bera e-m gott orðtale pænt om nogen;koma (e-m) í ringt orðbringe nogen i sladder;hann hevur einki orð á særhan har ikke et godt ord på sig;leggja góð orð fyri e-nlægge et godt ord ind for nogen;mátti hava vissu fyri, at maðurin var, so sum orðið gekk av honummåtte have sikkerhed for, at manden var som man sagde8ord, ordsprog, talemåde,eitt gamalt orðet gammelt ordsprog9løfte, tilsagn,halda orðholde ord, holde sit løfte;bróta sítt orðbryde sit ord / løfte;geva (e-m) orð og eiti fyri, at...forsikre en for at...;fútin vildi ikki bróta orð og eiti síttfogeden ville ikke bryde sit ord10ytring som gentages eller tilføjes,taka í aftur orðiðfortsætte;"ein kann ikki bara arbeiða", tók Gunnar í aftur orðið"man kan ikke bare arbejde", gentog Gunnar11replik,hava orð uppiísige noget (i en samtale);eg skoytti ikki um at geva orð tiljeg brød mig ikke om at svare12(rel.)orðiðordet, Guds ord, evangeliet, skriften, Bibelen13(folketr.)hava orðið á e-mrose (så meget at det bliver til ulykke),hav ikki orðið á honumtal ikke for godt om hans (en patients) tilstand;lat meg ikki hava orðið á (tí, tærosv.)lad ikke mine gode ord bringe ulykke
orða	bringe på tale, nævne, ytre, formulere,orða e-t við e-nnævne noget for nogen;orða burturfå (noget) til at forsvinde;tað gekk so væl - nú orðaði tú tað burtur!det gik så godt - nu fik du det til at forsvinde!;orða ein burturtale om nogen så han dør;orða ímótigøre indsigelse (imod), protestere;orðastformuleres
orðabanki	(datal.)(elektronisk) ordbank
orðabending	(lingv.)bøjning
orðabók	ordbog,føroysk-donsk orðabókfærøsk-dansk ordbog
orðabókarforrit	ordbogsprogram
orðabókargrein	ordbogsartikel
orðabókarhandrit	ordbogsmanuskript
orðabókarritstjóri	ordbogsredaktør
orðabrask	store ord, pral
orðadráttur	ordstrid, diskussion, debat, disput,verael.liggja í orðadrátti við e-nvære i diskussion med nogen
orðafall	udtryksmåde,eg havi sjáldan hoyrt so vakurt orðafalljeg har sjældent hørt så smuk udtryksmåde
orðafar	udtryksmåde, sprogbrug,hann er altíð so bøllutur í orðafarihan er altid så grov i sit sprog
orðafáur	1fåmælt, ordknap, tavs,hví mundu tey vera so orðafá og innisælhvorfor mon de er så tavse og indesluttede2ordfattig,málið er orðafáttsproget er ordfattigt
orðafelli	1udtryk, talemåde,føroysk orðafelli og orðtøkfærøske talemåder og ordsprog2sprogbrug,av teimum gomlu lærdi eg gott føroyskt orðafelliaf de gamle lærte jeg god færøsk sprogbrug
orðaflokkur	(lingv.)ordklasse(fx substantiver, adjektiver)(pars orationis)
orðafloymur	ordflom, udgydelse, ordgyderi,eg var eitt sindur illa við av hesum orðafloymijeg blev lidt ilde berørt af denne ordflom
orðaflóð	ordflom, udgydelse, ordgyderi
orðafrágreiðing	ordforklaring
orðagangur	store ord, pral
orðageip	snak, pral, praleri
orðagerð	(lingv.)orddannelse,orðagerð á heimligari grunddannelse af nye ord af hjemlige (færøske) elementer
orðagjálv	pral
orðakringur	ordsnild, veltalende
orðalag	udtryksmåde, ordføjning,hann kundi stundum tykjast bonskur í orðalaghan kunne mange gange synes bondsk i sin udtryksmåde;tað er eitt (ræðuligt) orðalag, hann hevurdet er et frygteligt sprog, han bruger;greitt, beinrakið og mergjað var orðalag teirra;hava gottel.ringt orðalag til e-nudtale sig godtel.slet om en;hann hava tey einki orðalag tilham har de ikke noget godt at sige om
orðalagsheild	(lingv.)syntagme
orðalagslæra	(lingv.)syntaks
orðaleikur	1ordspil2ordskvalder
orðaleyst	uden modsigelse, uden bebrejdelse,gert tú hatta, verður tað ikki orðaleystgør du det, bliver det ikke uden modsigelser;tað skal ikki vera orðaleystdet skal ikke være uden bebrejdelser;tað gjørdi hann orðaleystdet gjorde han uden indvendinger
orðalisti	ordliste
orðalítil	fåmælt, ordknap, tavs,álvarsom og orðalítilalvorlig og fåmælt;hon var orðalítil og læt aldri nakað leka út, sum hon vistihun var fåmælt og lod aldrig noget komme ud, som hun vidste, hun løb aldrig med sladder;hesi fólkini vóru so orðalítildisse mennesker var så tavse
orðaljóð	ordlyd,brævið varð lisið upp í fullum orðaljóðibrevet blev læst op i fuld ordlyd
orðalýsing	ordforklaring, definition
orðalæra	(lingv.)ordlære
orðamikil	pralende,tú plagar ikki at vera so orðamikildu plejer ikke at være så pralende
orðamunur	afvigende læsemåde, variant,orðamunur úr øðrum handriti stendur við hvørt undir tekstinumafvigende læsemåde fra et andet håndskrift står af og til under teksten
orðanøgd	ordflom, udgydelse, ordgyderi,orðanøgdin var ógvulig, men skilið var lítiðordflommen var stor, men fornuften var lille
orðarað	(lingv.)ordstilling,setningur við beinum orðaraðsætning med ligefrem ordstilling;øvut orðaraðomvendt ordstilling
orðaraðið	ordret, ord for ord, flydende,frásøgan er prentað at kalla orðaraðiðfortællingen er trykt nærmest ordret;ikki er orðaraðið avskrivaðafskriften er ikke ordret
orðaríkur	ordrig, meget talende,hann var tiltikin fyri at vera orðaríkurhan var kendt for at være ordrig
orðarætt	ordret,endurgeva orðarættgengive ordret;fleiri brot eru tikin at kalla orðarættflere stykker er gengivet nærmest ordret
orðarættur	ordret,orðarøtt frágreiðingordret fortælling;orðarætt;barnið segði søguna orðarætt, sum tað hevði hoyrt hanabarnet fortalte historien ordret, lige som det havde hørt den
orðasamband	ordforbindelse,fast orðasambandfast ordforbindelse;í vissum orðasambondumi visse ordforbindelser
orðasavn	ordsamling
orðaskifti	diskussion, debat, ordskifte, ordveksling,teir høvdu sitið í orðaskifti um okkurt málde havde siddet i ordveksling om en eller anden sag;orðaskifti um fíggjarlógdebat om finansloven
orðaskolan	(overflødig) snak, sludder, vrøvl
orðaskrá	ordliste
orðaskvaldur	pral, (overflødig) snak, sludder, vrøvl
orðasmiður	ordsmed,kringur orðasmiðurdygtig ordsmed
orðasmíð	(lingv.)orddannelse
orðastríð	skænderi, diskussion, kiv, kævl,tey vóru ógvuliga ofta í hvøssum orðastríðde var meget ofte i hårdt skænderi;hann var fúsur til orðastríðhan var klar til en diskussion
orðatak	talemåde, ordsprog, mundheld
orðatilfar	ordforråd,virkið og óvirkið orðatilfaraktivt og passivt ordforråd
orðatiltak	mundheld, talemåde, udtryk
orðatrot	bekneb for ord,hann er ikki í orðatrotihan er ikke i bekneb for ord
orðaval	ordvalg,hann er óstortsligur í orðavalihan er klodset i sit ordvalg
orðavargur	en der bruger store ord, praler, pralhals, blærerøv,hann var ein sovorðin orðavargur, hann tók so ógvusliga til orðannahan var sådan en pralhals, han brugte så store ord
orðavas	pral, (overflødig) snak, sludder, vrøvl
orðavavstur	pral, (overflødig) snak, sludder, vrøvl
orðbera	udtrykke i ord,orðbera segudtrykke sig;tað er torført at orðbera seg á rættan háttdet er svært at udtrykke sig på den rigtige måde
orðblindi	ordblindhed
orðblindingur	ordblind person
orðblindur	ordblind
orðbragd	udtryksmåde, sprogbrug, ordføjning,longu í 15. øld síggjast donsk orðbragd í føroyskum skriftmáliallerede i det 15. århundrede kan man se danske udtryksmåder i færøsk skriftsprog
orðbýta	(lingv.)dele ord
orðbýting	(lingv.)orddeling
orðfáur	fåmælt, ordknap, tavs,stillførur og orðfáur maðurstille og fåmælt mand;við hesi orðfáu lýsing er nógv sagtmed denne ordknappe beskrivelse er der sagt meget
orðfeingi	(lingv.)ordforråd
orðfella	bringe på tale, nævne, ytre, formulere,hann tosar reint suðuroyarmál og dugir væl at orðfella taðhan taler ren Suðuroy-dialekt og er god til at udtrykke sig på den
orðfelli	udtryk, talemåde, sprogbrug
orðfesta	bekendtgøre, kundgøre, meddele, bebude
orðfimur	som har en smidig tunge, mundrap, rapkæftet
orðfittur	som har en smidig tunge, mundrap, rapkæftet,vera orðfitturvære rapkæftet
orðformur	(lingv.)ordform
orðfúsur	snakkesalig,tú ert so orðfúsurdu er så snakkesalig
orðføra	orðføra segudtrykke sig,hann dugir væl at orðføra seghan er god til at udtrykke sig;hon dugdi væl at orðføra seg í kjakihun var god til at debattere
orðføring	udtryksmåde
orðførur	snaksom,hann kundi vera í so orðførurhan kunne være lovlig snaksom
orðgonga	ordstrid, diskussion, debat, disput
orðgýtast	bruge mund,hann er so raskur at orðgýtasthan er så dygtig til at bruge mund
orðhagur	veltalende, retorisk, oratorisk
orðhaldin	ordholdende, ordholden,orðhaldin maðurordholden mand
orðhavin	som snakker uden omtanke, kådmundet, rapkæftet,hann var so spotskur og orðhavinhan var så spotsk og rapkæftet
orðhildin	ordholdende, ordholden
orðing	udtryk, udtryksmåde, formulering
orðkringur	veltalende, retorisk, oratorisk,orðkringur maðurveltalende mand
orðkvettin	brysk, brøsig, bister,hann er so orðkvettinhan er så bister
orðleypa	i ordforb.orðleypa segfortale sig;at eg skuldi orðleypa meg soat jeg skulle fortale mig sådan
orðleysur	uden ord, usagt,ekki og iðran herja orðleys á hannpludselig ængstelse og samvittighedsnag angriber ham uden ord;orðleystuden at sige ord,orðleyst tilbað eg teyuden at sige et ord tilbad jeg dem
orðliður	(lingv.)ordled
orðloypin	som snakker uden omtanke, kådmundet, rapkæftet,hann var altíð nakað orðloypinhan var altid noget rapkæftet
orðloysi	løftebrud
orðloysingur	ordbryder
orðmikil	pralende
orðmynd	(lingv.)ordbillede
orðna	(talesp.)1ordne, klare, fikse,hetta er skjótt at orðnadette er hurtigt ordnet2give ordrer,hon orðnar altíðhun giver altid ordrer
orðníðingur	ordbryder
orðrót	(lingv.)rod(i ord)
orðrættur	ordret, enslydende, identisk;orðrætt;endursiga orðrættgenfortælle ordret
orðsending	bud, besked, pålæg,nógv fólk kom til býin eftir orðsending frá Ólavi kongimange kom til byen efter bud fra kong Olav
orðskiftast	diskutere,teir stóðu og orðskiftust um viðurskiftinide stod og diskuterede forholdene
orðskvaldur	pral, (overflødig) snak, sludder, vrøvl
orðsnið	ordform
orðsnildi	fremragende udtryksevne, veltalenhed
orðsnúgvin	veltalende, retorisk, oratorisk
orðsstaður	i ordforb.taka e-t í orðsstaðstole på, gentage,tað er ikki takandi í orðsstað, tað hann sigurdet er ikke til at stole på det som han siger
orðstovnur	ordstamme
orðstýrari	dirigent, ordstyrer
orðtak	1ordsprog, talemåde,sum orðtakið sigur: "eingin veit á morgni at siga, hvar hann á kvøldi gistir";"tungur er tigandi róður" er annað orðtak2i ordforb.taka e-t í orðtakgentage noget (en anden har sagt),eg taki tað ikki í orðtakjeg gentager det ikke, jeg udspreder det ikke (som rygte)
orðtaka	(lingv.)excerpere,orðtaka bókexcerpere en bog
orðtal	i ordforb.taka í orðtalrøbe, sladre, løbe med snak, udsprede rygter,tak tað ikki í orðtalikke mine ord igen
orðtøka	(lingv.)excerpering
orgul	orgel
orka1	1kraft, evne,leggja alla sína orku íel.á e-tlægge alle sine kræfter i2(fys.)energi,orkan í matienergien i mad;vatnorkavandenergi
orka2	være i stand til, evne, klare, formå, mægte,hann orkar ikki at eta upphan klarer ikke at spise op;hann orkar ikki at tiga við tí longurhan klarer ikke at tie stille med det længere;ikki orka meiravære mæt;hann róði alt tað, hann orkaðihan roede alt hvad han kunne;ikki orka1ikke have kræfter(fx til at gå)2ikke kunne udholde,eg orki ikki at síggja tegjeg kan ikke udholde at se dig;ikki orka fyri e-mikke holde en ud, ikke døje en
orkestur	(musik)orkester, band,hornorkesturhornorkester;symfoniorkestursymfoniorkester
Orknoyggjar	Orkneyøerne
orknoyingur	beboer på Orkneyøerne
orknoyskur	orknøisk
orkufrekur	energikrævende,orkufrek framleiðslaenergikrævende produktion
orkugerð	(fys.)energiudvikling
orkugevi	energigiver
orkukelda	energikilde, kraftkilde,olja og vindmegi sum orkukeldurolie og vind som energikilder
orkukreppa	energikrise
orkulind	energikilde, kraftkilde
orkulítil	svag, afkræftet,konan føldi seg sjúka og orkulítlakonen følte sig syg og svag
orkuloysing	(fys.)energifrigørelse, energiudvikling
orkumál	(pol.)energispørgsmål, energisager
orkumálaráð	(pol.)energiministerium
orkumálaráðharri	(pol.)energiminister
orkumikil	kraftig, stærk
orkunýtsla	(fys.)energiforbrug
orkuráð	energiråd, energistyrelse
orkuríkur	1kraftig, stærk2driftig, foretagsom, energisk
orkuspell	energispild,tað hevur óivað elvt nógv orkuspelldet har uden tvivl medført meget energispild
orkustøð	kraftstation, kraftværk
orkutilfeingi	energiressource
orkutøkni	(fys.)energiteknologi
orkutørvur	energibehov
orkuveiting	energiforsyning
orkuverk	kraftstation, kraftværk
orlov	orlov
ormaeitur	slangegift
ormagras	(bot.)øjentrøst
ormalamb	lam med bændelorm
ormasjúka	(med.)børneorm
ormasjúkur	plaget af børneorm,barnið var illa plágað av ormi
ormatógv	ganske fint spundet garn
ormaveður	fugtigt, lummert vejr(hvor der er fare for at der kommer maddiker i ophængt fisk og kød)
ormetin	ormædt, ormstukken
ormur	(zoo.)1slange2orm3larve4(folketr.,kvad)drage,Ormurin langi;jf.frænarormur5(med.)børneorm(Enterobius vermicularis)
ormvera	(zoo.)larve,ormveran skiftir hamlarven skifter ham, larven forpupper sig
orna	1blive varm, varmes, opvarmes,tá ið ornað var inni, var liðið út um miðja nátt;(overf.)nú var tað rættiliga farið at orna teirra millumnu var det rigtigt blevet varmt mellem dem2blive hed om ørerne,orna um skallan;orna av skomm;eg bæði ornaði og rodnaði
orr	stinkende dynd
orra	(om dynd, sur mælk, fiskeindvolde etc.)rådne, gære,flotkøstar og blárennur, sum standa og orra;(overf.)standa og orrastå uvirksom og i vejen for andre
orri	(ornitol.)urfugl(Tetrao tetrix)
orrusta	kamp, slag,vekja orrustuskabe ufred, skabe strid
orsaka	1forvolde, forårsage,orsakað av e-mpå grund af noget2undskylde,orsaka e-nbede om undskyldning for en;orsaka segundskylde sig
orsakareykasetningur	(lingv.)årsagsbisætning
orsaki	grund, årsag,hava orsaka at gremja seghave grund til at beklage sig
orsøk	årsag, grund,orsøkin til ólukkuna var ov nógv ferðårsagen til ulykken var for stor hastighed;hon hevði góða orsøk at vera feginhun havde god grund til at være glad;orsøk og virknaðurårsag og virkning
ortur1	seyrkja
ortur2	formuleret,vera væl / illa orturtale smukt / grimt,vera undarliga orturtale mærkeligt
orv	skaft på le
osa	1ose, ryge,lampanel.ljósið osarlampenel.lyset oser2dampe,ketilin stóð og osaði og var kókaður næstan tómur;potturin stendur og osargryden står og damper
o.s.fr.	fork. forog so framvegis
osi	os, damp, em,osin rann niður eftir bróstinumdampen løb ned ad væggen;turka osan av rútunumtørre dampen af ruderne
oskabjørn	(zoo.)en snylter på fisk(Aegidae)
oskamjólk	(mælk.)råmælk
oskasmør	smør af råmælk,oskasmør varð hildið vera dygdarbetri enn annað heimasmørsmør af råmælk blev anset for at være af bedre kvalitet end andet hjemmelavet smør
oson	(fys.,kem.)ozon(tegnO3)
osonlag	(fys.,kem.)ozonlag
ostafarg	osteform
ostaformur	osteform
ostagerð	ostefremstilling
ostahøvil	ostehøvl, osteskærer
ostamjólk	(mælk.)mælk til ostefremstilling
ostaskerari	osteskærer, ostehøvl
ostaskorpa	osteskorpe
ostevni	kasein
ostflís	osteskive
osthøvil	ostehøvl, osteskærer
ostra	(zoo.)østers(Ostrea edulis)
ostruskel	østersskal
ostskeri	osteskærer, ostehøvl
ostur	ost,kæsa ostlave ost
ota	skyde lidt fremel.tilbage, skubbe, trænge,ota e-n út á sjógvskubbe en i havet;ota burturfortrænge;ota seg framtrænge sig på;ota seg undantrække sig tilbage;ota seg inn á e-ntrænge sig på nogen
otan	opløb, sammenstimling, trængsel,tað var ein otan av fólki framman fyri skivunader var trængsel af mennesker foran disken
o.tíl.	fork. forog tílíkt
otur	(zoo.)odder(Lutra vulgaris)
oturskinn	odderskind
o.u.	fork. forokkurt um
ov	alt for, alt for meget,ov mikiðfor meget;ov mikið og ov lítiðfor meget og for lidt;ov tíðligafor tidligt;ov ungurfor ung;ov gamalfor gammel;teir vóru ov nógvir á bátide var for mange i båden;børnini komu ov seint í skúla í morgunbørnene kom for sent i skole i morges
ovarbeiða	overanstrenge (sig),doktarin segði, at hann hevði ovarbeitt seglægen sagde, at han havde overanstrengt sig
ovarbeiði	overanstrengelse,andsperri av ovarbeiðistivhed i lemmerne pga. overanstrengelse
ovari	1øvre, øverst (af to),ovari vegurøverste vej;ovari munnurovermund;ovara hæddin er útleigaðden øvre etage er udlejet2længere oppe(end noget andet),højere;jf.niðari
ovarlaga	(temmelig) højt oppe, højt beliggende,mods.niðarlaga,húsini standa ovarlaga í bygdinihuset står højt oppe i bygden
ovarliga	ovarlaga
ovast	øverst,mods.niðast,liggja ovastligge inderst i en seng (alkove)
ovastaloft	hanebjælkeloft
ovasti	(militær)øverstkommanderende (i hær)
ovastur	øverst,ovasta hæddin í húsinumøverste etage i huset;ovastur embætismaðurøverste embedsmand
ovát	frådseri
ovbeiðsla	for stor fordring
ovboðið	over evne, for svært at magte, umuligt,hon hevði roynt at berjast ímóti, men nú var ovboðiðhun havde forsøgt at kæmpe imod, men nu kunne hun ikke mere;vera ovboðiðvære for meget, for galt;vera e-m ovboðiðvære mere end man kan klare;honum var einki ovboðiðhan veg ikke tilbage for noget, han påtog sig alt;hann helt einki vera ovboðiðhan havde mod på det værste;(ordsp.)øllum er ovboðiðenhvers evnerel.formåen har (trods alt) en grænse
ovbyrja	overbebyrde,ikki vildi hann ovbyrja tingið;ovbyrjaður1overbebyrdet,ovbyrjaður avel.við e-m (fxarbeiði)overbebyrdet af noget (fx arbejde);vit vóru ovbyrjað av gestumvi var overbebyrdet med gæster2besværet
ovbýldur	overbefolket,ovbýldur býarparturoverbefolket bydel
ovdirvi	hovmod, overmod, arrogance,eg haldi tað vera ovdirvi av tygum at tala um slíkt fyri mær
ovdjarvur	dumdristig,hann er ovdjarvurhan er dumdristig
ovdrekka	drikke for meget(af alkohol)
ovdrukkin	døddrukken,hann varð ovdrukkin og datt avhan blev døddrukken og faldt i søvn
ovdrykkja	fuldskab,ikki gonguførur av ovdrykkjuikke i stand til at gå på grund af fuldskab
overva	overanstrenge,overva segoveranstrenge sig;overvaðuroveranstrengt
overvan	overanstrengelse,andlig og kropslig overvanpsykisk og fysisk overanstrengelse
overving	overanstrengelse,í ørviti av náttarvekri og overving
oveta	oveta seg (av e-m)forspise sig (af noget)
ovfarakátur	i overstadigt humør, overstadig, løssluppen, kåd
ovfarakæti	overstadigt humør, kådhed,ovfarakæti var á ungdóminumungdommen var i overstadigt humør
ovfarin	overrasket, forbavset, forbløffet,tey vóru øll ovfarin og undraðustde var alle overrasket og forundret;honum tyktist ovfariðhan syntes det var gået for vidt
ovfarni	overraskelse, forbavselse, forbløffelse
ovfegin	begejstret, henrykt, kisteglad,hin gamli varð mestsum ovfeginden gamle blev nærmest henrykt
ovfermdur	for tungt lastet,skipið er ovfermtskibet er for tungt lastet
ovfiska	overfiske
ovfisking	overfiskning,fiskaloysi av ovfisking og veðurlagsbroytingummangel på fisk pga. overfiskning og klimaændringer;fiskastovnarnir eru hóttir av ovfiskingfiskebestandene trues af overfiskning
ovfólkaður	overbefolket,landið er ovfólkaðlandet er overbefolket
ovframleiðsla	overproduktion,ovframleiðsla av olju fær prísin at lækkaoverproduktion af olie får prisen til at falde
ovfullur	1overfyldt,báturin var ovfullur og sakkbåden var overfyldt og sank2døddrukken, stangdrukken, plakatfuld
ovfylla	overfylde,tveir bátar gingu burtur, teir høvdu ovfylt seg av fuglito både forulykkede, de havde overfyldt båden med fugle;ovfylla marknaðin við vørumoverfylde markedet med varer
ovganga	i ordforb.ovganga seggå for stærktel.hurtigt, få indvendig skade af at gå for stærkt;hann er ein eldri maður og skilagóður, so hann ovgongur seg ikkihan er en gammel og fornuftig mand, så han går ikke for stærkt
ovgiftur	som får for meget af noget,ikki gott at verða ovgifturikke godt at få for meget forærende
ovgjørt	i ordforb. somikki var tað ovgjørtdet var ikke for meget forlangt;tað hevði ikki verið ovgjørt, um slíkt loyvi hevði verið giviðdet ville ikke være urimeligt, hvis sådan en tilladelse blev givet
ovgonga	alt for stærk gang(som medfører overanstrengelse)
ovgongd	alt for stærk gang(som medfører overanstrengelse)
ovgoyma	gemme for længe
ovhita	overophede
ovhiting	overophedning
ovkeypa	i ordforb.ovkeypa segforkøbe sig
ovklyvjaður	overbebyrdet
ovkóka	koge for meget,eplini eru ovkókaðkartoflerne er kogt for meget
ovkyrktur	i ordforb. somhon verður ovkyrkt av honumhan bliver hende til besvær
ovlaða	overfylde,teir høvdu ovlaðað seg, og báturin gekk burtur
ovlaðin	overlastet,ovlaðin báturoverlastet båd
ovleiður	led og ked (af),gera e-m ovleittgøre nogen led og ked af det
ovlýsa	overeksponere,ansið eftir ikki at ovlýsa filminpas på ikke at overeksponere filmen
ovlærdur	for lærd
ovmannaður	overbemandet,skipið var ikki ovmannaðskibet havde ikke for meget mandskab
ovmeta	overvurdere,ovmeta virðið í e-movervurdere værdien af noget
ovmeting	overvurdering
ovmetta	give for meget at spise,ovmetta segspise for meget, spise sig overmæt
ovmettur	overmæt
ovmikil	for stor og megen,semikil
ovmøða	overanstrenge,árin ovmøddi røðaranåren overanstrengte roeren
ovmøði	overtræthed, udmattelse,svímaður av ovmøðibesvimet af udmattelse
ovndyggur	ovnfast,ovndygt fatovnfast fad
ovnsskuffa	bradepande
ovnsverta	ovnsværte
ovnur	1ovn2radiator
ovnýtsla	1overforbrug,ovnýtslan er fíggjað við lántøku og studningioverforbruget er finansieret med lån og støtte2misbrug,ovnýtsla av rúsdrekka er skaðilig fyri heilsunamisbrug af alkohol er skadeligt for helbredet
ovnørast	blive overfodret, blive for fed,nátin kann fara at ovnørastmallemukken kan blive for fed
ovrasin	fremfusende, ubehersket, alt for ivrig, som styrter af sted
ovrasni	fremfusenhed, ubeherskethed
ovrásaður	fremfusende, ubehersket, alt for ivrig, som styrter af sted
ovrásin	fremfusende, ubehersket, alt for ivrig, som styrter af sted
ovrásni	fremfusenhed, ubeherskethed
ovrendur	med for meget fart på(så man ikke kan standse i rette øjeblik),við tað at eg var ovrendur, kom eg móti eini song og datt endalangur í hana
ovrenna	ovrenna segløbe for stærkt
ovrokaður	overfyldt,nakað ovrokað borð var tað ikkinoget overfyldt bord var det ikke
ovróður	for stærk roning
ovrógva	ovrógva segro for stærkt, få skade af for stærk roning;hann hevði ovróð seghan havde roet for stærkt
ovsagt	i ordforb.tað er ikki ovsagtdet er ikke for meget sagt, det er ikke usandt
ovsiga	i ordforb.ovsiga segfortale sig
ovskipa	have for stor besætning af får (i udmarken)
ovskipan	for stor besætning af får (i udmarken)
ovsleip	overanstrengelse(af fysisk arbejde),tað man bert vera ovsleip, ikki sjúkadet er nok kun overanstrengelse, ikke sygdom
ovsleipaður	overanstrengt(af hårdt arbejde)
ovslit	overanstrengelse(af fysisk arbejde)
ovsova	i ordforb.ovsova seg1sove for meget2sove over sig
ovstaðin	overmoden,vínberini vóru ovstaðinvindruerne var overmodne;ovstaðið kornovermodent korn
ovsteikja	stege for meget
ovsúpa	i ordforb.ovsúpa segspise for meget suppe
ovtaka	i ordforb.ovtaka segforløfte sig;(talem.)letingi ovtekur segden dovne synes alting er for tungt
ovtala	taleel.sige for meget;i ordforb.ovtala segkomme til at sige for meget;sjálv hevði hon ikki ovtalað seg fyri nøkrumselv havde hun ikke sagt for meget for nogen;e-m verður ovtalaðen kommer til at sige for megetel.en forsnakker sig
ovuransur	sensation
ovurást	inderlig kærlighed,sprottið úr ovurást
ovurbráður	(med.)hyperakut,ovurbráð brunagerðhyperakut infektion
ovurdjarvur	dumdristig,tveir ovurdjarvir smádreingirto dumdristige drenge
ovurdrykkja	umådeholdent drikkeri,mangt eitt heim er niðurbrotið av ovurdrykkjumange hjem er ødelagt af umådeholdent drikkeri
ovurfegin	begejstret, henrykt, kisteglad,ovurfegin uppi yvir e-mhenrykt over noget;ovurfegin um e-tbegejstret for noget
ovurfegni	begejstring, henrykkelse
ovurfeitur	laskefed, lasket, smækfed
ovurglaður	himmelhenrykt, sjæleglad, glædestrålende, hjertens glad, usigelig glad,ovurglatt fuglalátglædestrålende fuglesang
ovurgleði	henrykkelse, inderlig glæde
ovurhonds	overmåde,ovurhonds stórurovermåde stor
ovurhugaður	ivrig, rede, parat, villig,í ovurhugaðum stríðii ivrig kamp
ovurhugaleysur	ligeglad
ovurhugaloysi	ligegladhed
ovurhugi	1heftighed, iver,gera e-t av ovurhugahandleel.gøre noget overilet2(ny bet.)lidenskab, passion
ovurhýrur	(psyk.,med.)mani,við hvørt sinnistyngd, við hvørt ovurhýrurnogle gange depression, andre gange mani
ovurkátur	i overstadigt lune, overstadig, opstemt, løssluppen
ovurkæti	overstadighed, løssluppenhed
ovurleiðari	(elektr.)superleder
ovurlættur	1villig, kvik og ivrig,(talem.)hin lati ber seg í hel, hin ovurlætti gongur seg í helden dovne slæber sig ihjel, den alt for villige (ivrige) løber livet af sig2meget let
ovurmenni	overmenneske
ovurmikil	kolossal, vældig
ovurmorgin	i ordforb.í ovurmorgini overmorgen
ovurmóð	(bibl.)hovmod
ovurnógvur	overmåde megen,tað hevur ovurnógv at týðadet er af største betydning
ovurnýtsla	overforbrug,her er einki til ovurnýtsluher er ingenting til overforbrug
ovurnøgd	overflod, overflødighed, overdådighed,hann var ikki vanur við slíka ovurnøgdhan var ikke vant til sådan overdådighed
ovurorka	overflodsenergi
ovurprísur	ågerpris, opskruet pris, overpris,teir seldu brennivín í loynisølu fyri ovurprísde solgte brændevin i smug til ågerpris
ovurraskur	meget duelig, meget rask,teir vóru allir tríggir ovurraskir mennde var alle tre meget raske mænd
ovurrenta	ågerrente, ublu rente
ovurríkur	hovedrig, stenrig,hann er ovurríkurhan er stenrig
ovursinni	raseri, hysteri,ganga kykur í ovursinnisyde af raseri
ovursintur	rasende, sanseløs, hysterisk
ovurskipan	for stor besætning af får (i udmarken)
ovursterkur	meget stærk,ein ovursterk blá glæmaen meget stærk blå stråle
ovurstórur	kæmpestor, gevaldig,ovurstórur salurkæmpestor sal;ovurstór tølkæmpestore tal;Sahara er ein ovurstór sandoyðaSahara er en kæmpestor sandørken
ovurtal	utal, uhyre mængde,í ovurtalii massevis
ovurundra	beundre, højagte, vurdere højt,eg ovurundri teirjeg beundrer dem
ovurundran	beundring, højagtelse, ærbødighed
ovurvaksin	kæmpestor, kolossal, enorm,ein ovurvaksin, dimmur kópuren kæmpestor, mørk sæl
ovurvakur	forunderlig, henrivende, underskøn, vidunderlig, herlig,eitt so ovurvakurt broset underskønt smil
ovurveður	voldsomt uvejr,ikki ráðiligt at halda til sjós í hesum ovurveðrinumdet er ikke klogt at gå til søs i dette voldsomme uvejr
ovurviðkvæmi	(med.)overfølsomhed
ovurviðkvæmur	(med.)overfølsom, allergisk
ovurvirkin	(psyk.)hyperaktiv
ovvaksin	vokset for stærkt, forvokset(fx om kartofler der har et hulrum i midten)
ovveiða	overfiskning
ovvekraður	forvåget
ovvekur	forvågethed
ovvit	1genialitet,einki ovvit krevst til at gera taðingen genialitet kræves for at gøre det2geni,hann er einki ovvit, men býttur er hann heldur ikkihan er ikke noget geni, men dum er han heller ikke
oy1	betegnelse for diftong (kaldes )
oy2	(kvad,stedn.)ø
oy3	av!(for at vise overraskelse, glæde, medfølelse, pine, sorg osv.),oy, oy, hann var um at gráta
oyða1	1øde strækning, øde plads2strækningel.sted i et fuglefjeld hvorfra fuglene er blevet bortryddedeel.bortjagede3strækning uden for fiskebanke hvor man ved fiskeri ikke har pejlemærker at rette sig efter,stórur fiskur, sum er veiddur úti í oyðuni4ørken
oyða2	1lægge øde, ødelægge, udrydde,oyða rottuna í oynniudrydde rotterne på øen2forøde, bortødsle,oyða arvbortødsle arv;oyða burtur;oyða tíðina burturspilde tiden bort;oyða peningbortødsle penge;oyða upp;oyða útudrydde
oyðari	1ødeland,aftan á ein samlara skal ein oyðari komaefter en samler kommer en spreder2(militær)destroyer
oyðdráp	udryddelse ved rovdrift
oyðdrepa	udrydde ved rovdrift,verður lomvigin oyðdripin, so byggir fuglur aldrin aftur har
oyðeta	(om dyr)opæde,oyðeta grasið av jørðiniopæde græsset af jorden
oyði	det at være øde,leggja í oyðilægge øde, ødelægge;staðurin verður lagdur í oyðistaden bliver lagt i øde;tað var tað turra oyðider var fuldstændig mangel på fisk
oyðiberg	klippevæg hvor ingen fugle yngler,av omanlopi er har nú oyðibergpga. jordskred yngler der ingen fugle der nu
oyðibygd	ødebygd
oyðidrepa	udrydde ved rovdrift,bara fá pláss í bjørgunum, sum eru oyðidripinkun få steder i fuglefjeldet er udryddet ved rovdrift
oyðifuglur	fugle der ikke yngler,aftan á ræningina kemur oyðifuglurin í bergið
oyðiland	1øde, ubebygget land,tí fór eg í oyðilondderfor drog jeg til et øde, ubebygget land2(om personer)ødeland, flottenhejmer,eitt oyðilanden ødeland
oyðilandsvætti	ødeland, flottenhejmer,hatta eru tey oyðilandsvætti, ið erude er nogle rigtige flottenhejmere
oyðilegging	ødelæggelse, hærværk,kríggið hevði ómetaligar líðingar og oyðileggingar við særkrigen medførte umådelige lidelser og ødelæggelser
oyðileggja	ødelægge
oyðilendi	øde landskab, ødemark,velta oyðilendidyrke ødemark
oyðimási	(ornitol.)måge der ikke yngler
oyðimold	udyrket jord
oyðimørk	ørken
oyðin	øde, ubeboet, bar,jørðin var oyðin og tómjorden var øde og tom;bergið er oyðið við fuglfuglefjeldet er tomt for fugle;húsið er oyðiðhuset er tomt
oyðing	ødelæggelse, tilintetgørelse,oyðing JerúsalemsJerusalems ødelæggelse;vit frætta um orrusturnar og oyðingarnarvi hører om kampene og ødelæggelserne
oyðingarhugur	ødelæggelsestrang, ødelæggelseslyst,hann var fullur av oyðingarhugihan var fuld af ødelæggelsestrang
oyðingarverk	ødelæggelse, hærværk,stormurin framdi sítt oyðingarverk við sama lagstormen gjorde sin ødelæggelse med samme kraft
oyðini	(poet.)øde,í oyðini hølli en øde hal
oyðioyggj	ubeboet ø
oyðipallur	lille ubeboet afsats i fuglefjeldet
oyðipláss	øde sted,hann skuldi fáa oyðiplássið at liva og blómahan skulle få det øde sted til at leve og blomstre
oyðirók	ubeboet afsats i fuglefjeldet
oyðisandur	sandørken
oyðiskógur	øde skov, ubeboet skovstrækning,so langt eygað rakk, sást ikki annað enn oyðiskógurså langt som øjet kunne se, kunne man ikke se andet end øde skov
oyðistaður	(bibl.)øde sted,hann fór burtur á ein oyðistað og helt bøn harhan gik bort og ud til et øde sted og bad dér
oyðistrond	øde ubeboet strand,leggja at á onkrari oyðistrondlægge til på en eller anden ubeboet strand
oyðisúla	(ornitol.)sule indtil fire år gammel
oyðræna	plyndre, udsuge
oyðsl	1ødselhed, fråds, frådseri2ødsel person, ødeland,eitt oyðslen ødeland
oyðsla1	(om kvinde)ødeland,hon er eingin oyðslahun er ingen ødeland
oyðsla2	ødsle, rutte, øde
oyðslan	ødselhed, fråds, frådseri
oyðslari	ødeland
oyðslusamur	ødsel, sløset
oyðslusemi	ødselhed, fråds, frådseri,oyðslusemi við lít
oyðslutur	ødsel, sløset
oyðublað	blanket, formular,ognaruppgerðin er eitt oyðublaðejendomsopgørelsen er en blanket
oyðuleið	yderste fiskeområde, fjerneste fiskeområde,teir róðu út á ytstu havmið ella oyðuleiðirde fiskede ved de fjerneste fiskeområder
oygdur	i ordforb.væl oygdursom ser frit og lige ud af sine øjne;illa oygdursom altid skæver til siden
oyggj	1ø,á oynnipå toppenel.overfladen af øen;hann á oynna til Havnarhan gik med det samme over fjeldene til Tórshavn;tvær bygdir eru í oynnider er to bygder på øen;vera burtur í oyggjvære bortrejst på en anden ø;oyggjanna millummellem øerne;undir oynni(på søen)ved foden af klippevæggene;teir róðu runt um oynnade roede rundt om øen2beboerne på en ø,øll oyggin kom, alt, sum ragga kundialle beboerne på øen kom, alle som kunne gå3(overf.)stor og kraftig kvinde,hon var tjúkk sum ein oyggjhun var en stor og kraftig kvinde4(ny bet.)midterrabat
oyggjaflokkur	øgruppe,ein lítil oyggjaflokkuren lille øgruppe
oyggjafólk	øbo, øboer
oyggjahav	(geogr.)øhav
oyggjaland	øland,Føroyar eru oyggjalandFærøerne er et øland
oyggjarbrúdleyp	bryllup som alle på en ø er indbudt til
oyggjaríki	ørige
oyggjarmaður	mand fra samme ø som en selv,vit eru oyggjarmennvi er fra samme ø
oyggjarnavn	ønavn
oyggjarskeggi	øbo
oyggjaveðurlag	(geogr.)kystklima, øklima
oygla	se med begærlige øjne på noget,oygla eitt burtur frá e-mstirre på og misunde en noget
Oyndarfjørður	(stedn.)bygd i Eysturoy,í / úr Oyndarfirði;til Oyndarfjarðar
oyndfirðingur	person iel.fra bygden Oyndarfjørður
oyra1	gruset strandbred
oyra2	1øre,góð oyrugode ører, god hørelse;ring oyrudårlige ører, dårlig hørelse;lánael.læna e-m oyralåne nogen øre, lytte til nogen;lurta við hálvum oyralytte med et halvt øre;hava oyra við (e-m)høre efter nogen;berast e-m fyri oyrukomme nogen for øre;stinga e-m e-t í oyrafortælle en noget i hemmelighed;hava oyra fyri tónleikihave øre for musik;tað var komið fyri oyruni á teimumdet var kommet dem for øre;fyri alla manna oyrumi alles påhør;geva e-m ein undir oyraðgive en en lussing2øre(på gryde, krukke el.lign.)
oyra3	øre, 1 / 100 af en krone,har kom ein fátæk einkja og legði tveir smápeningar, sum er eitt oyraså kom der en fattig enke, som gav to småmønter af et par øres værdi;upp á oyraðhelt præcist;eg kann ikki siga tær upp á oyrað, hvussu nógv tú skyldarjeg kan ikke sige helt præcist, hvor meget du skylder
oyrabrósk	(biol.)ørebrusk
oyrafika	ørefigen, lussing
oyrahol	(biol.)øreåbning
oyraklaffur	øreklap, høreværn
oyralepi	øremusling, ydre øre
oyralippa	øreflip
oyralust	øregang
oyrarmaður	person iel.fra bygden Oyri
Oyrarsund	1Øresund2(ny bet.)Øresundskollegiet,tey búgva á Oyrarsundide bor på Øresundskollegiet
oyrasnippur	øreflip
oyratøppur	øresnegl
oyravaks	ørevoks
oyri	gruset strandbred
Oyri	bygd i Eysturoy,á / av Oyri,til Oyrar
oyrnabruni	(med.)ørebetændelse
oyrnadropar	(med.)øredråber(otoguttae)
oyrnagull	(bibl.)ørering
oyrnahol	(biol.)øreåbning
oyrnalepi	(biol.)øremusling, ydre øre
oyrnaleysur	1uden ører,Óli oyrnaleysi2døv,tey eru ikki oyrnaleysde er ikke døve
oyrnalippa	øreflip
oyrnalokkur	ørering, øreclips
oyrnalust	(biol.)øregang, øreåbning,kópur fær latið aftur bæði oyrnalustir og nasagluggar, tá ið hann kavaren sæl er i stand til at lukke både øregange og næsebor, når den dykker
oyrnalækni	(med.)ørelæge, otolog
oyrnaringur	ørering
oyrnarust	stykket omkring øret(af kvæghoved søndersavet til kogning)
oyrnasjúka	(med.)ørelidelse
oyrnastingir	(med.)ørepine
oyrnastong	stang som holder hjørnet på et vod åbent
oyrnastykki	stykket omkring øret(af kvæghoved søndersavet til kogning)
oyrnatræ	stang som holder hjørnet på et vod åbent
oyrnavaks	(med.)ørevoks
oyrnavágur	(med.)øreflåd
oyrnavernd	(med.)høreværn
oys	men dog,oys, hvat er hent?men dog, hvad er der sket?
oysa1	øse, øseske
oysa2	1øse, tømme,oysa bát(in)øse båden tom;oysa bát uppøse en båd tom(så den flyder igen);oysa uppúrøse op;jf.leggja uppúr;teir tóku at oysa, men einki batti - báturin sakkde begyndte at øse op, men intet hjalp, båden sank2øse (ned)(om regn),regnið oysti niðurdet styrtregnede;oysandi regnstyrtregn3overøse,oysa e-n undiroverøse nogen(fx med skældsord)4oysa útødsle bort;oysa út pengarødsle penge bort5(om heste)slå bagud,rossið oystihesten slog bagud6skænde,hon fór at oysa um óargaungarnarhun begyndte at skænde om ballademagerne
oysari	øse, øseske
oysing	øsning
oysregn	øsregn, styrtregn,í oysregni og stormii øsregn og storm
oysregna	øsregne, plaskregne, skylregne, styrtregne
o.ø.	fork. forog øðrum
