p	1(lingv.)konsonant2(lingv.)19. bogstav i det færøske alfabet (kaldes )
P	romersk taltegn for 400
pa	(barn.)skarn, snavs,gera palave bæ
padda	(zoo.)padde(Amphibia)
pað	bindevævshinde omkring musklerne(fascia)
Pakistan	Pakistan
pakistanari	pakistaner
pakistani	pakistaner
pakistanskur	pakistansk
pakk	(neds.)pak, rakkerpak
pakka	1pakke,pakka innindpakke,pakka gávu innpakke en gave ind;pakka niðurpakke ned;pakka samanpakke sammen,pakka upppakke op, pakke ud2pakka seg burturpakke sig, se at komme bort;pakka teg burtur!skrub af!3(datal.)komprimere, pakke,pakka teldutøkan tekstkomprimere en maskinlæsbar tekst
pakkaferð	færdigpakket rejse
pakkamjólk	mælk i kartoner
pakkapostur	(post.)pakkepost
pakkari	pakker
pakkhús	pakhus
pakki	pakke
pakking	pakning, indpakning
pakningur	pakning(fx i vandhane)
pakt	pagt
Palau	Palau
palaubúgvi	palauer
palauskur	palausk
palestini	palæstinenser
palestinskur	palæstinensisk
pallborð	panel,við pallborðiði panelet
pallborðsfundur	panelmøde
pallborðsorðaskifti	paneldiskussion
pallmynd	scenografi
pallseta	iscenesætte
pallseting	iscenesættelse
pallsmiður	scenograf
pallsmíð	scenografi
pallur	1bænk, sæde2(mindre) afsats el. hylde i en klippevæg3scene,standa á pallispille med i et skuespil4boreplatform
palmin	palmin
Panama	Panama
panamabúgvi	panamaner
panamaskur	panamansk
panda	(zoo.)panda(Ailuropoda melanoleuca)
panna1	pande, stegepande
panna2	pande(på mennesker og dyr)
pannubreyð	brød bagt på stegepande
pannuhola	(biol.)pandehule
pannuhvítur	(om dyr)med hvid blis i panden
pannukaka	pandekage
pannukøka	pandekage
pannukøkudeiggj	pandekagedej
pannukøkuhús	pandekagehus
pannumatur	mad tilberedt på pande
pansari	1(militær)panser, brynje, rustning2(militær)panser, pansring
pant	(jur.)pant,seta húsini í pantstille huset som pant;taka pant í húsinumtage pant i huset
panta	1(økon.)pantsætte2(økon.)pante, udpante,panta e-n fyri skattpante nogen for skat3(om heste)skide
pantari	(zoo.)panter(Panthera pardus)
pantifúti	(økon.)pantefoged
panting	udpantning
pantseta	(økon.)pantsætte
pantseting	pantsættelse
papp	pap
pappageykavakshattur	(bot.)papegøjevokshat(Hygrocybe psittacina)
pappageykur	(ornitol.)papegøje
pappeskja	papæske
pappír	1papir2dokument(er)
pappírsarbeiði	papirarbejde
pappírsbátur	papirbåd
pappírsblað	papirark
pappírsdukka	udklipsdukke
pappírsfiskur	(spøg.)papirfisk
pappírsfjas	papirnusseri
pappírsflagg	papirflag
pappírshandil	papirhandel
pappírskendur	papirsagtig
pappírsklemma	clips
pappírsklipp	udklip
pappírsknívur	papirkniv
pappírskurv	papirkurv
pappírslepi	papirlap
pappírsleypur	papirkurv
pappírsligur	1(om mennesker)tynd, svag, skrøbelig2(om genstande)skrøbelig, skør
pappírspeningur	papirpenge, seddelpenge
pappírspetti	papirlap
pappírsposi	papirpose
pappírsryggja	(bogb.)paperback;jf.fikkubók
pappírstunnur	papirtynd
paprika	paprika
papuabúgvi	papuaner
Papua Nýguinea	Papua Ny Guinea
papuiskur	papuansk
par	par,par um parparvis
para	parre, ordne parvis;para seg1opstille sig parvis,tey paraðu seg samande opstillede sig parvis2(om dyr)parre sig
parabil	(mat.)parabel
paradis	paradis
paradís	paradis, himmel,lakka paradíshoppe paradis
Paraguai	Paraguay
paraguaibúgvi	paraguayaner
paraguaiskur	paraguayansk
Paraguei	Paraguay
paragueibúgvi	paraguayaner
paragueiskur	paraguayansk
paralag	i ordforb. somgeva seg í paralag við (e-n),koma í paralag við (e-n)slutte sig til (nogen)
paralig	som danner et godt par,tey eru so paralig
pardansur	pardans
parhosa	lang ulden strømpe,í longum parhosum og við leypi á bakinum;hann var í parhosum uttan yvir buksunum
parisari	(talesp.)kondom, præservativ
parisarkunstur	i ordforb. somtað er eingin parisarkunsturdet er ingen stor kunst;tað er ikki tann parisarkunsturindet er (da) nemt nok
park	park
parka	parkere
parkera	parkere
parkering	parkering,parkering loyvdparkering tilladt;parkering bannaðparkering forbudt
parkeringarbásur	parkeringsbås
parkeringarpláss	parkeringsplads, p-plads
parkeringarvørður	parkeringsvagt, P-vagt
parking	parkering
parlag	vera í parlagleve i parforhold
parta	dele,teir hava partað tað sundurde har delt jorden i små stykker
partabræv	(økon.)aktie
partabrævamarknaður	aktiemarked,ein partabrævamarknaður verður settur á stovnet aktiemarked bliver iværksat
partaeigari	aktionær
partafelag	aktieselskab
partaflokkur	(pol.)politisk parti
partagjald	(økon.)afbetaling, ratebetaling
partagrind	hvalkød og spæk der fordeles mellem deltagerne i fangsten
partahvalur	den del af en dræbt flok grindehvaler som bliver delt ligeligt mellem distriktets befolkning
partalag	fællesskab, selskab,hann mátti altíð hava onkun uppi í partalagi við særhan måtte altid være sammen med nogen
partamaður	1partifælle2(kortspil)makker
partapeningur	aktiekapital
partapolitikkur	(pol.)partipolitik
partapolitiskur	partipolitisk
partasvíkur	en der svigter et fællesskab el. forening, skruebrækker, udbryder
parteigari	(økon.)aktionær
parthallur	subjektiv
parthavari	aktionær,parthavari í einum skipiaktionær i et skib
partískur	(talesp.)partisk
partleysur	objektiv
partloysi	objektivitet
partmongd	(mat.)delmængde
partna	i ordforb.á partnafor sig selv,hon helt seg á partnahun holdt sig for sig selv
partrol	(mar.)partrawl;jf.lemmatrol
partrola	(mar.)partrawle
partrolari	partrawler;jf.lemmatrolari
partroling	(mar.)partrawling
partsreiðari	partreder, medreder
partsreiðarí	partrederi
partsútvegari	underleverandør
parttíð	deltid,arbeiða parttíðarbejde på deltid
partur	1del, andel, part,fýra krónur í partfire kroner til hver;tveir partarto tredjedele;fyrra partinom formiddagen;seinna partinom eftermiddagen2andel i fangstel.andet udbytte,fáa / býta partfå / give andel;fáa í partfå som sin andel;partarnir vórðu ikki upptiknir(ved grindefangst, se upptikin)3ejendel,eiga part í bátieje del i en båd4folk med samme mening (om noget),partarnir á arbeiðsmarknaðinumarbejdsmarkedets parter;báðir partar eiga at viðurkenna taðbegge parter må erkende det;vera í parti við (e-m)være på ens side;sleppa upp í partblive regnet med;fara (geva seg) í part við (e-m)tilslutte sig, tage parti;taka sær aðrarel.betri partar fyritage sig sammen;taka sær góðar / ringar partar fyriopføre sig godt / dårligt;tað var betri parturindet ville være det bedste;fyri ein partfor en del, til en vis grad
partú	(talesp.)partout, absolut
partvísur	delvis,partvísur dagpeningurdelvise dagpenge;partvístdelvist
parykkur	paryk
pass	1pas2(kortspil)pas,melda passmelde pas3lille fiskeplads(især ved siden af en større)4i ordforb.tað er pass í lagi fyri tegdet har du godt af, det har du fortjent
passa1	1sømme, passe sig,tað passar mær ikki at komadet passer mig ikke at komme2passe, pleje,passa børnpasse børn;passa upp á e-nholde øje med nogen;passa uppá!pas på!3passe,skógvarnir passa vælde sko passer fint;eg passi ikki troyggjunatrøjen er for lille til mig4(om tøj, sko o.lign.)prøve,passa eina troyggjuprøve en trøje5passe, stemme,tað passardet stemmer
passa2	(kortspil)melde pas
passaligur	1passende, tilpas2med en temmelig stor rus på, pyntet, godt lakket til;-liga
passar	i ordforb.til passartilpas,vera væl / illa til passarvære godt / dårligt tilpas;illa til passarutilpas
passari	(mat.)passer
passmynd	pasfoto
passuligur	passende, tilpas
pasta1	pasta
pasta2	(med.)pasta
patent	patent
patriarkur	patriark
patrón	patron
pavnur	(skib.)fiskekasse
pá1	(barn.)ekskrementer,gera pálave pølser
pá2	på
pábót	forbedring, istandsættelse, reparation
páfinning	påfund, påhit
páfirvaldur	(zoo.)påfugleøje(Vanessa io)
páfuglur	(ornitol.)påfugl(Pavo cristatus)
Páll	personnavn,(talem.)tað er ikki oftari enn so, Páll fær røturdet gode får man sjældent
pálmagrein	palmegren
pálmaleygardagur	lørdagen før palmesøndag
pálmaolja	palmeolie
pálmapílur	(bot.)tofarvet pil(Salix phylicifolia)
pálmari	pilgrim
pálmasunnudagur	palmesøndag
pálmatræ	(bot.)palme
pálmi	(bot.)palme
pápabeiggi	farbror
pápabeiggjakona	tante, farbrors kone
pápaleysur	faderløs
pápasonur	fars egen søn, kæledægge
pápasystir	faster
pápi	far, fader
páradís	paradis
pásetligur	påståelig, stædig, rethaverisk
páskaaftan	påskeaften
páskaboðskapur	påskebudskab
páskadagur	påskedag,annar páskadaguranden påskedag
páskafrítíð	påskeferie
páskahald	påskefest
páskakvøld	påskedags aften
páskalamb	(bibl.)påskelam
páskalilja	(bot.)påskelilje(Narcissus pseudonarcissus)
páskamorgun	påskemorgen
páskaregg	påskeæg,rulla páskaregg(leg)(en leg 2. påskedag)
páskavika	påskeuge
páskir	(rel.)påske,halda páskirfejre, holde påske;á páskumtil påske;um páskirnarved påsketid
páskot	(talesp.)påskud
páskotraður	påtvunget
pástandur	(talesp.)påstand
pátriksmessa	17. marts
pátriksmessudagur	17. marts
pátrúgv	overtro;jf.fólkatrúgv
pátrúgvin	overtroisk
pávadømi	pavedømme
pávakirkja	pavekirke
pávaligur	pavelig
pávasetur	Vatikanet
pávastólur	pavestol(cathedra)
pávi	pave
pedalur	pedal
pegil	pægl
peglafløska	flaske der rummer en pægl
peglaglas	glas der rummer en pægl
peiga	pege
peiggja	1rage op,eingir steyrar stóðu og peiggjaðu á sýnunum2svinge(med stok, kniv el.lign.)
peika	pege,peika á e-nel.e-tpege på noget;peika e-m áudpege noget for nogen
peikipinnur	pegepind
peila	(skib.)pejle (bestemme retningel.vanddybde
peilari	(skib.)pejler
peiling	(skib.)pejling,(overf.)hava peiling av e-mhave anelse om noget
peis	pejs;jf.árnur
pelargonia	(bot.)pelargonie(Pelargonium)
peli	pæl
pelikánur	(ornitol.)pelikan(Pelecanidae)
pell	(barn.)1usandhed2løgner,eitt pellen løgnhals
pella	(barn.)lyve, tale usandt,eg pellaði fyri tærdet var ikke sandt, hvad jeg fortalte dig
pelur	pæl
pempa	rage til sig
penalarhús	(skole,talesp.)penalhus
pendul	(fys.)pendul
pengagrammur	pengebegærlig, pengegrisk
pengakassi	pengekasse
pengamaður	pengemand
pengaoyra	(barn.)mønt
pengapungur	pengepung, pung
pengar	penge,30 silvurpengartredive sølvpenge
pengaseðil	pengeseddel
pengaskáp	pengeskab
pengaspæl	pengespil
pengi	1mønt,gullpengarguldmønter;silvurpengarsølvmønter2penge,føroyskir pengarfærøske penge;fáa e-t fyri bíligan pengafå noget billigt;(ein) stórur pengien stor sum
peningafalsan	falskmøntneri
peningafalsari	falskmøntner
peningaflyting	pengeoverførsel
peningagirnd	pengegerrighed
peningagrammur	pengebegærlig, pengegrisk
peningagrískur	pengegrisk, pengebegærlig
peningajáttan	pengebevilling,peningajáttanin er nýttpengebevillingen er brugt
peningakassi	pengekasse
peningakærur	pengebegærlig
peningaleysur	som mangler penge, uden penge
peningaligur	finansiel, økonomisk;-liga,stuðla peningaligastøtte økonomisk
peningaloysi	pengeløshed
peninganeyð	pengetrang,vera í peninganeyðvære i pengenød
peninganýtsla	pengeforbrug
peninganøgd	pengemængde
peningasavning	pengeindsamling
peningaskuld	pengegæld
peningaspell	pengespild,tíðarspell og peningaspellspild af tid og penge
peningastovnur	pengeinstitut
peningastyrkur	finansiel støtte, økonomisk støtte
peningastøði	(økon.)møntfod
peningaupphædd	pengebeløb
peningavirði	pengeværdi
peningseind	møntenhed
peningsverk	i ordforb.ikki gera peningsverkikke gøre nytte for fem flade øre, ikke lave dagens gerning
peningsvirði	pengeværdi,tað er ikki peningsvirði í hesumdet er intet som helst værd
peningur	1(koll.)penge,nógvur peningurmange penge;hava (nógvan / lítlan) pening um hendurhave mange / få penge at råde over2mønt,gullpeningurguldmønt
penisillin	(med.)penicillin
penligur	1(ret) smuk, nydelig,ein penligur býuren ret smuk by2pæn, net, velopdragen,hann er ein penligur drongurhan er en pæn dreng;-liga,hann er so penliga vandurhan er så velopdragen
pennahúsi	penalhus
pennaskaft	penneskaft
pennasleikjari	(ironi)penneslikker
pennatekning	pennetegning
pennur	pen
pensil	pensel
pensjón	pension
pensjónistur	pensionist
pensla	pensle,også(med.
pensling	(med.)pensling
penta1	sting(til sammensyning af sår)
penta2	1hæfte løseligt(med tråd)2klinke (porcelænsskår) sammen3opdigte, lyve,penta eina søgu samanopdigte en historie;penta lygnir samanlyve
penur	1smuk, pæn,nú ert tú penur!(ironi)du er vel nok sød, hvad?2skikkelig, ordentlig, sømmelig
pera	1(bot.)pære2(elektr.)elektrisk pære
perikum	(bot.)perikum
peringur	perigæum
perla1	1perle;også(overf.)ein perla í føroyskum skaldskapien perle i færøsk digtning2fænghætte
perla2	perle,sveittin perlaði av honumsveden perlede af ham
perla3	(barn.)perle
perluband	perlebånd
perlublóma	(bot.)perlehyacintMuscari
perluleykur	(bot.)perleløg(Allium ampeloprasum)
perlumóðir	(zoo.)perlemor
perluportur	(bibl.)perleport
perluskel	(zoo.)perlemusling(Pteria)
perma	perm, bogbind
permumynd	omslagsbillede
persa	perse, presse
persi	perser
persilla	(bot.)persille(Petroselinum crispum)
persónbilur	personbil, bil
persóngerð	personifikation
persóngering	personifikation
persónleikaólag	personlighedsforstyrrelse
persónleiki	personlighed
persónleysur	(lingv.)upersonlig
persónligur	personlig,persónligt brævpersonligt brev;-liga,tosa við ein persónligasnakke personligt med en
persónlýsing	(litt.)personskildring
persónmenska	personlighed
persónsfornavn	(lingv.)personligt pronomen
persónssamband	(pol.)personalunion
persónstal	personnummer, CPR-nummer
persónur	person,også(lingv.
pertin	(om tøj)stram,buksurnar eru so pertnarbukserne er så stramme
Peru	Peru
peruari	peruaner el. peruvianer
perubúgvi	peruaner el. peruvianer
peruiskur	peruansk el. peruviansk
perutræ	(bot.)pæretræ(Pyrus communis)
peruvaksin	pæreformet
pest	(med.)pest,tað luktar sum pestindet lugter forfærdeligt;skýggja e-t sum pestinasky noget som pesten
pestaður	forpestet
pestfongdur	(med.)pestbefængt
pestur	pest
petrolium	petroleum
petroliumslampa	petroleumslampe
petroliumsovnur	petroleumsovn
petta	brække, rive el. skære i små stykker,petta sundurrive i stykker
petti	1(mindre) stykke,hon gekk tað pettið, ið eftir var oman til húshun gik det stykke, som var tilbage ned til huset;eitt petti av jørð(mindre) stykke jord;fara í petti(r)gå i stumper og stykker;vera í pettumvære sønderknust, være i små stykker;ikki petti(ð)ikke spor;eg veit ikki pettijeg ved intet;tað ger ikki pettidet gør ikke det mindste;hann er ikki petti svangurhan er slet ikke sulten2(neds.)bæst,hann er eitt ónæriligt pettihan er et uforskammet bæst
pi1	1det græske bogstav2(mat.)pi(ca. 22 / 7 el. 3,14)
pi2	let rus,eitt lítið pien let rus
piano	(musik)piano
piða	pille kød af ben,piða beinpille ben;piðaðurafpillet, radmager
pikk	1pik, (fugles) pikken2(leg)tagfat,spæla pikklege tagfat3uvilje, nag,fáa / hava eitt pikk til e-nnære uvilje mod nogen4hvørt nikk og pikkalt sit pik og pak
pikka	1(om fugle)pikke, give et let stød,pikka korn;pikka maðkarpille, opsamle orme2banke let på noget,pikka upp á dyrnarbanke på en dør;hann sat og pikkaði við fingrinum niður í borðiðhan sad og trommede med fingrene ned i bordet3(om ur)tikke4(leg)(i tagfat)fange,pikka e-nfange en5tað pikkar smáttdet går småt(fx med spisning og fiskeri),smátt (smáum) pikkar ádet går tilsyneladende småt,smátt pikkar íalt gør en forskel
pikkhamari	(håndv.)pikhammer, spidshammer
pikkulítil	ganske lille, lille bitte
pikkumæ	(barn.)spædlam
pilk	1pilleri2pilfinger
pilka	1pille,pilka rækjurpille rejer;pilka nøspille næse;pilka burturúrplukke, pille ud;pilka sundurpille fra hinanden;pilka viðfingerere,ikki pilka við!2(om fugl)pilka særplukke dun af sig (til rede)3pusle med noget,pilka við e-tpille ved noget;pilkast við ymisktpille ved forskelligt4pilke, fange med pilk
pilkandi	i ordforb.pilkandi rotinpilrådden
pilkur	pilk
pilkutur	1pilfingret2langsom, langsommelig, sendrægtig,hatta er so pilkut at fáast við;tú ert so pilkutur, tú verður ongantíð liðugur við hattadu arbejder så langsomt, at du bliver aldrig færdig med det
pillari	(med.)pille
pillbýttur	(vulg.)snydedum
pillsvakur	(vulg.)skrupskør
pillørur	(vulg.)pinegal
pilsnari	pilsner, pils
pilsnarøl	pilsner, pils
piltalið	(idr.)lilleputhold
piltur	lille dreng, lilleput
pimpa	pimpe
pimpsteinur	(geol.)pimpsten
pingvin	(ornitol.)pingvin
pinja	(bot.)pinje(Pinus pinea)
pink	lyserøde pletter på saltfisk forårsaget af bakterier(Pseudomonas salinaria og Sarcina littoralis)
pinka	1en lille pige2et lille væsen, en lille ting,baka eina pinkubage et lille brød
pinkalítil	ganske lille, lille bitte
pinkubarn	spædbarn
pinkulingur	lille bitte person, dværg
pinkulítil	ganske lille, lille bitte,ein pinkulítil løtaet ganske lille øjeblik
pinkur1	lille bitte person, dværg
pinkur2	lyserøde pletter på saltfisk forårsaget af bakterier
pinkutur	ganske lille
pinnabrenni	(talesp.)pindebrænde
pinnamatur	pindemad
pinnamynd	(mat.)pindediagram
pinnapakkaður	stopfuld, stopfyldt
pinnastillur	bomstille,sita pinnastillursidde bomstille
pinnastívur	så stiv som en pind
pinnaverk	pindeværk,hatta er sum pinnaverk
pinnpakkaður	stopfuld, stopfyldt
pinnstillur	bomstille
pinnstívur	så stiv som en pind
pinnur	1pind,(talem.)við pinn og skinnmed pik og pak;(talem.)standa sum pinnur í lortistå som ramt af lynet2(ur)viser,stóri pinnurden store viser;lítli pinnurden lille viser3tændstik
pipar	peber,ynskja e-n, har piparið grørønske nogen hen hvor peberet gror
piparfrukt	(bot.)peberfrugt
piparkorn	(bot.)peberkorn
piparkvørn	peberkværn;(talem.)muðurin gongur sum ein piparkvørnom en som snakker bestandig
piparkøka	ingefærkage
piparmoy	pebermø
piparmoyggj	pebermø
piparmylla	peberkværn,(talem.)sum ein piparmyllaom en som snakker bestandig
piparmynt	(bot.)pebermynte(Mentha piperita)
piparnøt	pebernød
piparrót	(bot.)peberrod(Armoracia rusticana)
piparsligur	jomfrunalsk, sippet
piparstertur	i ordforb. somsita á piparstertisidde som på nåle;komin á piparstertinhårdt trængt
piparsveinur	pebersvend
pipp	1(om fugle)pip2(talesp.)missa pippiðtabe modet
pippa1	(barn.)1fugleunge(fx kylling, ælling, gæsling)2lus3(barn.)pippurtæer
pippa2	(om en fugleunge)pippe
pippari	bipper
pippur	(barn.)pipfugl
pippus	(ornitol.)(betegnelse for) vagtel
pipra1	bæve, ryste, skælve,hendurnar pipraðuhænderne rystede;við piprandi hjartamed bævende hjerte;piprast av ræðsluskælve af rædsel
pipra2	pebre
pipran	bæven, rysten, skælven,ein pipran fór ígjøgnum kroppinen bæven gik igennem kroppen
piprilsi	bæven, rysten, skælven,fáa piprilsi av e-mkomme til at ryste af noget;piprilsi kom á hannhan kom til at ryste
piprutur	rystet, chokeret
pirikum	(bot.)perikum(Hypericum),fýrstrent pirikumkantet perikon(H. maculatum),fagurlitt pirikumsmuk perikon(H. pulchrum)
pirikumsætt	(bot.)perikonfamilien(Hypericaceae)
pirk	lille sår, mindre hudafskrabning
pirka3	pille, pirke, pusle,hann gekk og pirkaði undir bløðkurnar við eini kvísl
pirr	let rus,hann hevði eitt lítið pirrhan havde en lille fjer på
pirra	1(med.)filipens, bums2ganske lille (ung) ørred el. forel
pirruskotin	bumset
pirrutur	bumset
pirtl	1(let) skramme, (let) hudafskrabning2let rus, fjer
pirur	pier
pisa	1(ornitol.)unge af visse søfugle(fx lunde, tejst),hava pisuholde en tam søfugleunge i bur2rus, nybagt student3lommelærke
piss	pis
pissa	pisse, tisse,pissa undir seg (um náttina)gøre sengen våd;pissa í buks(urnar)tisse i bukserne;hann hevur ikki pissað í sjógvhan har aldrig været til fiskeri
pissari	1(spøg.)tissemand, penis2(talesp.)sprinkler
pisshús	pissoir
pissiboppa	(barn.)tissemand, penis
pissilingur	(barn.)tissemand, penis
pistól	pistol
pisuár	rusår
pisubúr	bur til søfugleunge
pisuhús	lille hus til tam søfugleunge
pisuligur	spinkel,hon var kløn og pisulighun var tynd og spinkel
pisurøða	rustale
pisuveitsla	rusfest
pitsa	pizza
pittur	(eufem.)penis
pík	pig, spids(særlig på stav)
píka1	sætte pigge i dæk,hevur tú píkað hasi dekkini?har du sat pigge i dækkene?
píka2	(eufem.)for søren
píkadekk	pigdæk
píkaretinar	for søren
píkarill	for søren
píkarillinar	for søren
píkarstavur	pigstav
píkasjey	for søren,píkasjey, sum tað var kaltfor søren som det var koldt
píkatráður	pigtråd
píkhælur	stilethæl
píkur	pig, spids(særlig på stav)
píl	pil(til bue)
pílagrímsferð	pilgrimsrejse, valfart
pílagrímur	pilgrim
pílahúsi	pilekogger, kogger
pílaspæl	pilespil, dart, dartspil,spæla pílaspælspille dart;jf.dart
pílatræ	(bot.)piletræ
pílaætt	(bot.)pilefamilien(Salicaceae)
pílgrímur	pilgrim
pílika	stikirendpige
pílikur	stikirenddreng
píllareising	(husbyg.)spids tagrejsning
píllhúgva	strikket tophue
pílltak	spidstag
píllur	spids,(talem.)fara av píllinumgå fallit
pílur1	(bot.)piletræ(Salix),arktiskur pílurarktisk pil(S. arctica)
pílur2	pil(til bue),hann fór sum ein pílur avstaðhan styrtede af sted;(eufem.)pílar og skotspilleme
pína1	1pine, smerte,hava pínuføle smerte;tola pínutåle smerte2(bot.)strengetang(Chorda filum)
pína2	1pine, plage, martre,pína dýrpine dyr;tað pínir megdet piner mig2tað pínir burtur úrtøjet bliver tørt når frosten forsvinder ud af det
pína3	bande, sværge
pína4	(eufem.)pinedød,á pína!åh pinedød!;pína, tað var stuttligtpinedød det var morsomt
pínadont	(eufem.)pinedød
pínadoyð	pinedød
pínegg	usædvanlig lille æg
píning	pinsel, tortur
píningur	1noget lilleel.småt1svækling2afkræftet får3usædvanlig lille æg2kold og tør vind,har sprettur ikki strá í hesum píninginum
pínsla	pinsel, pine, lidelse, smerte,helvitis pínslurhelvedes pinsler;ofta má lív hennara hava verið ein pínslaofte må hendes liv have været en pine
pínslaður	(rel.)pint,pínslaður undir Pontiusi Pilatusipint under Pontius Pilatus
pínslarváttur	(rel.)martyr
pínsling	pinsel, pine, lidelse
pínslustaður	pinested
pínslusøga	(bibl.)lidelseshistorie,pínslusøga JesusarJesu lidelseshistorie
pínudoyvandi	(med.)smertestillende
pínufullur	pinefuld, smertefuld
pínuleysur	smertefri
pínuloysi	uden smerte
pínumikil	pinefuld, smertefuld
pínusamur	pinefuld
pínustaður	(bibl.)pinested
pínustillandi	(med.)smertestillende
pínutablett	(med.)smertestillende tablet
pínuverkir	(med.)falske veer, plukveer, småveer(labores praesagientes)
pípa1	1pibe, rør2pibe, tobakspibe,festa í píputænde piben;fáa sær upp í pípunafylde piben med tobak;stinga pípunastoppe piben med tobak;hann kølir ikki pípunahan ryger meget3bøsseløb, geværpibe4(musik)pibe, fløjte5pípur1rynker2pibe,pípukragipibekrave6(bot.)rør(del af sambladet blomsterkrone)
pípa2	pibe, hvine, skrige,pípa og nístahyle og skrige
pípa3	rynke(tøj med rynkebånd),við eini pípaðari blondu framman
pípan	piben, hvinen, skrigen,pípan og nístanhyl og skrig
pípari	(musik)en som spiller på fx sækkepibe
pípil	(kem.)pipette
pípla	(kem.)pipettere
pípubressa	(zoo.)kompost-svirreflue(Syritta pipiens)
pípuheysur	pibehoved
pípuhólkur	pibering
pípuhøvd	pibehoved
pípukragi	pibekrave;jf.prestakragi
pípulangur	med langt bøsseløb,ein pípulong riflaen riffel med langt bøsseløb
pípuleggur	piberør, rør på (tobaks)pibe
pípuleykur	(bot.)pibeløg
pípulykil	hulnøgle, rørnøgle(med hul nøglepibe)
pípuopari	pibekradser, pibeskraber
pípuorgul	(musik)pibeorgel
pípureinsari	piberenser
pípuroyking	piberygning
pípuroykur	piberøg
pípustokkur	pibefoderal
píputubbak	pibetobak
pípuurga	(musik)pibeorgel
pípuvaksin	(bot.)pibet,pípuvaksin krúnasambladet (blomster)krone
píra	være (for) sparsommelig, være karrig med noget,har mundi verða pírtder blev nok sparet på alting;hann pírir ikkihan er ødsel
pírin	nærig
pírni	nærighed
písk	lille rus, fjer,hann hevði eitt pískhan havde en fjer på
píska1	1(om fugl)pille, ordne sine fjer med næbbet,hønan pískar særhønen ordner sine fjer med næbbet2(uafladelig) tirre, drille(ved lette slag, med ord),píska e-n (við e-m)drille nogen (med noget)3tage småbidder af noget,píska burtur av e-m4rapse, småstjæle,argur at pískaslem at rapse
píska2	piske,píska rómapiske fløde
píska3	piske
pískari	mikser
pískirómi	piskefløde
pískur	pisk
pískutur	tyvagtig, langfingret
pístr	1vedholdende kold blæst2pust
pístra	1blæse, puste,pístra við eldinfå ilden til at flamme ved at puste, vifte til den2puste,seta seg niður at pístra eitt sindursætte sig ned for at puste lidt
pístran	vedholdende kold blæst,tað er sovorðin pístrander er en sådan vedholdende kold blæst
pístur	vedholdende kold blæst,ein pístur av eystrivedholdende kold blæst fra øst
písturtonn	taptand
pjak	1pusleri,sum hann liggur, hoyrir hann pjakmens han ligger, hører han noget der pusler2smøl, smøleri3smøl,hann er eitt pjakhan er et smøl
pjaka	1pusle,pjakast við e-tpusle med, sysle med, være beskæftiget med (noget);onkur pjakast við at skefta sær nýtt grev upp á hakafótin;nakrar mýs pjakaðust í einum skýmligum króki2smøle,pjaka særvære omstændelig,tað var einki at pjaka sær viðdet var ikke noget at trække i langdrag
pjakan	pusleri
pjakutur	langsom (med hensyn til udførelsen af noget), sendrægtig
pjankast	pusle med,hvat pjankast tú við?hvad pusler du med?
pjága	arbejde langsomt el. kludre med noget,statt ikki og pjága!stå ikke og drys med det der!
pjátra	pludre, snakke venligt el. moderligt
pjátran	pludren,tað var ein stákan og pjátran
pjátur	pludren, snak
pjøgga	reparere (tøj),pjøgga um
pjøka	1pusle om,pjøka umhæge om, vise omhu for;pjøka og hugla um grøðinahæge om afgrøden;menninir royndu at pjøka um konufólkinimændene forsøgte at pusle om kvinderne2samle sine ting sammen,hon pjøkaði saman í eskju og fór síðan av húsum;pjøka seg ítage (tøj) på
pjøki	bylt
pjøkin	påpasselig, omhyggelig,vera pjøkin umpasse godt på;hann var sera pjøkin um henda báthan passede meget godt på båden
pjøkni	påpasselighed, omhu
pjøkur	bylt
pjøpp	1pjat, sludder, vrøvl2pjattehoved, vrøvlehoved
pjøskutur	uordentlig påklædt
pjøssa	1flikke,tað nyttar so lítið at pjøssa upp á tað, ið gamalt erdet hjælper så lidt at flikke på det, som er gammelt2tage unødvendig meget tøj på for at skærme sig imod kulde el. regn,hon var so pjøssað til
pjøssutur	uordentlig påklædt
plaga	pleje, have for skik, være vant til
plagg	klædningsstykke, beklædningsgenstand, stykke tøj
plaggdúkur	tøj, stof
plakát	plakat
planki	planke
plankton	(zoo.)plankton
planta1	(bot.)plante
planta2	plante, beplante
planting	plantning
plantuátin	planteædende
plantufiti	plantefedt
plantufrøði	(bot.)botanik
plantufrøðiligur	(bot.)botanisk
plantufrøðingur	(bot.)botaniker
plantuføði	planteføde
plantulæra	(bot.)1botanik2lærebog i botanik
plantuolja	planteolie
plantuplankton	(bot.)planteplankton
planturíki	planturíkiðplanteriget
plantusamfelag	(bot.)plantesamfund
planur	plan,eftir planinum skuldi arbeiðið verið liðugt núefter planen skulle arbejdet være færdigt nu
plast	(kem.)plastic, plastik,beriposar úr plastiplasticbæreposer, bæreposer af plastic
plasta	binde ind i plastic,plasta bøkurbinde bøger ind i plastic
plastbátur	plasticbåd, plastbåd
plasting	det at binde (fx bøger) ind i plastic
plastposi	plasticpose el. plastikpose, plastpose
platin	(kem.)platin
platonskur	platonisk,platonskur kærleikiplatonisk kærlighed
plattur1	palle
plattur2	i ordforb. somtann platta lognfuldkommen rolig sø, havblik
plága1	plage,giktin er hervilig plágagigt er en skrækkelig plage
plága2	plage, pine,ikki plága meg meira!ikke plage mig mere!
plágari	plageånd
plágumikil	trættende, anstrengende,mínir dagar eru plágumiklir og møðsamirmine dage er anstrengende og besværlige
pláss	1sted,rókin er eitt ógvuliga ringt pláss at koma til2plads,tey hava stórtel.gott plássde har et stort hus;vit hava lítið plássvi har lidt plads;tað er ikki pláss fyri tíder er ikke plads til det;tað er gott plássder er god plads3plads,dagstovnurin hevur 40 plássdaginstitutionen har 40 pladser;trý pláss eru tøk á ellisheiminumder er tre ledige pladser på alderdomshjemmet4(sidde)plads,enn eru nøkur pláss eftir(til framførslu el.tíl.)5hjemsted, bopæl, bygd, by,hann var ættaður haðan av plássinum6klasse(fx i flyvemaskine, tog),fyrsta plássførste klasse;annað plássanden klasse7plads, arbejde, stilling,hon fekk pláss á skrivstovuhun fik arbejde på et kontor
plásstrot	pladsmangel
plástur	(med.)plaster
pláta	1plade2grammofonplade3nummerplade,løgreglan tók pláturnar av bilinumpolitiet klippede nummerpladerne af bilen
plátuhúsi	pladeomslag, cover
plátusavn	(musik)diskotek
plátuspælari	pladespiller
plátuvendari	pladevender, discjockey
plátuvond	(geol.)pladetektonik
plettur	plet
pleyra	vade,pleyra gjøgnum evju
pleyrur	stor og klodset fod,eg dragi burtur av pleyrunum og fari berbeinaður inn í køkinjeg tager støvlerne af og går ind i køkkenet på bare ben;hann hevði fingið runu upp á pleyrarnar á særhan havde fået mudder på fødderne
pli	1lille mågeunge2mågeunges skrig
plia	1(om måge)sige "pli",uttan fyri húsini stóð ein skurapisa og pliaði2pusle (og småsnakke) med,plia fyri (el.uppi yvir) e-mtale kærligt til(et barn, en kalv etc.),fuglur pliar uppi yvir ungunum;hann pliaði fyri hundinumhan hægede om hunden;plia fyri smábarni, kálvio.lign.hæge om lille barn, kalv o.lign.3se venligt på, hykle for, smigre for at få noget,plia upp á e-n;plia upp í eyguni á e-mse blidt på en for at få noget af ham4(om spædbarn)pludre,barnið liggur og pliarbarnet ligger og pludrer
plikt	pligt
plikta	forpligte,plikta seg (til e-t)forpligte sig til noget
pliktigur	pligtig,pliktigur til at gera e-tpligtig til at gøre noget
plinki	(meget) lille fiskeplads(ofte tæt ved land)
plinkur	(meget) lille fiskeplads(ofte tæt ved land)
plintur	(idr.)plint,lop um plintspring over plint
plógbein	(biol.)plovskærben(vomer)
plógbonkur	(håndv.)høvlebænk
plógfoyra	1(håndv.)not2(landbr.)plovfure
plóghøvil	(håndv.)plovhøvl
plógjarn	(landbr.)plovjern,brýna plógjørnini
plógkambur	(håndv.)fer, fjeder
plógmaður	(landbr.)plovmand
plógross	(landbr.)plovhest
plógryssa	(håndv.)høvlebænk
plógtonn	(håndv.)jern i en plovhøvl
plógv1	(landbr.)plov(til jordpløjning)
plógv2	1(håndv.)plovhøvl2(håndv.)falsen(e) i et bræt3(landbr.)plov(til jordpløjning)
plukka	plukke, afplukke, afrykke
plukkfiskur	plukfisk
plukkufuglur	nar, tåbe, abekat,vera plukkufuglur millum fólkvære til grin for folk
plumba	(odont.)plombe, tandfyldning
pluss1	1(mat.)plus2fordel,tað er eitt pluss at duga nógv máldet er et stort plus at kunne flere sprog;jf.minus 1
pluss2	(mat.)1plus, og,tvey pluss trý er fimm (2 + 3 = 5)to plus tre er fem2plus(udtryk for at en værdi er over nul)pluss fýra stigplus fire grader;jf.minus 2
plusspólur	(fys.)pluspol
Pluto	(astronomi)Pluto
plúsin	ophovnet og rød,plúsin í andlitinumophovnet og rød i ansigtet
plúss	plys
pløga	1(håndv.)skære fals i, false, tilskære med plovhøvl2(landbr.)pløje3sejle,pløga haviðsejle havet
pløging	pløjning(også snedk.)
poesiur	(litt.)poesi, lyrik
pokari	ildrager
pokna	lille hul, pore,húðin andar gjøgnum poknurnarhuden ånder gennem porerne;hon kendi kuldan í hvørjari poknuhun følte kulde i hver en pore
poknueyga	lille hulel.hule i fuglefjeld hvor en fugl kan holde til og lægge æg
poknutinna	(geol.)poreudfyldning
poknutur	1småhullet, porøs,poknutur steinuren porøs sten;moldin er ikki føst og tøtt, men poknutjorden er ikke fast og tæt, men porøs2(med.)koparret el. koppearret,poknutur í andlitikoparret i ansigtet
poks	(med.)kønssygdom(spec. syfilis)
pokur	(med.)(sygdommen) kopper(variola),tá ið pokurnar ginguda kopperne grasserede
pokuskotin	(med.)koparret el. koppearret,hansara pokuskotna andlithans koparret ansigt
pokutur	(med.)koparret el. koppearret
politi	politi
politibilur	politibil, patruljevogn, salatfad
politikari	politiker
politikkur	(pol.)politik,málpolitikkursprogpolitik
politimaður	politimand, politibetjent, betjent
politimeistari	politimester
politiskur	politisk,politiskir flokkarpolitiske partier
politistur	politibetjent, politimand
politistøð	politistation
polka	polka,dansa polkadanse polka
polladunna	(ornitol.)odinshane
pollamjørki	lavtliggende tåge
pollur	nor,tvørtur um víkina gongur eitt riv, innan fyri er bládjúpur pollur
polstra	polstre,polstra sofupolstre en sofa
poppbólkur	(musik)popgruppe
poppil	(bot.)poppel
poppkorn	popcorn el. popkorn
popporkestur	(musik)popgruppe
popptónleikur	popmusik
poppur	(musik)pop
Porkeri	(stedn.)bygd i Suðuroy,í / úr Porkeri,til Porkeris
porkerningur	person iel.fra bygden Porkeri
portari1	porter
portari2	portner, portier
Portugal	Portugal
portugalskur	portugisisk
portugisari	portugiser
portugisi	portugiser
portugisiskur	portugisisk
portur	1port2låge3(datal.)portal
porturshválv	porthvælving
portvín	portvin
posabak	i ordforb.bera (e-n) posabakbære (en) på ryggen
posaband	sækkebånd
posadýr	(zoo.)pungdyr(Marsupialia),kengura er posadýrkænguruen er et pungdyr
posakelkur	den nederste del (indvendig) af pose
posakjaftur	åbning på poseel.sæk,hann roynir at halda posakjaftin sundurhan prøver at holde posen / sækken åben
posakloddi	sækketrævl, en sølle sæk
posalørift	sækkelærred
posamatur	mad erhvervet ved tiggeri;(ordsp.)ódrúgvur er posamaturel.posamatur er ódrúgvurdet der kommer let, går let
posapjøki	bylt
posarenning	(idr.)sækkeløb
posaspjørr	las af en sæk
posatroyggja	sweater
posi	1pose, sæk,(talem.)loysa frá posanumsnakke lige el. rent ud af posen;tit áttu at verið koyrdir í ein posaI er alle lige slemme2(mar.)sæk(på trawl)
positivur	(ogsåmed.,mat.,fys.)positiv
posta	poste, frankere
postalín	porcelæn
postalínsblóma	(bot.)porcelænsblomst(Saxifraga umbrosa)
postalínsjørð	(geol.)porcelænsjord
postalínsmáling	porcelænsmaling
postavgreiðsla	(post.)postekspedition
postávísing	(post.)postanvisning
postbátur	(post.)postbåd
postberi	(post.)postbud
postbilur	(post.)postbil
postboð	(post.)postbud
postboks	(post.)postboks
postei	postej
postfar	(post.)postskib, postbåd
postferð	(post.)posttur,postferðirnar vóru ótættar tá í tíðinider var langt mellem postturene dengang
postflutningur	(post.)posttransport
postførari	(post.)postfører
postgiro	(post.)postgiro
postgjald	(post.)porto
posthús	(post.)posthus
postkassi	(post.)postkasse
postkort	(post.)postkort
postkrav	(post.)postopkrævning
postlúka	(post.)brevsprække
postmaður	(post.)postmand, postbud
postmál	(post.)postsag
postmeistari	(post.)postmester
postnummar	postnummer,Tórshavn hevur postnummar 100Tórshavn har postnummer 100
postpakki	(post.)postpakke
postriva	(post.)brevsprække
postrúm	(post.)postboks
postsekkur	(post.)postsæk
postsending	(post.)postforsendelse
postsmoga	(post.)postboks
poststempla	(post.)poststemple
poststempul	(post.)poststempel
postur	1post,senda bræv við postinumsende et brev med posten;fáa postfå post2postbud, postmand3postbåd,nógv ferðafólk kom við postinum í morgunmange rejsende kom med postbåden her til morgen4post,almannamál er ein stórur postur á fíggjarlóginisocialt anliggende er en stor post på finansloven
postútbering	postombæring
postverk	postvæsen,Postverk FøroyaFærøernes postvæsen
pot	1stikken, ragen2(ny bet.)stikprøve
pota	stikke, rage,pota e-t í jørðinastikke noget i jorden;pota epli niðurlægge kartofler;pota tennel.burtur úr tonnumstange tænder;pota niður í e-nindprente nogen noget
potensur	potens
pottabrot	potteskår
pottadeyvur	stokdøv,hann er so pottadeyvurhan er så stokdøv
pottadulur	stokdøv
pottafløska	literflaske
pottafør	(om ko)som ikke malker mere end en liter
pottalok	grydelåg,hendurnar vóru sum pottalokhænderne var meget store
pottaløgur	vand hvori kød el. fisk koges (el.er kogt)
pottamakari	pottemager
pottamál	litermål
pottari	(bibl.)pottemager
pottbúgvin	(om mad)grydeklar
pottur	gryde,halda pottinfiske til husbehov;fáa sær pottin á reiggjel.loftfange så mange fisk at det bliver til et måltid;(sum) í pottinum(om grindeflok)så godt som fanget;(talem.,spøg.)fara undir pottblive gift (hjemme);(deyvur, dulur) sum potturinstokdøv,(talem.)nú má pottur standa (el.vera) sum pottur er setturder er ingen vej tilbage
pottøska	(kem.)potaske
pólalýsi	(astronomi)polarlys
pólfari	polarforsker
pólferð	polarekspedition
pólhav	(geogr.)polarhav, ishav
pólísur	polaris
pólkringur	(geogr.)polarkreds, polarcirkel
Pólland	Polen
póllendingur	polak
póllendskur	polsk
pólskur	polsk,pólsktpolsk sprog
pólur	1(geogr.)pol,norðurpólurnordpol;suðurpólursydpol2(fys.)pol
póløki	polaregn
p-pillari	p-pille
prál	pral, praleri
prála	prale
prálari	praler, pralhals, pralhans, blærerøv
prámur	1pram,ráevni og vøra verða flutt við prámum eftir áunumråstof og varer bliver fragtet med pram ad floderne2(båd.)lille træbåd3(spøg.)stor fod
prát	snak, passiar,fáa sær eitt prát við e-nfå sig en snak med nogen;prátið var óført við borðinisnakken gik livligt ved bordene
práta	snakke, passiare,sita og prátasidde og snakke
prátan	snak
prátari	snakkehoved, snakkemaskine,ein sovorðin prátarisikken et snakkehoved
prátingarhugur	snakkelyst
prátingarsamur	snaksom, snakkesalig
prátmikil	snaksom, snakkesalig
prátríkur	snaksom, snakkesalig
prátsemi	snaksomhed
prátutur	snaksom, snakkesalig
prei	1(mar.)praj,skipið kemur upp á preiskibet kommer på prajehold2(talesp.)praj, vink, påmindelse,geva e-m eitt prei (um e-t)give en et praj om noget
preia	1(mar.)praje, råbe an,vit preiaðu eitt skip, sum kom framviðvi prajede et forbipasserende skib2(overf.)kalde på (nogen),dreingirnir preiaðu nakrar genturdrengene kaldte på nogle piger
premia	præmie
prent	(typogr.)tryk,seta upp á prenttrykke
prenta	1(typogr.)trykke,prenta bøkurtrykke bøger2(overf.)indprente,prenta inn í børniniindprente børnene3(datal.)printe, udskrive,prenta eitt skjal (út)printe et dokument ud
prentari	1(typogr.)trykker, bogtrykker, typograf2(datal.)printer,geislaprentarilaserprinter;nálaprentarimatrixprinter
prentbúni	(typogr.)tryk,vakur prentbúnismukt tryk
prentfrælsi	trykkefrihed;jf.skrivifrælsi
prentgerð	(typogr.)layout
prenting	(typogr.)trykning,bókin er farin til prentingarbogen er gået i trykken
prentligur	(typogr.)typografisk;-liga
prentlist	(typogr.)bogtrykkerkunst, typografi
prentlutur	tryksag
prentlýti	(typogr.)(lille) trykfejl
prentmiðil	(typogr.)trykt (masse)medium(avis, tidsskrift o.lign.);jf.loftmiðil
prentmót	(typogr.)kliché
prentmynd	(typogr.)kliché
prentsmiðja	(typogr.)trykkeri
prentsnið	trykform
prentstaður	(typogr.)trykkested
prentstavur	(typogr.)type(i trykkeri)
prentsverta	(typogr.)tryksværte
prentverk	(typogr.)trykkemaskine, trykpresse
prentvilla	trykfejl
presending	presenning
press	1pressefold,pressið í buksunumpressefolden i bukserne2tryk, pres
pressa1	1presse,pressanpressen;tann fría pressanden frie presse;fáa góða umrøðu í pressunifå god omtale i pressen2trykpresse,blaðið var liðugt at fara í pressunaavisen var færdig til trykning
pressa2	presse,pressa klæðipresse tøj
pressari	knag,ein ordans pressarien rigtig knag
pressing	presning
pressuger	gær
prestafólk	præst og præstefrue
prestafrúa	præstefrue
prestagarður	præstegård
prestagjald	præstegæld, pastorat
prestajørð	præstegårdsjord
prestakall	præstekald
prestakamar	værelse hvor præsten logerer
prestakjóli	(kirk.)præstekjole, præstedragt
prestakona	præstekone
prestakragi	præstekrave
prestaligur	præstelig,tað var nógv prestaligt við honum
prestaloysi	præstemangel,prestaloysi var í fimm árpræsteembedet stod ubesat i fem år
prestaskapur	(koll.)præsteskab, præstestand, gejstlighed
prestastevna	(kirk.)præstemøde
prestbygd	bygd hvor præsten bor
prestfólk	præst og præstefrue
presthagi	(landbr.)præstegårdsjord i udmarken,dalarnir fyri norðan lógu undir presthaganum
presthús	præstebolig
prestinna	(rel.)præstinde, gydje
prestjørð	(landbr.)præstegårdsjord
prestkona	præstekone
prestloysi	præstemangel
prestlærdur	med præsteuddannelse
prestmaður	(spøg.)præst
prestsonur	præstesøn
prestur	(kirk.)præst,(talem.)lesa / skriva sum ein presturvære dygtig til at læse / skrive;lesa fyri prestigå til præst;fáa prestsins hond á høvdiðblive konfirmeret
prestvíga	(kirk.)præstevie
prestvígsla	(kirk.)præstevielse
pretin	1stolt, vigtig,hann var bæði pretin og stolturhan var både vigtig og stolt2meget smukt påklædt,tú situr so prúð og pretin fyri mær
pretna	kvikke (op), komme sig, live op,pretna uppel.pretnast;tá ið hann hevði etið, pretnaði hann uppda han havde spist, kvikkedes han op;so við og við pretnaðist hannlidt efter lidt kom han sig
priði	nål el.lign.,hann rendi ein priða í holdið á honum
prik	1stik med nål;(overf.)geva e-m eitt prikprikke til nogen2lille rus,hann hevði eitt lítið prikhan var let beruset
prika	1prikke, stikke,prika seg av eini nálstikke sig på en nål;prika hol á e-tstikke hul i noget;prika fliðurstikke albueskæl løse2(kortspil,spøg.)sætte en mindre trumf på3prikke, give stikpiller
prikka	prikke,prikka eina linjustiple en linje
prikkastrika	stiplet linje
prikkur	prik
prikkutur	prikket
prilla	drille
primtal	(mat.)primtal
primus	primus, primusapparat
prinsa	(talesp.)prinsa særgøre sig det mageligt,tú hevur ligið og prinsað tær í tríggjar dagardu har ligget og gjort dig det mageligt i tre dage
prinsessa	prinsesse
prinsur	prins
pripni	fornærmethed, nag
pripp	fornærmethed, nag,fáael.hava pripp (til e-n)bære nag (til en);pripp kom í hannhan blev fornærmet
prippin	nærtagende
prisma	1(fys.)prisme, optisk prisme2(mat.)prisme
pritla	drille
privatbilur	privatbil
privatlív	privatliv
privatskúli	(skole)privatskole,mods.kommunuskúli
privatur	privat
príla	1klippe(hests mankeel.hale)2studse (skæg),hann prílaði skeggiðhan studsede skægget
prílmánaður	(talesp.)aprilmåned
prílur	(talesp.)prílurinaprilmåned
prís	(bibl.)pris, lov, berømmelse
prísa	1prise, lovprise, love, berømme,prísa e-mlovprise nogen;prísa Gudiprise Gud;Gud, vit prísa og takka tærGud, vi lovpriser og takker dig2prismærke
prísan	lovprisning
prísansari	(økon.)priskontrollør
prísansing	(økon.)priskontrol
prísáseting	(økon.)prisansættelse
príseftiransing	(økon.)priskontrol, priskontrolforanstaltning
príseftirlit	(økon.)priskontrol
príshækkan	(økon.)prisstigning
prísískoyti	pristilskud
príslag	(økon.)prislag, prisniveau,príslagið hækkaðiprisniveauet steg
príslega	(økon.)prislag, prisniveau,høg / lág príslegahøjt / lavt prisniveau
prísliga	prismæssig
príslisti	prisliste, katalog
príslækkan	(økon.)prisfald
prísmerkja	prismærke,prísmerktar vørurprismærkede varer
prísmunur	prisforskel
prísráð	(økon.)pristilsyn,senda kæru til prísráðiðsende en klage til pristilsynet
príssteðgur	(økon.)prisstop;jf.vinningssteðgur
prístal	(økon.)pristal
prístalsviðbót	(økon.)pristalstillæg
prístalsviðgera	(økon.)pristalsregulere
prístalsviðgerð	pristalsregulering
prísur	1pris,fáa góðan / ringan prís (fyri vøru)få god / dårlig pris (for en vare)2berømmelse
prísviðbót	(økon.)pristilskud
professari	(skole)professor
profetera	(bibl.)profetere
profetur	(bibl.)profet
promilla	1(mat.)promille, tusindedel2promille, spirituspromille
proppa	proppe,proppa seg (við e-m)proppe sig med mad
propptrekkjari	proptrækker
proppur	1prop,fløskan er í proppinflasken er fuld til proppen2en korpulent person
props	props
prosa	(litt.)prosa
prosahøvundur	prosaist, prosaforfatter,hann er frálíkur prosahøvundurhan er en fremragende prosaist
prosayrking	(litt.)prosadigtning
prosent	(mat.)procent,fólkatalið vaks 5% í tíðarskeiðinumfolketallet steg med 5% i perioden
prosentpartur	procentdel
protein	(kem.)protein
protestantiskur	(rel.)protestantisk
protestantisma	(rel.)protestantisme
protestantur	(rel.)protestant
proton	(fys.)proton
proviantur	(mar.)proviant
prógv	1bevis,bera prógv umvære bevis for, vidne om;útsjónd hansara bar prógv um arbeiðssemihans udseende vidnede om arbejdsomhed2eksamensbevis,prógv í gudfrøðieksamensbevis i teologi;til lukku við próvnumtillykke med eksamensbeviset3eksamen,fara upp til prógvgå op til eksamen;fáael.taka prógvfå el. tage eksamen
prógva	bevidne, bevise,prógva, at e-t er sattbevise at noget er sandt
prónshøvd	knappenålshoved
prónur	nipsenål
próstadømi	(kirk.)provsti,Føroyar eru eitt próstadømiFærøerne er et provsti
próstagarður	provstegård
próstarættur	(kirk.)provsteret
próstur	(kirk.)provst
próvbók	(skole)eksamensprotokol
próvbræv	(skole)eksamensbevis
próvbyrði	bevisbyrde,próvbyrðan liggur á ákæranumbevisbyrden påhviler anklageren
próvdómari	(skole)censor
próvdøma	(skole)censurere
próvdøming	(skole)censur
próvfastur	bevislig,próvfast var, at drongurin hevði stoliðdet var bevisligt, at drengen havde stjålet
próvføra	belægge, bevise
próvførsla	bevisførelse
próvgrund	bevisgrund, argument,geva haldgóðar próvgrundir fyri e-mgive velunderbyggede argumenter for noget
próvlestur	(skole)eksamenslæsning
próvleysur	(skole)1eksamensfri,próvleys lærugreineksamensfrit fag2uden eksamen
próvnám	(univ.)eksamensstudium
próvroynd	(skole)eksamen
próvskeið	(skole)eksamenskursus
próvskjal	(skole)eksamensbevis
próvskúli	(skole)eksamensskole
próvtakari	(skole)eksaminand
próvtal	(skole)karakter
próvtøka	eksamen,fara (upp) til próvtøkugå op til eksamen;standa próvtøkubestå eksamen
prukka	lille stok
prumpa	prutte, fise, fjærte
prumpur	fjært, prut, fis
prunella	(bot.)brunelle
prunka	pynte
prus	(med.)lille sår, mindre hudafskrabning
prusal	(med.)lille sår, mindre hudafskrabning
prusali	(med.)lille sår, mindre hudafskrabning,eg fekk eitt lítið prusali á hondinajeg fik et lille sår på hånden
prutl	1små skud, knald som følger hurtigt efter hinanden2fjært, prut, fis3knallert,koyra prutlkøre knallert;koyra á prutlikøre på knallert
prutla	1(spec. om børn)lave lyde med munden,prutla eftir e-mvrænge ad nogen2boble op(om kogende vand, også overført om spændt situation),(talem.)tað prutlar undir loki(num)
prutta	(talesp.)prutte
prúdd	anseligt udseende,hann gav beiggjanum einki eftir í prúdd og styrkihan stod ikke noget tilbage for sin bror i udseende
prúdleiki	anseligt udseende
prúdligur	temmelig stor og kraftig af udseende,hon var stór og prúdlig konahun var en stor og kraftig kone
prúðka	blive større og kraftigere af udseende,hann er nógv prúðkaðurhan var blevet meget kraftigere
prúðleiki	anseligt udseende
prúður	1stor og kraftig, flot (af udseende),hann er eim prúður drongurhan er en flot fyr;prúða land míttmit storslåede land;nú situr tú prúð!nu kan du have det så godt2korpulent, velnæret,hon er prúðhun er gravid
prýða	pryde, smykke,prýða bók við myndumillustrere en bog
prýði	1pryd, prydelse,til prýðissom pynt2pryd,kirkjan er eitt satt  prýði fyri bygdinakirken er en sand pryd for bygden
prýðiligur	prægtig, herlig,prýðiligur borðbúnaðurprægtig (bord)opdækning
prýðing	prydelse
prýðisgripur	nipsfigur
prýðislutur	nipsfigur, pyntegenstand
prýðisplanta	(bot.)prydplante
prýðka	gøre smuk el. smukkere, pynte,tað hevði prýðkað umdet ville pynte på det
prædika1	(kirk.)prædiken
prædika2	1(kirk.)prædike,prædika Guds orðprædike Guds ord;(talem.)ikki gongst altíð sum prestur prædikardet går ikke altid, som præsten prædiker2påminde ustandselig, prædike,prædika lýdni og agapåminde om lydighed og disciplin
prædikari	(kirk.)prædiker,PrædikarinPrædikerens Bog
prædikastólur	(kirk.)prædikestol
prædikumaður	(rel.)prædikant
prædikutekstur	(kirk.)prædiketekst
prætika1	(kirk.)prædiken
prætika2	(kirk.)prædike
prøva	(talesp.)prøve
prøvi	(talesp.)1stikprøve,taka prøvar av kjøtitage stikprøver af kød2prøve
p-tal	personnummer
pu	fnug
pua	fnugge,dýnan puardynen fnugger
puff1	suk,puffini hoyrdustsukkene kunne høres
puff2	puf
puff3	puh, puha,puff sum tað er heitt!puh, hvor er det varmt!
puffa	sukke
pufferma	pufærme
pullur	(barn.)1lille fjer2(små)fugle
pulshosa	ragsok
pulsslag	pulsslag
pulsur	(biol.)puls,høgur / lágur pulsurhøj / lav puls;taka pulsintage pulsen
pulsæðr	(biol.)pulsåre
pultur	pult
pulvur	pulver
pummirskur	pommersk,pummirskur viðurpommersk tømmer
pumpa1	pumpe
pumpa2	pumpe,pumpa bátinpumpe båden;(med.)pumpa útudpumpe
pumping	pumpning
pumpuringur	1(zoo.)ung edderfuglehan(når den begynder at få den hvide farve)2(spøg.)grad af slægtskab,vit eru pumpuringarvi er meget fjerne slægtninge
pumpuskógvur	pumpestempel
pums1	bump, bums
pums2	pladask,barnið datt pums á gólviðbarnet faldt pladask på gulvet
pumsa	bumse, dratte,hann pumsaði útavhan faldt ud over fjeldkanten;smágrót pumsaði á sjógvder faldt småsten ned i vandet
pund	1(vægt)pund(1 / 2 kg)2(økon.)pund(møntenhed bl.a. i Storbritannien)
pundsseðil	pundseddel
pungur	1pung, pengepung, portemonnæ2(biol.)pung
punkt	1(mat.)punkt,næsta punkt á skránninæste punkt på dagsordenen2(typogr.)punkt(måleenhed i typografi),stavirnir eru í 9 punktumskriften er i 9 punkt
punktmongd	(mat.)punktmængde
punktum	punktum
punsabolli	punchebolle
punsur	punch
punta	kvadrere
puntalastrá	(bot.)bunke(Deschampsia),skyggjandi puntalastrábølget bunke(D. flexuosa)
puntur	1felt(fx på skakbræt)2firkantet stykke(fx af chokolade)
puntutur	ternet,eitt puntut turriklæðiet ternet forklæde
purka	1møgso, so2(zoo.)fodrodsknogle,tað er snor í purkuniel.tað er ikki søtt í purkunifåret er radmagert
purla1	krølle(i hår),ein purla var dottin fram um oyraðen krølle var faldet frem foran øret
purla2	1krølles,hárið purlaði um pannunahåret krølledes ned over panden2krølle,purla háriðkrølle sit hår
purlujarn	krøllejern
purluknokkur	(poet.)krøltop
purlutur	kruset, krøllet,purlut hárkrøllet hår
purpur	purpur
purpurhinna	(bot.)purpurhinde(Porphyra umbilicalis)
purpurkápa	(bibl.)purpurkåbe
purpurkúvingur	(zoo.)purpursnegl(Nucella lapillus)
purpurlittur	purpurfarvet
purpurlitur	purpurfarve
purpurreyður	purpurrød, purpurfarvet
purpurtari	(bot.)purpurhinde
purra1	(bot.)porre(Allium ampeloprasum porrum)
purra2	1tirre, drille,purra e-n (við e-m)tirre nogen(med noget)2purra upp undirægge, tilskynde3(isærmar.)purra útpurre ud
purrifinna	(biol.)klitoris, kildrer
purrukuldi	kulde i hovedet på penis
pusalaknektur	(fisk.)multe
puss1	1puds2puds, antræk, dress,vera í pussinumvære i stiveste puds
puss2	1uheld, beskadigelse2spælael.gera e-m eitt pussspille en et puds
pussa	pudse, polere,pussa silvurpudse sølv;pussa vindeygupudse vinduer;pussaðir útveggirpudsede ydervægge
pussfiskur	spøgefugl, galgenfugl
pussikrem	pudsecreme
putl	1småtteri, pilleri,putl og fjassmåtteri og pjank2langsomt og besværligt arbejde
putla	1pusle, pille, småsysle,putlast við e-tpusle med noget;putlastvære sendrægtig, arbejde småt og langsomt2rapse, småstjæle,eg havi einki putlað frá tærjeg har intet rapset fra dig
putlarbeiði	syssel med småtterier
putlispæl	puslespil
putlutur	sendrægtig, langsom, som fortaber sig i småting under et arbejdes udførelse,hatta er so putlut at fáast viðdet er et værre pillearbejde
putra1	pudre,putra segpudre sig
putra2	pusle, pille, småsysle,putra við e-tpille med noget
puts	vups
putt	kæp
puttur	kæp
putur	pudder
putursukur	puddersukker
puutur	fnugget
púff	puha, fy, føj,púff, sum hetta lukar illaføj, hvor det stinker
púki	djævel, trold,púkinfanden, djævelen
púra	helt, ganske,púra beintfuldstændig rigtigt;púra einkislet intet, ikke spor;púra stillurmusestille;púra einsamallurmutters alene
púrasta	(talesp.)helt, ganske
púrga	blanke af, udplyndre,púrga ein fyri pengarblanke en af;nú púrgaði tú meg heiltnu ribbede du mig for alt, nu blev jeg klædt af til skindet
púrgera	1blanke af, udplyndre,púrgera einblanke en af;hann púrgjørdi meg fyri tubbakhan tog al min tobak2púrgera særforspise sig3knubse,hann varð púrgjørdurhan fik nogle slemme knubs
púrgerð	svær mavepine el. diarré,tú fært púrgerð av hasum, sum tú eturdu får diarré af at spise sådan mad
púrgjørdur	håbløs, uforbederlig,hann er púrgjørdur, tað flættast ikki við hannhan er helt forstokket
púrt	helt, ganske,púrt einkislet intet, ikke spor
púrur	1ren, pur,sum tað púrasta gullsom det pureste guld;gera púrtudplyndre,nú gjørdi tú púrtnu tog du det hele2fuldstændig uvidende, blank,tú ert púrurdu er fuldstændig blank(fx lærer til elev)
púsin	bister, brysk,tú sært púsin út í morgundu ser så brysk ud her til morgen
pústr	vedholdende kold blæst
pústra	blæse, puste,pústra í eldinblæse til ilden
pústran	vedholdende kold blæst,gjóstur og pústran struku inn í hjallinvinden blæste koldt ind i forrådshuset
púta1	skøge, prostitueret, luder
púta2	pude
pútudevil	alfons
pútuhús	bordel
pyks	lille sår, mindre hudafskrabning,eg havi fingið eitt pyks á fingurinjeg havde fået et lille sår på fingeren;hann fekk ikki eitt pykshan var helt uskadt
pyksi	lille sår, mindre hudafskrabning
pylsa	pølse
pylsueitran	(med.)botulisme, pølseforgiftning
pylsufarg	rullepølsepresse
pylsuindur	blodpølse
pylsupressa	presse til rullepølser
pylsuvognur	pølsevogn
pynt	pynt, stads
pynta	pynte,pynta segpynte sig;pynta til jólapynte til jul
pyntidukka	(neds.)pyntedukke,hon er ein pyntidukkahun er en pyntedukke
pyntireyv	(neds.)pyntedukke
pyntutur	pyntesyg
pýggjapá	(barn.)skarn, snavs
pýramida	(mat.)pyramide
pýramidustubbi	(mat.)pyramidestub
pætursmessa	22. februar
pætursstólur	22. februar
pætursøka	29. juni
pør	separ
pøs	(mar.)pøs, spand
pøsa	trætte, udmatte fuldstændig
pøstur	træt, udmattet
