r	1(lingv.)konsonant2(lingv.)20. bogstav i det færøske alfabet (kaldes )
R	romersk taltegn for 80
rabarba	(bot.)rabarber
rabarbugarður	rabarberhave
rabarbugreytur	rabarbergrød
rabarbusuppa	rabarbersuppe
rabarbusúltutoy	rabarbersyltetøj
rabarbuvín	rabarbervin
rabbini	(rel.)rabbiner
radar	radar
radari	(fys.)radar
radarstøð	radarstation
raddaður	(lingv.)stemmet
raddloysi	(lingv.)ustemthed
radiatorur	radiator
radio	1(fys.)radio, radiofoni2radiosender,Tórshavnar radio3(talesp.)radiomodtager, radioapparat,tendra / sløkkja radiotænde for radioen / slukke for radioen
radisa	(bot.)radise(Raphanus sativus)
radium	(kem.)radium
radius	(mat.)radius
rað	1rad, række,fólk stóðu í longum røðumfolk stod i lange rader;trý ár á raðtre år på rad2benrad
raða1	i ordforb. somsigla beina raðusejle med vinden lige agterind
raða2	1rage op,standa og raðarage op el. i vejret;bert mastrarnar og skorsteinurin raðaðu undan;hømiliurnar frá í fjør standa og raða upp millum steinarnar2sætte i rad og række, ordne,ørindini eru raðað og skipað eftir frásøgn3i ordforb. somraða umdreje sig om;tá ið tað raðar um taðda det handler om det;tað raðaði ikki um stavn millum bátarnar(ved kaproning)bådene kom ind på linje(samtidig),raða avsætte alle sejl til,teir raðaðu hana av
raðan	1rækkefølge, orden2sigla beina raðansejle med vinden agterind, lænse
raðbinda	(fys.)serieforbinde
raðfesta	prioritere,raðfesta arbeiðiprioritere arbejde;raðfesta íløgurprioritere investeringer
raðfesting	prioritering
raðfylgi	rækkefølge,í raðfylgii rækkefølge
raðfylgja	rækkefølge,í raðfylgjui rækkefølge
raðhald	rækværk
raðhalt	i ordforb.saga raðhaltsave efter stregen men ude af vinkel
raðhús	rækkehus
raðið	flydende, uden standsning,lesa raðiðlæse flydende;tala fremmandamál raðiðtale fremmedsprog flydende;kunnael.duga e-t raðiðkunne noget flydende;tað lá raðið fyri hjá honumdet lå godt for ham
raðsáa	(landbr.)radså
raðsending	serietransmission
raðseta	ordne, arrangere
raðskipan	orden
raðtal	ordenstal, ordinaltal,raðtøl eru fyrsti, annar, triðiosv.ordenstal er første, anden, tredje osv.
rafsast	komme sig, komme til kræfter,hann hoyrdist rafsast og skava inni í koyggjuni
raft	rafte
ragg	nogen uro i søen,fitt ragg í sjónum, tó at tað er toluliga kyrt inni á gjónni
ragga1	gå langsomt,ragga sær aftur at húsumgå langsomt hjemad
ragga2	1(fx om kniv)sløve, gøre sløv,knívurin er raggaðurkniven er sløv;illa raggaðursærdeles sløv2gøre skrå indsnit (virkende som modhager) i bolt, nagle el. lign.,ragga seym
raggutur	(om søen)temmelig urolig,raggutur sjógvurtemmelig urolig sø;raggut í sjónum
ragna	bande, sværge,blóta og ragnabande og sværge
ragnarøk	1(mytol.)ragnarok2(overf.)ragnarok,ótálmað vápnadubbing elvir til ragnarøkuhindret våbenkapløb forvolder ragnarok
rak1	lysetande,kolan brann við tveimum rakum í
rak2	magerhed,koma upp í rakblive skindmager;bláur í rakiradmager;tað bláa rakyderste grad af afmagring;fáa rakserossa-;eitt ross fekk rak um várið;doyggja í raki;gløða í rakivære radmager
rak3	mager
rak4	sereka
raka1	ramme, træffe,raka e-nel.e-tramme nogen el. noget;blakið rakti hann á hálsin;hann rakti í hvørjum kasti;raka beinttræffe målet, træffe rigtigt;raka átræffe det rigtige sted;raka við (e-t)1træffe el. støde på2få øje på, opdage
raka2	1rage, skrabe sammen(med fingre, rive etc.),rakael.raka hoyggjrive hø;raka saman (hoyggj)rive hø sammen(til stakning)2rage, rode,raka í øskuni3barbere, rage af(skæg, hår),raka særtage skægget af;raka skinnrage hårene af et skind;raka húðarskøði;skógvar av rakaðum roð;jf.rakaroð4(overf.)skrabe sammen, rage til sig,raka inn undir segrage til sig
rakan	omgang, overhaling,tað verður ein rakan, tú fært, tá ið pápi tín kemur afturdin far giver dig en ordentlig overhaling, når han kommer igen
rakarastova	barbersalon
rakari	barber;jf.bartskeri
rakaroð	fåreskind hvoraf ulden er blevet raget af,mods.roturoð
rakaroðskógvur	sko af fåreskind hvoraf ulden er blevet raget af
rakaskógvur	sko af fåreskind hvoraf ulden er blevet raget af
rakár	magert år,(ordsp.)ravnur er feitastur rakár
rakbeist	(vulg.)fattig og uduelig person
rakbendil	1meget mager person2fattig og uduelig person
rakbóndi	fattig bonde,ikki hevur tað verið rakbóndi, ið her hevur búð;ein slíkur rakbóndi átti ikki annað enn vrakvørur í sínum goymslum
rakbýlingur	slumkvarter
rakdeyði	(om får)sultedød,einki er eftir av gróðri, og rakdeyði spyrst tí víða hvar
rakdirðil	(neds.)meget mager person
rakdoyggja	dø af sult
rakdropanøs	dryppende næse
rakdropi	næsedryp
rakdýr	1magert dyr2meget mager person,fara ikki til sovorðin rakdýr at fáa sær nakað
rakdæmi	ansigtsfarve pga. magerhed
rakett	raket
rakfuglur	mager fugl,rakfuglur er loftskotin
rakføddur	underernæret(spec. om køer),leiddi við sær eitt lítið rakføtt tarvaskapilsi
rakhagi	dårlig græsgang(lidt græs, få får)
rakhola	fattig hytte
rakhosa	1vraget (kasseret) strømpe2(overf.)kasseret, rejekt person(især kvinde),so tað er ætlanin, at Tobia skal koma heim aftur higar sum ein rakhosa
rakhundur	(spøg.)mager person
rakhøna	mager høne,ein fjaðursár rakhøna
rakiblað	barberblad
rakigreiður	barbergrej;jf.greiða 1(2)
rakiknívur	ragekniv, barberkniv;(overf.)hava munn sum ein rakiknívurhave en tunge så skarp som en ragekniv;hann hevði munn sum ein rakiknívur og var ikki at teppa
rakikustur	barberkost
rakimaskina	barbermaskine
-rakin	sebein-,skeiv-
raking	barbering
rakingarblað	barberblad
rakingarkustur	barberkost
rakingarmaskina	barbermaskine
rakingartól	barbergrej
rakisápa	barbersæbe
rakiskúm	barberskum
rakispegil	barberspejl
rakispritt	barbersprit
rakistova	barbersalon
rakitól	barbergrej
rakivatn	barbervand
rakjørð	ufrugtbar jord
rakk	serøkka
rakkahorn	(båd.)bøjle af horn hvormed råen holdes ind til masten;jf.rakki 1
rakkali	hansælens avlelem
rakkendur	noget spinkel el. tynd af legemsbygning
rakki1	(båd.)rakke(på fartøj)
rakki2	(zoo.)(ung) hund
rakkroppur	menneskeel.dyr som er mager
rakkúgv	mager ko
rakleittur	med markerede ansigtstræk
raklendi	mager jord
rakligur	temmelig mager,seyðurin er heldur rakligurfårene er temmelig magre
rakløn	dårlig løn
rakmurtur	(hån.)mager småtorsk,(roynt) eftir upsum og lúsa rakmurtum
rakna	1gå løs, opløses, trævles op(spec. om strikket tøj),raknael.rakna uppopløses;jf.rekja2rakna viðkomme til besindelse igen, komme til sig selv(efter besvimelse),tá ið hann raknaði við aftur, var maðurin horvinda han kom til sig selv igen, var manden forsvundet;hann er raknaður eitt sindurhan har det bedre3rettes op,húkurin raknaði upp
rakneyt	magert kreatur
rakpláss	fattig plads, fattigt sted,hasin hagin er rakpláss hjá seyði
rakreyv	(hån.)ludfattig person,hatta er ein rakreyvdet er en ludfattig person
rakross	mager hest
rakrot	(om kreaturer)det at ulden bliver løsel.falder af(fx pga. magerhed, sygdomo.lign.),ærin hevur fingið rakrot
rakrota	tabe ulden(pga. magerhed, sygdomo.lign.),seyðurin rakrotar
rakrotna	i ordforb. somtað rakrotnar burtur av seyðinumfårene taber ulden(pga. magerhedo.lign.)
rakrukka	rynke(i et magert ansigt),rakrukkurnar rylkjast saman, og andlitið stendur í einari skriðu
rakseyður	magert får,ravnur nemur ikki rakseyð
rakskarvur	meget mager person
rakskrokkur	meget mager person
rakslánur	1(fisk.)(meget) mager (stor) torsk,upsin er vorðin ein rættur rakslánur2(overf.)opløben person
raksmakkur	smag karakteristisk for unormalt magert kød,raksmakkur gongur at kjøtinum
rakstraravlop	(økon.)driftsoverskud
rakstrarár	(økon.)driftsår
rakstrarbátur	en af de både som driver en flok grindehvaler
rakstrarboð	besked om deltagelse i drivning af får(til folden),hann hevði verið við rakstrarboðum
rakstrarbúskapur	(økon.)driftsøkonomi
rakstrardagur	dag på hvilken fåredrivning finder sted,ringur rakstrardagur
rakstrarfígging	(økon.)driftsfinansiering
rakstrargøgn	driftsmateriel
rakstrarhall	(økon.)underbalance
rakstrarhoyggj	hø der bliver liggende så længe på marken udsat for regn og tåge at det mister størstedelen af sin næringsværdi,í óterraárum verður nógv rakstrarhoyggj
rakstrarhundur	hund til at drive fåreflokke med,fyrr høvdu teir her um leiðir bæði rakstrarhundar, tøkuhundar og aktingarhundar;jf.tøkuhundur
rakstrarkostnaður	(økon.)driftsomkostning
rakstrarlag	måde at drive (fx grindehvaler) på,ringt rakstrarlag
rakstrarlán	driftslån
rakstrarlíkindi(r)	omstændigheder til drivning(af hvaler el. får),ring rakstrarlíkindi(r);góð rakstrarlíkindi(r)
rakstrarlýsi	tilstrækkeligt lys el. sigtbarhed til fåredrivning
rakstrarmaður	1mand som deltager i drivningen af en flok får fra bjergene til fårefolden,ikki so sjáldan áttu rakstrarmenninir ein lut2mand som deltager i jagt på el. drivning af en flok grindehvaler
rakstrarmáttur	(fys.)dynamik
rakstrarmiðstøð	operationscenter
rakstrarpeningur	(økon.)driftskapital,tørvur er á rakstrarpeningider er mangel på driftskapital
rakstrarroknskapur	(økon.)driftsregnskab;jf.fíggjarstøða
rakstrarróp	1propaganda2tilråbfxpå protestmødeel.demonstration,rópa rakstrarróp
rakstrarstað	(økon.)driftssted
rakstrarstjóri	(økon.)driftsleder
rakstrartíð	1den tid fåredrivningen finder sted2(økon.)driftstid
rakstrarundirskot	(økon.)driftsunderskud
rakstrarútreiðsla	(økon.)driftsomkostning, driftsudgift,rakstrarútreiðslurnar eru stórardriftsudgifterne er høje
rakstrarveður	vejr til fåredrivning,vána rakstrarveðurdårligt vejr til fåredrivning
rakstur	1drift, drivning(spec. sammendrift, drivning af får el. grindehvaler),ikki fáa rakstur á seyðel.grindikke kunne drive får el. grindehvaler(de første ind i folden, de sidste ind i bugten),vera á rakstridrive får i fold;nú kom betri rakstur á grindinanu kunne de bedre drive hvalflokken, nu begyndte hvalflokken at gå villigere2vejstrækning ad hvilken man driver fx en flok grindehvaler3det stykke vej man lader båden drive for strømmen fra fiskepladsen indtil man sejler igen til denne,leggja ein rakstur4(flok) får som drives på én gang fra bjergene til fårefolden,slapp veðurlamb úr rakstrinum, mátti tað verða hundtikið5(økon.)drift,raksturin sýnir halldriften viser underskud
rakti	serekja,raka
raktíð	mager tid, magre år,tað var mongum hollur stuðul í raktíðini
rala	ralle,tað var, so tað ralaði í honum
raman	kraftigt,hann tók so raman tilhan brugte store ord
ramaróp	ramaskrig
ramaskríggj	ramaskrig
ramdanskur	ærkedansk, pæredansk
ramføroyskur	ægte færøsk, rent færøsk,yrkingin er bæði í anda og í máli ramføroyskdigtet er rent færøsk
rami	1ram lugt2afsmag
ramjútskur	ravjysk
ramligur	kraftig, stærk, solid, robust,ein ramligur óvitiet kraftigt barn;hann gav honum eitt ramligt slaghan gav ham et voldsomt slag;-ligastærkt, hårdt,høgga ramliga til;taka ramliga til (orðanna)bruge store ord
ramma1	ramme,eg havi latið myndina seta í vakra rammujeg har fået billedet smukt rammet ind;(overf.)framsýningin hevur víðar rammur og er fyri fólk úr fleiri londum;felagið hevur fingið glæsiligar rammur at virka íder er sat rummelige rammer for foreningens virkefelt;jf.karmur
ramma2	ramme,hann rammaði nevan í grótveggin
rammi	ramme
rams	i ordforb.drekka íel.við ramsidrikke i en slurk
ramsa1	remse,læra síðu eftir síðu upp á ramsulære udenad;hon dugdi alla ramsuna
ramsa2	remse,her galt mest um at læra uttanat og ramsa
ramsaltur	meget salt, salt som havvand,hann fekk sjórokið so ramsalt oman yvir seg
ramsi	i ordforb.(drekka) við ramsa(drikke) i en slurk
ramur	1ram, stærk, kraftig, dygtig,hann var ramur í øllum verki og av ítastu dugnamonnum;hann er ramur til althan har let ved alting;tíkin er ramast í tonnunumtæven er flinkest i tænderne;ramar rúnirramme runer, kraftige (kraftigt virkende) runer;ramur á málinumgrov i mælet, grovmælet;í ramasta álvarai ramme alvor;ramur í ganditroldkyndig,hon var rom í gandihun var trolddomskyndig;ramur illgerningurram (kraftig) trolddom;har var ramt1der boede der huldrefolk2der spøgte det2(meget) udpræget, meget slem, durkdreven,ramur tjóvurfuldendt, durkdreven tyv;tað rama hungurden rene og skære hungersnød;tað rama tvætldet rene sludder3ram, skarp, stram, bitter,ramur roykurstram lugt;ramur smakkurbitter smag
randa	rande, omkranse,(poet.)tá randa rósur roðandi vín
randar	serond
randarformur	randform
randarhús	randbebyggelse
randblóma	(bot.)randblomst
randformur	randform,stoyt deiggið í smurdan randform
randhvítur	(poet.)hvidbræmmet(af brænding),á vetri so randhvítt
randhærdur	(bot.)randhåret, ciliat
randreyður	rødrandet,randreyð eygurødrandede øjne
randseyma	randsy
randseymur	randsyning
ranga	vrange, vrangside,troyggjan er á rangunitrøjen vender vrangen ud,mods.rætta 1
rangaborð	(båd.)bagbord
rangaeystur	(båd.)bagbords øserum,mods.rættaeystur
rangarendi	(båd.)enden (endestykket) af rong,(poet.)reisast brot um rangarenda
rangarhol	(båd.)den trekantede åbning mellem rong og stævn
rangarúm	(båd.)bagbords øserum,ein róði í rangarúmi og ein í rættarúmi;jf.rættarúm
rangasnúður	(ved tvinding) forkert (modsat) snoning
rangastrúpi	(med.)vrangstrube,fáa e-t í rangastrúpan1få noget galt i halsen(i den gale hals),hann hostaði, eins og hann hevði fingið okkurt í rangastrúpanhan hostede som om han havde fået noget galt i halsen2også(overf.)misforstå noget
rangatoft	(båd.)pladsen i bagbordsside på toftubekkur
rangblak	voldsom kastevind(der kommer fra en anden side end vindretningen),frek rangbløk túta og ýla uppi yvir bygdini;jf.rangur (6)
rangeyga	1(i strikning)vrangmaske2(neds.)en som er skeløjet
rangeygutur	vindøjet
ranggerð	misgerning,revsa hann fyri ranggerðir hansarastraffe ham for hans misgerninger
ranghentur	venstrehåndet,hann var ranghenturhan var venstrehåndet;jf.lámur
ranghugsan	(psyk.)vrangforestilling
rangla	rangle
ranglaðin	(båd.)forkert lastet (for tung foran) så at vandet i kølbunden ikke løber til øserummet
rangleiki	urigtighed
rangliga	urigtigt, fejlagtigt,seta spurning rangliga framstille et spørgsmål fejlagtigt;tit ganga her frá øllum tí, tit hava rangliga fingið
ranglisin	forkert læst,ranglisin orðformurforkert læst ordform
ranglýsing	forvrængning, forvanskning,ranglýsingar og beinleiðis ósannindi rapla úr teimum
ranglæra	vranglære
ranglæti	(bibl.)uretfærdighed,við ranglætimed urette
rangmintur	som husker forkert
rangmynd	1negativ2(overf.)vrængbillede,frágreiðingin sýndi rangmynd av tí, sum veruliga fór frambeskrivelsen gav et vrængbillede af hvad der virkelig var sket
rangnýttur	brugt forkert
rangoygdur	vindøjet, skeløjet,vera rangoygdurvære vindøjet
rangsettur	(båd.)(om båd)hvis bundvand ikke samler sig i øserummet
rangsinnaður	1(bibl.)ulydig, falsk,rangsinnaðir eru Harranum ein andstygd2vred, gal, rasende,konan mundi fara at verða rangsinnað, um eg ikki hevði fingið so frægt sum til knettafisk
rangsnúður	(ved tvinding)forkert (modsat) snoning
rangsnúgva	fordreje,rangsnúgva sannleikanfordreje sandheden
rangsnúgvin	fordrejet, forvrænget
rangsovari	en der sover længe om morgenen og er oppe ud på natten
rangstaddur	(idr.)offside,málið varð ikki viðurkent, tí leikarin var rangstaddurmålet blev annulleret, fordi spilleren var offside
rangstoyttur	(båd.)(om båd),hvis bundvand ikke samler sig i øserummet,torv og seiður vóru ringur farmur, tí báturin kundi skjótt verða rangstoyttur
rangstøða	(idr.)offside
rangsvøvntur	hvis søvnvaner er kommet i ulave,tey eru vorðin púra rangsvøvnt um jólini
rangtrúgvin	(bibl.)kættersk,rangtrúgvin hugsanarhátturkættersk tankegang
rangtýða	oversætte forkert
rangtýðing	forkert oversættelse
rangur	1skæv, ikke lige,støkka rangt(om mad)komme i den forkerte hals;fáa bitan í ranga hálsinfå en bid i den gale hals2vrang, med vrangsiden ud, vrænget,rangt eyga(i strikning)vrangmaske;binda rangt og rættstrikke ret og vrang;rangur kalvivrangflynder3bagvendt, galt, forkert,gjøgnum tann ranga endan á kikaranum4falsk, urigtig(fx om en ed),rangur atburðururigtig fremgangsmåde;rangur siðurfalsk skik;gerael.svørja rangan eiðsværge falsk;døma rangar dómardømme forkerte domme;hann fer ikki við rongumhan taler ikke usandt;sig mær, hvat er rangt og hvat er rættfortæl mig, hvad er rigtigt og hvad er forkert5i bagbord,sita rangursidde i bagbord;(overf.)tað er farið langt á ranga borðdet er gået den forkerte vej6(om vind)kommende fra en anden side end den værende vindretning,rong hvirla;skjótt er at kollsigla í rangari glaðu
rangviðaður	(om træ, tømmer)forvreden, med årer som går uregelmæssigt ud til siderne,(overf.)hvør mundi tann rangviðaði krotusmiðurin vera?
rangviður	tømmer med uregelmæssige årer,rangviðurin var flusnaður upp
rangvørgur	1med vrangsiden ud,lata seg í rangvørga troyggjutage trøjen på med vrangen udad2bagvendt, forkert,hetta skjalið gevur eina rangvørga mynd av viðurskiftunumdette dokument giver et forkert billede af forholdene3(om folk)sær, umedgørlig
rani	1noget smalt, smal strimmel, spids(spec. en meget smal teigur),báðir partar áttu ranan millum stykkini, men hvørgin skuldi velta hann2elefantsnabel,fílurin lyftir hana við rananum
ranka1	besøge et sted tit, gå ofte, løbe vidt omkring,ranka landið runt;ganga og ranka og slankavanke, stryge om;rankastdrive om;hvar gongur tú og rankast?
ranka2	opstable,ranka viðin uppopstable tømmeret
rankari	omløber, omstrejfer,fylgisneyti hjá útlendskum rankarumfølgesvend hos udenlandske omstrejfere
ranki	(håndv.)stabel,ranki av viðien stabel tømmer;jf.viðarranki
rankur	1(om en båd)ustøt, som let krænger;báturin er rankur undir seglinumbåden er ustøt, når sejlene er oppe2rank, strunk,hann er rankurhan er rank
rann	serenna 2
rannsaka	ransage, undersøge,løgreglan rannsakaði bústað hansarapolitiet ransagede hans bopæl;hann fór til læknan at verða rannsakaðurhan gik til lægen for at blive undersøgt;hann fer undir at rannsaka føroyskthan skal forske i færøske sprog
rannsakan	ransagelse, ransagning, undersøgelse,rannsakan fór fram í húsinumder fandt en ransagning sted i huset;eftir langa rannsakan gjørdist læknin vissur um sjúkuna
rannsókn	undersøgelse, forskning,søguligar rannsóknirhistoriske undersøgelser;náttúrufrøðiligar rannsóknirnaturvidenskabelige undersøgelser;rannsóknir av norrøna málinumundersøgelser af det norrøne sprog
rannsóknarevni	forskningsemne
rannsóknarferð	ekspedition, opdagelsesrejse,fara rannsóknarferð til Norðurgrønlandstage på ekspedition til Nordgrønland
rannsóknari	forsker, gransker
rannsóknarløgregla	opdagelsespoliti
rannsóknarmaður	forsker, videnskabsmand
rannsóknarnevnd	undersøgelseskommission
rannsóknarstova	laboratorium, undersøgelseslaboratorium
rannsóknarúrslit	forskningsresultat
rannvæla	gennemrode, endevende,hann rannvælaði øll húsini, men fann ikki tað, hann leitaði eftirhan endevendte hele huset, men fandt ikke hvad han søgte
ransón	(mar.)ration,teir fingu smáar ransónirderes rationer var små
rapa	1styrte ned, falde ned,standa at rapatrue med at styrte;har er ikki lukkuligt at lata børn spæla, tí garðurin stendur at rapa;nú tekur eggin at rapa oman í stórum;niðurrapaður garðurnedstyrtet gærde2vælte, rulle,rapa grótrulle sten ned;rapa grót oman á teir3(om æg)falde ud,eggin rapar(fxpå kniv)
rapl	skred,hvør kundi so gruna, at hann lá undir raplinum?
rapla	styrte, falde ned,garðurin raplaðigærdet faldt ned;múrurin raplaði niðurmuren styrtede ned;lata raplasnakke meget;rapla urpt(om gæs)lægge æg med kortere tidsrum imellem hen imod rugetiden
rapp	(musik)rap, rapmusik
rappa	(musik)fremføre rapmusik, rappe
rasa1	rase, tage voldsomt på vej(især om storm, uvejr),tað rasar og vasar um eygur og nasar, tað kylir á kinn;rasandimed stor fart på;rasandi rennur hann runt í klingur
rasa2	snuble, falde,kúgvin rasaðikoen snublede
-rasin	seal-,ov-
rasisma	racisme
raskleiki	raskhed, kækhed,tiltikin fyri raskleikaberømt for raskhed
raskur	1rask, flink, flittig, arbejdsom,raskur sjómaðurrask sømand;hon er røsk til arbeiðishun er flink til at arbejde2dygtig(til noget),raskur maður at fiskadygtig mand til at fange fisk;raskur at svimjadygtig til at svømme3slem til,raskur at deilastslem til at skændes;raskur at finnast atslem til at kritisere
Rasmus	(spøg.)i ordforb. somflytael.seta Rasmus um fjørðin, rógva við Rasmusi, hittael.kasta Rasmusforrette sin nødtørft
rasp1	rasp, grovfil
rasp2	rasp
raspa	raspe
rassa	1bringe noget i uorden ved at vælte sig derpå el. ved at sidde urolig,rassa seingina niðurbringe sengen (sengetøjet) i uorden;rassa niðurtræde ned,tær høvdu rassað akurin niður2rassastel.rassa segel.særsidde urolig, uafbrudt forandre stilling(siddende el. liggende);hann rassaði seg upphan kvikkedes op;(ordsp.)tað grør ikki undir tí steini, sum altíð verður rassaður
rasshaft	1i ordforb. somærin er komin upp í rasshaftfåret har fået den løsnende uld viklet om bagbenene, så det er hindret i sin gang2(overf.)hann er komin (upp) í rasshaft (av e-m)han er kørt fast
rasshol	anus
rassur	1bagdel, røv,(gåde)reytt leikar undir rassinum svarta(om ild under en gryde)2ende, stump af en tørvestak (el.høstak),kráirnar, tómar og raplaðar, ein rassur eftir av summum3(stedn.)skrånende afsats i klippevæg,rassurin á Mýlingi;Staksrassurin
ratt	(mar.)rat
rav	rav
ravarakstur	i ordforb.leggja ein ravarakstur1fiske efter helleflynder2(overf.)gå på besøg hos gæstfri mennesker
ravasteik	stegt ravi(af helleflynder),nú sita tit sum ravasteik rundan um eldin(tæt sammen);teir sigla sum á ravasteikjum(om speedbåd)
ravgulur	ravgul
ravhúsi	(fys.)akkumulator
ravi	1strimmel af helleflynderens yderste og fedeste dele nærmest finnerne2sidestykket af en rokke, den ene halvdel lige til ryggen,hon kókaði ravan av skøtuni
ravindaligur	(fys.)elektronisk
ravindi	(fys.)elektronik
ravkleiv	(fys.)elektrode
ravlað	(fys.)batteri
ravmagn	(fys.)elektricitet,leggja ravmagn inn í eini húsinstallere elektricitet i et hus;ravmagn vunnið úr vatnorkuelektricitet frembragt ved vandkraft
ravmagna	(fys.)elektrificere, elektrisere
ravmagnaður	(fys.)elektrisk
ravmagnan	elektrificering
ravmagnsbrigda	(elektr.)elektrisermaskine
ravmagnsgeri	(fys.)elektrisk generator
ravmagnsljós	elektrisk belysning
ravmagnsmaður	elektriker
ravmagnspera	elektrisk pære
ravmagnsskøta	(fisk.)elektrisk rokke(Torpedo)
ravmagnsspenningur	(elektr.)elektrisk spænding
ravmagnsstik	elektrisk hegn
ravmagnsstoytur	elektrisk stød
ravmagnsstreymur	(elektr.)elektrisk strøm
ravmagnsstøð	elektricitetsværk, elværk
ravmagnstól	(elektr.)elektrisk apparat
ravmagnsveiting	(elektr.)elektricitetsydelse, elektricitetskilde
ravmagnsverk	elektricitetsværk, elværk
ravmagnsverkfrøðingur	elektroingeniør
ravnabøli	1ravnerede2(overf.)ravnerede, svinesti,tú hevur gjørt okkara heim til eitt ravnabøli
ravnagorr	ravneskrig
ravnagøtubrá	(bot.)fliget vejbred(Plantago coronopus)
ravnakavi	sne ved den tid når ravnen bygger rede(i marts),hetta er ravnakavi
ravnaleika	(bot.)gøgeurt
ravnaleikur	(leg)bestemt børneleg,at spæla ravnaleik;(talem.)hetta er verri enn ravnaleikur(om noget som går hårdt for sig)
ravnamatur	ravneføde
ravnaminni	god hukommelse,hon hevur ravnaminnihun har god hukommelse
ravnariv	det at ravne grådigt æder et selvdødt får,skilið er ringt bæði av ravnarivi, vatnsjúku og øðrum vanda
ravnastør	(bot.)blank star(Carex saxatilis)
ravnatugga	fåreådsel næsten opædt af ravne
ravnsegg	ravneæg,(ordsp.)sjáldan kemur dúvuungi úr ravnseggisjælden ligner man ikke sin slægt
ravnsfótur	ravnefod,ravnsfótur líkist nógv smáfuglafóti
ravnsmóðir	i ordforb.draga til sín sum ravnsmóðiraltid være ude om sig for at tilrive sig noget
ravnsnev	ravnenæb
ravnsreiður	1ravnerede,mangt kann vera at finna í ravnsreiðri2(overf.)ravnerede, svinesti,tað er sum eitt ravnsreiðurdet ligner en ravnerede
ravnsungi	ravneunge
ravnsvartur	ravnsort, kulsort
ravnur	1(ornitol.)ravn(Corvus corax),ravnurin troðar í torra, verpur í gø, klekir í einmána2(i forskellige ordforbindelser og vendinger)svartur sum ravnurel.ravnurinsort som en ravn;stjala sum ravnurstjæle som en ravn;hann sær sum ravnurinhan ser godt;sum ravnar áel.um deyðseyða(om folk som begærligt guffer i sig af noget);har vóru ravnar um soðið;fara fyri ravnar og ránsmenngå til spilde;fara fyri hund og ravngå i skuddermudder;(ordsp.)tá ið ravnurin legst í fjøruna, veit hann sær lítið(fx om en som begynder at lave noget som vedkommende ikke plejer at gøre);(ordsp.)ravnur drepur ikki, har hann byggirel.eigur;(ordsp.)ravnur er feitastur fellisárel.rakár3(spøg.)gammel dårlig hue
ravperla	ravperle
ravsigul	(fys.)elektromagnet
ravsigulmagn	(fys.)elektromagnetisme
ravsigulmagnaður	(fys.)elektromagnetisk
rá1	rådyr
rá2	(skib.)1rå,teir vundu segl í rá2langagtigt stykke træ, (rund) stok
rá3	råæg(på skærende redskab),rá fyri knívi;hann brýnir rá frá líggjanum
ráarnokki	(skib.)rånok
rábakaður	1(om bagning)ikke bagt igennem,kakan er rábakað2(neds.)(om folk)halvstuderet
rábandskoyril	pisk til at slå med,fáa rábandskoyril um lendarnar
rábeittur	(om skærende redskaber)med råæg,rábeittur knívur
rábítur	skabning som er grådig efter rå føde(især hund)
rábleytur	blød ved fugtighed(fx om skind)
ráborð	uhøvlet bræt
rábukkur	(zoo.)råbuk(Capreolus capreolus)
ráddur	i ordforb.við ráddum hugamed velberåd
rádjór	(zoo.)rådyr(Capreolus capreolus)
rádni	seráðin
rádýr	(zoo.)rådyr(Capreolus capreolus)
ráð	1råd, vink,leggja e-m ráðgive en råd;spyrja til ráðsspørge til råds;vera góður í ráðumvære en god rådgiver;(talem.)góður er gamal í ráðiel.ráðumden gamle giver gode råd;teir høvdu tikið eftir ráðum hansara;leita ráð við e-nel.e-msøge råd hos en, rådføre sig med en;leita sær ráð hjá e-msøge råd hos nogen;ganga saman í ráðbegynde på overvejelser2ledelse, styre,umsjónarráðtilsynsråd;NorðurlandaráðiðNordisk Råd3beslutning, vedtægt,taka ráðtage en beslutning;taka til ráðatage en beslutning,hvat hevur hann til ráða tikið?hvilken beslutning har han taget?;hvat er nú til ráða at taka?hvad er nu at gøre, hvad skal man gribe til?;hvat ráð eru nú at fáa?;eftir egnum ráðiselvstændigt;leggja upp ráðafgøre4plan, anslag,hvat tey skuldu til ráða fáhvilken plan, hvilket anslag de skulle finde på;hon var í ráðum vondhun var ond i anslag;hann hevði longu í ráðum at keypa nýtt skiphan havde allerede planer om at købe nyt skib;hava í ráðioverveje;leggja ráð samanel.saman ráðkonspirere;tey hava lagt ráð saman;væl er til ráða fingiðplanen er god5middel, hjælpemiddel, udvej,læknin visti eingi ráð fyri sjúkuni;tað eru ráð fyri tí;hvat er so til ráðs at taka?;nú eru góð ráð dýr;einastu ráðiniden eneste udvej el. lignende;hann tók sær taðel.tey ráð, at...han valgte den løsning, at...;hann veit sær eingi ráðhan er rådvild;finna upp á ráðfinde en udvej(løsning),nú gitti eg ráðininu fandt jeg en løsning;finna upp á ráðfinde en løsning6lejlighed, udsigt,um tað verður ráðhvis der bliver råd el. lejlighed7omstændigheder, vilkår(specielt finansielt),ráðini vóru so ring;meira rummiskur við peningi enn ráðini ætlast at vera8rådighed, myndighed,hava ráð áhave myndighed over, have magt til;taka e-n av ráðitage magten (kommandoen) fra nogen9i ordforb. somtað vóru onnur ráðinidet var en anden sag
ráða	1råde, give råd,ráða e-m (til) e-tråde en til noget2afgøre, bestemme,ráða (e-t) avbestemme, beslutte, afgøre, tage endelig beslutning;ráða e-mafgøre noget;eg ráði tí, nær vit farajeg bestemmer, hvornår vi tager af sted3tilvejebringe,,ráða e-m bóthjælpe en, redde en;er tað krabbamein, so er tað eingin, ið kann ráða honum bót4forårsage, volde,tú skalt hans deyða ráðadu skal volde hans død5udtyde,ráða dreymråde (tyde) en drøm6råde (over, for), have rådighed (herredømme, magt) over,ráða fyri borgum;(bibl.)hann livir og ræður um allar ævir;hvørt ráddi sær innan síni mørk;eg veit ikki, hvussu hon skal ráða sær í lívinumjeg ved ikke, hvordan hun skal kunne klare sig i livet;(talem.)veður (og vindur) má sær ráðaman må tilpasse sig efter vejret;tú ræður tærdu gør som du vil;ráða yvir (e-m)herske;ráða særstyre sig, beherske sig;hon fekk ikki rátt sær fyri pínuhun kunne ikke styre sig pga. pine7Gud ráði, um...gad vidst, om...;Gud ráði, um hann ikki hevði...  / /ráða á:ráða á (e-n)gå løs på en, angribe en;ráða avafgøre,av avráddum hugamed vilje;ráða fráfraråde;ráða fyriråde,tí ræður tú fyridet bestemmer du;ráða til:ráða til (e-t)råde til, anbefale;hann ráddi til, at hann straks skuldi fara;ráða umgælde, gælde om, være af vigtighed,tað ráddi um at skapa føroyskar bókmentir;tá ið um ráddinår det gjaldt;tá ræður um at rógvada gælder det om at ro  / /ráðast:ráðast á (e-n)gå løs på (nogen);ráðast á hendur (el.hondum)el.ráðast hondum (saman)komme i håndgemæng, komme op at slås;ráðast samanfare løs på hinanden;ráðast um e-trådslå om noget;teir ráðast nú um, hvat er at gera
ráðabót	forbedring, reparation,tær ráðabøtur, sum gjørdar kunna verðade forbedringer, som kan blive lavet
ráðafastur	bestemt, sikker
ráðagera	rådslå, forhandle,vit ráðagera um, hvussu vera skalvi forhandler om, hvordan det skal være
ráðagerð	forræderi,royndur í ráðagerðprøvet (erfaren) i listige el. onde anslag
ráðagóður	forstandig og god til at give råd,hon er vitug og ráðagóð
ráðaklókur	1forstandig og god til at give råd,hon var tiltikin at vera framsíggin og ráðaklók2kløgtig,brennivínsmaður er altíð ráðaklókur(er altid i stand til at skaffe sig brændevin)
ráðaleggja	give råd, tilråde
ráðaleysur	rådløs, rådvild
-ráðaligur	seó-
ráðaloysi	1rådløshed, rådvildhed2modløshed,ráðaloysi í hugamodløshed i sindet
ráðamikil	magtfuld,hann er ráðamikilhan er magtfuld
ráðaríki	herskelyst, magtsyge
ráðaríkur	herskesyg,ráðaríkur og hástórurherskesyg og hovmodig;hann er ráðaríkurhan er herskesyg
ráðasjúkur	med sygelig trang til at bestemme alene,hann var ikki ráðaríkur, men ráðasjúkur
ráðasnild	fiffighed
ráðasnildur	fiffig
ráðatøkin	beslutsom
ráðavillur	rådvild
ráðfastur	bestemt, sikker,ráðfastur í eygnabragdi
ráðføra	i ordforb.ráðføra seg við (e-n)rådføre sig med én
ráðgerð	planlægning,ráða ráðgerðgive godt råd
ráðgeva	rådgive, råde, vejlede
ráðgevari	rådgiver
ráðgevi	rådgiver
ráðgeving	rådgivning,stuðul og ráðgevingstøtte og rådgivning
ráðharrastova	ministerium
ráðharri	(pol.)minister
ráðhús	rådhus
ráðiliga	sindigt
ráðiligur	1forstandig2gammelklog
ráðin	1klog, erfaren, vis(nu mest som fyldeord i tiltale),nú, hin rádninu, du gamle!;tú hin rádni!unge mand!2(mat.)ráðin tølrationale tal;jf.óráðin
ráðisligur	gammelklog,ráðisligur drongurgammelklog dreng;-liga,helt hann fyri, so ráðisliga sum eitt gamalt fólk
ráðklókur	forstandig og god til at give råd
ráðlegging	rådslagning
ráðleggja	rådslå, planlægge,tey gera, sum tey hava ráðlagt;jødarnir ráðleggja um at drepa Jesusjøderne lægger råd op om at dræbe Jesus
ráðleysur	rådløs, rådvild,betri er at vera breyðleysur enn ráðleysur, segði kellingin;sjómaður er ongantíð ráðleysursømand er aldrig rådvild
ráðloysi	rådløshed, rådvildhed
ráðsnarur	rådsnar, snarrådig,børnini læra at hugsa og vera ráðsnarbørnene lærer at tænke og være rådsnare
ráðsnildur	fiffig,hann var so ráðsnildur, at hann fekk greitt seg burtur úr fløkjuni
ráðstevna	kongres, konference
ráðstova	(pol.)ministerium
ráðtøkin	beslutsom;jf.óráðtøkin
ráðuliga	sindigt
ráðuligur	1forstandig2gammelklog
ráðusligur	gammelklog;-liga,tosa ráðusliga
ráðvillur	rådvild, i vildrede,við ráðvillum yvirbragdi í andliti
ráðvísur	god til at give råd, forstandig,(bibl.)har sum mangir eru ráðvísir, gongst alt væl
ráevni	(industri)råstof,ráevni í undirgrundiniråstof i undergrunden
ráfiskur	utilvirket fisk,virkið tekur ímóti ráfiski alt árið
ráflustur	skrællet rå,ráflust epli;ráflustur leykur
rágummi	rågummi,ta harðnaðu sevjuna kalla vit rágummi
ráhjørtur	(zoo.)råbuk(Capreolus capreolus)
ráhvítur	råhvid,ráhvítt løriftråhvidt lærred
rái	fugtighed,hon hevði kynt upp til at fáa ráan burtur
rák	1strømdrift, strøm,rák í sjónum;hart rákhård strøm;spakt rák;so fór rákið at skifta;leggja fyri ráklægge båd til at drive(for at få fisk);fara á rákdrive;liggja fyri rákilade båden drive for strømmen;báturin lá fyri ráki2skydrift,rák á luftini;hann hevði skift rákið á luftini;(poet.)rákið norðanav so spakt um mánan dregur3(åndelig) strømning, retning, tendens,ráðandi rák í bókmentum og listden førende retning i litteratur og kunst;rákið í klædnamótaretningen i modetøj
rákafiskur	fisk der i svag strøm følger efter fiskesnørerne væk fra fiskepladsen(mið)
rákagerð	(biol.)spytafsondring,at tyggja turran, harðan kost fremur rákagerðina
rákakertil	(biol.)spytkirtel
rákaldur	råkold
rákaleið	fiskefelt(for bådfiskeri ved aftagende strøm),vit fóru ikki langt út, men settust á rákaleið;góð rákaleið(hvor man normalt fanger mange fisk),rákaleið fyri kalva;jf.rák (1),reka (2)
rákaleyst	(om farvand)frit for strøm,har sum rákaleyst er;jf.deyðavatn
rákamikil	1(om personer)med stærk spytsekretion2(om mad)som fremkalder stærk spytsekretion3(om vejr)fugtig
rákar	serók
rákarendi	enden af en klippeafsats(i bjergene)
rákarlag	smal klippeafsats i en skrånende bjergside
rákarskapilsi	lille klippeafsats,upp frá helluni gekk eitt lítið rákarskapilsi
rákatíð	fiskesæson for helleflynder(fiskeri hvor man lader båden drive for strømmen),fyrst í mai byrjaði rákatíðin, og farið varð at reka eftir kalva
rákavandin	(om fisk)som ikke bider på krogen undtagen ved passende strøm,longa er rákavandin
rákfríur	skyfri,so rein og rákfrí var luftin, sum sjáldan kann henda um heystið
rákgongd	tendens, trend
ráki	1(biol.)spyt, mundvand,væta fingurin á tunguni og smyrja rákan uppá2smagsfornemmelse,fáael.hava rákan av e-m;góður rákigod smag;vilt tú ikki hava ein ráka?vil du ikke have et glas brændevin?
rákísur	drivis,vit sóu leivdir av rákísinum
ráksnúgvin	opportunistisk,ráksnúgvin politikkuropportunistisk politik
ráksnúni	opportunisme,politiskt ráksnúnipolitisk opportunisme
ráksnúningur	opportunist
ráleiki	1fugtighed2vold, grusomhed,hjartaloysi og ráleiki menniskjanshjerteløshed og menneskernes grusomhed
ráligur	fugtig,summarið var ráligtsommeren var fugtig
rálýsi	ukogt tran,rálýsi varð smurt upp á júgrið fyri mjólkarfepur
rám1	mellemrum,stuttel.langt rámkort el. langt mellemrum
rám2	1det at rammeel.træffe,havaldan fær aftur rám á klettin;náa e-m í rámiðløbe nogen op;sleppa ikki í rámikke få tag (i), ikke få ram på2(datal.)træf
ráma	ramme, træffe,lukkan rámi teirra verk;rámanditræfsikker;rámandi lýsingtræfsikker beskrivelse
rámaður	moden,kornið var grovt og hartil væl rámað;væl (illa) rámaður(om kornmark)tilstrækkelig (for lidt) gødet
rámátin	grådig, forslugen,lambið hevur verið so rámátið
rámeti	råkost
rámi	ram lugt
rámjólk	(mælk.)råmælk
rámlisti	(datal.)træfliste??
rámur	slem, uartig, durkdreven,ein rámur ránsmaðuren durkdreven røver;tað endaði við rámum bardaga;her rýkur so rámt innanveggjaher stinker forfærdeligt indenfor
rámúli	spidsen af en fiskestang
rán	ran, tyveri;eftir ránii hast, lige på en studs,etael.drekka eftir ránispise el. drikke i hast
rána1	røve, plyndre,rána bankarøve en bank
rána2	(om vejret, skind, hø etc.)blive fugtig,hoyggið ránar
ránakendur	havesyg
rándjór	(zoo.)rovdyr(Carnivora)
rándýr	(zoo.)rovdyr(Carnivora)
ránfuglur	(ornitol.)rovfugl
ránfúsur	rovgrisk,ránfús leyvaen rovgrisk løve
ránir	i ordforb.(ikki) fáa ránir til e-t(ikke) få lejlighed til noget
ránisliga	på en rovgrisk måde,her sýnist longu at fara at ganga ránisliga til, hugsaði hann
ránnýtsla	eksploitering
ránokki	(skib.)rånok
ránroyna	drive rovdrift
ránsdjór	rovdyr
ránsdýr	rovdyr
ránsferð	plyndringstogt,teir vóru kønir og royndir sjómenn og gjørdu ofta langar keyp- og ránsferðir
ránsfongur	rov,mikil ránsfongurstort rov
ránsfuglur	(ornitol.)rovfugl
ránsfæ	rov, bytte,teir tóku alt ránsfæið og allan herfongin;býta ránsfæiðdele rovet
ránskroppur	røverisk person,hann hevði ikki nógva jørð, men hann var ein ránskroppur, og so við og við fekk hann skavað eina mongd undir seg;ránskroppurin fór burtur við barninum
ránskur	rovgrisk, havesyg,hann er so ránskur og vil hava meira enn sítt;fiskur hevði óivað verið at fingið, um ikki trolararnir vóru so ránskir;ránskur at etagrådig at spise
ránsmaður	røver, tyv,ein tiltikin ránsmaðuren berømt røver;fara fyri ravnar og ránsmenngå til spilde
ránsmannabøli	røverkule, røverrede
ránstonn	(zoo.)rovtand
ránsveiða	rovdrift
ránveiða	rovdrift,smátøkin fiskiskapur, ið als ikki kann kallast ránveiða av nøkrum slag
ráolja	råolie
rárur	sjælden,tað er ikki meiri enn rárasta hending, at...det hører til sjældenhederne, at...
rás	1smal sti(spec. smal sti, hvor får går el. ad hvilken de bliver drevet),kúgvin snávaði og fór av rásini;grava rásir2(om får)løb,seyðurin hevur so sterka rásfårene løber så stærkt;hava góða rás í seyðinum3vej, bane, rute,hvar er rás yvir reynið?;ryðja sær rásbryde bane, bane vej;rúmar ræsurgod plads4række af flyvende fugle,lomvigin flýgur í rásum5(ny bet.)kanal
rása	1(om får under drivning)bevæge sig i en bestemt bane,seyðurin rásar;hann segði, hvussu fylgini itu, hvussu tey rásaðu2i ordforb. somfuglurin rásar(flyver i flok),fuglurin er farin upp at rása
rásalat	råsalat,afturvið ber til at hava langabreyð og okkurt rásalat
rásan	hast, skynding,rásan upp og niður
rásarfuglur	fugle (lomvier) der flyver i række
rásarúm	plads, tumleplads, bevægelsesfrihed,havael.fáa rásarúm;også(overf.)aftan á 1900 hevur danskt ikki sama rásarúm sum fyrr
rásegl	(skib.)råsejl
ráskapur	råhed, brutalitet
ráskera	kløve fisk (især torsk) i to halvdele næsten til haleroden og derpå hænge den op på stænger til tørring,ráskorin fiskur
rásmakkur	rå smag,tað gongur rásmakkur at matinum(ikke kogt godt nok)
rásmør	smør af råmælk
rásukur	1råsukker2puddersukker, farin
rátýða	oversætte interimistisk
ráur	1(især om mad)rå,ráur fiskurukogt fisk;hvørki rátt ella soðiðhverken det ene el. det andet,tá var hvørki rátt ella soðið, hvørja leið eg skuldi halda;tað er hvørki rátt ella soðið teirra millum(køligt venskab);geva e-m rátt fyri ósoðiðgive nogen en ordentlig opsang;svølgja e-t ráttsluge det hele råt, tage noget for gode varer(uden protestel.indvending)2(om tømmer, vejr etc.),fugtig,ráur viður;rátt hoyggj3uforarbejdet4rå, brutal, ubehøvlet,ráur kræklinguren som er grov i munden
ráviður	uhøvlet tømmer
rávøra	råvare
realisma	realisme;jf.romantikk;realisman byrjar í Fraklandi í fyrru helvt av 19. øldrealismen opstår i Frankrig første del af 1800-tallet
realprógv	(skole)realeksamen
red	(mar.)red,skipið liggur á rediniskibet ligger på reden
redda	(talesp.)redde,teir skipbrotnu vórðu reddaðirde skibbrudne blev reddet i land;Gud reddi so meg!Gud hjælpe mig!
redningur	(talesp.)redning
reðr	penis
reður	penis
reðurbressa	(zoo.)almindelig marksvirreflue(Eupeodes corollae)
reðurfall	impotens
reðurstøða	erektion, rejsning
refsast	(om et meget sygt menneske),komme lidt til kræfter igen, blive lidt bedre,fara at refsastkomme sig, blive bedre
regera	(talesp.)1regere, styre, lede2regere, støje, larme,regera sum eitt ótt
regla1	1linje, streg2række ord el. bogstaver,lesa ímillum reglurnarlæse mellem linierne3regel, bestemmelse4selskab, forening, organisation, orden
regla2	i ordforb. somregla á beinunumknap nok holde sig på benene(på grund af alderdom, sygdom, drukkenskab og lignende),tað er ikki meir enn hann reglar á beinunum(om en fuld mand)han kan knap nok holde sig på benene;jf.ragla,reyla
reglubeinur	regelret,skriva reglubeintskrive regelret
reglubrot	ny linje
reglubróðir	ordensbroder
reglubundin	regelbunden el. regelbundet, regelmæssig,reglubundið ørindislagregelbundet versemål
reglufastur	regelmæssig,regluføst stavsetingregelmæssig retskrivning
reglufesti	1regelmæssighed2formalisme
reglugerð	(jur.)reglement, statut,reglugerð fyri náttúruverndreglement om naturbeskyttelse
regluglopp	(typogr.)linjeafstand
reglugroyping	(litt.)enjambement
reglulag	princip
regluleiki	regelmæssighed
regluleysur	1regelløs, uregelmæssig,regluleys skrift2lovløs, anarkistisk,tann regluleysi standur í oyggjunum
regluligur	regelmæssig, normal,regluligt ferðasamband oyggjanna millumregelmæssig samfærdsel mellem øerne;reglulig bendingregelmæssig bøjning
regluloysi	uregelmæssighed
reglurættur	regelmæssig,reglurætt lívregelmæssigt liv
reglusamur	regelmæssig,reglusom blaðútgávaregelmæssig bladudgivelse
reglusemi	regelmæssighed
regluskeivur	med ulige linjer,skriva regluskeivt
regluskipa	(lingv.)normalisere,regluskipa rættskrivingina í gomlum handritumnormalisere retskrivningen i gamle håndskrifter
regluskipaður	normaliseret, normeret
regluskipan	1reglement,sælur hann, sum ger eftir teirri halgu regluskipan2(lingv.)normalisering
reglusnið	formalitet,stríð um rætt reglusniðstrid om ret og formalitet
regluvillur	som tager fejl af linjerne,tú fert regluvillurdu springer (en el. flere linjer) over
regn	regn,loysa við regniel.loysa regniðbegynde at regne stærkt;hann loysti við regniregnen brød løs
regna	1regne,nú regnarnu regner det;tað regnardet regner;hann var farin at regnadet var begyndt at regne;í dag regnar av grimdi dag regner det stærkt2falde ned i store mængder(lige som regn),kúlurnar regnaðu niður yvir skipið
regnbjálvi	regntøj
regndagur	regnvejrsdag,nógvir regndagar hava verið henda mánaðinder har været mange regnvejrsdage i denne måned
regndropi	regndråbe
regnfrakki	regnfrakke
regngráur	regntung,regngráur dagurregntung dag
regnhol	bygd hvor det ofte regner
regnklæði(r)	regntøj,havið regnklæði(r) við!tag regntøj med!
regnligur	(om vejr)i ordforb. somtað er so regnligtdet truer med regn;luftin er so regnligdet ser ud til regn;hann sær mær so regnligur út
regnloysi	tørvejr,fyrra helmingin av august var terri og regnloysi
regnluft	regnluft
regnmikil	regnfuld, fugtig, våd,regnmikil veturregnfuld vinter
regnskadda	regntåge,í regnskaddunii regntågen
regnskíggi	paraply
regnskjól	paraply,hann hevði keypt sær regnskjólhan havde købt en paraply
regnskógur	regnskov
regnskúrur	heftig regnbyge
regnskýggj	(meteorol.)regnsky,himmalin er ímgráur av ývnum regnskýggjum(nimbostratus)
regntíð	(geogr.)regntid,mods.turrtíð,har verður árið skift sundur í turrtíð og regntíðder bliver året opdelt i tørtid og regntid
regntjúkn	heftig regnbyge,skonnartin sást inni í regntjúknini
regntoka	regntåge,fjøllini vóru øll huld í regntoku
regntungur	regntung,luftin var vorðin regntung og tokumikilluften var blevet regntung og tåget
regnvatn	1regnvand,hann sýgur regnvatnið burtur úr skegginum2overfladevand,alt drekkingarvatn í Føroyum er regnvatnal drikkevand på Færøerne er overfladevand;jf.grundvatn
regnvátur	regnvåd,regnvátur klæðiregnvådt tøj
regnverja	paraply
regnæl	(meteorol.)regnbyge;jf.heglingsæl,kavaæl
regnælingur	(meteorol.)regnbyger
regnætt	vindretning der gerne bringer regn
reiða1	1rede, udstyre,reiða tiltilberede;reiða borðdække bord;reiða til jarðarberede (et lig) til begravelse;skipini vóru farin at reiða seg útskibene var begyndt at gøre klart til fiskeri2rede, berede, tilberede,reiða (e-t) tiltilberede noget;reiða songel.reiða upprede en seng3udrede, udbetale
reiða2	transportere på kløvhest,reiða torv;reiða tøð
reiðar	i ordforb.til reiðarrede, parat
reiðarafelag	rederiforening,Føroya reiðarafelagFærøernes rederiforening
reiðaravirki	rederivirksomhed,reiðaravirkini vinna stóran pening av siglingini
reiðari	reder, skibsreder
reiðarí	(talesp.)rederi
reiðarklæddur	rejseklar, rejsefærdig
reiðast	vredes
reiði1	vrede
reiði2	1udrustning, tilbehør2(skib.)rigning, takkelage
reiðiliga	1ganske, ret, rigtig,reiðiliga stórurganske stor;reiðiliga illurrigtig vred;ikki reiðiligaikke rigtig, ikke helt;reiðiliga ikkialdeles ikke;reiðiliga helvtingodt og vel halvdelen;teir kýttu seg, alt teir vóru mentir, og reiðiliga tað2redeligt, ærligt
reiðiligur	1redelig, retskaffen2rigtig, hel, sand
reiðimikil	vred, forbitret
reiðing	transport på kløvhest
reiðingarross	kløvhest, hest med kløvlæs
reiðlag	(elektr.,fys.)relæ
reiðlið	(militær)rytteriafdeling
reiðmaður	rytter,hann var frálíkur reiðmaðurhan var en fortrinlig rytter
reiðra	(håndv.)reiðra skrúvuforsænke en skrue
reiðran	puslen, sendrægtighed,reiðran og fjasan
reiðrarhestur	ridehest,reiðrarhestur má vera væl skógvaður
reiðrarleypur	stor trækasse med tremmer som bruges ved transport af gødning og navnlig tørv til hest
reiðrast	1bygge rede,fuglurin er farin at reiðrastfuglene er begyndt at bygge rede;(overf.)sita og reiðrastsidde urolig2pusle, nusse(ikke blive færdig),at enda var hann liðugur at reiðrast í køkinum;hon er ikki klár, men reiðrast har niðri enn
reiðregg	redeæg
reiðrhestur	ridehest
reiðring	puslen, sendrægtighed,tað vóru einar øgiligar reiðringar á honum
reiðskapur	1redskaber, værktøj, tilbehør2(vulg.)genitalier, kønsorganer
reiðsla	1transport på kløvhest2læs på kløvhest, hvad der transporteres på én gang
reiðslubarn	barn som transporterer på kløvhest
reiðsludagur	dag når der transporteres på kløvhest
reiðsludrongur	dreng som transporterer på kløvhest(fx tørv)
reiðsluveður	(godt) vejr til transport på kløvhest
reiðsluvegur	den vej ad hvilken man transporterer noget på kløvhest(e),reiðsluvegurin til tann innara og ovara bøin var langur
reiðuliga	1ganske, ret, rigtig2redeligt, ærligt
reiðuligur	1redelig, retskaffen2rigtig, hel, sand
reiðupeningur	rede penge, kontanter,gjalda fult virði fyri jørðina í reiðupeningi
reiður1	1rede, fuglerede,draga í reiðursamle til rede;(bibl.)himmalsins fuglar bygdu reiður í greinunum;(ordsp.)ringur er fuglur, í sítt reiður dríturel.tað er ringur fuglur, ið drítur í egið reiðurden som dadler sit eget(fx sit land, sin hjembygd etc.)er ikke meget værd;(talem.)vátt er komið í reiðriðde er blevet uvenner2hjem, hjemsted,teir eru stutt frá reiðrinumde er lige uden for hjemmet3fordybning i spónalag
reiður2	vred,hann var reiðurhan var vred
reiður3	i ordforb. somreiður peningurrede penge,hundrað túsund krónur í reiðum peningihundred tusind kroner i rede penge
reiðuviðbót	rådighedstillæg
reiggiband	tovgynge,eitt reiggiband er í kjallaranumen tovgynge er i kælderen;rossið ber so lættliga, at tað er sum at sita í reiggibandi
reiggj1	omgang, bekomst, omgang af sygdom,tað var honum ein ring reiggj
reiggj2	1svingende bevægelse (især i tov), sving,hann gjørdi eitt reiggj við spakanum;missa reiggið(om en fuglefænger)komme ud af svingende bevægelse og derved komme til at hænge lige ned uden kontakt med fjeldvæggen(hvor denne rager ud foroven),fáa pottin á reiggjfange så mange fisk at der bliver til et måltid2(overf.)sving,tað hevur gingið striltið at fáa reiggj í kolavirkið
reiggj3	i ordforb.taka sær um reiggjtage sig sammen
reiggja1	tovgynge,heingja upp eina reiggju
reiggja2	1svinge i vejret, svinge,reiggja við (e-m)svinge(en genstand, i regelen truende el. til slag),reiggja við stavisvinge staven;reiggja tilhugge kraftigt til,hann reiggjar til við stavinum;tað reiggjar um ein tímadet drejer sig om en times tid2sætte i svingende bevægelse, svinge frem og tilbage3være i svingende bevægelse, gynge(i tov),reiggja í reiggibandi;fuglarnir sótu longu og reiggjaðu í greinunum;reiggja sær á1bryste sig2(overf.)forbedre sig4(um sigmann)reiggjael.reiggja sær(om sigmaður)svinge ud og ind i linen for at holde kontakt med fjeldvæggen(hvor denne rager ud foroven),sígingarmaðurin reiggjar, tá ið hann sígur, og loft er
reiggjuband	tovgynge
reigras	(bot.)slægt i græsfamilien(Lolium),snøgt reigrasalm. rajgræs(L. perenne)
reik	farten af sted,hann var ikki mentur at fáa huga sín á reik longur;hugi mín er á reiki;vera á reikumrakke omkring
reika1	1vanke, vandre, spadsere,reika umvanke, stryge om;hann reikaði um bygdinahan spadserede rundt i bygden;(bibl.)friðleysur og griðleysur skalt tú reika um á foldini2(datal.)surfe3(talesp.)have en rus4reika fyri (e-m)forberede;reika seg tilforberede sig
reika2	lave skilning,reika háriðskille håret;reika særrede sig skilning
reikan	farten af sted,reikan aftur og framdriven frem og tilbage
reiking	1handlingen at skille håret2skilning
reikur	1skilning(i håret),greiða sær reikrede skilning;beinur reikur:skeivur reikur2(spøg.)hava reikhave en lille bjørn på
reim	1rem,vera sum ein reim (el.sum reimin)1rask og smidig;hann var sum reiminhan var rask og smidig;fá fatur á hasum, ver sum ein reim!2ydmyg og medgørlig;hann var sum ein reim fyri honum;(ordsp.)gott er at rista breiðar reimar av annans húðum,seál (1);fáa reiminafå klø;røtur tora tey ikki at taka, tí so fáa tey reimina2agerren,hann loysti eina reim av, har tvørveitin skal vera
reimaskógvur	remsko, sandal
reimavelta	kartoffelmark med græstørv lagt omvendt over læggekartofler og gødning
reimhjól	remskive
rein1	agerren,skjóta út á rein
rein2	serína
reina	i ordforb.reina upp (veltu)danne ryg el. kam i en kartoffelmark
reindjór	(zoo.)rensdyr, ren(Rangifer tarandus)
reindýr	(zoo.)rensdyr, ren(Rangifer tarandus)
reinfann	(bot.)vanlig reinfannrejnfan(Tanacetum vulgare)
reinføri	renlighed,persónligt reinføripersonlig hygiejne
reinførisbind	hygiejnebind
reinførur	renlig
reingerð	rengøring,upphæddin til reingerð er skerdbeløbet til rengøring er reduceret
reingerðarevni	rengøringsmiddel
reingerðarkona	rengøringskone
reingering	rengøring
reingi	hvalpenis
reinging	forvrængning, forvanskning
reingja	1bestride rigtigheden af noget,reingja e-n1bestride rigtigheden af ens udsagn,tú skalt ikki reingja meg2lukke munden på en,hann rongdi hannhan stoppede munden på ham2forvrænge, fordreje,reingja veruleikanfordreje virkeligheden;reingja sannleikanforvrænge sandheden;tað reingist ikkidet er usvigelig sikkert
reingresi	ren græsvækst(der er fri for ukrudt),mods.illgresi
reingresin	(om græsmark)med rent græs og fri for ukrudt,hetta stykkið er so reingresið
reingresjaður	(om græsmark)med rent græs og fri for ukrudt,reingresjað stykki
reingrøsutur	(om græsmark)med rent græs og fri for ukrudt,kornveltur bøur er reingrøsutari enn hin eplavelti
reinhald	renholdelse
reinhalda	renholde,barnið er illa reinhildiðbarnet er dårligt renholdt
reinhentur	med rene hænder
reinhind	(zoo.)hunrensdyr(Rangifer tarandus)
reinholdaður	med smuk hud
reinhugaður	renfærdig
reinhvítur	(poet.)renhvid,reinhvítur kavirenhvid sne
reinleiki	renlighed
reinligur	1renlig2hæderlig, ærlig;-liga
reinlitaður	med ren(e) farve(r)
reinlittur	med ren(e) farve(r),reinlitt tvíbundin skipstroyggja;reinlittir svartir seyðir eru ringari at kenna at enn reinlittir hvítir
reinlyndi	ærlighed,hann kom tvørt fyri vegna óbendiliga reinlyndi sítt
reinlyndur	ærlig, oprigtig
reinlyntur	ærlig, oprigtig
reinmeintur	oprigtig,reinmeint lyndioprigtigt sind
reinmosi	(bot.)rensdyrlav(Cladonia rangiferina),reindýrið føðir seg av reinmosarensdyret spiser rensdyrlav
reinmæli	(lingv.)purisme
reinmælingur	(lingv.)purist
reinmæltur	med ren stemme,hann er frálíkur sangari, reinmæltur og mjúkmæltur;ljóðið av reinmæltum barnarøddum
reinprent	rentryk
reinprenta	rentrykke
reinsa	1rense,reinsa neglrense negle;reinsa sárrense sår;reinsa klæðirense tøj;reinsa hvørja gørnkaste voldsomt op2(overf.)rense, rehabilitere,reinsa seg við illgitingrense sig for mistænksomhed
reinsan	renselse
reinsanareldur	(rel.)skærsild
reinsarí	renseri
reinsemi	renlighed,reinsemi skygdi ikki av honumhan skinnede ikke af renlighed
reinsibrunnur	rensebrønd
reinsing	renselse
reinsingareldur	(rel.)skærsild
reinsiverk	rensningsanlæg, raffinaderi
reinska1	renlighed
reinska2	1rense, gøre ren,hann reinskaði hvørja gørnhan kastede voldsomt op2rydde op, gøre rent bord, tage alt bort,drongurin er gingin eftir eini lomvigarók til at reinska øll nátaeggini útav3i ordforb.reinska e-n fyri e-tganske berøve en noget
reinskan	renselse,roynslan er júst tann reinskan, sum okkum tørvar
reinskera	renskære
reinskerari	en som renskærer fiskefilet
reinskering	renskæring
reinskolaður	renskyllet,reinskolað fjørarenskyllet forstrand
reinskrift	renskrift
reinskriva	renskrive
reinskriving	renskrivning
reinskúraður	renskuret,gáttin er reinskúraðdørtrinet er renskuret
reintarvur	(zoo.)rentyr(Rangifer tarandus)
reintonktur	velment
reintvigin	renvasket
reinur	1ren,rein luftren luft;hon mátti ansa eftir, at húsið var bæði reint og ruddað;(ordsp.)lítið batar at breiða reint lak á skitna song,sesong2klar, gennemsigtig,eitt reint nei svíkur ongan3tydelig,reint máltydelig stemme4(musik)reinur tónien ren tone5ublandet, uforfalsket6ubesmittet7uskyldig,hann er reinur fyri tíhan er uskyldig i den henseende8(om sø)fri for skær,í millum steinin og hólmin er reint og djúpt, og tí rógva summir har9afgjort, absolut,reinur meirilutiabsolut flertal;reinur og beiskur veruleikiden rene skære sandhed10(overf.,idr.)halda málið reintholde målet rent11gera reint1vaske, rydde og lignende2(på skib)om rensning af fisk efter fangsten,snørini vóru inndrigin, og menn skuldu fara at gera reint;reinthelt, fuldkommen, ganske
reinvaskaður	renvasket
reion	rayon
reip	reb,gera upp reipopvinde reb;slíta reipiðgå af med sejren,tveir dreingir vilja hava somu gentu, tann, ið fekk hana, sleit reipið;ikki vórðu tað vit bæði, Símun var hann, ið reipið sleit
reipatari	(bot.)remmetang(Himanthalia lorea)
reipsband	bånd el. tyndt reb af hestehår
reipsendi	rebsende,hon bant ein stein upp í reipsendan
reipslongd	et rebs længde(dvs. ca. 8 favne),tað er reipslongd millum húsini
reipstól	redskab til at slå reb og liner
reis1	1(om tid)gang,eina reisén gang;tvær reisirto gange2(i visse udtryk)fødsel,hon hevur so ringar reisirnarhun har strenge fødsler;hitta reisabortere3i ordforb.liggja á reishave i sinde;eg havi ligið á reis at ringja um hattajeg har længe tænkt på at ringe om det
reis2	serísa
reisa1	1gang,tvær reisurto gange2(talesp.)rejse,ynskja e-m góða reisuønske nogen en god rejse
reisa2	tre sammenstillede stykker tørv sat op på skrå til tørring,tey høvdu tríggjar torvur til hvørja reisu, eina undirtorvu og tvær yvirtorvur
reisa3	1få til at stå op, rejse, oprejse, hæve,fjøllini reisa seg ímóti himli høgt;reisa upp;reisa torvsætte tørv over ende;reisa sjógvsætte søen i oprør(fx om vind),streymurin gekk nú í ættina og reisti sjógvstrømmen gik nu i vindretningen og satte søen i oprør;reisa seg (upp)rejse sig op;reisa hárygginhidse sig op;reisa høvurprotestere,kirkjan reisti høvur móti kongi fyri tað ræði, ið hann vildi taka sær yvir henni;reisastrejse sig;teir reistust ímóti teimum útlendsku valdsharrunumde gjorde oprør mod de udenlandske herskere2rejse, opføre, oprette,reisa bátstrække kølen og rejse stævnene;reisa búgvsætte bo;(husbyg.)reisa (hús)sætte tagsparrer op til hus3rejse, sætte i gang4(talesp.)rejse, drage,hann reisti uttanlands nógv árhan rejste udenlands i mange år
reisigildi	rejsegilde
reising	1(husbyg.)rejsning,húsini hava høga reisinghuset har høj rejsning2(båd.)bådens rejsning el. rejsningens dannelse fra køl til stævne,reyst reisingstejl rejsning;báturin hevði lágar reisingar3(ny bet.)vækkelse,hin tjóðskaparliga reisingin í Føroyumden nationale vækkelse på Færøerne
reistur	rejsning, udvikling, fremgang,tjóðskaparligur reisturnational fremgang
reita	tirre, ophidse,reita (e-n) upptirre en;reitastblive vred
reitingarsamur	drillesyg, slem til at tirre
reiv1	1svøb, barnesvøb2(bot.)blomstersvøb, bloster3(zoo.)puppehylster,3-4 vikur seinni krýpur firvaldurin út úr reivinum
reiv2	seríva
reiva	svøbe,reiva barnsvøbe et barn;barnið varð vandaliga reivaðbarnet blev svøbt omhyggeligt
reivabarn	svøbelsesbarn,vera sum eitt reivabarngå i barndom
reivblað	(bot.)svøbblad,smáreivblaðsmåsvøbblad
reivlingur	svøbelsesbarn,tey hava ein reivlingde har et svøbelsesbarn
reivvera	(zoo.)puppe
reka	1drive,reka grind;reka seyðdrive får i fjeldene;reka seyð í rættdrive får i fårefolden;reka smáumdrive får gennem folden for at gøre dem fortrolige med denne;reka av garðivise en bort;hann hevur rikið meg á dyrhan har smidt mig ud;reka (e-n) á gáttvise én døren;(bibl.)hann rak út andarnar við einum orði;reka úr starviafskedige2drive(for strøm el. vind),skøta etur alt, at kjafti rekur;koma rikinkomme drivende;minur komu riknar í báðum støðum;reka av kóskomme ud af kurs;motorurin steðgaði, og vit lógu og róku í fleiri dagarmotoren gik i stå, og vi lå og drev i flere dage;seta seg at rekafiske mens båden driver med strømmen;hann (tað) rekur av norðriskyerne driver for nordenvinden3(om strøm)drive med ret høj og jævn hastighed(i bestemt retning),har rekur nakað hart;tað rak við mígandi ferð(meget stærkt);tað rak sum í ánni(meget stærkt);tað rekur ikkistrømmen har ikke magt til at drive båden;tað rekur norð(ur)strømmen driver mod nord4slå, slå hurtigt og kraftigt,reka nevan á nasarnar á e-mgive (drive) en et næveslag på næsen5drive(fx en virksomhed),reka handildrive handel;reka fiskiskapdrive fiskeri6udøve, udføre,reka politikkføre politik;reka valstríðføre valgkamp;reka ørindiforrette ærinde7(idr.)drible,hann rak frameftir í høgru síðu;hann rak móti málinum8begynde at koge,tað rekur í pottinumvandet viser de første tegn til kogning;hann gjørdi mjølið útá, so skjótt tað var farið at reka í pottinum9reka spott á (e-n)el.reka (e-n) á spottspotte en, forfølge en med spot;øll reka meg á spott;systir hans rekur hann á spotthans søster spotter ham  / /medreka aftur1benægte,stjórnin rak øll leysatíðindi um kvettroynd aftur2vrage, forsmå,áheitanin um eykajáttan varð afturrikinhenvendelsen om tillægsbevilling blev vraget;reka avkomme ud af kurs;reka burtur1skaffe af vejen2skræmme bort, jage3komme ud af kurs,reka burtur av leið;reka framundir (el.uppundir):reka framundir (el.uppundir)hentyde, komme med hentydninger;reka framundir við e-n;reka fránægte at tage til konfirmation(pga. manglende kundskaber),ikki skulu tygum reka mær sonin frá(sagt til en præst);hann varð frárikinhan blev ikke konfirmeret;reka fyri:reka e-m e-t fyri;reka e-t fram fyri e-nforekaste, hånende bebrejde en noget;reka inn:reka naglael.seym innslå en nagle (søm) ind(med kraft);reka ígjøgnumdrive får gennem folden for at gøre dem fortrolige med denne;reka niðurdrive med strømmen,báturin rekur niður á miðið, og teir fyrstu menninir fara at kenna;reka samansamle får sammen,tá saman var rikið, og gongan var komin at bakka, leyp eitt veðurlamb á hjá honum;reka undan(talem.)tað rekur ikki undan okkumvi har god tid;reka uppdrive op på land,líkið rak upp;reka uppundirsereka framundir;reka út1vise nogen døren,hann varð rikin út2jage bort,reka rottur út við royki3drive til havs  / /rekast1flyde(om ting, der ikke er på deres rette plads),órudd liggur og rekst allastaðni2drive, slentre, vanke om,børnini ganga úti og rekast
rekafjøra	strandbred med meget drivtømmer
rekafløska	drivflaske,rekafløska við bræviflaskepost
rekafuglur	(død) fugl der driver på havet,sum teir liggja og reka, kemur ein rekafuglur aftur við borðinum
rekagóðs	drivgods,dragsa saman rekagóðssanke drivgods
rekagrót	sten som man finder ved jorddyrkning o.a. og samler sammen til byggearbejde,henta (upp) rekagrót;hvørja ferð hann fór eftir torvi, tók hann rekagrót upp í leypin
rekahvalur	(død) hval der driver (på havet el.) ind mod kysten
rekaísur	drivis
rekalíkindi(r)	vejrforhold til at søge efter drivtømmer
rekamaður	mand som er ivrig til at samle drivtømmer
rekamina	drivmine
rekapláss	sted hvor der kommer (meget) drivgods,gott rekapláss
rekapostur	flaskepost
rekasteinur	rekasteinarsten som man finder ved jorddyrkning o.a. og samler sammen til byggearbejde
rekastokkur	stok drivtømmer,brúgv løgd av tjúkkum rekastokkum
rekastøð	sted hvor det er almindeligt at finde drivtømmer,ganga í rekastøðgå (langs stranden) for at søge efter ilanddrevet tømmer(drivtømmer)
rekatari	tang som driver op langs med strandbredden,rekatari var eini lunnindi til jørðina
rekatræ	drivende el. ilanddreven træstamme, stykke drivtømmer
rekatunna	drivtønde
rekaviður	drivtømmer,húsini eru gjørd av rekaviðihuset er lavet af drivtømmer;hann hevði bjargað sær væl av rekaviði
rekavætti	vagabond, landstryger
rekaætt	vindretning der bringer drivtømmer
rekaøða	musling(er) der driver op på kysten efter brænding,leita eftir rekaøðu
rekfiskur	(fisk.)vragfisk(Polyprion americanus)
rekfjøður	(tekn.)drivfjeder
reki	drivtømmer,leita eftir rekasøge efter drivtømmer
rekil	1spindegarn der er gået i urede og trukket ud af tenen;jf.snyril (3)2opløben, ranglet fyr,hasin langi rekilin3(bot.)rakle(amentum)
rekja	1opvikle, trævle op(strikkede ting),rekja upptrævle op;rekja línu;rekja snørihaspe en fiskesnøre op;rekja viltrække tyndtarmen ud af slagtet får2(håndarb.)rende(garn)3skildre, beskrive,rekja ætt sínaskildre sin familie
rekkja	1seng,taka (e-n) á rekkjutage nogen på sengen2vægliste hvor man sætter knive, skeer etc.,knívurin stendur í rekkju3krybbe med tremmer foran(til får)
rekkjubundin	sengeliggende(fx pga. sygdom)
rekkjulagstur	sengeliggende(især pga. alderdom),hon er rekkjuløgsthun er sengeliggende
rekkjuváð	uldent sengetæppe,tey eru sum stúka og rekkjuváð(om to som er meget forelskede)
rekkverk	rækværk;jf.jarnverk,træverk
rekmáttur	1(tekn.)drivkraft, drivfjeder2(overf.)drivkraft
rekmegi	(tekn.)drivkraft,tað var einaferð sett at mala, og so mól tað við ongari rekmegi
rekningur	1en som ikke har noget hjem, en hjemløs,hann gongur sum ein rekningurhan er altid på farten,fara á rekningigå på omgang, ikke have fast ophold, farte2lam som er kommet bort fra sin rette græsgang,ein rekningur kom fyri í rakstrinum
rekreim	(tekn.)drivrem
reksa1	lang remse,hann las upp sína gomlu reksu
reksa2	reksa uppopremse,hann lá og reksaði tøl upphan remsede tal op
rekseymur	(båd.)jernsøm i køl og stævn
rekspónur	(husbyg.)det bræt der sidst indsættes i en væg, gulv el. loft,seta rekspónin ílægge sidste hånd på værket(under opførelse af et træhus)
rekstøð	sted hvor det er almindeligt at finde drivtømmer,farael.ganga í rekstøðgå (langs stranden) for at søge efter ilanddrevet tømmer(drivtømmer)
rektari	(skole)rektor,rektari á Fróðskaparsetri Føroyarektor ved Færøernes Universitet
remba	i ordforb.remba segel.særel.rembaststrække sig, strække lemmerne;menninir rembdu seg, stívir í kroppinum, eftir at teir høvdu sitið so leingi og hokið á vøllinum;rembast,(overf.)tað rembdist nógv innan í honumhan var meget ophidset
remban	1stor kraftanstrengelse2gentagen rækken og strækken
rembi	noget man praler af,tað er einki rembi í tídet er ikke noget at rose sig af
rembing	1det at strække sig2svær bølgegang, høj sø,rembing í sjónummeget stor bølge;ongar rembingar vóru í streyminum, so illa sást munur millum streymasjógv og deyðavatn3også(overf.)brydning(uro, kamp),aftur lá hon avvelt á gólvinum, hevði tær undarligastu rembingar á sær;stórar rembingar hava gingið um jarðarskorpuna;samfelagsligar rembingarsamfundsmæssige brydninger;andaligar rembingaråndelige brydninger
rembingartíð	brydningstid,vit liva í eini rembingartíðvi lever i en brydningstid
rembingur	svær bølgegang, høj sø,rættir rembingarmeget store bølger
remma1	(båd.)det smalle bræt hvorpå toftens ender hviler, langrem
remma2	bismag,tað er sovorðin remma við kópaspiki;tað gongur ein remma at tídet har en bismag,ein rom remmadårlig smag
remmuborð	(båd.)det næstøverste bord hvor langremmen (remma) som tofterne er falset ind i nagles fast
remsa1	remse
remsa2	remse
rend1	1løben, løb, fart,gera rend á segsætte fart på, sætte af sted i fart;taka eina rend á segoppe sig2kort besøg, lynvisit,gera eina rend inn á gólviðkomme på en kort visit
rend2	løben, løb, fart,eg gjørdi eitt rend inn á gólvið hjá hennijeg aflagde hende en fransk visit;gera (eitt) rend til Danmarkarforetage en kort rejse til Danmark;flogfarið koyrir fram at taka rend á(dik);rend av fiskisamling af fisk, som søger ind til en fiskeplads;jf.rensl
-rendur	se fxá-,blá-,blóð-,for-,gull-,harð-,heil-,hund-,kvik-,mjúk-,niður-,ov-,seyð-,stív-,trá-,tví-,upp-,út-
rendur1	serond
rendur2	som der kan løbes igennem til el. fra,rókin er rend allan vegin;har er illa rent til hjá seyði og ikki rent frá;jf.óføri (1)
rengur	serong
renna1	1rendesten2tildækket grøft3større afløbsrende4sliske, slisk
renna2	1(om væske)rinde, strømme,vatnið rennur í takrennu;henda áin rennur nógv undir heilum;tað rann úr hvørjari fjøður(dryppede);sveittin rennur úr hvørjum tráðsveden hagler af én;tað rann ikki vatn ímillum teirrade var de fortroligste venner2smelte,spikið rennur so illa(svinder så meget når det koges),renna væl(om spæk, som smeltes)give meget tran3løbe, rende, fare hurtigt,renna kappløbe om kap;eg sá hann fara rennandi eftir vegnum;laksurin rennur niðan í áirnar at gýta;snørið rennursnøren løber ud;skipið rann lættliga undir seglunum4stævne, bevæge sig,streymurin í Føroyum rennur ymsar vegir(bevæger sig i forskellige retninger)5vokse hurtigt op, gro (spire) hurtigt op,hornið rennur;sumt fell millum tornir, og tornirnar runnu upp og køvdu tað6(om tid)gå hurtigt,tíðin rennur;øldir runnu7(om solen)stå op8i ordforb. somrenna e-m í hugel.hugafalde en ind;tað rann fram fyri megjeg kom til at tænke på;spurningurin rann fram fyri hann;minnini renna fram fyri meg;renna e-m í minnifalde en ind;tá rann honum í minni, at...;hvat um vegin rannhvad der gik for sig, hvad man tog sig for;nú rann henni ilt í sinninu blev hun vred;lata reiði rennagive vreden frit løb;hann letur av reiði rennahan giver vreden frit løb;renna møðinahvile;lata møði rennaudhvile sig, puste ud;seyðurin er runnin(er blevet bedækket)  / /medrenna afturgro til igen,hon visti, at brotna beinið rann aftur fyrr ella seinni;renna at:sinnið rann at honumhan blev gal i hovedet;spakuliga rann vitið at hennilangsomt kom hun til bevidsthed igen;renna av:tað rann av honumhan blev ædru;nú er avrunnið;møði av honum ranntrætheden forlod ham;renna e-n avløbe hurtigere end en anden;renna á:tað rann á hannhan blev beruset;møði rennur á hanahun bliver træt;vitið rann aftur á hannel.at honumhan kom til bevidsthed igen, kom til sig selv igen;lata hvíld renna á seg og sita og hugsa(hvile sig);renna eftir:renna eftir (e-m)forfølge (en),renna eftir konufólkijagte damer;renna samansmelte sammen, blive ét,søgn og søga renna saman í eitt;renna samansmelte sammen, falde sammen;tað rann saman aftur millum teirrade blev venner igen;har runnu ástir samande blev forelsket i hinanden;renna samanel.renna saman afturgro sammen, gro til igen;renna undan:renna undan (e-m)flygte for,ótangarnir runnu undan, tá ið løgreglan kom á staðið;kyrrindini runnu undanman forpassede strømskiftet(til en overfart);renna undir:renna undir høggiðlige akkurat nå nogetel.undgå faren i sidste øjeblik;renna upp1vokse hurtigt2renna upp fyri e-mbliveel.stå klart for en;tað rennur upp hjá teimumman har vel nok fået munden på gled(især om sladder);nú rennur upp hjá mærnu forstår jeg ikke mere;dámligt er tað ikki, tá ið sunnan rennur upp við sóldet tegner ikke godt, når en dag med søndenvind begynder med solskin(det bliver regnvejr);renna uppí:báturin rennur uppíbåden er luvgerrig;renna út1spire,setin er útrunnin2udløbe,sáttmálin rennur út á nýggjárinumkontrakten udløber til nytår;renna við:tá rann vitið við megda forstod jeg;renna yvirstrømme over,vatnið rennur yvir í baðikarinum
renna3	1rende, lade rinde,renna niðurspilde, komme til at hælde ned(ved uheld),hann rendi mjólkina í seghan hældte mælken i sig, drak mælken hurtigt2gyde, hælde(hurtigt),hann mangan sveitan rendihan udgød meget blod;renna av (e-m)hælde af;renna løgin av døgurðapottinum3lade løbe,renna eygunilade øjnene løbe, skele, rulle med øjnene, se til alle mulige sider;renna eygum víðase sig vidt omkring;renna garn(ved vævning)rende garn;renna vevordne og tillave væven4støde (heftigt) bort, støde,renna e-n á dyrvise én døren;reiður rendi hann hana burtvred stødte han hende bort;renna e-n um kollstøde nogen omkuld;renna undir (e-n)støde til, skubbe på5bortvise, afskedige, fyre,hann varð rendur6(håndv.)dreje,renna trædreje i træ7lade forsvinde, få til at forsvinde,i ordforb. somrenna møðinael.møðinipuste ud, udhvile sig;lata møðina rennapuste ud;renna reiðinistille sin vrede;mær rendi kenslu á (hann, tað)det forekom mig, at jeg kendte (ham, det)8stikke, bore(en ting igennem en anden),renna ígjøgnum;hann rendi knívin í hannhan stak (med magt) kniven i ham;rennir til hansara við spjótinumstikker til ham med spydet9fire,renna niður(fx får);tað varð rent til báts10sætte af sted i fart,gammurin rendi í loftið upp  / /medrenna ástøde på(imod),renna á landstøde på grund(om fartøj),skipið rendi á land;bilurin rendi á ein garð;renna í:nú renna vit okkum beint í eina grind(fandt vi en flok grindehvaler);renna í botnlade en fiskeline gå helt ned til havbunden;renna ímótistøde imod (nogetel.nogen);renna seg:renna seg fastan1løbe fast, køre fast,hann rendi seg fastan í kavanum2løbe sig en staver i livet
rennan	løben,mong halda, at tað er trampan, rennan og skrálan, sum skapar dansin
rennari	1løber2landstryger3slag, stød,hann gav havrinum ein rennara millum hornini4løber
rennibori	(håndv.)redskab til at rende garn på til vævning
rennibreyt	(idr.)løbebane
rennifjøl	skateboard
rennihjól	løbehjul
rennihurð	skydedør
rennikavaæl	byge med tøsne
rennikavaælingur	byger med tøsne,nú rann alt saman aftur í rennikavaælingi
rennikavi	våd sne, tøsne,(folketr.)tá ið kúgv stendur og sleikir, veit hon rennikava í
rennikrím	(med.)forkølelse med stærk slimafsondring(rhinitis),hon fær rennikrím, serliga um tað dumbar úr hoynum
rennikúla	rendekugle, mindre bøssekugle hvoraf flere lades ad gangen
rennil	1tenring2(zoo.)svinetryne3hoved (glans) på hestepenis4fyr, rad5(tekn.)rotor
rennilás	lynlås
rennimát	(håndv.)skydelære
renning	1løben2passage(for får),vit kunnu ikki teppa renningina hjá seyðinum3rendegarn4det at snøren løber ud,hann fekk tveir í renningini;jf.heinti5renningin, renning aftur og framstrikkemønster
renningarbreyt	(idr.)løbebane
renningarhjól	løbehjul
renningarlag	måde at løbe på,hesturin er viðgitin fyri vakurt renningarlaghesten er berømt for sin smukke måde at løbe på
renningarlop	tilløb,gerael.fáa sær renningarloptage tilløb(til et spring),menn komu við renningarlopummændene kom styrtende
renningarvatn	drypvand(vand som drypper af våde klæder, våde fiskesnører o.lign., ophængte til tørring)
renningur	1den omstændighed at fedtet under kogningen af kød smelter,renningur kemur í2træk af søen frem og tilbage ved stranden, træk af søen ud og ind,renningur inni í bátahylinum3(bot.)udløber
rennisjógvur	træk af søen frem og tilbage ved stranden, træk af søen ud og ind,rennisjógvurin fór við hvørt langt niðan í ánna
renniskræpa	diaré
rennislettingur	(byger med) våd sne, tøsne
rennisót	løbesod
rennistrongur	hejseværk,alt mátti berast, tí eingin rennistrongur var
rennisúgur	træk af søen frem og tilbage ved stranden, træk af søen ud og ind,børnini runnu kapp við rennisúgin
rennitól	(håndv.)drejebænk
rennitrappa	rulletrappe, eskalator
renniælingur	vådt haglbygevejr
rennugravari	rendegraver
rennustokkur	1rende, møllerende,tveir rennustokkar vóru til mylnuna2nedløbsrør (af træ) fra tagrende,tað dryppaði úr rennustokkinum
rennvátur	drivvåd
rensl	1renderi, løben,hetta renslið kann ikki halda fram, børnini verða í ørviti2farten, træk(af hval),á hvørjum ári gjørdi grønlandskópurin stór rensl suður undir Ísland og Finnmørkina;á sumri ger krossnev stór rensl út í onnur lond3mere el. mindre tilfældig sammenstimlen af fisk på en fiskeplads,um summarið er ofta gott rensl av hýsu4begyndende brænding(ved stranden)
rensla	1(ved begyndende brænding ved stranden)brydes(om bølgerne),nú renslarel.nú fer at rensla2renslastrende omkring, strejfe rundt,børnini verða í ørviti, sum tey renslast um húsið
renslsótt	(bibl.)flåd, udflåd,renslsótt og líktrá
renta1	(økon.)rente,renta av samanspardum peningirente af opsparede penge;renta av innlánum og útlánumrente af indlån og udlån;gjalda rentur og avdráttbetale renter og afdrag;(overf.)lata aftur við rentubetale rigeligt tilbage
renta2	forrente,renta segbetale sig
renting	(økon.)forrentning
rentlast	rende omkring, strejfe rundt,ganga úti og rentlast við hinum dreingjunum;rentlast havn úr havn
rentufótur	(økon.)rentefod,rentufóturin er 8%rentefoden er 8%
rentufrádráttur	rentefradrag
rentufríur	rentefri,rentufrítt lánrentefrit lån
rentuinntøka	(økon.)renteindtægt
rentuleysur	(økon.)uden rente,rentuleyst lánlån uden rente
rentumaður	(økon.)rentenyder
renturenta	(økon.)rentes rente el. sammensat rente
renturokning	(mat.)renteberegning
rentuseðil	(økon.)rentekupon
rentuskattur	(økon.)renteskat
rentustudningur	(økon.)rentestøtte
rep	(skib.)reb(i sejl),taka rep ítage reb i sejlene;teir tóku tvey rep niður
repa	1(skib.)rebe,repa seglini1rebe sejlene,hvat sigur tú, repa í hesum Harrans veðri?2(overf.)spænde livremmen ind;fyritøkan hevur repað seglini í seinastuni2(spøg.)blive brysk,hon fór so smátt at repahun begyndte at se brysk ud
repil	rad, række, skare,ein repil av tunnum stóð á dekkinum;við einum repli av dreingjum
repp	1lille fiskeplads2slæng, bande,nú kemur alt reppið(om ubudte gæster)3i ordforb. somverael.standa um (tað) reppiðvære på nippet til;tað var um reppið, at...det var på nippet, at...;tað stendur um reppið hjá teimumde er ved at gå konkurs
reppur	(hån.)skare, flok,nú kemur allur reppurin
ressast	1komme lidt til kræfter igen, blive lidt bedre(om et meget sygt menneske),ressast við;hann ressaðist við av og á, men ongantíð so mikið, at hann fekk skilið2begynde at vågne,hon ressaðist ikki við, hóast tann nógva larmin
rest1	stærk strøm, havstrøm
rest2	rest
resta	mangle,enn restar okkum nógv;restael.resta áel.resta ímangle i;hann fekk tað, ið áel.í restaði
revagarður	rævefarm
revil	1strimmel2liste, smalt og aflangt stykke træ som ved husbyggeri lægges uden på en sammenfalsning
revla	1forsyne med lister uden på sammenføjninger2lette, blive klarere,hannel.tað revlar í mjørkanumel.mjørkantågen letter
revlaklæðing	beklædning med sammenføjninger uden på et hus
revolvari	revolver
revsa	revse, straffe,revsa e-n fyri e-trevse nogen for noget;revsa óargaligt barnstraffe et uartigt barn
revsast	komme lidt til kræfter igen, blive lidt bedre,revsast við aftur
revsiarbeiði	(jur.)strafarbejde
revsidómur	(bibl.)straffedom,við stórum revsidómum
revsifangi	(jur.)straffefange
revsilóg	(jur.)straffelov
revsimál	(jur.)straffesag
revsing	straf, revselse
revsirættur	(jur.)strafferet, kriminalret
revsitiltak	straffeaktion,seta revsitiltøk í verkiværksætte straffeaktioner
revsitollur	straftold
revsiverdur	(jur.)strafbar,revsivert virksemistrafbar aktivitet
revskinn	(vulg.)rævepels, slyngel,títt revskinndin rævepels!
revsmaki	en der er snu som en ræv,revsmaki hevði hann altíð borið orðið fyri at vera
revtík	(zoo.)hunræv(Vulpes vulpes),revtík leggur bert eina ferð um áriðhunræven får blot unger en gang om året
revur	1(zoo.)ræv(Vulpes vulpes),(leg)renna rev;revur er komin í hagan(siges når solen om foråret igen skinner så stærkt, at skyernes skygger aftegner sig tydeligt på jorden)2lumsk person,hann er ein sovorðin revurhan er sådan en lumsk person3pigejæger, skørtejæger
reydleittur	rødlig
reydligur	rødlig,reydligur lituren rødlig farve
reydlingar	(med.)røde hunde(rubella)
reydlitaður	rødfarvet
reydlittur	rødfarvet
reyðadeyði	i ordforb.fletta í reyðadeyða;(ved fåreslagtning)tilsøle skind og ydersiden af fårekroppen med blod,hetta hevur tú flett í reyðadeyða
reyðagras	rødligt græs
reyðakkuleya	(bot.)trævlekrone(Lychnis flos cuculi)
reyðargull	det pureste guld,eg trúði upp á hann sum reyðargulljeg troede ham fuldt og fast;goyma sum reyðargullgemme som sin øjesten
reyðaviður	mahogni,borð úr reyðaviðimahognibord
reyðber	(bot.)1røde bær på flere planter2fruebær(Rubus)
reyðbláur	rødblå, lilla,myrkar myndir móti hinum reyðbláa loftinum;vakur reyðbláur tarismuk rødblå tang
reyðblomstur	(bot.)pragtstjerne
reyðbotnaður	(skib.)med rødmalet stribe i vandgangen(ved forstavnen),reyðbotnað slupp;jf.hvítbotnaður
reyðbók	(bot.)blodbøg
reyðbrúnur	rødbrun
reyðdæmdur	1rødmosset, rødkindet,hann var reyðskeggjutur og reyðdæmdurhan var rødskægget og rødmosset2med rødligt skær,eldurin beitti eina reyðdæmda hálvalýsing út um roykstovuna
reyðfiskaeyga	(meget) lille fiskeplads hvor rødtorsk opholder sig
reyðfiskaleið	den del af søen (nærmest kysten) hvor rødtorsken opholder sig,skipið sigldi inn á reyðfiskaleið
reyðfiskamál	(spøg.)elendig sangstemme,hann hevur reyðfiskamál
reyðfiskaprógv	(spøg.)kystskipperbevis
reyðfiskaskipari	(spøg.,ironi)kystskipper
reyðfiskur	(fisk.)rødtorsk,inni á reyðfiskiinde ved land;sita við snøri á reyðfiski
reyðflekkutur	rødplettet,reyðflekkut holdrødplettet hud
reyðgrann	(bot.)rødgran(Picea abies)
reyðgulur	rødgul,nev og bein eru reyðgulnæbbet og benene er rødgule
reyðgyltur	rødgylden,heit og reyðgylt skínur sólin yvir bygdina;reyðgyltar sólstrálurrødgyldne solstråler
reyðhani	i ordforb.nú gelur reyðhani í eystrinu er solen ved at stå op
reyðholdaður	rødhudet,teir reyðholdaðu indiánarnirde rødhudede indianere, rødhuderne
reyðhúgva	rød færøsk hue,í reyðhúgvu og hvítbotnaðum gummiskóm
reyðhærdur	rødhåret
reyði	æggeblomme, blomme
Reyðikrossur	Røde Kors
reyðiviður	mahogni,reyðiviður var sterkasti viður, ið rekandi kom
reyðkál	(bot.)rødkål(Brassica oleracea capitata rubra)
reyðkembingur	(zoo.)nordkaper(Balaena glacialis)
reyðklæddur	rødklædt,ein bæriligur, reyðklæddur maður kom ríðandien høvisk, rødklædt mand kom ridende
reyðknokkur	(spøg.)rødhåret person,hetta var ein av teimum ungu, ein reyðknokkur
reyðkollur	(ornitol.)gråsisken(Carduelis flammea)
reyðkot	(fisk.)lille rødtorsk
reyðkrit	rødkridt
reyðleykur	(bot.)rødløg(Allium cepa)
reyðlista	rødliste, sætte på en rød liste(fx planter, dyr)
reyðlitaður	rødfarvet,grasið á mýrunum er nakað reyðlitað
reyðlittur	rødfarvet,hennara reyðlitta andlit glógvarhendes rødmossede ansigt lyser
reyðmaðkur	(zoo.)regnorm(Lumbricidae),tá ið reyðmaðkurin skríður omaná, er hann vissur at fara at køla í veðrinum;(talem.)liggja sum reyðmaðkur á rósindø på stedet,tarvurin lá sum reyðmaðkur á rósin
reyðmaður	rødhud, indianer
reyðmálaður	rødmalet
reyðnasaður	rødnæset
reyðoygdur	rødøjet
reyðpílur	(bot.)purpur-pil(Salix purpurea)
reyðprikkutur	rødprikket,alt andlitið reyðprikkut og skriðin hareftir
reyðpuntutur	rødternet
reyðrandaður	rødrandet,reyðrandað eygurødrandede øjne
reyðrognkelsi	(fisk.)hanstenbider
reyðrót	(bot.)rødbede(Beta vulgaris var. rubra),súltaðar reyðrøtursyltede rødbeder
reyðryggjutur	med rød ryg,reyðryggjutur kálvur;reyðryggjut kúgvrød ko med anderledes farvet, især hvid ryg
reyðrygna	(zoo.)hestemusling med rød rogn(en hun)(Modiola modiolus)
reyðskeggjutur	rødskægget,reyðskeggjutur maðuren rødskægget mand
reyðskortaður	rød i ansigtet
reyðsmæra	(bot.)rødkløver(Trifolium pratense)
reyðsokkur	rødstrømpe
reyðspógvi	(ornitol.)kobbersneppe(Limosa limosa),reyðspógvi er minni enn spógvikobbersneppe er mindre end spove
reyðsprøka	(fisk.)rødspætte(Pleuronectes platessa)
reyðtari	(bot.)rødalge
reyðteinutur	med røde striber på langs,reyðteinutum skjúrti og stimatroyggju
reyðtomba	(fisk.)rødnæb(Labrus bimaculatus);jf.blátomba
reyður	1rød,reyður liturrød farve;við reyðum kinnumrødkindet;fjøllini stóðu so gløðandi reyð;leygardagurin reyðipåskelørdag,teir eru sum tvær reyðar kýrde er fjender, tåler ikke synet af hinanden;reyður haniild;reytt ljósrødt lys(en af farverne på et trafiksignal),(idr.)fáa reytt kortfå et rødt kort;ikki eitt reytt oyraikke en rød øre;reyður í rustirød af rust;reyði tráðurin í e-mden røde tråd;roynael.dyrgja eftir reyðumfiske rødtorsk;stinga niður fyri reyttfiske rødtorsk2(pol.)rød, venstreorienteret,teir reyðukommunister (og socialister)3(zoo.)reytt undir steinirød mide på strandklipper(Acarus litoralis)
reyðviðaður	(om træ)begyndt at rådne,hatta er reyðviðað
reyðvingul	(bot.)rød svingel(Festuca rubra)
reyðvín	rødvin
reyðæti	(zoo.)vandloppe(Calanus finmarchinus)
reyk	serúka
reykur	kam på hane el. høne,hanin legði reykin á liðina
reyla	1gå og drive,hann gongur og reylar húsanna millum og hevur hvørki klæði ella pengar2være i vejen3rave,ein og annar kom reylandi út úr vertshúsinum;tað er ikki meir, enn hann reylar á beinunum(om en fuld mand)han kan knap nok holde sig på benene
reyn	stengrund, stenet højdedrag
reyp	1pral, brovten, praleri2pralhals,hann hevur altíð verið eitt reyphan har altid været en pralhals
reypa	prale, brovte,reypa av nøkrumprale af noget;tað er einki at reypa avdet er ikke noget at prale af
reypan	pral, praleri,tað nógva var skrøgg og reypandet meste var skryderi og pral
reypari	pralhals
reypsamur	(bibl.)pralende,reypsom menniskjupralende mennesker
reyputur	pralende,hann var nakað reyputurhan var temmelig pralende
reyst	røst, stemme,mikil reysten dyb røst
reystiliga	tappert, kækt og kraftigt
reystkappi	tapper helt, stærk kæmpe
reystkempa	stærk kæmpe, vældig stærk mand
reystleiki	1tapperhed, raskhed,teir eru tiltiknir fyri reystleikade er kendte for deres tapperhed2høj, rank og kraftig figur
reystligur	(temmelig) tapper, rask og kæk,hann sýndi slíkt dirvi og reystligan atburð, at fólk fekk virðing fyri honum;rødd tín í fyrndini reystlig og snjøll;reystligur høvuðburðurtapper holdning;-ligatappert, kækt og kraftigt,menninir løgdu árarnar reystliga í sjógvin
reystmaður	(poet.)tapper helt
reystmansligur	tapper, kæk,hann var reystmansligur og sterkur á at lítahan var tapper og stærk at se til;-liga
reystmenni	tapper helt,hatta man vera eitt reystmennidet er vist en tapper helt
reystmæltur	med kraftig stemme, højrøstet,hin reystmælta kempaden højrøstede kæmpe
reystna	styrkes, komme sig,hann er reystnaðurhan har det bedre nu,eisini hesaferð reystnaði hon aftur og orkaði út fyri dyr
reystnasutur	kæphøj
reystur	1stærk, kraftig2kæk, tapper3stejl,reyst bergen stejl klippevæg;stigarnir eru so reystirstigerne er så stejle4høj og rank,við reystum høvuðburðimed høj og rank holdning5(båd.)med buet rejsning,báturin er heldur reystur
reystvaksin	(poet.)høj og stejl,reisa seg reystvaksnir tindar av skørðum
reyt	serjóta
reyv	1røv, bagdel(podeks),venda e-m reyvikke ville høre efter nogen;(spøg.)set reyvina í trætag plads!2buksebag,(talem.)koma aftur ongul í reyvkomme tomhændet tilbage fra fiskeri3endetarmsåbning, anus4(på skib)hæk,afturi á reyv5ende af læggekartoffel modsat spirerne(blev undertiden skåret af og spist)6stodder, stymper,(vulg.)nú skal hvør reyv hava skip7(vulg.)tår, dråbe,ein reyv av víni er eftir í fløskunider er en tår vin tilbage i flasken8i ordforb.ganga eftir reyvgå baglæns;tað gongur eftir reyvdet går skidt, der er ingen fremgang;(vulg.,talem.)ikki eiga reyvina íel.á sær sjálvumvære ludfattig;fáa fótin í reyvina1få et spark bagi2(overf.)få afsked på gråt papir;(vulg.,talem.)skíta av einari reyvvære meget samstemmige
reyvarbøllur	balde el. balle
reyvarfall	fald på bagdelen,fáa reyvarfall
reyvarfíl	(mar.,spøg.)i ordforb.fíla reyvarfílvende ryggen mod lønningen mens man hiver i snøren(tegn på liden fangstiver)
reyvargrein	mellemrummet mellem balderne
reyvarhol	1røvhul, anus2(vulg.)røvhul, dumt svin, lort,títt reyvarhol!dit røvhul!
reyvari	(vulg.)røvpuler, bøsse
reyvarlummi	baglomme,í reyvarlummanumi baglommen
reyvarringur	røvhul, anus,(vulg.)tín reyvarringurdit røvhul
reyvarsíður	med hængende buksebag
reyvast	(vulg.)ligge og rakke om(kring),ganga og reyvast uppiígå og pusle med noget
reyvfíl	(mar.,spøg.)vende ryggen mod lønningen mens man hiver i snøren(tegn på liden fangstiver)
ribbaldakendur	balstyrig, ustyrlig
ribbaldi	vild krabat, selvrådig og ustyrlig dreng, vildbasse
ribbaldur	vild krabat, selvrådig og ustyrlig dreng, vildbasse,teir eru sannir ribbaldarde er nogle rigtige vildbasser
ribbingsveður	koldt og stormende vejr(især om efteråret)
ribbingur	storm og uvejr med kulde,ribbingur í sjónumoprørt sø
ribes	(bot.)ribsbusk
ribesrunnur	(bot.)blod-ribs(Ribes sanguineum)
ribs	(bot.)1ribsbusk2ribs
ribsber	(bot.)ribs
ribsberjarunnur	(bot.)have-ribs(Ribes rubrum)
ribsrunnur	(bot.)ribsbusk
riddarakrossur	ridderkors
riddarakvæði	riddervise
riddaraligur	ridderlig,riddaraligur í atburðiridderlig i optræden;-liga,hann kysti riddaraliga hond hennara
riddaralop	(skak)reglerne for springerens bevægelse
riddaraskák	(skak)skak ved hjælp af springeren,riddaraskák bøtist ikki(kan man ikke forsvare sig imod)
riddarasøga	(litt.)riddarasøgurriddersagaer
riddari	1ridder2(skak)springer i skakspil340 riddarar9. marts(som vejret var den dag skulle det være de næste 40 dage)4ridder,sláa til riddaraslå til ridder
ridla	1vakle, slingre,hann ridlaði á beinunum sum ein fullur maðurhan slingrede som en beruset2fordrejes
ridlingarsamur	ustøt, som let vælter
ridluskriði	(med.)smittende sygdom blandt får(encephalitis spongiosa)
ridlutur	1ustøt, som let vælter2som let krænger,ridlutur bátur
rið1	1anfald af uvejr,eitt ringt rið av landnyrðingi norðri2anfald af smerte,áður enn riðini eru á hana komin, eigur hon sveinsbarninden fødselsveerne kommer, føder hun et drengebarn3periode med drikkeri,við hvørt komu long rið á hann4til riðis(om båd)til at vippe, balancere(på lunnur),teir fingu bátin uppá til riðis, men so ikki meir
rið2	(om ko)i ordforb. somverael.ganga á riðivære tyregal;kúgvin misti riðiðkoen tabte tyrens sæd
riða1	1stå (ligge) usikkert, vakle,riða ásvaje;mitt á gólvinum stóð ein stólur og riðaði á trimum beinum(vaklede);ein kensla, sum riðaði millum øvundsjúku og øgiliga andstygden fornemmelse, som vekslede mellem misundelse og frygtelig afskyelighed;riða við høvdinumvrikke med hovedet;tað stendur og riðardet er på nippet til at falde2få til at vakle
riða2	ri, knytte, filere,riða nótel.netri et net;netið er rutt;riða niðurstrikke løst,hon ruddi bulin niður
riðandgerð	(fys.)kædereaktion,kjarnorkuspreinging fer fram sum riðandgerðatomsprængning foregår som en kædereaktion
riðil	1rad, række, flok, opstillet i rad,ein riðil av børnumen flok børn;ein riðil av treytumen mængde betingelser2(idr.)heat
riðin	seríða
riðinál	nål til at knytte garn med
riðingarnál	nål til at knytte garn med
riðis	serið
riðmaður	rytter
riðsæri	ridesår el. ømhed i sædet af langvarigt ridt uden sadel;jf.gongurisali
riðul	1rad, række, flok, opstillet i rad2(idr.)heat
rifla	riffel
riflukúla	riffelkugle
rifluskot	riffelskud
rigga	1berede, forberede,rigga tillave til;rigga skip tilgøre sejlklar, sejlfærdig;skipið varð nú riggað til at veiða svartkjaftskibet blev udredet til fiskeri efter sortmund;rigga seg tiltræffe forberedelser, udruste sig(især til forestående rejse el. arbejde),(overf.)fikse sig op,hin gamla hevur riggað seg til;rigga av1(på skib)gøre klart til hjemrejsen,skipið var avriggað2afslutte(et arbejde)2i ordforb.rigga væl1(fx om tøj)passer el. sidder godt,kjólin riggar væl uppi á hennihendes kjole sidder godt2(om personer)tager sig godt ud,bæði rigga tey vælbegge tager sig godt ud3gå godt,hetta riggar væl3fungere, virke,fáa e-t at riggafå noget til at fungere;motorurin riggarmotoren fungerer
riglast	(om køer)blive tyregal, løbe på ryggen af en anden ko,kúgvin hevur riglast alt summar
rigna	1regne,nú rignir á meg;hann er farin at rignadet er begyndt at regne;(ordsp.)rignir á prestin, dryppar á dekninnår det regner på præsten, drypper det på degnen2(overf.)drysse, strø,har rignir altíð niður(sten fra klippevæg)
rigningur	(skib.)rigning
rikin	sereka
riklingskast	sammenhængende strimler af riklingur
riklingur	helleflynder skåret i strimler og derpå tørret
rilta	1dingle2rokke,hellan fyri gáttini, hon riltar enn
rim	1tremme,turka við rimartørre korn i tremmehus2(båd.)rimindet øverste bord
rima	sætte tremmer i(fx "leypur" og "hjallur");rimaðurmed tremmer;húsið má hava gott, rimað gólvhuset må have godt gulv med tremmer
rimaborð	tremmebord
rimabúr	tremmebur
rimagarður	tremmestakit
rimagirðing	tremmestakit,útveggirnir eru burturtiknir og ein rimagirðing komin afturfyri
rimahjallur	forrådshus, tremmehus, udhus
rimahurð	tremmedør,har var rimahurð fyri og heingilás
rimaleypur	leypur med tremmer,mods.tættleypur
rimaportur	gitterlåge, gitterport
rimasong	tremmeseng
rimatjald	persienne
rimatrog	træfad af tremmer(til uldvask)
rimaveggur	tremmevæg,onnur síðan á neystinum var stoypt, men hin var rimaveggur
rimaverk	gitter
rimil	smalt sund mellem to skær el. mellem et skær og land
rimmar-	betydelig, betragtelig, rigtig stor, overordentlig,ein rimmarveitslaen super fest
rimmarfastur	aldeles fast, ikke til at rokke,línan stendur rimmarføst í botnilinen er aldeles fast i bunden
rimpa	sammenkrympe,rimpa samanrimpe sammen;hon rimpaði munnin saman;rimpa afturstoppe skødesløst
rimpil	(båd.)båd der let kæntrer
rimpilsi	(hos kvinder),stærk momentan sanselighed, nymfomani
rin1	hvinen, piben, klynken,við rin og hvinmed hvinen og piben
rin2	(fys.)induktion
rina	(fys.)inducere
rinda	el.1betale,rinda skuldbetale gæld;rinda afturtilbagebetale2fordrive, forjage,rinda møðinael.møðinihvile, puste;rinda av særhvile ud;børn rinda av sær so skjótt
rindan	betaling
ringa	el.1bøje i ring, sammenbøje, krumme,ringa línurinke en line op;teir ringaðu línuna niður;hundurin ringaði halan;ringa seg samankrumme sig sammen2hule,hann ringaði eitt stórt stykki (innan) úr tjónum
ringafesti	(bibl.)kæde
ringan	med lethed, sagtens, nok,hann kemur ringan afturhan kommer såmænd nok igen
ringast1	forværres, blive værre,veðrið ringaðist í hvørjumvejret blev værre og værre;hon fekk eina sjúku, ið ringaðist meira og meira
ringast2	sagtens, nok,hann er ringast farinhan er nok gået
ringbind	ringbind
ringbreyt	ringvej
ringbrósk	(biol.)ringbróskiðringbrusken(cartilago cricoidea)
ringferð	kredsløb,ringferð lívsinslivets kredsløb
ringgongd	cirkelbevægelse
ringhyrntur	(om en vædder)med stærkt krummede horn
ringiklokka	ringeklokke
ringing	ringning
ringja1	1bøje i ring, sammenbøje, krumme,kettan ringdi halan uttan um seg;ringjastel.ringja seg samankrumme sig sammen, vride sig,ringja seg um (e-n)danne ring omkring, omslynge, omslutte;ringdurbøjet i ring;ringja niður (línu)kvejle;ringja upplægge i ringe;snørið má ringjast upp, so hvørt sum maðurin dregur;ringja inniindestænge,hesin streymur ringir inni ein part av Atlantshavinum2(om fugle ved fuglefjeldet)flyve i ring, kredse,fleygasessirnir eru, har sum mesti lundin ringir framvið
ringja2	1ringe, kime,telefonin ringirtelefonen ringer,(skole)ringja innringe ind;ringja útringe ud,(kirk.)ringja tilringe tredje gang (til kirke),nú ringir fyrstu, nú ringir aðru, nú ringir til;(kirk.)ringja frá (kirkju)slå bedeslag;ringja samanringe tredje (og sidste) gang til kirke;nú ringir saman, og alt í einum vóru tey ávegis til kirkju:ringja jólini inn;klokkan ringirklokken ringer2suse,tað ringdi fyri oyrunum á honum3telefonere,ringja til e-ntelefonere til nogen
ringkópur	(zoo.)ringsæl(Phoca hispida)
ringla1	rangle,barnið spældi við eina ringlubarnet legede med en rangle
ringla2	1ringle, klingre, rasle,tað ringlaði hvør tonntænderne klaprede (af kulde);ringla við lyklumringle med nøglerne2(leg)rasle med terninger (i bæger),tú eigur at ringla
ringlan	raslen
ringleið	kredsløb,ringleið lívsinslivets kredsløb
ringleikhús	amfiteater
ringlomvigi	(ornitol.)lomvie med hvid cirkel omkring øjet
ringmerkja	(ornitol.)ringmærke(fugle)
ringnót	(mar.,skib.)snurpenot
ringongul	fiskekrog med øje
ringrás	(fys.)kredsløb,rúmdarfarið er farið í ringrás um jørðina
ringreið	karrusel
ringrensl	kredsløb
ringrørsla	cirkelbevægelse
ringskapaður	ringformet
ringur1	1ring, fingerring,hava ring á fingriel.armibære ring;(om to)taka ring uppásætte guldring på (venstre) ringfinger som tegn på forlovelse2ring, kreds, rundkreds,í ringi ring, i kreds;lundin flýgur í ring;sláa (í) ringforme en rundkreds til dans, idet alle de dansende tager hinanden i hænderne3fællesskab,lesiringurlæsekreds
ringur2	1meget syg,hava ringa heilsuhave et dårligt helbred;øll vóru ring av sjóverki;ringur eftir seghave tømmermænd;hava ringt høvdhave en slem hovedpine;hava ringa samvitskuhave dårlig samvittighed2ringe, dårlig, værdiløs,ring eplidårlige kartofler;kjøtið er ringt í ár3slem,ringt veðurdårligt vejr;tað gingu ring kavaæl;ringur sjógvuroprørt sø;hann hevur ikki verið so ringt á sjógvhan har aldrig været på søen i så dårligt vejr;ringar tíðirsløje tider, dårlige tider;tíðirnar vóru ringar;ringt skildårlig tilstand;ringt var við oljuder var ikke megen olie4slet,hava ringan munnhave en beskidt mund;koma húsinum í ringt orðbringe vanry over familien;eingin skal sigast ringur fyri tað;eingin skal siga hann ringan fyri taðingen skal dadle ham for det, ingen skal bebrejde ham det;ring tungauheldig tunge,hava ringa tungu;ring eygu1dårlige øjne2onde øjne5begærlig efter noget,ringur eftir verðinibegærlig efter verdens gods;tey vóru so ógvuliga ring at dansa(ville så gerne)6vanskelig,ringur at fáast viðikke medgørlig;hann er ringur at koma í takholt viðhan er svær at komme i kontakt med;roknistykkini eru so ringregnestykkerne er hundesvære7sorgfuld, bedrøvet (over), ked (af),ringur um e-nel.e-t;nú skalt tú ikki vera so ring um hetta;ring tíðindijobspost8ufarbar, uvejsom, ufremkommelig,har er so ringt umman kan knapt nok komme frem der
ringvegur	ringvej
ringvøddi	(biol.)ringmuskel(musculus orbicularis)
rinka	1vakle,tonnin rinkartanden er løs;rinka aftur og framvakle frem og tilbage2bevæge, rokke, flytte lidt,kanska ber til at rinka steinin leysan
rinkuliður	(biol.)glideled
rinstreymur	(fys.)induktionsstrøm
rintól	(fys.)induktionsapparat
rip	lussing, huskekage,hon gav honum eitt riphun gav ham en lussing
ripa	1afrive aks fra strået,ripa korn;fyrr í tíðini varð akurin ripaður í hond2slynge, slå hurtigt og kraftigt, slå til,ripa tilhugge kraftigt til;hon ripaði til mín, og nú er nøsin dupult so stór, sum hon eigur at vera;ripa niðurslå ned, fælde;ripa hurðina aftursmække døren i;hann ripar hornið á aftur og ferhan smækker røret på telefonen og går sin vej;ripa nevan í borðiðsmække hånden i bordet3kaste, smide, slænge,hann ripaði ferðaskrínið út í tún;hann ripar seg úr troyggjunihan flår trøjen af;ripa uppbygge i en fart4strikke flittigt og hurtigt,situr og ripar eina ermu fyri og aðra eftir
ripari	redskab hvormed aksene rives af strået,nú vóru allir riparar av jarni, men fyrr høvdu teir verið gjørdir av hørðum træ
riping	afrivning af aks fra strået,við ripingina máttu helst vera trý fólk
rippa1	mandgal pige
rippa2	rykke hastigt, snuppe,rippa e-t til sínsnuppe noget;hann ripti stavin úr hondunum á mær
rippa3	rippa húkarfastgøre fiskekroge til langlineforfang(teymar)
rippast	rippast eftir (e-m)løbe gal efter mandfolk
rips	(bot.)1ribsbusk2ribs
ris	1rejsning2skummen af bølger, pludselig brænding i stille vejr3(håndv.)hældningfxpå trappe
risa-	1jætte-, kæmpe-2kæmpestor, gigantisk
risagleiv	syvmileskridt
risahøgur	meget høj, kæmpestor
risakelling	troldkælling, heks
risakendur	jætteagtig, enorm, voldsom,risakend tramp og traðk
risaklapp	alt for voldsomt klap(kærtegn),hansara kín vóru oftast sum risaklapp
risakona	1jættekvinde, gyge2jættes kone
risaligur	kæmpestor, jætteagtig,risaligur tóktist hann vera bæði í útsjónd og skapi
risamikil	kæmpestor, kolossal
risastórur	kæmpestor, kolossal
risavaksin	kæmpestor, kolossal,ein risavaksin náhvaluren kæmpestor narhval
risaveldi	stormagt, supermagt
risi	1(folketr.)jætte2kæmpe, meget stor og høj mand
riskandi	i ordforb.riskandi ódnrasende uvejr(især om brænding)
riskur	rust(plet),har var ikki ein riskur á
risla	ridse, indridse(løselig);jf.rísla
rispa	kradse, rive
rist1	vrist(på fod)
rist2	rist(spec. til bagning el. stegning),steikja úti á riststege udenfor på rist
rist3	rysten,eg kendi knappliga eitt øgiligt rist í øllum skipinum
rista1	1ryste, skælve, dirre,hann situr og ristir av illsinnihan skælver af vrede;hann risti á røddinihans stemme skælvede,ristast á hondunumryste på hænderne2ryste, ruske, få til at ryste,rista við høvdinumel.rista høvdinumryste på hovedet;rista (e-t) av særryste (noget) af sig;rista kavan av sær;(overf.)rista letina av sær;rista e-n tilryste en hårdt3sprede (nyslået) græs til tørre, ryste hø;rista um(fx om høstak)rive ned og opføre på ny
rista2	ridse, skære, riste,rista ein svullskære en byld;rista fótamør(ved slagtning af får)afskære mavedækket;rista niðurfyriel.rista fyriridse før man skærer (fx spæk el. fåreskind, før man begynder på flåningen);rista rúnirhekse;rista gandel.illgerningarøve trolddom;rista kross fyri særgøre korsets tegn,rista fyri(ved spadegravning)opridse grønsværen
rista3	riste,rista breyðriste brød
ristari	redskab til opridsning af grønsværen
ristarreim	(på træsko),rem tværs over vristen
risthentur	som ryster på hænderne
ristilsi	rysten,eg fekk ristilsi, tá ið eg hoyrdi tað;hava ristilsi í kroppinum;hetta vanlukku ristilsi
risting	1udrystning (spredning) af græs (hø),nú er ristingin eftir2rystelse, dirrende bevægelse
ristleggur	(biol.)mellemfodsknogle el. mellemfodsben(ossa metatarsi),í fótinum eru 5 ristleggir
ristmæltur	med skælvende stemme,hann var bæði hásur og ristmæltur
riststeikja	riste
rit	1skrift, værk,eitt forvitnisligt rit um kvæðaskald okkaraet interessant skrift om vores kvaddigter2det at skrive,(poet.)flestra manna lív er rit í moldum(noget som let forgår)
rita1	(ornitol.)ride(Rissa tridactyla),(talem.)tigur ikki heldur enn ritan í berginum (el.á Kalsvík)kan aldrig tie stille;sum ein piðað ritaradmager
rita2	skrive,(poet.)navnið veit eg eitt í klettum ritað
ritari	skriver, sekretær
ritbera	skrive, formulere skrifligt
ritbering	formel
ritbúnaður	(datal.)software, programmel
ritdómari	(litt.)kritiker, anmelder
ritdómur	(litt.)kritik, anmeldelse
ritfrælsi	(jur.)ytringsfrihed
ritgerð	afhandling,nógvar lærdar ritgerðir eru um evniðmange lærde afhandlinger handler om emnet
rithøvundafelag	forfatterforening,rithøvundafelag FøroyaFærøernes forfatterforening
rithøvundur	forfatter
ritil	(datal.)editor
ritlingur	pjece
ritminni	(datal.)ram,ritminnið í telduni er 32 Mbcomputeren har 32 Mb ram
ritmynd	kurve, graf
ritroynd	(litt.)essay
ritsavn	(litt.)samlede skrifter
ritskoðan	censur
ritstjóri	redaktør
ritstjórn	redaktion
ritstjórna	redigere,ritstjórna eina orðabókargreinredigere en ordbogsartikel;ritstjórna mentanarteigi í blaðiredigere en kulturspalte i avisen
ritstjórnan	redigering
ritstýra	redigere
rittin	slagfærdig
rittinorðaður	slagfærdig
ritual	(kirk.)ritual
ritubátur	(skib.)lille skibsbåd(anvendt til ridejagt)
rituberg	fjeld hvor rider yngler,málanin er sum í ritubergi
ritufella	fælde til at fange rider i
ritufjøður	ridefjer,fátæk fólk leitaðu fram við vøtnunum at henta ritufjaðrar at selja
ritugákan	rappende lyde fra rider
ritugól	skrig fra rider
ritupisa	(ornitol.)rideunge
ritureiður	riderede,ritureiður er so sterkt, at tað heldur væl at stíga á
riturók	fjeldhylde hvor ride yngler,sum á riturókmeget højrøstet tale
rituræ	1kroppen af en (død) ride2meget mager krop, magert menneske,hetta er tað rituræið, ið er
ritusnara	fælde til at fange rider i
rituungi	(ornitol.)rideunge,summastaðni síga teir eftir rituungum
Rituvík	(stedn.)bygd på øen Eysturoy,í / úr Rituvík,til Rituvíkar
rituvíkingur	person iel.fra bygden Rituvík
ritverk	(litt.)(bog)værk
ritøld	(litt.)tiden efter skriftens indførelse, perioden efter ca. 1100(i islandsk litteraturhistorie)
riv1	1(biol.)ribben(costa),(overf.)lata fara út ímillum rivinisige noget indirekteel.i vrede2rev, smal banke i søen tæt ved land,tvørtur um víkina gongur eitt riv
riv2	1rivning,í fáum bygdum er so veðurgott, at riv kemur ongantíð á tekjurnar2urolig sø,riv í sjónum;tað kom riv í sjógvinsøen begyndte at blive urolig, at gå højt3dyb gravning i jorden
riva1	1rift, revne, sprække2klipperevne
riva2	1danne en revne, sprække, gøre en lille åbning,riva fyri degiblive dag;tað rivaði fyri eygunum á honumhan åbnede øjnene ganske lidt;tað var ikki meir enn tað rivaði fyri eygunum á honumhan kunne knap nok holde øjnene åbne(især om en, der lige er vågnet),riva fyri e-mblive klart for en,nú rivaði ein øgn av vón fyri henni2ri, rimpe,vaðmalsstykkið var rivað við grovari nál;riva samanrimpe sammen
rivin	sønderrevet, forrevet,rivin og skræddurlaset og forrevet
rivja1	(med.)en hudsygdom hos børn(impetigo),fyri rivju vaskaðu tey við jarðarsipan(husråd)
rivja2	skære ribben af siden på en (tørret) fårekrop,(folketr.)eingin skal rivja kjøt (síðu) á sjógv
rivja3	i ordforb.rivja á(om bølger)bryde (skumme) i toppen,tað rivjar á boðanum
rivjabein	(biol.)ribben(costa);(overf.)fyrr fer tað millum rivjabeinini, enn hann kann tiga við tí
rivjablað	forreste ende af et ribben,mods.rivjatrólpur
rivjabugur	et ribbens krumning
rivjalangur	med lange ribben
rivjast	(med.)have udslæt(om børn)
rivjatrólpur	bageste ende af et ribben(mod ryghvirvlerne),mods.rivjablað
rivna	revne,jørðin rivnaðijorden revnede;tey vóru um at rivna í látride var ved at revne af grin
rivtráður	tråd hvormed tøjet hæftes til bommen
rivudalur	(geol.)sprækkedal
rivulag	(geol.)lamelzone
rivumyrja	(geol.)forkastningsbreccie
rivur	bom(i den gamle opretstående væv),barmurin er uppi á rividet som er vævet, er på bommen
rivutur	med revner, revnet,rivutur vegguren revnet væg;lendið er rivut
ríð	1hårdt anfald af uvejr, stærkt snefog,gera ríðblive uvejr med snefog, slå over i snefog fra regn,hann gjørdi ríðder indtrådte stærkt snefog2salve(af skydevåben),ríð av skotumanfaldel.regn af skud3anfald af veer,livimátin er vánaligur, tá ein ríðin er av, er onnur væl á veg;jf.kavaríð
ríða	1ride,ríða hestiride en hest;ríða hestride en hest til, ride en hest et sted hen;(overf.)ríða sín vegel.sína leiðride sin vej;ríð (tú) og renn!rend og hop!;ríða í ring við (e-m)løbe om hjørner med;hann ríður ikki undanhan overlever ikke;hetta ríður okkum úr garðidet ruinerer os, er for bekosteligt;(overf.)ríða niðarlagavære usømmelig2hvile el. ligge usikkert (svingende snart over til den ene, snart over til den anden side), vippe op og ned, balancere(fx på et spidst underlag),eg reið á (at fara)jeg var lige ved at styrte, falde;(om sygdom)tað ríður av og ádet tager vekselvis af og til;stokkurin reið tvørtur um steininbjælken lå og vippede tværs over stenen;tað ríður í vektinivægten balancerer;hann ríður ímillum ættirnarvinden bevæger sig frem og tilbage imellem to verdenshjørner;hann ríður undir útsynningivinden er næsten sydvest;tað ríður um (tað)det er tvivlsomt;ríða um snariðlige akkurat kunne klare en situation;ríða yvirfå overbalance;honum tykir yvir (at) ríðahan synes, det går for vidt;hann reið afturopinhan tumlede, faldt således, at han kom til at ligge på ryggen3(om handyr, især tyre)springe, bespringe,kúgvin er riðinkoen er sprunget;kúgvin ríðst ikki afturkoen kan ikke blive drægtig igen
ríðing	ridning
ríðingarbreyt	væddeløbsbane
ríðingarfelag	rytterforening
ríðingarhestur	ridehest
ríðingarmaður	rytter,vera góður ríðingarmaðurvære en god rytter
ríðingarross	ridehest
ríflutur	riflet
ríggin	1vægelsindet, sær, lunefuld2sen til at glemme en tilføjet fornærmelse, uforsonlig3(lidt) svimmel,lítið bar til at hugsa, eg var so ríggin í høvdinum;ríggin á beinunumustøt
ríggja1	1sygdom hos får med træk i halsen2ríggjurvægelsind, luner,í dag eru tær rættu ríggjurnar á honum3hunfår som hele tiden strejfer om, ikke finder en fast plads i græsgangen,hatta er tann ríggjan, ið er4person der aldrig er i ro nogen steder, flakke
ríggja2	forberede, tilberede,ríggja til;hann ríggjaði til at skjóta
ríggjuskøltur	sær, lunefuld, vægelsindet person
ríggjutur	vægelsindet, sær, lunefuld,hon kennir seg eitt sindur ríggjuta í høvdinum
ríka	berige,málið er ríkað við nógvum nýggjum orðumsproget er blevet beriget med mange nye ord;ríka uppberige;ríka seg uppberige sig;hann hevur ríkað seg upp av krígnumhan har beriget sig af krigen
ríkan	højlig, strengt,leggja e-m ríkan viðsætte en hårde betingelser, formane el. forbyde strengt
ríkdómur	rigdom
ríki	1rige, stat2magt,taka við ríki
ríkidømi	rigdom
ríkiligur	rigelig;-liga
ríkisarvingi	tronfølger
ríkisákæri	(jur.)rigsadvokat
ríkisár	regeringsår,á sjeynda ríkisári sínumi sit syvende regeringsår
ríkisborgararættur	(jur.)statsborgerret, indfødsret
ríkisborgaraskapur	statsborgerskab, indfødsret
ríkisborgari	(jur.)statsborger
ríkisdagur	(pol.)parlamentet i Sverige
ríkiseind	rigsenhed,hann er ikki trúgvur móti ríkiseindini
ríkisfelagsskapur	rigsfællesskab,Føroyar og Grønland eru í ríkisfelagsskapi við DanmørkFærøerne og Grønland er i rigsfællesskab med Danmark
ríkisforseti	rigspræsident
ríkisgóðkendur	statsautoriseret,ríkisgóðkendur grannskoðaristatsautoriseret revisor
ríkiskassi	statskasse,ríkiskassin ber kostnaðinstatskassen betaler
ríkiskirkja	(kirk.)statskirke
ríkiskroppur	rigmand, krøsus, velhaver,hann er ein ríkiskroppurhan er en rigmand
ríkisleiðari	(pol.)statsleder,ríkisleiðarar hittast á fundistatsledere holder møde
ríkislóg	(jur.)rigslov
ríkisløggildur	statsautoriseret
ríkismaður	rigmand
ríkismál	(lingv.)1rigssprog,mods.málføri (1)2rigsmål, bokmål,mods.nýnorskt3(pol.)statsanliggender
ríkisogn	statsejendom
ríkispartur	rigsdel
ríkisráð	1rigsråd2ministerium
ríkisrættarligur	(jur.)statsretlig
ríkisrættur	(jur.)1statsret2rigsret
ríkissjúkrahús	rigshospital
ríkisskattur	statsskat
ríkisskjalasavn	rigsarkiv
ríkisskjalavørður	rigsarkivar
ríkisskuld	statsgæld
ríkissóknari	(jur.)rigsadvokat
ríkisstjóri	regent
ríkisstjórn	1regering2styre
ríkisstudningur	statsstøtte
ríkisstyrkur	statsstøtte
ríkisstýri	regering
ríkisumboð	rigsombudsmandens kontor
ríkisumboðsmaður	rigsombudsmand(den danske stats øverste repræsentant på Færøerne siden 1. april 1948)
ríkisvald	statsmagt
ríkj	knirken,eitt doyggjandi ríkj
ríkja1	1knirke, pibe(fx om hængsler, sko o.lign.),hurðin ríkirdøren knirker;portrið ríkti á hongslunum;tað ríkir fyri bróstinumman trækker vejret med en pibende lyd(pga. slim o.lign.)2knurre, give ondt af sig,hann ríkir um alt, ið til kann vera3(om visse fugle)pibe,lundarnir hoyrdust liggja og ríkja inni í holum sínum;her situr eitt og ríkir sum eitt akurskritt(om en som aldrig tier stille)
ríkja2	råde, herske, styre,andi hansara ríkir enn á staðnum
ríkjan	knirken,ríkjan frá einum vogniknirken fra en vogn
ríkjasamband	(pol.)konføderation el. konfederation, statsforbund;jf.samveldi
ríkligur	rigelig;-liga
ríkmaður	rigmand
ríkmansligur	rigmandsagtig;-liga
ríkmanssonur	rigmandssøn
ríkmenni	rigmand, krøsus, velhaver,hann kendi seg sum eitt ríkmenni, tá hann fekk sína fyrstu lønhan følte sig som en krøsus, da han fik sin første løn
ríkur	1rig, som ejer meget,vera ríkur at, tilel.við e-m;tað sigst, at hann er ríkurhan skal være rig;(ordsp.)ríkir bøndur oksar keypa, mangt má feitt um fátækan ríkur,seleypa2dyrebar, værdifuld,nú er rændur frá mær ríkastur av lutum;mítt føðiland, tú ríkt ert fyri mær
ríligur	vredladen,hon var nakað rílighun var i dårligt humør;-liga
rím1	rim, rimfrost,rím á jørðinijorden er dækket med rim
rím2	(litt.)1rim,bera upp á rímrime,"náttin" og "sprottin" bera upp á rím;bera í rímrime;tey eru skaldaorð, tó at tey ikki bera í rím;sláa í rím2rimet strofe el. digt
ríma1	1kvæde, folkevise,eina veit eg rímuna;nú fellur ríman(slutter)2rimet digt
ríma2	1rime,rímaðurrimet;rímað yrking;orðini "orð" og "borð" ríma2digte,hann dugdi so ógvuliga væl at ríma3harmonere,hetta rímar væl saman við, at húsabyggingin var lítil í Føroyum tá
rímbløðka	(bot.)mælde(Atriplex)
rímbløðkuætt	(bot.)salturtfamilien(Chenopodiaceae)
rímbræv	(litt.)rimbrev,myndskrýdd rímbrøvillustrerede rimbreve
rímfrost	rimfrost
rímhvítur	dækket med rim,rímhvít fjøll
rímiligur	1rimelig,í rímiligari tíði passende tid;tað er rímiligtdet er rimeligt;eitt rímiligt kravet naturligt krav2selvfølgelig, indlysende,men rímiligt, avgerðin er tykkaramen selvfølgelig, det er jeres afgørelse;rímiligt taðindlysende;-liga
rímleysur	rimløs, rimfri,rímleys yrkingrimløst digt;yrkja rímleyst
rímneyð	rimnød,týðingarnar eru við hvørt heldur tungfloygdar av rímneyð
rímorð	rimord,honum tróta ikki rímorðini;talið á nýtiligum rímorðum er avmarkað
Rín	Rhinen
rína1	virke, have virkning el. indflydelse,rína á (e-nel.e-m)hænge ved, bide på;væl rínur ádet har god virkning;einki rínur á, alt ið prædikað verðurformaningerne er ganske spildte;bakteriur, sum einki rínur á;rína viðefterlade sig synlige spor på, hænge ved;skarn rínur ikki við;vatn rínur ikki við frískan fugl;ikki lata við seg rínaikke lade sig mærke (med), ikke reagere på
rína2	1hvine, pibe,rína og hvína1klynke og klage,hann rein og hvein sum hartaður hundur2ralle,tað rínur og hvínur í henni, tá ið hon andar2klynke, pibe,ikki batti at ringla, barnið rein líka illa3(om grise)grynte
rínskur	rhinsk,rínskt vínrhinsk vin
rípa	stribe;reyðar rípurlymfekarbetændelse(lymfangitis)
rípuskel	(zoo.)hjertemusling(Cardium edule)
ríputur	stribet, med ophøjede striber
rís	(bot.)ris
rísa	1rejse sig, hæve sig, stå op,rísa tíðligastå tidlig op om morgenen;rísael.rísa upp1stå op af sengen,árla risintidlig på benene;(talem.)tann, ið árla upp rísur, er um mangt vísurel.tann, ið tíðliga rís, verður mikið vís;Jesus reis upp frá deyðumJesus steg op fra de døde2(om solen)stå op,sólin rísursolen står op;árla ið sól upp reisårle da solen stod op;rísa upp ímóti e-mgøre oprør2(om sø, bølger)komme i oprør, bryde lidt, skumme,sjógvurin rísur;tað rísur á boðanumdet bryder, der er lidt brænding på skæret;tað rísur á bylgjunibølgen skummer i toppen;hann rísur upp undir ættinader kommer pludselig brænding i stille vejr som varsel om en forestående fralandsstorm3i ordforb.ikki rísa undir (e-m)1ikke kunne bære(om noget tungt),tú rísur ikki undir hasi byrðini2ikke kunne klare, ikke have råd til,eingin rísur undir at fara so dýra ferðingen har råd at foretage en så dyr rejse
rísakur	rismark
rísakustur	i ordforb.hárið sum ein rísakusturhåret er i urede
rísgreytur	risengrød
rísgrýn	risengryn
rísin	1(især om hår, uld)strid, stiv,rísin ullstiv uld;klæðini vóru grov av rísnari ull;sítt og rísið hárlangt og stridt hår;rísið sum skøtubakskarp, ru2(om søen)oprørt, urolig,strongurin er rísin í dag3(noget) vred,tá gjørdist hann rísinda blev han vred;konan var rísin og segði tvørt neikvinden var vred og sagde nej4(om træ)ru, ikke glat,rísin viður
rísinbløðkuætt	(bot.)rubladfamilien(Boraginaceae)
rísinhærdur	(bot.)ruhåret,bløðini eru rísinhærdbladene er ruhåret
rísinskinn	ruskind
rísla	skrive hastigt, kradse ned, grifle,hon ríslaði nøkur orð niður á ein pappírslepahun griflede et par ord ned på en lap papir
rísmjøl	rismel
rísmjølsgreytur	rismelsgrød
rísna	1blive vred,hann rísnar meir og meirhan bliver mere og mere vred2(om søen)komme i oprør, blive urolig,sjógvurin rísnarsøen bliver urolig
rísplanta	(bot.)risplante(Oryza sativa)
rísullaður	(især om får)med stiv uld
rísvellingur	risvælling
rísvelta	rismark
ríva1	rive, hørive
ríva2	1rive, rive i stykker,ríva í segsluge i sig, æde grådigt,kúgvin legðist at ríva í seg í eini veltu;rivin og skræddurlaset og forreven;hann vildi ríva seg sundur av blíðskapi(gjorde alt for at vise gæstfrihed);ríva barkgrave bark;tað rívur leyst á fjørðinumhavvandet hvirvles op(i stormvejr)2rykke, oprive,ríva upp við rót;ríva frá særgøre færdigt i en fart;ríva oman avrive de(t) øverste af noget;mosin varð rivin omanav;ríva oman av sær í svøvni(smide dynen)3pille,ríva (turran) seiðel.fisk(rense for ben)(til børn)4karte uld første gang,fyrst varð ullin blandað, síðan rivin við grovkørðum og síðan karðað við fínkørðum;ríva ullkarte uld anden gang med grove karter5rives(af storm),húsini rivuhuset blev revet ned af stormen;takið reiv;tað rívur(så megen vind at den river tagene af husene  / /ríva av:neytini eru komin inn á bøin, og tey ríva alla veltuna av(gennemroder hele kartoffelmarken);ríva burturúrslagte et selvdødt får;ríva í(om vejret)klare lidt op;hann rívur ískyerne spredes ad, tågen spreder sig;nú er íriviðnu er det klaret lidt op;ríva niður1rive ned, rykke ned,ríva húsini niðurrive huset ned;úthúsið er niðurriviðudhuset er revet ned2ríva niður á fólkbagtale sine medmennesker;ríva sundursønderrive,tá reiv hann sundur eyga síttda lukkede han med anstrengelse øjet op;ríva umtage fisk op af salt og lægge den ned igen med mindre salt imellem,skiparin fór í lastina at ríva um;nú er umrivið;ríva út1sprede (nyslået) græs til tørre,tá nulvað varð, tornaði hógvurin so væl, so tá rivið varð út aftur, tornaði bæði uppeftir og niðureftir2plyndre reder i fuglefjeldene,ríva ein fugl útplyndre en fugls rede;i ordforb.ríva út úr særtale frit fra leveren  / /ríva seg1bruge mund,ríva seg sum ráur kræklingur2ríva seg ítage tøj på i en fart;ríva seg í klæðinifå tøjet på i en fart;rív teg nú í klæðini;rívast:rívast og skræðast:børnini rívast og skræðastbørnene er uenige og ryger sammen at slås
rívan	rigelig,teir høvdu rívan til av øli;í fyrstuni gekk rívan at seljai begyndelsen gik det meget godt at sælge;taka rívan til1tage meget (af noget)2bruge store ord, bruge kraftudtryk, sværge
rívandi	energisk, ihærdig,ein rívandi ond
ríviligur	rigelig, masser af;-liga,hann skonkti ríviligahan skænkede masser af brændevin
ríving	1nedrivning,húsið er dømt til rívingar2det at noget(fxhus, tag)rives (af storm),tekjan er nýggj, so nú er eingin vandi fyri ríving;jf.ríva 2(5)
rívingarkarðar	grove uldkarter,ullin varð blandað, síðan rivin við rívingarkørðum og so karðað
rívitunga	(zoo.)raspetunge(Radula),flest lindýr hava hvassa tungu, sum er nevnd rívitunga
rívligur	rigelig, masser af;-liga;hann tók rívliga til orðannahan brugte store ord
rívugras	(bot.)musevikke
rívuhøvd	rivehoved
rívuskaft	riveskaft
rívutindur	rivetand
rjóta	snorke
roddi	1stort vædderlam2stor fisk, torsk
roddur	stort vædderlam
rodna	rødme, blive rød,nú fara skýggini at rodnanu bliver det snart mørkt;hann rodnaði av skommhan rødmede af skam;rodna uppblive blussende rød;hon rodnar upp, bara onkur spyr hanahun bliver ildrød, bare nogen spørger hende;rodna upp um bæði oyrublive ildrød i hovedet
roð	1fåreskind uden uld,isærroturoðfåreskind hvoraf ulden efter at være gået lidt i forrådnelse er blevet afplukket og som derefter er blevet tilberedt og barket;teir fingu ikki fjaltel.barkað roðiðde fiskede meget lidt2sted på fåreskind hvor ulden er faldet af,summir royttu ikki búkullina, teir vildu ikki at ærin skuldi leggja seg niður á jørðina á tað bera roð
roða	1rødfarve,(poet.)oyggin er roðað í setandi sól;tað roðar fyri sólhimlen bliver rød;dagur roðar í eystridagen bryder frem;sólin roðar í kavel.havsolen står op af havet;sólin roðar í fjøllfjeldene bliver røde af solen som står op2smøre, indgnide,roða drýlindgnide et askebagt brød med æg, smørel.vand;seiðalivur roðað í mjøli3trykke, tilsøle, snavse,hann roðaði hann niður í móruna;hann roðaði meg til(lagde mig ned og gav mig en hård medfart);smálombini roða sær í moldini(vælter sig);roðastslås, brydes;dreingirnir roðaðust á jørðini
roðamaðkur	(zoo.)regnorm(Allolobophora rosea)
roðál	strimmel fåreskind,dreingir brúktu eina roðál til sleingju
roðbjóri	strimmel fåreskind
roðbjølgur	fingertut af fåreskind (uden uld)
roðbrøkur	skindbukser
roðbuksubrók	bukseben på skindbukser
roðbuksur	skindbukser
roðhít	skindpose
roði	1rødme, rød farve,roði á kinnumrødkindethed;hann setti roðan so langt vestur á luftinamorgenrøden bredte sig over himlen langt vestpå;roðin datt aftur í havið2(bot.)meldrøje
roðkloddi	strimmel fåreskind,heldur tú, eg fái ein roðklodda frá tær?
roðklæddur	klædt i fåreskind,allir menn sótu roðklæddir og vóru í hettu og vøttum
roðklæða	roðklæða segiføre sig skindklæder
roðklæði(r)	skindklæder(i ældre tid brugt af fiskerne til søs)
roðlepi	strimmel fåreskind
roðsla	skæl
roðslutur	skællet
rogn	(fisk.)rogn,fiskur gýtir rognfisken gyder
rognaboppa	lille rogn
rognabrók	1rogn2lille person
rognabuppa	lille rogn
rognadrýlur	drýlur tilberedt af æltet mel og rogn(torskerogn)
rognafiskur	(fisk.)rognfisk, hunfisk,mods.siljafiskur
rognakalvi	(fisk.)helleflynder der har gydt
rognaknetti	stor bolle (knetti) af torskerogn æltet sammen med lidt mel(koges)
rognakorn	(fisk.)enkelt æg i fiskerogn
rognfiskur	(fisk.)rognfisk, hunfisk
rognkalvi	(fisk.)helleflynder der har gydt
rognkelsi	1(fisk.)stenbider(Cyclopterus lumpus)2skarnsmenneske, afskum,hatta rognkelsið!det afskum!;sum eitt rognkelsikort, stumpet
rognkilsi	stenbider
rognkorn	(fisk.)enkelt æg i fiskerogn
rok	1rygen, fygen, drev,(poet.)rok og fok og rangvørgt sjógvað;fjørðurin stóð í einum roki2snefog, fygevejr,hann slær í rokder kommer en stærk snebyge3damp op af jorden (marken)4tummel, voldsom ståhej el. ophidselse,vera á rokinumvære ophidset, rasende;alt í einum rokii vild forvirring
roka	fylde således at der bliver topmål,roka í eyga1(om kværn)sprude korn ud igennem øjet2(overf.)prale, brovte,hann rokar í eygahan praler for meget
rokaður	topmålt, fyldt til topmål, propfuld,dekkið var rokað(af fisk)
rokafullur	overfyldt
rokaleysur	uden top(roki),eg visti einki um, at maður bar torvleyp rokaleysan;reiða rokaleyst
rokaligur	som har forrygende travlt,tað var nakað rokaligt í fyrstuni;hon er so rokalighun er så ustyrlig
rokan	stærk travlhed, tummel, alarm,har var ein rokan og trokander var tummel og trængsel
rokari	person som arbejder voldsomt
rokasettur	overfyldt,rokasettur leypur
rokasligur	som har forrygende travlt
rokast	arbejde voldsomt, ase,hann rokaðist við snørinum;við rokandi ferði flyvende fart
rokár	år med stort fiskeri
rokdagur	dag med stort fiskeri,hann er sum murran rokdagar
rokfiskiskapur	stort fiskeri, stor fangst i løbet af kort tid,skipini høvdu rokfiskiskapskibene gjorde god fangst
rokfundur	rabaldermøde,politiskur rokfundurpolitisk rabaldermøde
roki	top, topmål,hann setur altíð høgan roka;(talem.)spar av rokanum, botnurin sparir seg sjálvurdet gælder om at være sparsommelig med det som man har
rokilsi	1(talesp.)støvsky,hann gróv, so rokilsið stóð frá honum2tummel, voldsom ståhej el. ophidselse, hurlumhej
rokin	serúka
rokka	rocke
rokkaásur	aksel på rok
rokkafingur	træpind til at dreje rokkehjulet rundt med
rokkahjarta	hjerte (centrum) i spinderok
rokkahjól	rokkehjul
rokkavi	1fin, fygende frostsne2fin sne som fyger hen ad snelag på marken
rokkbólkur	(musik)rockband
rokkendur	som har forrygende travlt,vásarbeiði, sum eigur at verða latið grovligari og rokkendari monnum upp í hendur
rokkin	serøkka
rokkorkestur	(musik)rockorkester
rokktónleikur	(musik)rockmusik
rokkur1	1rok, spinderok,roykstovan var so stór, at har gingu seks rokkar í senn;fara í rokkinbegynde at spinde;hann fór ikki úr rokkinumhan holdt ikke op med at spinde(om en uvenlig mand),saðla rokkinlægge snor på en spinderok2rokkarnirbestemt strikkemønster3(spøg.)stort fuldskæg,tað var tann rokkurin, hann hevði4(astronomi)Rokkur MariuOrions bælte
rokkur2	(musik)rock,spæla rokkspille rock
rokmaður	(mar.)dygtig og energisk fiskerel.fiskeskipper der gør god fangst;jf.rokskipari
rokmikil	1som har forrygende travlt,hvar fert tú so rokmikil?2voldsom, ubændig, ustyrlig,so verður eldgosið ein rokmikil brestur
rokna	1(mat.)regne,rokna roknistykkiregne regnestykker;rokna í høvdinumregne i hovedet;rokna (e-t) útregne noget ud2opremse, optælle,rokna uppopregne;rokna upp ímedregne, inkludere3regne (for), anse,eg rokni meg lukkuligan;rokna við e-mregne med noget,vit kunnu ikki rokna við honumham kan man ikke regne med
roknari	(mat.)regnemaskine
rokniark	(datal.)regneark
rokniarksforrit	(datal.)regnearksprogram
roknibók	(skole)regnebog
roknidømi	(mat.)regnestykke, regneopgave
roknihefti	(skole)regnehæfte
roknikønur	regnekyndig
roknilærari	(skole)regnelærer
roknimaskina	regnemaskine;jf.lummaroknari
roknimeistari	regnemester
rokning	1(mat.)regning, aritmetik2regning, faktura,gjalda rokningarbetale regninger3(økon.)konto
rokningarháttur	(mat.)regnemåde,teir fýra rokningarhættirnirde fire regnemåder
roknistokkur	(mat.)regnestok
roknistykki	(mat.)regnestykke
roknitalva	(mat.)tabel
roknitími	(skole)regnetime
roknivilla	(mat.)regnefejl
roknskaparár	(økon.)regnskabsår,roknskaparárið er álmanakkaáriðregnskabsåret følger kalenderåret
roknskaparbók	(økon.)regnskabsbog
roknskapardagur	(økon.)regnskabsdag,roknskapardagurinogså(overf.)regnskabets time
roknskaparførsla	(økon.)regnskabsførelse
roknskapargrannskoðari	(økon.)revisor
roknskaparhald	(økon.)regnskabsførelse
roknskaparlok	(økon.)regnskabsafslutning
roknskaparmaður	(økon.)regnskabsfører
roknskaparskylda	(økon.)regnskabspligt
roknskaparskyldigur	(økon.)regnskabspligtig
roknskapur	(økon.)regnskab,haldael.føra roknskapholde el. føre regnskab
rokódn	forrygende orkan
roks	1pusleri,ofta varð lítið roks gjørt úr matinum2vrøvl, snak,roks og koks;roks í teg!du vrøvler3en som gør besværlige og vidtløftige forberedelser,tú ert eitt verri roks
roksa	1være for omstændelig, have for mange dikkedarer,roksa(st) fyri e-m;hann fór at roksast við byggingina2sludre, vrøvle,situr og roksar og aldri tigursidder og sludrer og aldrig kan tie stille
roksandur	flyvesand,vestari endi á oynni (Jersey) er roksandur og lyngheiðar
rokskip	(mar.)skib der gør god fangst
rokskipari	dygtig og energisk fiskeskipper der gør god fangst
rokstormur	voldsom storm
roksutur	1omstændelig, vidtløftig,hon er so roksut og verður ongantíð útskavað2sludrevorn,hann er so roksuturhan er så sludrevorn
roktíð	myldretid
roktjúkn	mørk byge af snefog
roktúrur	fisketur med (usædvanlig) godt fiskeri
rokutur	som har forrygende travlt
rokveður	dårligt vejr med snefog
rokveiða	stort fiskeri, stor fangst i løbet af kort tid
rokvika	uge med (usædvanlig) godt fiskeri,teir høvdu eina sovorðna rokviku
rolla	1lang skrivelse,tað er ein rolla, tú hevur skrivað2remse,ein long rollaen lang remse
rom	seramur
romantikari	romantiker
romantikk	1romantik,ein grein av romantikkini er tjóðskaparromantikkinen gren af romantikken er nationalromantikken2sværmeri
romantikkur	romantik
romantiskur	1romantisk,romantiskur skaldskapurromantisk digtning2romantisk, sværmerisk,romantisk kærleikasøgaen romantisk kærlighedshistorie
romm	rom(drik)
rommfløska	romflaske
rommum	i ordforb.fram eftir rommumforover;detta fram eftir rommumfalde på næsen;liggja fram eftir rommumligge forover
rond	1stribe, linje(spec. stribe (på tværs) i tøj af anden farve end selve tøjet),jf.rondutur,tólv-trettan rendur í bulin høvdu tey tá, nú hava tey einar sjey-átta;svartur bátur við hvítari ronden sort båd med en hvid stribe2rand, kant(spec. øverste rand af en strømpe el. nederste rand af en trøje)
rondutur	(om tøj)tværstribet,rondut troyggjatværstribet trøje
rong	(båd.)sæde i for- og bagstavn,frammi í rongi forstavnen;aftur í rongi bagstavnen
rongutoft	(båd.)pladsen i bagbordsside på toftubekkur,á rongutoft
ront	højrøstet snak,geylið og rontið úr dansistovuni
rop	ræb, bøvs, opstød
ropa	ræbe, bøvse
ropp	i ordforb. somliggja uppi á roppi(om stor sten)ikke ligge støt p.gr. af ujævnheder på undersiden
roppa	gafle i sig
rosina	rosin
rosinubreyð	rosinbrød
rosinukøka	rosinkage
ross	1(zoo.)hest(Equus caballus),tey føroysku rossini er smá og knáden færøske hest er lille og udholdende;standa sum bitið rossstå aldeles betuttet, aldeles miste fatningen;jf.hors2(overf.)bæst, asen,rossið tað!det asen3(overf.)stærk person,hann er eitt ross (til styrki)han er stærk som en bjørn
rossabak	hesteryg,vera á rossabakivære til hest, ride
rossabarn	rossabørnbørn som transporterer på kløvhest(fx tørv);jf.rossadrongur
rossabásur	hestebås
rossabein	hesteben
rossaber	(bot.)fruebær(Rubus)
rossabjølgur	skindunderlag under hø-el.stråmåtte hos kløvhest
rossadrongur	dreng som transporterer på kløvhest(fx tørv)
rossafaks	hestehår,reip av rossafaksi
rossafetil	bånd til kløvtøj,bringufetil er rossafetil, sum liggur um bringuna
rossafjós	hestestald
rossaflokkur	hesteflok
rossafluga	(zoo.)hestebremse(Oestridae)
rossafrælsi	græsningsret (i udmarken) til en hest,eitt rossafrælsi samsvarar sjey ærfrælsum
rossagron	næseparti på hest
rossagryvja	grøftlignende sti trådt af kløvheste
rossagrøv	grøftlignende sti trådt af kløvheste
rossahald	(landbr.)hestehold
rossahandil	(pol.,spøg.)politisk studehandel
rossahoyggj	hø til heste
rossahógvur	hestehov
rossahúð	hestehud,av rossahúð varð ullin hærd
rossahús	hestestald
rossahøvd	hestehoved
rossajøkil	udmark afgnavet af heste;jf.jøkil (3)
rossakjøt	hestekød,tann, ið etur rossakjøt, fær reyða nøsel.verður smolturskotin í andlitinum;so virðismikil rossamergur varð hildin at vera, so vanvirt var rossakjøt(RKR Heimaráð)
rossaklæði(r)	seletøj til hest
rossakreftir	legemsstyrke, kropsstyrke,hann hevur rossakreftir
rossakroppur	i ordforb.leggjastel.detta á rossakroppudrette et ærinde og komme sent tilbage;nú er hann mestur lagsturel.dottin á rossakropp
rossalív	hundeliv,tað var eitt rossalív at vera kokkurdet var et hundeliv at være kok
rossalortur	hestepære
rossalær	hestelår,armarnir vóru sum rossalørarmene var tykke
rossamakrelur	(fisk.)hestemakrel(Trachurus trachurus)
rossamergur	hestemarv(tidligere anvendt som lægemiddel bl.a. mod gigt)
rossametta	hø-el.stråmåtte som lægges under kløvsadelen
rossamua	(barn.)hest, pruhest
rossarak	afmagring som kan ramme heste om foråret,ringasta rossarakið var á halvarðsøku;rossarakið bøtist ikki;fara í rossaraki;doyggja í rossaraki(om mennesker)dø af sult
rossaríva	(landbr.)hesterive
rossaræ	hesteådsel
rossarækja	(zoo.)hestereje(Crangon vulgaris)
rossaskittur	hestepære
rossaskon	næseparti på hest
rossaskrelja	skralde til at skræmme heste bort med
rossaslag	hesterace
rossaslóð	hestespor
rossaspor	hestespor,ikki standa (stíga, vallael.næla) upp úr rossasporivære meget (ung og) lille
rossatár	krokodilletårer,gráta rossatárgræde krokodilletårer
rossatjógv	hestelår
rossatraðk	sted nedtrampet af heste
rossatrøð	indhegnet græsgang for heste
rossatunga	(bot.)hestetunge(Mertensia)
rossatýggi(r)	seletøj
rossatýggj	hestetøj til transport på paksadel (kløvsadel) hørende udrustning
rossatøð	hestegødning
rossavagnur	hestevogn
rossavognur	hestevogn
rossleypur	stor trækasse med tremmer som bruges ved transport af gødning og navnlig tørv til hest,einir rossleypar;skinklar sum gamal rossleypur(om noget gammelt og skrøbeligt)
rosslær	hestelår,leggir sum rosslør
rossmaður	(folketr.)hestemenneske(kentauros)
rossvognur	hestevogn
rostla	(etym.)->roðsla
rot1	1råd, råddenskab, forrådnelse,rot er í eplunumder er råd i kartoflerne;eitt sár, sum rot var komið í2(vedvarende) fugtigt vejr
rot2	styrten, fald;i ordforb. somrennael.ganga e-n í rotløbe med stærk fart, så man er ved at støde en omkuld;renna seg í rotløbe til man er dødtræt(til man styrter)
rot3	snorken,rotini eru ófør á teimumde snorker frygteligt
rota1	vedholdende regnvejr,ólavsøkuroturvedholdende regn ved olajtid(29. juli)
rota2	gøre rådden, bringe til at rådne,rota skinnlade fåreskind henligge i fugtig tilstand, indtil ulden af sig selv løsnes
rotabukka	(neds.,mar.)gammelt dårligt skib
rotbakteria	(biol.)forrådnelsesbakterie
rotfríur	frisk,viðurin var rotfríur enn
rotin	1rådden,er stikulin rotin, skerst lambið væl;(ordsp.)rotið er snart brotiðdet som er svagt, tåler ikke meget;rotið grótsten som smuldrer let2dårligt oplagt om morgenen
rotinskapur	1råddenskab, råd2demoralisation
rotna	rådne, blive rådden,(gåde)liggur í á og ikki rotnar, fer fyri berg og ikki brotnar(regnbuen)
rotplanta	(bot.)saprofyt, rådplante
rotroykur	forrådnelseslugt
rotta	(zoo.)rotte(Rattus)
rottangi	septiktank
rottueitur	rottegift
rottuetin	rotteædt
rottufella	rottefælde
rottufríur	rottefri
rottuhali	1rottehale,ein lítil genta við rottuhalumen lille pige med rottehaler2stiksav
rottukattur	(zoo.)rottekat
rottukrút	rottekrudt, rottegift
rottuoyðing	rotteudryddelse
rottur	1snude2dårligt humør,nú er rottur á honumnu er han i dårligt humør
rottureiður	rotterede
rottutrónur	(fisk.)blå antimora(Antimora rostrata)
rottutýning	rotteudryddelse
rottuungi	(zoo.)rotteunge
rotuglottur	kortvarig opklaring i fugtigt vejr
rotugluggi	kortvarig opklaring i fugtigt vejr
roturoð	fåreskind hvoraf ulden efter at være gået lidt i forrådnelse er blevet afplukket og som derefter er blevet tilberedt og barket(bl.a. til sko og tøj),mods.rakaroð,barka roturoð;biðiskinnið er av roturoð
roturoðskógvur	fåreskindssko
rotuskinn	fåreskind gået lidt i forrådnelse(før ulden er afplukket),tey ullfríðastu rotuskinnini vórðu nappað, áðrenn tey vóru avlatin;tenja rotuskinniðgabe (af søvnighed);jf.gæruskinn
rotuskógvabark	garvemiddel til fåreskindssko
rotuskógvur	fåreskindssko,fríðir rotuskógvar
rotuveður	fugtigt vejr, fugtig tåge, småregn
rotvatn	råddent vand
rotveður	fugtigt vejr, fugtig tåge, småregn
rov	1brud, hul,gerael.seta rov ábegynde at brække, sætte hul på, gøre skår;vit settu rov á húsini og gjørdu nakað uppí2nedstyrtning i fuglefjelde,tá ið rov kom í bjørgunum, áttu allar 48 merkurnar tær urðar, sum niður vóru komnar3rester af noget(får, fugl, skib),rovini av einum seyði, fugli, skipi, bátio.a.4i ordforb.detta burtur úr rovumgå bag af dansen
rova	(biol.)1slimhinde, indvendig hud2børnehud3overhud,í húðini eru trý jaður: rovan, so holdroðið og innast undirhúðin
rovdjór	(zoo.)rovdyr(Carnivora)
rovdýr	(zoo.)rovdyr(Carnivora)
rovfuglur	(ornitol.)rovfugl
rovhvalur	(zoo.)spækhugger(Orcinus orca)
rovkroppur	røverisk person, skarnsmenneske, tyveknægt,skúgvurin er ein rovkroppur millum hinar fuglarnar
rovubruni	(med.)slimhindebetændelse
rovuleysur	hudløs
rovuloysi	(med.)hudløshed
royða	(geol.)rød okkerjord, rødligt dynd som vælder frem af jorden
royðrargeisli	hvirvel af en stor hval(royður, anvendt som sæde)
royðrarroyggj	(bot.)rørgræs(Phalaris arundinacea)
royðrartákna	(zoo.)hvalbarde
royðrartvøst	kød af storhval(oprindelig kun af royður)
royðuber	(bot.)hønsebær(Cornus),svensk royðubersvensk hønsebær(C. suecica)
royðubersætt	(bot.)kornelfamilien(Cornaceae)
royðugrót	(geol.)rødlig tuf
royðugrøv	grav med rød okkerjord,(poet.)sóljur í royðugrøvum vaða
royðulind	tuflag(der fx ses i en fjeldvæg)
royður	(zoo.)blåhval(Balaenoptera musculus),hann er sum royðurhan er sen i vendingen
royggj1	(fisk.)fisks bughinde
royggj2	(bot.)rørgræs(Phalaris)
roykbólkur	røgsky,roykbólkarnir, menn blása frá sær, verða størri og størri
roykeitran	(med.)røgforgiftning
roykfríur	røgfri
roykgras	(bot.)gulaks(Anthoxanthum)
roykguva	røgel.røgskyer (fra tobak),hann slepti nakrar stórar roykguvur út úr munninum
roykhanus	(mar.,spøg.)røghætte
roykhattur	røghat
roykhetta	røghætte
roykhola	(neds.)gammeldags hus,tú mátti ikki tímt at fara inn í hasa roykholuna
roykiborð	rygebord
roykilsi	røgelse
royking	1rygning2røgning
roykingartubbak	røgtobak
roykistova	rygesalon
roykitubbak	røgtobak,mods.skrá 2
roykivirki	røgeri
roykja	1røge, ryge,roykja fiskrøge fisk;roykja kjøtrøge kød;royktur maturrøget mad2ryge,roykja pípuryge pibe;roykja vindilryge på en cigar3roykja útfordrive med røg,roykja rottur út
roykjari	ryger
roykkavari	røgdykker
roykkápa	(ny bet.)emhætte
roykkjøt	røget kød(spec. fårekød)
roykleysur	røgfri,roykleys stovaen røgfri stue
royklittur	røgfarvet
roykluktur	røglugt
roykmikil	røgfyldt
royknerv	(biol.)lugtenerve
roykoffur	(bibl.)røgoffer
roykpylsa	røget pølse
roykringur	røgring
roykrotin	i ordforb. somhasin er ikki roykrotin1han er ikke uden kræfterel.mod2han er ren og pæn
roykrør	(skib.)aftræksrør
royksansur	(biol.)lugtesans
roykskaði	røgskade
roykstova	(i ældre færøske huse)rum som tjente som køkken, arbejds- og dagligstue(havde åbning i tagrygningen)
roykstovubiti	røgstuebjælke,krovini vórðu hongd upp undir roykstovubitan
roykstovugólv	(jord)gulv i røgstue,roykstovugólvið plagdi at verða umrivið upp undir jól
royksúla	røg i en tynd stribe som står lige op,ein tjúkk royksúla reis upp úr borgini
royktám	røgsky, røgslør,eitt lítið royktám kemur líðandi upp úr takinum
roykur	1røg,roykur sæst úr skorsteinunumder stiger røg op fra husene;draga roykryge tobak;nú var langt síðan, hann fekk ein royknu var det længe siden, han havde røget;balla sær ein roykrulle sig en cigaret;sum ein roykmed glans2lugt,ein sterkur roykur av smoltri og lýsi gongur at honum(fra mallemuk);teir toldu ikki roykin hvør av øðrumde var uvenner
roykvarnari	røgdetektor, røgalarm
royna	1prøve, erfare,royna roysniprøve på at udføre en stor bedrift, prøve sin manddom el. styrke(spec. i kappestrid);royna segforsøge sig, prøve sine kræfter;hann bað hana royna seghan bad hende forsøge sig;royn teg nú!nu sidder du net i det!2fange fisk, fiske,vit royndu undir Føroyumvi fiskede i nærheden af Færøerne;tað var ikki roynandi fyri vindi;royna eftir (e-m)prøve på at fange (noget);royna eftir upsa;(spøg.)royna eftir konufólkijagte damer3sande, erkende,at hon mátti royna, hvat tað var at fara svong til neyta;royna gott av e-mmodtage venskabsbeviser af en;royna ilt av e-mmodtage beviser på fjendskab af en, blive narret af en4roynast1prøves, forsøges2vise sig el. give sig til kende på en vis måde,roynast vælvise sig at være over forventning, bedre end der var udsigter til;roynast illavise sig at stå under forventning, ikke svare til forventningerne
roynd	1prøve, forsøg, eksperiment,tað kundi verið ein roynddet kunne være et forsøg værd;prógva við royndumbevise med eksperimenter2virkelighed,í royndumel.í roynd og verui virkeligheden, faktisk;(poet.)tað er betri í royndum enn í sjóndumdet viser sig at være bedre end der var udsigter til;tá ið til royndar komnår alt kom til alt3erfaring, empiri,hava góðar royndir av e-mhave gode erfaringer med noget4(skole)prøve, eksamen,fara til royndgå op til en eksamen;ársroynd, upptøkuroyndårsprøve, optagelsesprøve5forsøg, eksperiment,evnafrøðilig royndet kemisk forsøg6prøve,blóðroyndblodprøve7forsøg på at fiske(fange fisk),teir hava havt lítla roynd;eg hevði nógva roynd8plage, fristelse
royndarár	prøveår
royndarboring	(geol.)prøveboring
royndarbrúk	forsøgslandbrug
royndardjór	(biol.)forsøgsdyr
royndarferð	prøvetur
royndarfiskiskapur	prøvefiskeri
royndarflúgva	prøveflyve
royndarglas	(kem.)reagensglas
royndarheimur	den virkelige verden
royndarkoyra	prøvekøre,royndarkoyra bilprøvekøre en bil
royndarløta	alvorens el. prøvelsens stund
royndarprædika	prøveprædiken
royndarsettur	prøveansat,royndarsettur lærari
royndarskeið	prøveperiode
royndarskipan	prøveordning, forsøgsordning
royndarstig	forsøgsstadium,framleiðslan er enn á royndarstigiproduktionen er endnu på et forsøgsstadium
royndarstjóri	forsøgsleder
royndarstova	laboratorium
royndarstund	alvorens el. prøvelsens stund,í lívsins royndarstundum
royndarstøð	forsøgsstation
royndartíð	prøvetid
royndartúrur	prøvesejlads
royndarval	prøvevalg
royndskygdur	realistisk
royndskygni	realisme
royndur	1prøvet, forsøgt,tað er royndur luturel.leikurdet er en kendsgerning2erfaren, dreven,ein væl royndur maðuren erfaren mand;royndur í leikumerfaren3sat på en prøve,tá varð hann royndurda var han i knibe;hann mundi fara at fáa seg royndanhan ville nok blive sat på en prøve;illa royndur (av e-m)som har dårlige erfaringer
royniber	(bot.)rønnebær
royniligur	virkelig, faktisk, real,royniliga úrslitiðdet virkelige resultat
royning	forsøg på at fiske(fange fisk),ov stutt tíð verður til royningar útiá
roynitræ	(bot.)røn
royniviður	(bot.)røn
roynsla	1erfaring, empiri2plage, fristelse,tungar roynslur og pínur
roynslustund	alvorens el. prøvelsens stund
roysikattur	(zoo.)hermelin, lækat(Mustela erminea)
roysikøttur	hermelin, lækat
roysimikil	med stor overkrop,roysimikil maðuren mand med stor overkrop
roysin	1(om mennesker)høj og rank2stejl,takið var so roysiðtaget var så stejlt3vred,hann gjørdist roysin, klárur at leypa áhan blev vred, klar at fare løs på4roysin skriftstejlskrift
roysni	manddomsværk, (stor) bedrift, vovestykke, styrkeprøve,gerael.vinna roysniudføre en bedrift;(poet.)roysni og brøgd at gera;tað er einki roysnidet er ikke noget at prale af;royna roysni við e-nprøve styrke med én;summir bóru tungt til roysnis
roysningstonn	hvalrostand
roysningur	(zoo.)hvalros(Odobenus rosmarus)
roysnisbragd	stor bedrift, dåd
roysnisgerð	manddomsværk, stordåd
roysnishugur	lyst til at udføre bedrifter,(poet.)roysnishugur í bringu er
roysnismaður	mand der øver storværk
roysnisverk	manddomsværk, stordåd
roystmansligur	høj og kraftig(af vækst);-liga
royta	1plukke af, rykke af,royta fuglplukke en fugl;royta grátt, royta burturav, royta til dúnsplukke fugl ind til dunene2plukke, rykke ulden af får,teir vóru farnir at royta, summir brúktu ullarsaks, aðrir knív;royta úrtage hele ulden af et får3rive,hon roytti hannhun rev ham i håret;saksurin roytirsaksen er uskarp4samle (op), plukke,royta grasafrive græs;royta sýru;hann sat og tugdi nøkur strá, hann hevði roytt av bønum5(om fisk)nappe til maddingen(uden at bide på krogen),fiskurin roytir;tað roytir ikkider er ingen fisk at føle6trække, hale,situr og roytir burturav (turrum fiski), sum hundur roytir skóklút7royta oman (grót)rive (stene) løs
royting	1plukning af fugle2det at rykke ulden af fårebesætningen,seyðurin er búgvin til roytingar, tá ið sýruleggurin sæst at seta fræ3det tidspunkt (om foråret) da man tager ulden af fårene,rekael.fara á fjall í royting
roytingarfólk	person som plukker fugle
roytingarknívur	kniv der bruges ved plukning af fugle,roytingarknívarnir skuldu vera hvassir
roytingarkona	kvinde som plukker fugle
roytingarmaður	mand beskæftiget med at tage ulden af får(ved áseyðaroyting)
roytingartíð	det tidspunkt (om foråret) da man tager ulden af fårene
royva	1flytte (lidt), bevæge, rokke,hann royvdi honum ikkihan kunne ikke gøre ham noget(fxved slagsmål),hann royvir sær ikkihan bevæger sig ikke2royva særvigte sig, blære sig3royva á (e-m)sætte sig synlige spor;sálarligir stoytir mundu ikki royva á honum;knívurin royvir ikki ákniven er uskarp
royvi	1uldbeklædning på får,ein ærull ella royvið av einari ær varð roknað at vera seks merkur;(overf.)dottin burtur úr royvumlaset, pjaltet;bókin er dottin burtur úr royvum2(overf.)klædedragt,ringur er sá maður, ið ikki er mentur at bera royvi síni
royvildi	dimension,hús við hábærsligum royvildum;fjórða royvildiðtiden
ró	ro, rolighed, stilhed,hon fekk hvørki rógv ella ró;tað var meiri ró á honum
róði	serógva
róðrarbátur	(båd.)robåd
róðrarlag	måde at ro på,hava vakurt (ljótt) róðrarlag;jf.áralag
róðrarligur	(om båd)let at ro
róðrarmaður	(på båd)roer
róðrarsessur	(båd.)rosæde,sleppa sær í róðrarsessin til ára
róðrartak	åretag,við stillisligum róðrartøkummed lette åretag
róðrarveður	vejr til at ro i,gott róðrarveður
róður1	roning,í róðriunder roning;setast til róðrarbegynde at ro
róður2	(båd.,skib.)1ror2(skibs)ror,standa til róðursstyre, navigere3rat
róðurarmur	(skib.)rorpind,róðurarmin niður í bakborð
róðurhjól	rat
róðurhøvd	(skib.)rorkop
róðurjørn	(båd.)det jern der hører til roret
róðurketa	(skib.)rorkæde
róðurkista	(skib.)rorkiste
róðurknappur	(skib.)rorkop
róðurkraft	(mar.)(ved sejlads),så megen fart at man kan styre
róðurlína	(båd.,skib.)rorline
róðurlykkja	(båd.)en af de to jernbøjler hvormed roret fastgøres til bådens stævn samt den øverste bøjle på stævnet
róðurmaskina	(skib.)rormaskine, styremaskine
róðursina	(båd.)rortap
róðurslína	(skib.)rorline
róðursmaður1	rorgænger
róðursmaður2	(på båd)roer
róðursteingil	(båd.)(på båd),pind hvormed den øverste del af roret fastholdes til stævnet
róðurtalja	(skib.)rortalje
róðurtúrur	(mar.)rortørn
róðurtørn	(mar.)rortørn
rógv1	ro, rolighed, stilhed,hann hevur onga rógv á særhan har ingen ro på sig
rógv2	(båd.)klinkeplade, klinkering, klinkeskive
rógv3	i ordforb. somhalanel.við halanum upp í rógv(om dyr)med halen i vejret
rógva1	(stedn.)smalt fremspring, smalt fremstikkende højdeparti,á Rógvu
rógva2	1ro,tað mundu vera ókunnumenn, ið róðu bátin;rógva (um) kappro kap;rógva sum í grindro meget stærkt;rógva upp landro ind til land(i dårligt vejr),(talem.)teir rógva ikki í sama borðide er ikke enige2(om svømmefugl)svømme,nakrar ógvellur fóru rógvandi suður við landinum3ro imodel.frobi,rógva andstreym1ro imod strømmen2(overf.)møde modgang og kæmpe imod,nú er tann fyrsti streymtangin rógvin;(overf.)nú hevur hann rógvið sín fjørðel.nú er hansara fjørður rógvinhans dage er talte4transportere med robåd5slæbe med robåd,báturin róði skipið út á streym6ro ud på fiskeri, drive fiskeri,fyri norðan rógva teir mest við línu, fyri sunnan og vestan við snøri;báturin, ið hann róði við  / /rógva afturro tilbage til fiskepladsen(efter at båden er ført bort af strømmen),teir miðaðu av og róðu aftur;rógva afturáro tilbage til fiskepladsen,tað var ikki afturárógvið uttan til miðis;rógva afturá afturro tilbage til fiskepladsen,(overf.)komme tilbage til(fxet emne som man før har omtalt),í einum brævi rør hann afturáaftur evnið;rógva avforlade fiskepladsen(så at andre ikke finder den);rógva ásætte årerne i vandet;rógva framundirgøre hentydning til, antyde, gøre forsøg på at bringe på bane, pirre ved noget,hann vildi ikki siga tað rættiliga, men hann róði so mikið framundir, at eg væl skilti talu hansara;rógva uppfyritage højde for strøm (med robåd);rógva úr:rógva úr botnifå fiskeline løs af bunden ved at ro,kom línan føst um skølt, varð roynt at rógva úr botni;rógva útdrive hjemmefiskeri;(ordsp.)tann sum tíðum (ofta, dúgliga) rør út, hann fiskar umsíðirdet betaler sig at holde udel.fortsætte
rógva3	berolige
rógving	roning,hann hevði ovtikið seg av rógvingini
rók	(stedn.1klippeafsats(spec. hylde i en klippevæg);(overf.)liggja eftir á rókinialtid ligge hjemme;(overf.)fara av rókiniforlade den hjemlige eng;tey fara ikki av rókini(om indesluttede mennesker);upp í røkuri træk, den ene gang efter den anden;nógv ár upp í røkurmange år i træk;børnini fingu tey upp í røkur;alt kemur upp í røkurdet hele kommer på en gang2skrånende afsats mellem to hamre3(spøg.)etage(i højt hus),á fimtu rókpå femte etage
rókaferð	mislykket rejse
rókafinna	(skak)tårnbonde, hjørnebonde
rókarbelti	smal klippeafsats
rókarendi	ende af klippeafsats
rókarlag	smal klippeafsats i en skrånende bjergside,leiðin gekk eftir einum rókarlag á skák oman á helluna
rókarskapilsi	lille klippeafsats,eitt rókarskapilsi
rókartrom	kant på klippeafsats,ungin fer útá rókartromina
róku	sereka
rókur1	(ornitol.)allike(Corvus monedula)
rókur2	(skak)tårn
rókutur	1(om hår)ujævnt klippet2(om tækkehalm)ujævnt lagt
ról	højrøstet tale, snak, skrigen op
róla	være højrøstet, skrige op, skryde
rólan	højrøstet tale,eg hoyrdi rólan frá stórari mannfjøldjeg hørte højrøstet tale fra en stor menneskemængde
rólari	pralhals, blærerøv
róligur	rolig;-liga
Róm	Rom
rómafleytir	flødeskum
rómaísur	flødeis
rómakrukka	krukke til opbevaring af tyk fløde
rómakrúss	flødekande,sukurskál og rómakrúss
rómakøka	flødekage
rómalittur	flødefarvet,rómalitt málingflødefarvet maling
rómanskur	romansk,rómanskar tjóðirromanske nationer;rómanskt málromansk sprog,rómanskur stílurromansk stil
rómareyður	rødmosset
rómartal	rómartølromertal
rómastampur	(mælk.)tykmælk,rómastampurin er lopintykmælken er blevet stiv
rómi	(mælk.)fløde
rómur	1højrøstet snakken, høj skrigen el. gråd,tá var rómur í høllda var højrøstet snakken i hallen2støj, larm, spektakel
rómverji	romer
rómverskkatólskur	(rel.)1romerskkatolsk2rómverskkatólska kirkjanromerskkatolsk kirke, katolske kirke
rómverskur	1romersk2rómversk tølromertal
róp	råb,gera eitt rópudstøde et skrig;skera í rópbegynde at råbe;gera róp ígøre anskrig, slå alarm;róp kom ífolk begyndte at råbe
rópa	1råbe,rópa grindaboð;rópa sum á fjalliråbe højt;rópa e-nråbe nogen;mamma rópar teg beinanvegin2kalde, benævne,tey rópa hann Jákupde kalder ham Jacob;at rópaså godt som  / /rópa átilkalde,faðirin rópti á hann;rópa inn(om lærer)kalde eleverne ind(efter frikvarter),so varð innrópt, og dreingirnir skundaðu sær inn;rópa til1komme med tilråb2rópa til síntilkalde,hann rópar hundin til sín;rópa upp:rópa upp ákalde på, påkalde, henvende sig til;jeg rópti upp á tað dýra navn(Jesu navn);hann rópti upp á hin versta;rópa upp í háråbe højlydt;rópa útbede om at komme ud;rópa viðråbe op(fx pga. smerte)
rópan	råben
rópari	råber, megafon
róphol	skrålhals
rópitekn	(lingv.)udråbstegn, interjektionstegn
rós	ros, lovord,upp á rósfor at vinde ros, stolt og pralende, brystende sig;teir róðu upp á rós;hanin gelur upp á róshanen galer stolt og udfordrende
rósa1	(bot.)rose(Rosa)
rósa2	rose, berømme,rósa e-mrose nogen;rósa sær (av e-m)rose sig (af noget);tú skalt ikki rósa av ferðini, gert tú ikki, sum eg sigidet skal komme dig dyrt at stå;(spøg.)rósi eg ikki mær sjálvum, so er mín æra eingin
rósa3	(mar.)rovse
rósin	(med.)rosen(erysipelas);sereyðmaðkur
rósorð	rosende ord, lovord
rósuber	(bot.)hyben
rósublað	rosenblad,varrar sum rósubløðlæber som rosenblade
rósudæmi	smuk rød ansigtsfarve,rósudæmið var fánað
rósuhjálpirót	(bot.)rosenrod(Rhodiola rosea)
rósukál	(bot.)rosenkål
rósukransur	1rosenkrans2(rel.)rosenkrans, paternoster
rósulittur	rosenfarvet,í rósulittum silkikjólaiført rosenfarvet silkekjole
rósuolja	rosenolie
rósureyður	rosenrød
rósurunnur	(bot.)rosenbusk
rósutræ	(bot.)rosentræ
rósuvatn	rosenvand
rósuvín	rosévin, rosé el. rose
rósuætt	(bot.)rosenfamilien(Rosaceae)
rósverdur	rosværdig
rót	1(bot.)rod,festa rótfæste rod;ríva upp við rótrykke op med rode;(gåde)rótin horvir til himmals upp, og skarið horvir niður(istap);(med.)taka røtur fyri seg(om sår)blive betændt2(bot.)rodfrugt;gularót, hvítarót, kálrótgulerod, majroe, kålroe;(ordsp.)tað er ikki oftari enn so, at Páll fær røturhvad godt er, får man sjælden3det nederste af en klippe el. ø,rótin á fjallinum4fårs fine uld(dvs. uldhårene),mods.broddur (3)5stamme, afstamning,føroyingar eru av norskari rótfæringerne er af norsk afstamning6(lingv.)rod7(mat.)rod,onnur rót av 4 er 2den 2. rod af 4 er 28knop, knag,hann var ein rót at fiskahan var en særlig dygtig og energisk fisker;hon var ein rót til arbeiðishun var en rigtig slider
róta1	1snorke,(ordsp.)hann, á morgni rýtur, á kvøldi dríturden der sover længe om morgenen, bliver ikke færdig med sit arbejde om dagen2styrte, tumle, falde
róta2	rode, grave, oprode,hann rótar alt á gos;hann rótar taran burturav;róta upp
rótafræ	roefrø
rótagreytur	grød af majroero.a.
rótakál	(lille) roemark
rótamaðkur	(zoo.)orm i roer
rótan	stærkt oprør i søen, meget oprørt sø,rótan í sjónum
rótangi	(bot.)rodgren
rótarbløðka	(bot.)roetop
rótarkvistur	(bibl.)rodskud,spyrja eftir rótarkvistinum av Ísai
rótastuldur	roetyveri
rótasúpan	suppe med roer,(talem.)tað gongur sum rótasúpan (um bygdina)det rygtes vidt og bredt
rótateigur	roemark
rótatjóvur	roetyv,rótatjóvar vórðu sendir upp á mánan;í mánanum situr rótatjóvurin
rótavaksin	(om kornmark)med kornstråene voksende i klynger,mods.strávaksin
rótavelta	roemark
rótavelting	roedyrkning
rótbíta	æde (græs) lige ned til roden,gæs rótbíta;seyðurin rótbítur svørðin
rótbjálvi	(bot.)rodhætte
rótendi	rodende,træið var fimm føtur í tvørmál í rótendanum
rótfastur	1(bot.)rodfast,rótfast lokrodfast ukrudt2(overf.)rodfast,í hesi fjálgu bygdini við sínum rótfasta fólki
rótfesta	rodfæste,træið rótfestist
rótfrekur	(bot.)med store rødder(om en plante)
rótføroyskur	ægte færøsk, rent færøsk,skaldið hevur gjørt tað útlendska so heimafjálgt, at tað kennist, sum tað var rótføroyskt;røtur, eins og føroyskt korn, kunnu gerast ein rótføroysk urt
rótgnaga	æde (græs) lige ned til roden,gásin rótgnagar grasið
rótgrógvin	(overf.)rodfæstet, indgroet,hann kollvelti rótgrónar áskoðanirhan revolutionerede rodfæstede anskuelser;vera rótgrógvin í gomlu bóndamentaninivære rodfæstet i den gamle almuekultur
róthali	(bot.)tynd, uudviklet rod
rótleysur	1rodløs,(poet.)er rótleysur stelkurin hin stinni2rodløs,eitt rótleyst ættarliðen rodløs generation
rótloysi	rodløshed
rótmikil	i ordforb.hann er so rótmikilluften er mørk og truende
rótorð	(lingv.)rodord
rótrotin	rodrådden,tá oyggin hon skalv rætt sum rótrotin eik
rótskot	(bibl.)rodskud,koma skal rótskot Ísais
rótskyldur	(lingv.)rodbeslægtet,"megi" og "máttur" eru rótskyld orð
rótsterkur	med stærk rod,eplið er rótsterk urt
róttøkin	radikal
rótvaksin	(om kornmark)med kornstråene voksende i klynger
rótviðgerð	(odont.)rodbehandling(pulpa)
Ruanda	Rwanda
ruandari	rwander
ruandi	rwander
ruandiskur	rwandisk
rubba	1binde fast, snøre stærkt, trække til,hann rubbaði kjaftbandið fast tvørturum2snære, være for stramt,húðin er avfarin, sum bandið hevur rubbað;tað rubbar at3(håndarb.)strikke fast,rubba eyguni at stokkunum4gnide,hann rubbaði sær um eygunihan gned sig i øjnene
rubbari	(kortspil)rubber
rubbikast	løkke der kommer på en snor og bringer den i urede,rubbikast kom á línuna
rubbutur	ru, ujævn
rubil	(økon.)rubel
rubinur	rubin
rudd	ryddet sted, opryddet plads,eitt rudd í skóginumet ryddet sted i skoven
-rudd	seoman-,ó-
rudda	1rydde, gøre ryddelig,húsið var bæði reint og ruddaðhuset var både rent og ryddet;rudda uppoprydde;rudda jørðrydde den dyrkede mark for småsten2bortrydde, udrydde,rudda burturafrydde;brimið hevur ruddað nógv grót burtur;rudda útudrydde;bygdin ruddaðist út av sóttini
ruddi	seryðja,riða
ruddiliga	helt, aldeles, fuldstændig,hann vann / tapti so ruddiligahan vandt / tabte så fuldstændig;hann hevur tað ruddiliga uppiboriðhan har helt fortjent det
ruddiligur	1ryddelig, ordentlig,stovan var ruddiligstuen var ryddelig2pålidelig, redelig,hann var ruddiligur í øllum sínum verkihan var en pålidelig mand3afgjort, sikker,hann vann ein ruddiligan sigurhan vandt en sikker sejr;tað er so ruddiligtdet er så oplagt
rudding	rydning
ruddingararbeiði	rydningsarbejde
rudningur	stærk brænding der har forandret stranden
rudstaður	ryddet sted, opryddet plads
ruðuleiki	forvirring, hurlumhej,alt í einum ruðuleikaalt i vild forvirring
ruff	(båd.)ruf
ruffutur	uordentlig(især med hensyn til påklædning)
rufla	rifle,eitt lot ruflaði hin blanka havspegilin
ruflutur	riflet
rugakur	(landbr.)rugmark
rugbreyð	1rugbrød;jf.blandingsbreyð2(ny bet.)folkevognsrugbrød
rugbreyðsflís	rugbrødsskive
rugdrýlur	usyret rugbrød
rugga	1rokke, vippe,omman situr og ruggar á bríkini;rugga í ruggustólirokke frem og tilbage i en gyngestol2gå langsomt,gásin kom ruggandi eftir gólvinum;(talem.)tað ruggar ikki rættder er noget lusk ved sagen3vugge,rugga barnivugge et barn
ruggreytur	grød af rugmel,tey høvdu ruggreyt at baka fyri útbrot
rugguhestur	gyngehest
ruggustólur	gyngestol
rugkorn	rug
rugmjøl	rugmel
rugosarósa	(bot.)rynket rose(Rosa rugosa)
rugur	1(bot.)rug(Secale cereale)2rugkorn
rukka1	1rynke, fold,klæðini eru tær beru rukkur;seta rukkur í brýrrynke brynene2nar, abekat,hann gongur sum ein rukka;tín rukka!din nar!3person man har til bedste,rukka skal vera umborð í hvørjari slupp;hava e-n til rukkuholde nogen for nar
rukka2	1rynke, frembringe rynker el. folder på noget, krølle,hosurnar rukkaðust niðri við øklar;hon rukkaði brævið samanhun krøllede brevet sammen;rukka brýrrynke brynene2klynke, smågræde,eitt lá og rukkaði í vøgguni;nú rukkar lítla barnið hjá mær
rukku	serøkka
rukkublikk	bølgeblik
rukkujarn	bølgeblik
rukkukoyring	uforsvarlig bilkørsel(ofte med spiritus indblandet)
rukkulakki	(biol.)bladmave,tann genta, ið vaskaði vemburnar, átti rukkulakkan og vilini;rukkulakki og vil hoyra vambakonu til
rukkulív	1løsagtighed2strengt liv,kryvjing á dekkinum er rukkulív
rukkupapp	bølgepap
rukkutari	(bot.)sukkertang
rukkutur	rynket,klæðini eru rukkuttøjet er rynket;rukkutur í andlitirynket i ansigtet;nú eri eg gamal og rukkuturnu er jeg gammel og rynket;rukkutur og skrukkuturrynket og runken
rulka	lægge uordentligt fra sig, krølle,rulka ikki klæðinipas på du ikke krøller tøjet
rulkur	1noget uordentligt sammenrynket el. sammenrullet el. sammenviklet,húgvan lá í einum rulki fram á pannuna2lille, tykt menneske el. dyr,hatta verður ein rulkur(om hvalp)3uorganiseret mængdeel.flok,húsini standa í einum rulki;skipini lógu í einum rulki
rulkutur	1uordentlig og rynket(i tøjet),lat meg hampa teg, tú sært mær so rulkutur út2krøllet
rull	1rullen,fara á rullbegynde at rulle;tunnan fór á rull oman gjøgnum brekkunatønden begyndte at rulle ned ad bakken;teir tóku stórar steinar og settu á rull2rulle,eitt rull av tubbaki;skrárullrulle skråtobak;eitt rull av tapetien rulle tapet3(om sø, bølgers bevægelse)rulling,tað var alda inná og rull í sjónum;vit komu út í rulliðvi kom hvor der var rulling
rulla1	(tøj)rulle
rulla2	1rulle, trille,annan páskadag er siður at rulla egg;rulla kavaknetti2dreje (på), dreje rundt,rundir steinar rulla best3glatte i rulle,rulla klæðirulle tøj4(om fartøj i bølgegang)rulle,sluppin rullaði illa
rullibukka	(hån.)fartøj der er slemt til at rulle(vippe)
rullifjøl	(idr.)skateboard
rullistartur	rullestart
rullistólur	rullestol, kørestol
rullitrappa	rulletrappe
rullugardina	rullegardin
rullukøka	roulade
rulluportur	vejrist
rullupylsa	rullepølse
rullupylsupressa	rullepølsepresse
rulluskoyta1	(idr.)rulleskøjte
rulluskoyta2	stå på rulleskøjter
rullutur	(om sø)urolig,tað er rullut í sjónumsøen er urolig
rumbla	1rumle, skrumle,tað rumblar í búkinumdet rumler i maven2lave uro,teir hava tað at rumbla við
rumbul	1rummel, forstyrrelse, uro, urolighed2uro i søen,rumbul í sjónum
rumdi	serymja
rumenari	rumæner
rumeni	rumæner
Rumenia	Rumænien
rumenskur	rumænsk
rumla	rumle, lyde hult og stærkt,tað rumlar í búkinumdet rumler i maven
rummalareiggj	forvirring, hurlumhej
rummanareiggj	forvirring, hurlumhej
rummarareiggj	forvirring, hurlumhej
rummiska	rundhåndethed, gavmildhed,eg við tíni rummisku aldri sat við sviðusoð
rummiskheit	(talesp.)rundhåndethed, gavmildhed
rummiskur	rundhåndet, gavmild,rummiskur við peningirundhåndet med penge;hann er rummiskurhan er gavmild
rumpa	rumpe, bagdel, ende
rumpari	(vulg.)røvpuler, bøsse
rumpusteyri	(barn.,spøg.)rumpe, bagdel
rumpustumpur	(barn.)rumpe, bagdel, ende
rumpustykki	(barn.)rumpe
rumsa	rumsael.rumsastlarme, støje;hann hoyrdi, at onkur rumsaðist innanfyri;rumsael.rumsast við1(om en sovende lige før opvågnen)give livstegn fra sig, røre på sig2(overf.)indse situationen, komme til sig selv
rumsalareiggj	forvirring, hurlumhej,eitt ræðuligt rumsalareiggj aftan á alt ólavsøkufólkið
run	meget svag brænding, oprør i søen,tað er run í sjónum
runa1	mudder, pløre, pladder
runa2	(om søen)komme i oprør,tað hevði hug at runa við bergið;hann runaði sjógvin
runast	foretage el. sysle med noget hvormed man tilsmudser sig,her kann barnið runast, sum tað vil
Runavík	bygd på øen Eysturoy,í / úr Runavík,til Runavíkar
runavíkingur	person iel.fra bygden Runavík
runda	1gøre rund, afrunde2runde,vit rundaðu Hvarviðvi rundede Kap Farvel3(mat.)runde
rundan	i ordforb.rundan umrundt om
rundanum	udenom
rundbogaður	(arkitektur)rundbuet,vindeyguni eru rundbogaðvinduerne er rundbuede
rundbogastílur	(arkitektur)rundbuestil
rundbogi	(arkitektur)rundbue
rundbóltur	(idr.)rundbold
rundbygdur	(båd.)med rund bund
rundbøllingur	rund sten
rundbøllutur	1rund, buttet,ein rundbøllutur kneysi;høvdið á grindahvali er rundbøllut og verður nevnt kúlan2sammenrullet,hann fór so rundbøllutur stiklandi omaneftir, fekk hvørki hendur ella føtur fyri seg
runddorg	redskab til sejfiskeri(snøre med mange kroge, der går i kreds),dyrgja við runddorg
rundferð	rundrejse
rundføttur	slem til at falde,tú ert rundføttur, dettur um hvønn sparlalort
rundingur	runding, kreds, cirkel,báturin varð rógvin tríggjar ferðir í runding við sólini
rundkoyring	rundkørsel
rundleittur	rundagtig,eru fá í dansi, verður ringurin rundur ella rundleittur;at jarðarkringurin var rundleittur, tað sástat jordens kreds var rundagtig, det kunne ses tydeligt;hin rundleitta æðubøgan
rundligur	rundagtig, buttet,á gomlum toftum er skapilsið ofta rundligt;ein lítil, rundlig og sera fryntlig konaen lille, buttet og særdeles venlig kvinde
rundmyntur	(zoo.)rundmundet
rundovnur	rundovn,rundovnur í stovunien rundovn i stuen
rundsag	rundsav
rundsalta	salte uden at flækkeel.opskære,rundsalta sild
rundskriv	cirkulære, rundskrivelse
rundstokkur	1rundstok2(håndarb.)to strikkepinde i ét
rundstykki	rundstykke
rundtentur	(bot.)rundtakket
rundtræ	rundholt
rundtæring	(geol.)sfæriodal forvitring
rundur	1rund,runt talet rundt tal;rundur føðingardagurrund fødselsdag;fylla runtfylde rundt2kuglerund,rundir steinar rulla best;(talem.)mangur lovar runt, men heldur tunt3rund, buttet, trind,hann er vorðin heldur rundurhan er blevet lidt for buttet;runtrundt,sveimar um allan bøin runt
rundvaksin	rundvoksen, rund, trind,kroppurin á kópi er rundvaksin
rundveltur	hulter til bulter,har var alt rundvelt og í einum ruðuleika
runga	runge,hann kvað, so at tað rungaði eftiríhan kvad, så det rungede
rungur	pukkel,rungur á nøsinipukkel på næseryggen
rungutur	med pukkel på næseryggen
runi	(geol.)lava
runnabládepla	(bot.)klippe-ærenpris(Veronica fruticans)
runnagirðing	hæk
runnaskógur	(bibl.)kratskov
runnastik	hæk
runnin	serenna 2
runnu	serenna 2
runnur	1(bot.)busk,berjarunnurbærbusk;tornarunnurtornebusk;(talem.)hatta átti at ligið undir rís og runni(om en som er uartig)2(med.)knude(på krop, legeme),børn høvdu runnar við skøvningarnar(pga. den engelske syge)
runt	rundt,teir róðu runt um oynnade roede rundt om øen
runublak	1snavs, dynd tildannet som en bold hvormed drenge bombarderer hinanden i leg2(overf.)bagvaskelse,teir tveitast við runubløkum
runubloti	mudderpøl,túnið er ein runubloti
runudálkaður	snavset af mudder el. dynd
runudíki	mudderpøl
runukaka	(leg)mudderkage,at gera runukakur vóru genturnar kringari til enn dreingirnir;baka runukakur
runusíl	ørred der holder af at rode i mudder
runutur	pløret, mudret,runutar gøturplørede veje
runuvatn	muddervand
runuveit	muddergrøft
rupl	uro i søen,rupl í sjónum
rupla	rive el. røre i noget,tú ruplar alt um;rupla í eplunum til at fáa nálirnar av
ruplaligur	(om søen)urolig,tað verður nakað ruplaligt um fjørðin
ruplutur	(om søen)urolig,ruplutur sjógvururolig sø;ruplut er útiá, enn verri undir landinum
rupul	uro i søen,rupul í sjónum
rura	1dysse,rura e-n í svøvnel.blunddysse nogen i søvn;rura fyri e-m;hond, ið rurar, hond, ið ræður(moderen)2rokke, vippe,títt leika stokkarnir, meðan hon rurar aftur og fram
ruran	det at dysse
rusk	1affald, skrald,í øllum ruskinum har sum bakarnir eiga;(overf.)hann letst, sum øll eru ruskhan opfører sig som om ingen er noget værd2støv, støvgran, snavs,fáa rusk í eygaðfå noget (et fremmedlegeme) i øjet;taka rusk úr eyga3slemt vejr, ruskvejr,sirmið gjørdist til grovt rusk;(poet.)tá var vetur og vátakavi og rusk
ruska	1ruske, rive,ruska uppruske op;ruska í e-nruske i en;ruska mat í segguffe i sig2(om uvejr)tage til, blive strengere,hann fer at ruska veðriðvejret begynder at blive uroligt, stormfuldt;út á dagin ruskaði hann lágt
ruskbilur	skraldevogn, renovationsvogn
ruskbingja	affaldscontainer
ruskdagur	dag med slemt vejr
ruskdungi	affaldsbunke, affaldsdynge
ruskinnsavning	affaldsindsamling, renovation
ruskílat	skraldespand, skraldebøtte, affaldsspand, skarnspand, skarnbøtte
ruskkassi	skraldespand, skraldebøtte, affaldsspand, skarnspand
ruskkoyring	renovation
ruskmaður	skraldemand, renovationsarbejder
ruskovnur	brændingsanstalt for affald
ruskpláss	affaldsplads
ruskposi	affaldspose
ruskspann	skraldespand, affaldsspand, skarnbøtte, skarnspand, skraldebøtte
ruskstøð	forbrændingsanstalt
ruskutur	1(om vejr)slem, barsk, urolig,veðrið var ruskutvejret var slemt2(om personer)bøs, vred,risin er ógvuliga ruskutur3snavset,(poet.)grátt og rátt og runuvátt rennur ruskut túnið
ruskveður	ruskvejr
rusl	1skrammel, ragelse2kragetæer
rusla	skrive hastigt, kradse ned, grifle
rusp	jaskeri, klatteri
ruspa	1gøre noget hurtigt og dårligt, jaske,ruspa e-t frá hondinijaske et stykke arbejde af;ruspa e-t saman2skrabe, rode,ruspa eitt sindur í hoyggið3skrive hurtigt og skødesløst,ruspað í skundi
russari	russer
russi	russer
russiskur	russisk,russisktrussisk sprog
Russland	Rusland
russur1	russer
russur2	uordentlig klædt person
russutur	uordentlig klædt,russut klæddur
rust	1bjergryg,áir og gjáir, rustir og bustir eru mark2ryg på hval, øverste kant på en hval(også: kant nedentil på en hval),rust av bøkslum til homlubond;jf.rustarspik
rusta	ruste, angribes af rust,knívurin er rustaðurkniven er rustet;jf.gravrustaður
rustarspik	hårdt og bruskagtigt spæk på hval(fx i lufferne)
rustblettur	rustplet
rustdyggur	rustfri
rustetast	ruste,(poet.)lat ei rustetast brand
rustfríur	rustfri,rustfrítt stálrustfrit stål
rustikustur	(foragteligt om)rustædt genstand(fx bøsse, skib)
rustlittur	rustfarvet
rustloysari	rustfjerner
rustreyður	rustrød
rustur	rust,reyður í rustirød af rust
rustverja	rustbeskyttelse
rustviðgera	rustbehandle
rustviðgerð	rustbehandling
rusutur	urolig, støjende,hon er so rusut, at eg vænti, hon verður skjótt rættiliga ør
rut	1levninger fra et fiskemåltid2andenklasses fisk,toskurin verður flaktur og tann stóra longan, men rutið fer sum ísfiskur
ruta	rute
rutast	rive i, rode med noget,hon rutast í øllumhun gør al slags arbejde;tað ber ikki til, at eitt fólk fer við máli sínum sum við einum gomlum koti, tú rutast í gerandisdagar heima við hús
rutt	seryðja,riða
rutu	serjóta,róta
rutubilur	rutebil
rutubussur	rutebil
rúðrutur	ujævn, ridset, skrabet, med mange små ujævnheder,rúðrut húðujævn hud
rúður	(zoo.)rur
rúðurbori	(noaord)strandskaden(tjaldur)
rúðurkragi	pibekrave
rúðurpadda	(zoo.)skrubtudse(Bufo bufo)
rúgva1	1dynge, opdynget hob, masse, bunke2mængde,teir fingu eina rúgvude fangede en masse fisk;nógvel.lítið í rúgvuaf stort el. lille omfang
rúgva2	fylde, optage plads,(bibl.)alt ilt skal eg rúgva yvir teir;rúgva segel.rúgvast (saman)ophobe sig,rúgvast upphobe sig op;rúgvaðurfyldt,yrkingin er rúgvað við dirvi, reystleika og styrki(digtet er fyldt med);rúgva uppfylde meget;var kornið vátt, rúgvaði tað meira upp
rúgvismikil	omfangsrig, som fylder meget
rúgvufóður	fyldefoder,annað rúgvufóður eiga vit ikki enn hoyggj
rúgvuligur	som fylder meget
rúgvulítil	som kun fylder lidt
rúgvumikil	omfangsrig, som fylder meget
rúgvutal	í rúgvutalii massevis;teir duga rímur og søgur í hópatali
rúgvuvís	i ordforb.í rúgvuvísi læssevis
rúilsi	(talesp.)ruelse, samvittighedsnag,rúilsi kom á hannhan havde samvittighedsnag
rúka	1ryge, afgive røg,tað rýkur úr skorsteinidet ryger fra skorstenen;tað var farið at rúka uppi í bygdini(folkene var vågnet),rúka av(om ild)ikke ryge længere2dampe, dunste,tað rýkur upp úr pottinumdet damper af gryden;tað rýkur úr sandinum3lugte, udsende lugt,tað rýkur væl / illadet lugter godt / dårligt;rósurnar rúka so vælroserne dufter så dejligt;hann reyk av brennivínihan lugtede af brændevin;hann reyk sum ein tunnahan lugtede stramt af brændevin4lugte, snuse,rúka at (e-m)lugte til (noget);hon rýkur at mosanum5ryge, fyge,tað bæði rýkur og fýkurdet blæser voldsomt;tað reyk illa inn í bátin;fossarnir rúka uppum6ryge, styrte, fare(hastigt, heftigt),hann reyk av durunumhan for til dørs;árin reyk avåren knækkede (midt) over;(poet.)bylgjurnar tær rúka av stað sum skjótasta hind;rúka á (e-n)ryge løs på en, anfalde en(pludselig og voldsomt),rúka samanfare i hårene på hinanden;prísirnir vóru roknir upp ígjøgnumpriserne var steget kraftigt7rúkandi:rúkandi illveðuret forfærdeligt uvejr;rúkandi stormuren voldsom storm;rúkandi óðurvoldsomt vred;rúkandi ósamdirganske uenige;kumpassin var so rúkandi skeivkompasset var meget skævt
rúm	1plads, område,ikki var rúm fyri teimumder var ikke plads til dem2rum, værelse3(båd.)plads imellem tofterne i en båd,tofturúm, bógrúm, siglurúm
rúma1	rumme, kunne give plads,húsið rúmar teimum ikkihuset kan ikke rumme dem;rúmastrummes, få plads,í skríninum rúmaðist allur posturin;alt fólkið rúmtist ikki inni
rúma2	(båd.)danne "rúm" i båd,hann rúmaði bátin, so at bakskuturin kom at vera minni;rúma sundursætte tofterne i en båd
rúman	sigla rúmansejle rumskøds
rúmasigling	(båd.)rum sejlads;jf.rúmur (4)
rúmár	(båd.)åre anvendt ved rúmbekkur,árarnar vórðu lagdar eftir bekkjunum, toftuárin uttast, síðan bógvárin, og innast rúmárin
rúmbekkur	(båd.)den næstbageste tofte
rúmbúgvi	kollegianer
rúmd	1plads,húsini vóru smá, so har var eingin rúmd til avlopshuset var lille, så der var ingen plads tilovers;her er bæði rúmd og líkindi fyri nógv meiri fólki2kapacitet3(astronomi)himmelrum, verdensrum,úti í rúmdiniude i verdensrummet;(poet.)rúmdar kalda tøgn;rúmdin endaleysa andar so kalt
rúmdarbúni	rumdragt
rúmdarfar	rumfartøj
rúmdarfari	astronaut
rúmdarferð	rumrejse
rúmdarferja	rumfærge
rúmdarhylki	rumkapsel
rúmdarmaður	astronaut
rúmdarskip	rumskib
rúmdarstøð	rumstation
rúmdarøld	rumalder
rúmdur	(båd.)hvad angår plads imellem tofterne i en båd,báturin er ikki væl rúmdurpladserne mellem tofterne er ikke rummelige nok
rúmgóður	med god plads, rummelig,ein rúmgóð, vøkur og bjørt kirkjaen rummelig, smuk og lys kirke
rúmhyrntur	(om vædder)med stort mellemrum mellem hornene
rúmka	gøre rummelig, udvide,so hvørt hann át, rúmkaði hann reimina eini tvey hol;hann roynir altíð at rúmka viðurskiftini hjá teimum fátækuhan forsøger altid at forbedre forholdene for de fattige;(poet.)hann ræsurnar rúmkaði tær;vindurin rúmkar(ved sejlads)vinden bliver mere rum;rúmka umgøre rummelig;hønan rúmkasthønen skal snart lægge æg
rúmkan	udvidelse,rúmkan fyri andanum
rúmlendi	åbent terræn,teir komu út á rúmlendi og á fagran vøll
rúmliga	godt og vel, noget ud over,báturin var rúmliga hálvsettur;rúmliga hundrað metrargodt og vel hundrede meter
rúmligur	1rummelig,kømurini eru stór og rúmligværelserne er store og rummelige2rigelig, masser af,...um vetrarfóðrið var knípið ella rúmligt3holden, velbeslået,eg fari ikki so rúmlig av bygdini
rúmloysi	pladsmangel,vegna rúmloysipå grund af pladsmangel
rúmmaður	(båd.)mand som har sin plads i "eysrúm",nógvur sjógvur kom inn, so rúmmenninir ofta máttu leggja inn at oysa
rúmmál	(mat.)1rummål, rumfang2kapacitet
rúmmetur	(mat.)kubikmeter
rúmmikil	rummelig, omfangsrig,skúlin er bæði rúmmikil og sterkurskolen er både rummelig og solid
rúmrót	(mat.)kubikrod,3 er rúmrótin av 273 er kubikroden af 27;jf.rót (8)
rúmsáttur	rummelig, med god plads,har er rúmsátt innider er rummeligt indenfor;landið er nóg rúmsátt til teirralandet er stort nok til dem;koyggjan var bæði stór og rúmsáttkøjen var både stor og rummelig
rúmskinnaður	med løst siddende skind eller hud,hetta verður góð mjólkkúgv, hon er so rúmskinnað
rúmskygdur	fordomsfri, tolerant
rúmtak	kapacitet
rúmtal	(mat.)kubiktal,rúmtalið til 3 er 27kubiktallet til 3 er 27
rúmtollur	(båd.)åretold ved rúmbekkur
rúmtøkur	tredimensional,høggmyndir eru rúmtøkarskulpturer er tredimensionale
rúmur	1rummelig,eitt gott og rúmt land;rúmt snar verður gjørt á endan (á línuni);sigla fjørðin rúman(så at man kan se ind i den åbne fjord),í rúmari merkingi videre forstand2(om tid)rigelig, mere end nok,í rúmari tíði god tid;rúmt hálvt árgodt og vel halvt år3med gode betingelser,hann var ikki rúmur við pengumhan havde ikke ret mange penge;vit høvdu tað ikki so rúmt tá á døgum(ikke mange penge, ikke meget at rutte med)4sigla rúmtel.rúmansejle rumskøds5(om en høne)rúmsom snart skal lægge æg6som trækker vejret let,hann hevur verið trongur, men nú er hann rúmarihan har haft åndedrætsbesvær, men nu trækker han vejret lettere
rún	rune,rista rúnirriste runer,serista 2
rúna	trylle, hekse,hann rann og rann, men ikki leið um fliðuna, hann var sum rúnaður fastur
rúnabinda	fortrylle, tryllebinde,rúnabundintryllebundet
rúnabók	trolddomsbog
rúnafrøði	(lingv.)runologi
rúnafrøðingur	(lingv.)runolog
rúnakelvi	runestav
rúnakønur	runeekspert
rúnar-	rúna-
rúnarað	(lingv.)runealfabet,eldra rúnaraðiðdet ældre runealfabet;yngra rúnaraðiðdet yngre runealfabet
rúnarista	runeristning
rúnaristur	runeristet,alt stóð sum rúnarist í tonkunum
rúnarøð	runealfabet
rúnasteinur	runesten
rúsa1	(mar.)ruse
rúsa2	beruse,rúsa segberuse sig;rúsandiberusende;rúsandi drykkuralkohol;rúsaðurberuset
rúsa3	styrte af sted, storme frem,rúsa framstyrte af sted
rúsdrekka	alkohol, spiritus
rúsdrekkabann	spiritusforbud, alkoholforbud
rúsdrekkakoyring	spirituskørsel
rúsdrekkaloyvi	spiritusbevilling
rúsdrekkalóg	(jur.)spirituslov
rúsdrekkamisnýtsla	spiritusmisbrug, alkoholmisbrug
rúseitur	(med.)rusgift, narkotikum
rúsevni	(med.)narkotikum, narko, euforiserende stof
rúsevnismisnýtari	narkoman, stofmisbruger, eufoman
rúsevnismisnýtsla	narkomani, stofmisbrug, eufomani, narkomisbrug
rúsløgur	alkohol, spiritus
rúsur	rus
rút	i ordforb.(en leg),bólta rútslå kolbøtte
rútaglas	rudeglas
rútardrongur	(kortspil)ruder knægt
rútaress	(kortspil)ruder es
rútarfrúgv	(kortspil)ruder dame
rútari	(kortspil)ruder
rútarkongur	(kortspil)ruder konge
rútaspræna	(på køretøj)sprinkler
rútaturkari	vinduesvisker, visker
rútur	1rude, vinduesrude2firkant, tern,rútarnirstrikkemønster3(på en blanket)rubrik, felt
rútutur	rudet, ternet,rútut teppiternet tæppe
ryðja	1rydde,ryðja jørð (el.jarðir)rydde den dyrkede mark (bøur) for småsten;ryðja sær rásel.ræsurbryde sig en bane2male,ryðja maltskrå, grutte malt3glide (ned), falde, drysse,grót ruddi oman úr fjøllunumder faldt (med mellemrum) store sten ned fra bjergene;støvið ryður niður yvir hannstøvet drysser ned over ham;hann hevur rutt í svørðinel.nú er rutt í svørðinder er faldet så megen sne, at marken er hvid4(om æg)falde ud,eggin ryður
ryðmold	mør, let bearbejdelig jord, finjord
ryggbrotna	få sin ryg brækket,einaferð ryggbrotnaði ein hestur
ryggbróta	brække ens ryg,mýrisnípu skjýtur kjógvin seg niður á, so hon verður ryggbrotin
ryggdýr	(zoo.)hvirveldyr(Vertebrata)
ryggfjøður	(fisk.)rygfinne
rygging	bølgekam som ikke bryder,brotini vóru ikki av tí ringasta, men ryggingarnar vóru øgiligar
ryggja1	1danne ryg el. kam i en kartoffelmark,ryggja upp eplaveltu2(om bølger)danne kam(uden at bryde),tað ryggjar á boðanum, hann er um at bróta
ryggja2	1bedrøve, volde en sorg2bevæge, rokke,einki skal ryggja hennara veldiintet skal rokke ved hendes magt;tað ryggist ikkidet er uigendriveligt
ryggjaður	(om kartoffelmark)med rygel.kam,veltan er so tætt ryggjað
ryggjarfattur	svajrygget
ryggjarfjøður	(fisk.)rygfinne
ryggjargeisli	(biol.)ryghvirvel
ryggjarstykki	(på fårekrop),rygstykke,ryggjarstykkini eru hálsur, háryggur, mjóryggur og hárógva
ryggjarvøddi	(biol.)rygmuskel
ryggjutur	(om kvæg)med hvid ryg,ryggjut kúgvko med hvid ryg
ryggleysur	(zoo.)hvirvelløs,ryggleys dýrhvirvelløse dyr(Invertebrata)
rygglund	(fisk.)rygmuskelen der omslutter hvirvlernes øverste halvdel og de opadstående tappe(på fisk)
rygglundir	mørbrad
ryggsekkur	rygsæk
ryggskaði	rygskade,hann hevði fingið ryggskaða av tungum burði
ryggsneið	kotelet
ryggsterkur	som har en stærk ryg
ryggstirvin	(med.)stiv i ryggen
ryggsvimjing	(idr.)rygcrawl
ryggtak	hold i ryggen, hekseskud,tak nú ikki ryggtak á teg
ryggur	1ryg,ryggdýr hava rygg úr geislum;taka ryggin úr(når fisk bliver fileteret),ryggurin var ikki úrtakandi nøkrum sterti, so smátt var slagið;(overf.)ryggurin var ikki úrtakandi nøkrum av teimumom uduelige personer;missa rygginforløfte sig;rætta seg í rygginumrette ryggen;tað kiknaði í rygginumman fik et hold over ryggen,sekikna;ganga til ryggjarbukke under, lide nederlag;hon formár sær einki, hon verður drivin til ryggjar;dettael.fara um rygg(om køer)falde og blive liggende på ryggen;(overf.)renna e-n um ryggløbe én omkuld;eta seg yvir rygg(in)(om køer, også overført om mennesker)forspise sig2ås, højderyg,undir rygginum millum vøtnini3langstrakt havbund,Hetlandsryggurin4bølgeryg,á krossmessu er ryggurin brotin á havalduni5ryg el. kam i kartoffelmark,moldin verður løgd upp í breiðar ryggir6(ved høhøst)"ryg" hø,leggja upp í ryggir7i ordforb.leggja upp á rygg(om reb o.lign.)flette (slå) af fire snore(med spjaldur),herðabond vórðu altíð løgd upp á rygg
ryggverkur	hold i ryggen,takael.bera ryggverk á segfå hold af at bære på ryggen
rygna	(om fisk)gyde, udtømme rogn,rygnastfå rogn,nú fer fiskurin at rygnastnu begynder fisken at få rogn
rygndur	(om fisk)med rogn,fiskurin er vælel.illa rygndurfisken har gode, dårlige rogn
rygning	gydning
rykk	ryk,hann gjørdi eitt rykk á seg
rykkiband	løbebånd
rykking	1rykning2rynkning(fx på færøsk hue),tá var í brúki at hava rykkingina (á føroyskari húgvu) liggjandi fram á ennið3(som vejrmærke)stribe,rykkingar á luftinistriber på luften(som tegn på godt vejr)
rykkingarband	løbebånd
rykkja	1rykke, trække med ryk,í somu stund varð hurðin rykt upp;rykkja og skrykkjarykke og hale i;eg vaknaði við, at eitt rykti og skrykti í fingurin;(bibl.)hin óreini andin rykti og skrykti í hann;rykkjastslås, brydes2(økon.)rykke, sende en rykker,rykkja eftir gamlari skuld;jf.rykkjari3(ved syning af tøj, sko etc.)rynke, gøre rynket,rykkja (føroyska) húgvu;ryktar buksur og kvarðaðar;rykkja brýrrynke bryn
rykkjari	(økon.)rykker
ryktast	(talesp.)rygtes
rykti	(talesp.)rygte, forlydende
rylkja	rynke, sammenrynke,rylkja gákin saman
rymja	rumle,tað rymur fyri bróstinumel.bringuni(pga. forkølelse),tað rumdi í búkinumdet rumlede i maven
ryski	(bot.)frytle(Luzula),margblømt ryskimangeblomstret frytle(R. multiflora),tættblømt ryski(R. campestris)
ryssa	1(zoo.)hoppe,(talem.)stendur (og nípirel.bínir) sum ryssa uppi yvir deyðum fylifortabt, betuttet, himmelfalden2buk(under bord)3i ordforb. somríða ryssuni skjarru(leg)vippe4(kortspil)ruder ni i kortspillet styrvolt
ryssufyl	(zoo.)hoppeføl, hunføl
ryssuhjálmi	hoppes fosterhinde,tann ið fann ryssuhjálma, kundi kasta hvørvu yvir seg
rystka	(etym.)->riska
ryta	ride
rytma	rytme
ryvja	udslæt (svedknopper el. lign.) hos spædbørn
rýða	smøre, påsmøre, besmøre,rýða smyrsl ásmøre salve på;(bibl.)rýða blóð upp á durastavirnar;rýða e-m e-t um nasarbebrejde en noget, beskylde en for noget
rýkur	serúka
rýma	rømme, flygte,vindurin gjørdi, at vit máttu rýma haðaniblæsten tvang os at rømme vores pladser;rýma úr landiflygte fra et land
rýming	rømning, flugt,sleppa (sær) til rýmingarslippe bort;taka til rýmingarløbe bort
rýmingarávaring	evakueringsalarm
rýmingarroynd	flugtforsøg
rýmingarskipan	evakueringssystem
rýmingarútgerð	evakueringsudstyr
rýmingarvegur	flugtvej
rýmingarætlan	evakueringsplan
rýmingur	desertør
rýpa	(ornitol.)rype(Lagopus)
rýtma	rytme
rýtur	serjóta
ræ	ådsel, død krop,sum piðað ræradmager
ræast	(om kniv),sløves,knívurin ræist(Sv);jf.rá (3)
ræddhugi	fejhed,ein, sum av býttskapi og ræddhuga varð hildin fyri spott
ræddoygdur	med bange øjne
ræddur	ræd, bange,ræddur fyri e-mbange for nogenel.noget;hann var ræddur við bakka;(ordsp.)hann (el.mangur) er ikki so ræddur sum illa klæddurhan er mere modig end han ser ud til at være
rædduskítur	kujon, fej og ussel karl
rædjór	(zoo.)dyr der æder ådsler
rædýr	(zoo.)dyr der æder ådsler
ræð	seráða
ræða1	1skræmmebillede2fugleskræmsel
ræða2	skræmme, forskrække, gøre bange,ræðastvære bange;ræðast fyri e-mfrygte, være bange for noget;ræðst ikki;ræðast blóðbange for blod;ræðast vatnhave vandskræk
ræði	herredømme, myndighed, magt,hava ræðihave myndighed over;taka ræði;taka e-n av ræðitage magten fra nogen;sita við ræðisidde ved magten
ræðiligur	frygtelig, skrækindjagende
ræðimikil	streng, striks,hon er ræðimikilhun er striks
ræðing	afskrækkelse
ræðsla	rædsel, skræk,ræðsla kom á hannhan blev grebet af rædsel;har var ræðsla og grátur á fólki;ófriðarskip, ið loyptu ræðslu á fólk
ræðslubundin	grebet af rædsel
ræðslukendur	ængstelig
ræðslumikil	rædselsfuld, forfærdelig,tann ræðslumikli sannleikin
ræðslusjón	rædselssyn
ræðslusligin	rædselsslagen
ræðslutikin	rædselsslagen
ræðubílæti	skræmmebillede
ræðufilmur	gyser, thriller
ræðuleiki	rædsel, grufuldhed,slepp okkum undan at hoyra um fleiri ræðuleikarvi vil ikke høre om flere rædsler
ræðuligleiki	rædsel, grufuldhed
ræðuligur	1frygtelig, forskrækkelig,ein ræðuligur ganguret forskrækkeligt spektakel2(talesp.)enorm, kolossal, vældig,ein ræðulig fólkarúgva var samankomin;øll skip fingu ræðuligan fisk;-liga
ræðumynd	skræmmebillede
ræður	seráða
ræðusjón	rædselssynræðandi sjón
ræðuskítur	kujon, fej og ussel karl
ræfuglur	(ornitol.)ådselfugl
rægammur	(bibl.)ådselgrib
rækja	(zoo.)reje(Natantia)
rækjubland	rejecocktail
rækjutrolari	(skib.)rejetrawler
rækjuvirki	rejefabrik
ræklukka	(zoo.)ådselbille(Silphidae)
ræla	1drive langsomt og skånsomt,ræla seyð;ræla gæs2(om vædder)vise tegn på parringslyst,seyðurin er farin at rælafårene er begyndt at vise tegn på parringslyst;(overf.)jagte damer,hatta gongur og rælir allastaðni
rælari	(neds.)kvindebedårer, don juan,hann varð sagdur at vera tølari og rælarihan blev betegnet som en frister og kvindebedårer
ræna	1røve, plyndre,herja og rænaplyndre og røve;teir rændu ein bankade røvede en bank2(fuglefangst)plyndre reder i fuglefjeldene3(ved deling af får)gøre den ene andel større på bekostning af den anden(som gerne består af et særdeles godt får),nú rændi tú handa partin illa;hann varð rændur í býtinum4udspejde fugle for at få fat i deres æg,ræna skúgv;ræna dunnu;skjótt er at avoyða ternu, tí hon er so góð at ræna;(overf.)ræna fríggjaraparligge på lur efter to som er kærester
rænari	røver
ræning	1ægsamling, redeplyndring i fuglefjeldene, det at tage lomviens æg,ræningin sveik illa í ár, ikki var meir enn hálvvorpið2tiden når ægsamlingen finder sted,í ræning
ræningardagur	(fuglefangst)dag når der plyndres reder i fuglefjeldene,seinasti ræningardagur
ræningartíð	(fuglefangst)tiden når ægsamlingen finder sted
ræplanta	(bot.)rådplante
ræplantuætt	(bot.)blærerodfamilien(Lentibulariaceae)
ræsa1	lade gå i gæring,ræsa grunningshøvdlægge torskehoveder i bunke og lade dem gå i gæring
ræsa2	ræsa seyð1drive får ad en smal sti2drive får voldsomt (frem og tilbage),hann ræsti tað fyri sær at vita, hvat tað toldi
ræsa3	lade fiskesnøren løbe til bunds,hann ræsir og heintar
ræsi	1kanal, lille vandløb,eitt ræsi rennur omanfyri og eitt niðanfyri2(biol.)urinrør
ræsing	det at "ræsa"(lade gå i gæring),krov hanga til ræsingar í hjallinum
ræsna	begynde at gå i gæring
ræstna	begynde at gå i gæring,fiskurin er ræstnaður
ræsttornaður	(om fisk)tørret efter at den først er blevet "ræstur"
ræstur	(især om tørret kød og fisk)som er begyndt at gå i gæring, som har en vis skarp og stram smag,ræstur fiskur;ræst kjøt;ræstur tari
ræsur	serás
rætla	1bringe i orden;rætla segel.rætlastfalde i leje;hann hevði verið sjúkur, men tað hevur rætlað seg afturhan havde været syg, men var nu kommet sig efter sygdommen2irettesætte,tú kanst tola, at ein rætlar teg eitt sindur
rætna	1rettes op(om noget kroget),ein rætnaður stórongul;hann er eitt sindur rætnaður í rygginum2læges, blive bedre,tað vardi minst tríggjar dagar, áðrenn eg rætnaði afturdet varede mindst tre dage, før jeg blev rask igen;rætna við (aftur)komme sig igen
rætt1	fårefold,í rættind el. inde i folden;reka seyð í rættdrive får i fårefolden;gongan kom í rætt;sum seyður í rættsom sild i tønde;á rætt1hen til el. ved folden, indel.inde i folden,teir fingu ikki seyðin á rætt;alt var vargur, lítið kom á rætt bæði vár og heyst2(op) til fårefolden,hann slapp á rætt við mati, tá ið fjallmenninir komu við gonguni;tá ið gongan kom í rætt, sluppu børnini á rætt
rætt2	serættur 3
rætta1	retside;troyggjan er á rættunitrøjen er på retsiden
rætta2	drive får i fold,rætta seyð;rætta rossdrive heste i fold
rætta3	rette, berigtige,rætta mistakberigtige en fejltagelse;rætta stílrette en stil;rætta kumpass;rætta segrette sig, føje sig
rætta4	1rette, gøre lige,rætta útrette ud;rætta tongtrække krog (prøve styrke ved at) rette en andens krummede finger ud;rætta seg upp, rætta seg í rygginumrette (ranke) ryggen;hann rætti seg í sæti2række, udstrække,rætta hondina fram (út, upp)række (strække) hånden frem (ud, op);rætta (e-m) eina (hjálpandi) hondgive en håndsrækning;hann rættir ikki hondina frá særhan er fornæret;rætta fingrarnar frá særvære langfingret, tyvagtig;rætta seg eftir e-mrække sig ud efter noget3række, overrække(en noget),rætta e-m e-trække nogen noget;ger so væl at rætta mær sukrið;sum at rætta hundi brand(om noget som er meget forhadt)
rættaeystur	(båd.)styrbords-øserum
rættaravgerð	(jur.)retsafgørelse, retshandling
rættarbak	bagside af fårefold, skrånende side på et græstørvgærde(udvendig)
rættarbotnur	inderste ende af en fårefold,rættarbotnur er innast í rættini
rættarbók	(jur.)retsbog
rættarbrot	(jur.)retsbrud
rættardyr	indgang til en fårefold,tá ið seyðurin kemur fram við viðtøkugarðinum og at rættini, kemur hann í ein tronga, sum er rættardyrnar
rættardømi	(jur.)retskreds
rættarforseti	(jur.)retsformand
rættarfundur	(jur.)retsmøde
rættarførur	(om får)i stand til at blive taget i fårefolden,hatta krovið er nóg frætt, tí ærin var at kalla ikki rættarfør í heyst
rættargangslóg	(jur.)retsplejelov
rættargangur	(jur.)rettergang, retssag
rættargarður	gærdet omkring en fårefold
rættargildi	(jur.)retsgyldighed, retskraft
rættargonga	(jur.)rettergang
rættargongd	(jur.)rettergang
rættarhjálp	(jur.)retshjælp
rættarhjáseti	(jur.)retsassessor
rættarhøli	(jur.)retslokale, retssal
rættarkálvi	inderste del af en fårefold, rummet hvor fårene står
rættarkjaftur	åbningen på rættargarður
rættarkrav	retskrav,seta fram rættarkravfremsætte et retskrav
rættarlag	grund fra en fårefold
rættarleysur	(jur.)retsløs,teir vóru rættarleysir eins og vill djórde var retsløse ligesom vilde dyr
rættarligur	(jur.)retslig, retlig,ein rættarligur úrskurðuren retslig kendelse;-liga;jf.løgfrøðiligur
rættarloysi	(jur.)retsløshed,ótrygd og rættarloysi valdaðuutryghed og retsløshed rådede
rættarlæknafrøði	(med.)retsmedicin
rættarlækni	(med.)retsmediciner
rættarlæring	(jur.)retsbelæring
rættarmál1	retssprog,lóg um føroyskt rættarmállov om færøsk retssprog
rættarmál2	(jur.)retssag, søgsmål
rættarmunni	åbningen på rættargarður
rættarnevnd	(pol.)retsudvalg
rættarregla	(jur.)retsregel,eftir somu rættarreglum sum fyri 5-600 árum síðanefter de samme retsregler som for 5-600 år siden
rættarsalur	(jur.)retssal
rættarsamfelag	retssamfund
rættarskipan	(jur.)retsorden, retssystem,grundlógin er støðið undir rættarskipaninigrundloven er grundlaget for retssystemet
rættarsókn	(jur.)retsforfølgning
rættarstig	(jur.)instans
rættartrygd	(jur.)retssikkerhed,rættartrygdin er í vandaretssikkerheden er i fare
rættartræta	(jur.)retstrætte
rættartrøð	indhegning ved fårefold
rættarull	uld efterladt i en fold
rættarúm	(båd.)styrbordsrum,eg róði í rangarúmi og systkinabarnið í rættarúmi;fremra rættarúm, aftara rættarúmforreste styrbordsrum, bageste styrbordsrum;jf.rangarúm
rættarúrskurður	(jur.)retskendelse, kendelse, dom, judicium,rættarúrskurðurin gav honum ikki viðhaldretskendelsen gav ham ikke medhold
rættarvernd	(jur.)retsbeskyttelse
rættarviðgerð	(jur.)retsforhandling
rættarvitni	(jur.)retsvidne
rættarvørðsla	indgang til en fårefold, rum imellem to fra fårefolden udløbende gærder
rættatoft	(båd.)á rættutoftel.røttutoftplads i styrbordsside på toften,hann sat á røttutoft og helt har
rættatofta	(båd.)plads i styrbordsside på toften
rættferð	retfærd,(bibl.)hann elskar rættferð og rætt
rætthugsandi	rettænkende,ongum rætthugsandi Guds barni leingist at doyggja
rætthugsin	rettænkende
rætthyrningur	(mat.)rektangel
rætthyrntur	(mat.)vinkelret, retvinklet,rætthyrntur tríhyrningurvinkelret trekant
rættiliga	1helt, rigtig, ganske,tað er rættiliga vistdet er ganske sikkert;ikki rættiliga álítandiikke rigtig (ganske) til at stole på;ein rættiliga stórur parturen rigtig stor del;rættiliga væl;rættiliga illurganske vred2retskaffent, på retskaffen og ærlig måde,tá ið teir rættiliga fingu at vita, hvussu vorðið var
rættiligur	1rigtig, fuldstændig, ægte,omma var ein rættilig omma í orðsins besta týdningibedstemor var en rigtig bedstemor i ordets bedste betydning;hann var eitt rættiligt ólukkudýrhan var en rigtig stakkel;ein rættiligur ribbalduren rigtig vildbasse2som gør en forskel,tað var rættiligt áarføri;har var rættiligur hurlivasi3retskaffen, ærlig,hann bar ikki orð fyri at vera rættiligur;hann var ikki rættiligur og stjól seyð4normal,nei, rættiligur kann hann ikki vera, tí hann hevur ongan skugga
rættilækni	(med.)ortopæd
rættindi(r)	rettigheder
rætting1	rettelse, korrektion,stílurin var fullur av rættingumder var mange rettelser i stilen
rætting2	det at drive får i fold
rættis	i ordforb. somleggja til rættistilrettelægge, arrangere, planlægge;leggja eina bók til rættistilrettelægge en bog;leggja útvarps-el.sjónvarpssending til rættistilrettelægge radio el. fjernsynsudsendelse;tosael.tala e-n til rættissnakke en efter munden;seta seg væl til rættissætte sig mageligt til rette;hann setti seg væl til rættis at hyggja í sjónvarphan satte sig mageligt til rette for at se tv
rættisrúm	(båd.)styrbordsrum
rættkjølur	(skib.)i ordforb. somfáa eitt skip á rættkjølfå et skib på ret køl;(overf.)fáa e-n á rættkjølhjælpe en på fode igen
rættlag	orden,fáa e-t aftur í rættlagbringe noget i orden igen,koma aftur í rættlagkomme i orden igen
rættlátur	(bibl.)retfærdig
rættleiða	retlede,einki var at rættleiða seg eftir;eg má rættleiða teg, tí at tað tú sigur, er ikki rættjeg må retlede dig, fordi det du siger, er forkert
rættleiðing	retledning,hann gav honum rættleiðing um trúnna og kristnina;vraka ikki rættleiðing móður tínar
rættleiðis	i den rigtige retning,lata kirkjuna beina henda streymin meira rættleiðis, enn hann gongur
rættleiki	rigtighed,rættleikin í tí, hann sigurrigtigheden af det, han siger
rættlesa	læse korrektur(på noget),rættlesa eitt handritlæse korrektur på et manuskript
rættlesari	korrekturlæser
rættlestur	korrektur, korrekturlæsning,rættlesturin tekur langa tíðkorrekturlæsningen tager lang tid;vit fingu rættlesturin frá prentsmiðjuni í gjárvi fik korrekturen fra trykkeriet i går
rættlæti	retskaffenhed, retfærdighed,sýna rættlætiøve retfærdighed;(poet.)signað skín' rættlætis sólin
rættsiktaður	(om mennesker)normal, ved sine fulde fem,ikki rættsiktaðurikke normal
rættsinnaður	retsindig,einki rættsinnað fólk ger soleiðisintet retsindigt menneske gør sådan
rættsinni	retsind
rættsintur	(bibl.)retsindig,við teir rættsintu hann samfelag hevur
rættskaffin	retskaffen,tað er ikki rættskaffiðdet er ikke naturligt
rættskriving	retskrivning, ortografi
rættskrivingarbroyting	retskrivningsreform
rættskrivingarorðabók	retskrivningsordbog
rættskrivingarregla	retskrivningsregel
rættstavari	(datal.)stavekontrol
rættstundis	præcis, rettidig, rettidigt,koma rættstundis til arbeiðiskomme rettidigt på arbejde
rætttíðis	rettidig el. rettidigt, præcist
rætttrúgv	(rel.)ortodoksi
rætttrúgvandi	(rel.)ortodoks,rætttrúgvandi muslimurortodoks muslim
rætttrúgvin	rettroende
rætttrúnaður	rettroenhed
rættuliga	rættiliga
rættuligur	rættiligur
rættumegin	på den rigtige side
rættur1	1(jur.)ret,eftir lóg og rættii henhold til lov og ret2(jur.)domstol,hann skuldi fyri rættinhan skulle stilles for en domstol;málið kom fyri rættinsagen kom for retten;fara í rættin (við einum máli)gå rettens vej;hægstirætturhøjesteret;landsrætturlandsret;skiftirætturskifteret3(jur.)retslokale, retssal4ret, rettighed,tú hevur rættdu har ret;geva e-m rættgive nogen ret;tað hevur tú rætt ídet har du ret i;allan rættin hevur túdu har retten på din side;fáa rættfå ret;gera rætt og skjaløve ret og skel
rættur2	ret, anretning,tveir rættirto retter
rættur3	1ret, lige,beinini eru long og røtt;hava rættan rygg;koma aftur á rætt;(båd med kølen i vejret)komme på ret køl igen;binda rangt og rætt,serangur2(mat.)ret vinkel,rættur vinkulen ret vinkel3ret, rigtig,rætt er tað;hvat er røtt klokka?;sig mær, hvat er rangt og hvat er rætt;rætt skal vera rættret skal være ret;av røttumel.rættumegentlig, i grunden, med rette;hann kann av røttum vera stolturhan kan med rette være stolt4rigtig, ægte, sand,ein rættur maðuren sand dygtig mand;ein rættur ribbalduren rigtig vildbasse;hon var eitt rætt konubrothun var en rask og dygtig kvinde;tað var ein røtt illveðursnátt;ein rættur yvirgangskroppuren rigtig bandit;nú er rætta gabbið á henni5rætt1rigtigt2just, netop,skeivleikin er rætt tann, at ...;rætt sumligesom,rætt sum dreivaður hani;rætt sum hetta hendii samme øjeblik som dette skete
rættvaksin	ret, lige,ein rættvaksin vøkstur
rættvinklaður	(mat.)vinkelret
rættvísandi	(mar.)rættvísandi norðanlige nord
rættvísgera	1(bibl.)retfærdiggøre,rættvísgjørdur við trúgv;rættvísgera segretfærdiggøre sig,hvussu skulu vit rættvísgera okkum2værge, forsvare,hvussu kanst tú rættvísgera eina slíka ógerð?hvordan kan du forsvare en sådan skændig gerning
rættvísgerð	retfærdiggørelse,hugmyndir um synd og rættvísgerðforestillinger om synd og retfærdiggørelse
rættvísi	retfærdighed
rættvísiliga	retfærdigt,hann dømir rættvísiligahan dømmer retfærdigt
rættvísliga	retfærdigt
rættvísur	1retfærdig, fair,ein rættvísur dómarien retfærdig dommer;ein rættvís avgerðen retfærdig afgørelse2velfortjent,ein rættvísur siguren velfortjent sejr3(bibl.)retfærdig,ein rættvísur maðuren retfærdig mand
rættvorðin	normal
rættvorðinskapur	normalitet
rættvørgur	(om tøj)rigtig vendt
rødd1	1røst, stemme,hava djúpa, grova røddvære grov i mælet;rópa við reystari rødd2(musik)sangstemme,hann syngur aðru røddhan synger anden stemme3(musik)stemme,urgan hevði nógvar røddirorglet havde mange stemmer
rødd2	seræddur
rødda	1skvaldre,gongur og røddar og røddar2rødda á málinumtale med skælvende stemme(pga. bevægelse)
røddan	højrøstet tale,tað var ein øgilig røddan
røddur	1som kan ros, skikket til roning,báturin er væl røddur2røttsom man kan ro over el. igennem, farbar,tað var røtt millum skerini á flóð;røtt sund;bert í tveimum støðum var væl røtt fyri bátar;har er ikki røttman kan ikke ro der
røð	1skarp kant,í bønum lá ein steinur við einari røð upp undan svørðinum2bjergryg,teir dagaðu undan uppi á røðini3række,fólk stóðu í longum røðumfolk stod i lange rækker;e-t kemur í aðru røðnoget kommer i anden række
røða1	tale,halda røðuholde en tale
røða2	tale, snakke,vit hava so mangt at røðavi har så meget at tale om;røða um e-tsnakke om noget;røða framundirantyde;røða ímótitale imod
røðarapallur	talerstol
røðari1	taler,góður / ringur røðarigod / dårlig taler
røðari2	roer
røðil	telefon
røðiligur	(om en åre)god at ro med,røðilig ár
røðilsnummar	telefonnummer
røði(r)	(båd.)(båds) udstyr til roning,andróður var, og teir komu onga leið, tí røðini vóru í so ringum standi
røðuhald	det at holde tale
røðumaður	taler,góður røðumaðurgod taler
røðusnild	retorik, talekunst,góð røðusnildgod retorik
røðutur	med skarp(e) kant(er),røðutir jakslir
røka	i ordforb. som(hvassur) sum røkanel.ein røka(er skarpt som en ragekniv)
røkil	(skole)ordensduks,røkilin turkar talvuna reinaordensduksen tørrer tavlen ren
røkin	omsorgsfuld, omhyggelig,røkin og pjøkin hevði hann verið
røkiskapur	røgt, omsorg, pleje
røkja	røgte, drage omsorg for, passe,teir vóru so ósamdir, at teir kundu ikki røkja bát saman;hann var dúgligur maður til at røkja bøinhan var flittig til at bearbejde jorden;(ordsp.)eingin kann allar gáttir røkja,jf.eingin kann allar dyr at goyma,segoyma;røkja handilinvaretage (passe) forretningen;røkja kalliðpasse præsteembedet;røkja land og sjógvbeskæftige sig med landbrug og drive hjemmefiskeri;røkja siglingsejle regelmæssigtfxmellem øerel.lande;røkja skúlarholde skolerne ved lige;røkja útróðurdrive hjemmefiskeri hyppigt;røkja síni ørindigøre sig et ærinde  / /røkja fyrigide,hann røkir ikki fyri at hjálpa systur síni;røkja sær fyri torvisørge for at skaffe sig den nødvendige tørv til huse;røkjast fyri:einki røkist fyri, at hann kemurder er intet der tyder på, at han kommer;røkja umgide,hann røkir ikki um at taka hondina í nakaðhan gider ikke at bestille noget
røkjuskapur	røgt, omsorg, pleje,røkjuskapur og dugnaskapur eyðkendi hetta fólkrøgt og dygtighed kendetegnede disse mennesker;(skole)fáa gott ummæli fyri røkjuskapfå god karakter i orden
røkjutur	omsorgsfuld, omhyggelig,umhugsin og røkjuturbetænksom og omsorgsfuld
røkka1	1række, nå,røkka (atel.eftir) e-mnå (at berøre el. få fat i) noget;eg røkki ikkijeg kan ikke nå(det),hann røkk at høgga í kongin;(ordsp.)eingin toyggir seg longri, enn armarnir røkka2være lang nok,bandið røkkur ikkibåndet er ikke langt nok;kjólin rakk niður á skógv;fáa endarnar at røkka saman(overf.)få det til at løbe rundt;bøndurnir fingu ikki endarnar at røkka samanbønderne fik det ikke til at løbe rundt;so langt, sum eygað røkkurså langt, som man kan se;(talem.)nú má røkka ella støkkanu må det bære el. briste3strække til, være tilstrækkeligt,røkkael.røkka til;hesin maturin røkkur ikki langt;fáa tíðina til at røkkafå tiden til at strække til;royna at fáa dagin at røkka;inntøkan rakk ikki tilindtægten strakte ikke til4røkka umomfatte;í hesum brævi, sum røkkur um árini frá 1918 til 1938i dette brev, som omfatter årene 1918-1938
røkka2	vige, trække sig tilbage,tað sýntist sum henda fylking rakk undan, tá ið hann søkti at henni
røkt	1røgt, omsorg, pleje,barninum hevur bilað røkt2tilsyn med fårene, pasning af udmarken,eingin røkt er á seyðinumfårene er vilde(pga. mangelfuldt tilsyn og pasning)3løn til fårehyrde,røktin var góð
røkta	1røgte, pleje, se efter, passe,(bibl.)Gud setti hann í urtagarðin Eden til at røkta hann2have tilsyn med fårene i udmarken,røkta seyð;tá var garðurin so illa røktaður, at alt var vargur
røktarheim	plejehjem,verael.búgva á røktarheimivære el. bo på et plejehjem
røktari	(med.)plejer
røktarsjúklingur	plejepatient
røktingarlamb	lam som røktingarmaður får som løn
røktingarløn	løn for tilsyn med fårene,røktingarlønin var tá tvey vald lomb og ein kenningarær at ganga
røktingarmaður	mand som røgter el. har tilsyn med fårene i udmarken, fårehyrde
røktingarseyður	får som løn til røktingarmaður
røktingarær	hunfår som røktingarmaður har tilladelse til at have gående i udmarken
røkur	serók
rølikur	(bot.)røllike(Achillea),margblømdur rølikuralmindelig røllike(A. millefolium)
rønta	1synge højt og på en ubehagelig måde,tey røntaðu niðurlagið2skvaldre,røntið ikki;á Jesus, hvat tey rønta úti á gongini
røntga	(med.,talesp.)røntgen,fara í røntgunafå røntgen
røntgen	(med.)røntgen
røntgengeisli	(med.)røntgenstråle
røntgenkanning	(med.)røntgenundersøgelse
røntgenmynd	(med.)røntgenbillede
røntgentól	(med.)røntgenapparat
røntgenviðgerð	(med.)røntgenbehandling, radioterapi
rør1	1rør2rør(et rørformet organ i kroppen)
rør2	serógva
røra	1røre, røre ved, berøre,hann rørir ikki brennivínhan rører ikke spiritus;røra viðberøre,barnið rørir so illa við;(overf.)tað rørdi við hjartaðdet var rørende2bevæge,hann rørir hvørki lið ella lim;tað rørdist ikkider var vindstille;røra segrøre sig, bevæge sig;hann sat so pinnastillur og rørdi seg (rørdist) ikkihan sad musestille og rørte sig ikke3røre rundt i, røre sammen, piske(spec. piske fløde el. lign.),røra rómapiske fløde;tað mesta av blóðinum verður rørt til blóðmør;røra í pottinumrøre (rundt) i gryden4ombinde, omvikle,røra húkarvikle snor omkring fiskekroge;vit rørdu húkarnar á veg yvir
røralop	(med.)lyskebrok
rørar	(biol.)lyske,fáa ilt fyri rørarnarfå smerter i lysken;fótbóltsleikarin varð sparkaður fyri rørarnarfodboldspilleren blev sparket i lysken
rørari	røremaskine, køkkenmaskine
rørdur	rørt, bevæget
rørilsi	1sindsbevægelse2bevægelse,tú treingir til rørilsidu trænger til motion
rørimaskina	røremaskine, køkkenmaskine
rørinerv	(biol.)bevægelsesnerve
røring1	1bevægelse,nú kom røring í øll;býurin var í røringbyen var på benene2stor forandring,tær veldigu røringar, sum fram eru farnar í Kina í 19. og 20. øld
røring2	bevikling, omvikling, surring
røringarfimleikur	(idr.)motionsgymnastik
røringarorka	(fys.)bevægelsesenergi, kinetisk energi
røringartráður	tyndt sejlgarn hvormed tømmen ved omvikling fastholdes til fiskekrogen
røringur	1bevægelse,hann gekk aftur og fram fyri at fáa røring í seg;hann hevði fingið røring í blóðið2røre, uro, forvirring,røringur kom í;tá kom røringur í trunkan;øll bygdin var í røringi;loypael.seta røring ísætte i bevægelse;ein tjóðskaparlig alda hevur sett røring í allastaðni;tann røringur, Martin Luther skapaði innan kirkjugátt við nýggju læru síni3urolig sø,røringur var komin í sjógvin;tað var røringur í sjónum
røritól	røremaskine, køkkenmaskine
rørleiðing	rørledning,rørleiðingin er 10 km til longdarrørledningens længde er 10 km
rørligur	1(blevet temmelig) vred,nú fór hann at vera rørligur;rørligt orðaskiftiheftig debat2bevæget, følelsesladet,ein yrking við vøkrum og rørligum orðumet digt med smukke og følelsesladede ord3bevægelig4(ny bet.)mobil,rørligt samfelagmobilt samfund
rørportur	vejrist
rørsla	1bevægelse,hann hevur fingið rørslu í blóðið2bevægelse, sammenslutning,tjóðskaparlig rørslanational bevægelse;politisk rørslapolitisk bevægelse;arbeiðararørslaarbejderbevægelse
rørslubrekaður	bevægelseshæmmet, handicappet,ítrótt fyri rørslubrekaðidræt for bevægelseshæmmede
rørslufimleikur	(idr.)motionsgymnastik
rørsluleysur	ubevægelig,andlit hennara var rørsluleysthendes ansigt var ubevægeligt
rørslunerv	(biol.)bevægelsesnerve
rørsluorka	(fys.)bevægelsesenergi, kinetisk energi
rørslutarnaður	bevægelseshæmmet, handicappet
rørsluvøddi	(biol.)bevægemuskel
rørsmiður	rørlægger
rørsoppur	(bot.)rørhat(Chalciporus)
rørsukur	(bot.)rørsukker
rørtong	rørtang
røst1	stærk strøm, havstrøm
røst2	seræstur
røtast	fæste rod
røtt	serættur 3
røttumegin	på den rigtige side
røtugás	(ornitol.)strømand
røtur	serót
røur	serógv 2
røva	1røve, plyndre,hann hevði bæði røvað góðs og gullhan havde både røvet gods og guld2være herskesyg,røva ikki so illa(sagt til barn som leger med et andet barn)
røvari	1røver,spæla røvara og soldát(børneleg)2bandsat dreng,tín røvari!din laban!
røvil	halepartiet af fisk(fx helleflynder)
røvilsbein	(fisk.)hvirvelsøjlen i en fisks haleparti
